monthofyear,year,tractce10,total,econ_crime,violent_crime,drug_crime
1,1999,540101,36,25,11,6
2,1999,540101,25,21,4,8
3,1999,540101,42,26,16,14
4,1999,540101,61,46,15,13
5,1999,540101,57,33,24,3
6,1999,540101,53,37,16,9
7,1999,540101,64,44,20,8
8,1999,540101,42,29,13,6
9,1999,540101,40,22,18,12
10,1999,540101,42,28,14,9
11,1999,540101,32,23,9,12
12,1999,540101,47,34,13,23
1,2000,540101,38,22,16,12
2,2000,540101,28,20,8,10
3,2000,540101,37,21,16,9
4,2000,540101,32,21,11,10
5,2000,540101,64,46,18,11
6,2000,540101,53,34,19,17
7,2000,540101,62,40,22,9
8,2000,540101,50,33,17,11
9,2000,540101,50,32,18,11
10,2000,540101,43,30,13,13
11,2000,540101,32,23,9,13
12,2000,540101,33,20,13,14
1,2001,540101,15,9,6,9
2,2001,540101,33,21,12,21
3,2001,540101,32,21,11,24
4,2001,540101,30,18,12,15
5,2001,540101,40,23,17,15
6,2001,540101,37,18,19,12
7,2001,540101,38,31,7,13
8,2001,540101,39,20,19,26
9,2001,540101,31,21,10,32
10,2001,540101,37,25,12,26
11,2001,540101,26,20,6,19
12,2001,540101,33,19,14,13
1,2002,540101,43,29,14,14
2,2002,540101,24,16,8,12
3,2002,540101,27,15,12,3
4,2002,540101,32,18,14,8
5,2002,540101,36,21,15,6
6,2002,540101,39,24,15,16
7,2002,540101,55,28,27,15
8,2002,540101,47,31,16,12
9,2002,540101,45,23,22,15
10,2002,540101,35,25,10,8
11,2002,540101,32,20,12,14
12,2002,540101,29,21,8,16
1,2003,540101,15,13,2,14
2,2003,540101,22,12,10,7
3,2003,540101,39,21,18,6
4,2003,540101,33,18,15,9
5,2003,540101,34,20,14,11
6,2003,540101,32,16,16,14
7,2003,540101,35,22,13,14
8,2003,540101,41,24,17,18
9,2003,540101,28,17,11,12
10,2003,540101,37,23,14,21
11,2003,540101,21,15,6,6
12,2003,540101,24,19,5,10
1,2004,540101,21,12,9,22
2,2004,540101,24,16,8,18
3,2004,540101,29,15,14,16
4,2004,540101,19,11,8,9
5,2004,540101,22,13,9,19
6,2004,540101,32,19,13,7
7,2004,540101,32,14,18,9
8,2004,540101,28,17,11,10
9,2004,540101,36,28,8,9
10,2004,540101,38,26,12,10
11,2004,540101,32,23,9,7
12,2004,540101,23,20,3,7
1,2005,540101,24,16,8,10
2,2005,540101,16,11,5,14
3,2005,540101,20,12,8,6
4,2005,540101,29,15,14,25
5,2005,540101,22,12,10,8
6,2005,540101,24,18,6,5
7,2005,540101,29,21,8,11
8,2005,540101,33,19,14,10
9,2005,540101,18,12,6,9
10,2005,540101,26,22,4,5
11,2005,540101,24,17,7,14
12,2005,540101,27,19,8,22
1,2006,540101,28,19,9,17
2,2006,540101,13,10,3,9
3,2006,540101,18,11,7,12
4,2006,540101,25,14,11,8
5,2006,540101,19,12,7,4
6,2006,540101,33,21,12,9
7,2006,540101,37,22,15,9
8,2006,540101,15,12,3,3
9,2006,540101,12,8,4,8
10,2006,540101,15,12,3,8
11,2006,540101,26,18,8,28
12,2006,540101,24,17,7,19
1,2007,540101,22,16,6,24
2,2007,540101,6,4,2,17
3,2007,540101,17,12,5,10
4,2007,540101,21,14,7,16
5,2007,540101,20,12,8,21
6,2007,540101,30,20,10,5
7,2007,540101,35,28,7,7
8,2007,540101,20,17,3,3
9,2007,540101,25,19,6,8
10,2007,540101,17,15,2,5
11,2007,540101,28,23,5,11
12,2007,540101,23,21,2,9
1,2008,540101,17,14,3,3
2,2008,540101,16,14,2,12
3,2008,540101,16,11,5,9
4,2008,540101,17,13,4,7
5,2008,540101,12,3,9,8
6,2008,540101,22,15,7,2
7,2008,540101,18,10,8,3
8,2008,540101,17,12,5,3
9,2008,540101,18,15,3,3
10,2008,540101,17,9,8,2
11,2008,540101,20,17,3,7
12,2008,540101,16,15,1,2
1,2009,540101,17,13,4,3
2,2009,540101,7,4,3,5
3,2009,540101,14,9,5,3
4,2009,540101,14,9,5,2
5,2009,540101,10,6,4,2
6,2009,540101,21,12,9,1
7,2009,540101,19,10,9,1
8,2009,540101,28,21,7,4
9,2009,540101,24,22,2,4
10,2009,540101,26,23,3,6
11,2009,540101,17,12,5,9
12,2009,540101,14,12,2,3
1,2010,540101,20,14,6,13
2,2010,540101,13,11,2,7
3,2010,540101,18,14,4,4
4,2010,540101,17,11,6,7
5,2010,540101,18,12,6,1
6,2010,540101,16,12,4,0
7,2010,540101,15,6,9,8
8,2010,540101,17,11,6,2
9,2010,540101,20,15,5,5
10,2010,540101,15,11,4,3
11,2010,540101,17,12,5,4
12,2010,540101,10,5,5,3
1,2011,540101,10,10,0,4
2,2011,540101,9,6,3,0
1,1999,550100,22,21,1,0
2,1999,550100,39,33,6,0
3,1999,550100,23,22,1,6
4,1999,550100,15,11,4,1
5,1999,550100,44,39,5,5
6,1999,550100,25,22,3,5
7,1999,550100,39,34,5,4
8,1999,550100,33,28,5,3
9,1999,550100,47,41,6,1
10,1999,550100,25,23,2,4
11,1999,550100,52,50,2,7
12,1999,550100,29,26,3,2
1,2000,550100,29,24,5,2
2,2000,550100,23,16,7,5
3,2000,550100,27,23,4,1
4,2000,550100,23,19,4,3
5,2000,550100,24,19,5,9
6,2000,550100,40,30,10,5
7,2000,550100,26,22,4,2
8,2000,550100,31,29,2,7
9,2000,550100,24,21,3,3
10,2000,550100,29,25,4,0
11,2000,550100,31,30,1,1
12,2000,550100,17,16,1,1
1,2001,550100,22,19,3,5
2,2001,550100,12,11,1,0
3,2001,550100,26,20,6,12
4,2001,550100,19,18,1,2
5,2001,550100,16,12,4,0
6,2001,550100,29,24,5,7
7,2001,550100,16,13,3,0
8,2001,550100,18,15,3,5
9,2001,550100,23,22,1,3
10,2001,550100,22,19,3,2
11,2001,550100,23,18,5,7
12,2001,550100,21,19,2,3
1,2002,550100,16,14,2,1
2,2002,550100,15,14,1,3
3,2002,550100,16,14,2,1
4,2002,550100,14,9,5,3
5,2002,550100,18,14,4,2
6,2002,550100,26,22,4,3
7,2002,550100,26,24,2,5
8,2002,550100,17,16,1,1
9,2002,550100,21,18,3,3
10,2002,550100,21,19,2,2
11,2002,550100,20,20,0,0
12,2002,550100,15,15,0,0
1,2003,550100,14,12,2,2
2,2003,550100,12,11,1,4
3,2003,550100,19,15,4,8
4,2003,550100,19,18,1,2
5,2003,550100,19,13,6,3
6,2003,550100,20,16,4,0
7,2003,550100,19,15,4,6
8,2003,550100,24,21,3,12
9,2003,550100,29,28,1,4
10,2003,550100,14,12,2,1
11,2003,550100,19,17,2,6
12,2003,550100,20,20,0,7
1,2004,550100,22,21,1,0
2,2004,550100,18,17,1,1
3,2004,550100,16,14,2,8
4,2004,550100,17,16,1,10
5,2004,550100,28,18,10,6
6,2004,550100,36,29,7,1
7,2004,550100,26,24,2,9
8,2004,550100,20,17,3,7
9,2004,550100,19,16,3,5
10,2004,550100,15,13,2,3
11,2004,550100,18,14,4,9
12,2004,550100,15,15,0,1
1,2005,550100,13,12,1,9
2,2005,550100,19,17,2,10
3,2005,550100,12,10,2,5
4,2005,550100,24,21,3,5
5,2005,550100,17,15,2,1
6,2005,550100,19,16,3,1
7,2005,550100,19,17,2,2
8,2005,550100,17,16,1,4
9,2005,550100,17,13,4,3
10,2005,550100,14,13,1,3
11,2005,550100,18,18,0,5
12,2005,550100,10,8,2,4
1,2006,550100,24,24,0,7
2,2006,550100,17,16,1,4
3,2006,550100,23,22,1,2
4,2006,550100,10,8,2,1
5,2006,550100,18,15,3,7
6,2006,550100,20,16,4,3
7,2006,550100,18,16,2,9
8,2006,550100,28,26,2,3
9,2006,550100,14,12,2,7
10,2006,550100,17,14,3,2
11,2006,550100,25,21,4,1
12,2006,550100,25,22,3,3
1,2007,550100,17,17,0,7
2,2007,550100,10,10,0,5
3,2007,550100,18,14,4,2
4,2007,550100,18,12,6,3
5,2007,550100,20,18,2,6
6,2007,550100,19,14,5,2
7,2007,550100,25,23,2,1
8,2007,550100,18,13,5,5
9,2007,550100,24,20,4,3
10,2007,550100,22,18,4,1
11,2007,550100,19,17,2,4
12,2007,550100,10,9,1,0
1,2008,550100,14,13,1,11
2,2008,550100,11,10,1,15
3,2008,550100,19,13,6,5
4,2008,550100,14,10,4,6
5,2008,550100,27,19,8,3
6,2008,550100,15,15,0,1
7,2008,550100,29,25,4,6
8,2008,550100,22,20,2,6
9,2008,550100,18,17,1,4
10,2008,550100,20,20,0,3
11,2008,550100,15,11,4,4
12,2008,550100,5,3,2,5
1,2009,550100,13,12,1,8
2,2009,550100,18,15,3,5
3,2009,550100,21,17,4,7
4,2009,550100,10,9,1,4
5,2009,550100,13,9,4,7
6,2009,550100,34,32,2,1
7,2009,550100,16,14,2,2
8,2009,550100,21,18,3,5
9,2009,550100,26,23,3,2
10,2009,550100,17,16,1,1
11,2009,550100,18,16,2,7
12,2009,550100,16,14,2,1
1,2010,550100,15,13,2,1
2,2010,550100,15,14,1,2
3,2010,550100,11,10,1,5
4,2010,550100,12,9,3,1
5,2010,550100,10,7,3,3
6,2010,550100,20,17,3,0
7,2010,550100,19,18,1,2
8,2010,550100,10,8,2,4
9,2010,550100,16,15,1,0
10,2010,550100,13,10,3,6
11,2010,550100,14,11,3,3
12,2010,550100,25,23,2,5
1,2011,550100,8,5,3,4
2,2011,550100,6,5,1,2
1,1999,550200,7,6,1,0
2,1999,550200,4,4,0,1
3,1999,550200,4,3,1,0
4,1999,550200,6,6,0,8
5,1999,550200,8,7,1,4
6,1999,550200,4,2,2,2
7,1999,550200,7,6,1,1
8,1999,550200,18,16,2,0
9,1999,550200,15,15,0,0
10,1999,550200,8,8,0,1
11,1999,550200,5,4,1,1
12,1999,550200,11,9,2,0
1,2000,550200,11,10,1,0
2,2000,550200,4,4,0,2
3,2000,550200,14,8,6,0
4,2000,550200,3,2,1,0
5,2000,550200,9,9,0,0
6,2000,550200,8,6,2,0
7,2000,550200,6,5,1,3
8,2000,550200,8,7,1,0
9,2000,550200,8,7,1,0
10,2000,550200,8,8,0,0
11,2000,550200,4,4,0,3
12,2000,550200,10,9,1,0
1,2001,550200,4,3,1,3
2,2001,550200,7,5,2,2
3,2001,550200,7,6,1,0
4,2001,550200,8,7,1,2
5,2001,550200,9,6,3,0
6,2001,550200,7,7,0,0
7,2001,550200,11,10,1,4
8,2001,550200,9,8,1,1
9,2001,550200,10,7,3,1
10,2001,550200,5,5,0,2
11,2001,550200,3,3,0,0
12,2001,550200,5,3,2,2
1,2002,550200,6,5,1,1
2,2002,550200,4,3,1,0
3,2002,550200,4,3,1,1
4,2002,550200,3,3,0,1
5,2002,550200,5,3,2,1
6,2002,550200,9,9,0,0
7,2002,550200,6,6,0,1
8,2002,550200,5,4,1,0
9,2002,550200,4,3,1,0
10,2002,550200,4,4,0,0
11,2002,550200,4,3,1,1
12,2002,550200,1,1,0,3
1,2003,550200,4,4,0,0
2,2003,550200,4,3,1,0
3,2003,550200,3,3,0,0
4,2003,550200,7,5,2,3
5,2003,550200,6,6,0,0
6,2003,550200,8,4,4,0
7,2003,550200,5,4,1,2
8,2003,550200,8,6,2,2
9,2003,550200,9,7,2,3
10,2003,550200,4,3,1,2
11,2003,550200,3,2,1,0
12,2003,550200,8,5,3,2
1,2004,550200,5,2,3,2
2,2004,550200,4,4,0,1
3,2004,550200,9,9,0,3
4,2004,550200,4,2,2,0
5,2004,550200,8,7,1,3
6,2004,550200,2,2,0,0
7,2004,550200,8,7,1,1
8,2004,550200,8,7,1,0
9,2004,550200,5,4,1,1
10,2004,550200,6,6,0,1
11,2004,550200,6,6,0,3
12,2004,550200,3,3,0,1
1,2005,550200,7,7,0,1
2,2005,550200,6,4,2,1
3,2005,550200,6,6,0,0
4,2005,550200,4,4,0,0
5,2005,550200,4,3,1,0
6,2005,550200,7,7,0,2
7,2005,550200,6,5,1,0
8,2005,550200,4,2,2,0
9,2005,550200,6,6,0,2
10,2005,550200,4,4,0,0
11,2005,550200,4,4,0,0
12,2005,550200,6,6,0,0
1,2006,550200,9,9,0,2
2,2006,550200,3,3,0,0
3,2006,550200,8,8,0,2
4,2006,550200,1,1,0,1
5,2006,550200,7,6,1,0
6,2006,550200,4,4,0,3
7,2006,550200,10,9,1,2
8,2006,550200,8,8,0,3
9,2006,550200,7,7,0,0
10,2006,550200,4,3,1,2
11,2006,550200,7,7,0,0
12,2006,550200,8,8,0,0
1,2007,550200,2,2,0,3
2,2007,550200,2,2,0,1
3,2007,550200,7,6,1,0
4,2007,550200,6,6,0,0
5,2007,550200,7,7,0,3
6,2007,550200,1,1,0,0
7,2007,550200,8,7,1,0
8,2007,550200,5,4,1,1
9,2007,550200,10,10,0,0
10,2007,550200,6,6,0,2
11,2007,550200,9,8,1,0
12,2007,550200,7,7,0,0
1,2008,550200,6,6,0,0
2,2008,550200,3,3,0,2
3,2008,550200,2,2,0,0
4,2008,550200,6,6,0,3
5,2008,550200,9,8,1,0
6,2008,550200,10,10,0,1
7,2008,550200,10,9,1,0
8,2008,550200,8,8,0,0
9,2008,550200,7,7,0,1
10,2008,550200,6,6,0,0
11,2008,550200,11,9,2,2
12,2008,550200,2,2,0,2
1,2009,550200,5,4,1,1
2,2009,550200,4,4,0,0
3,2009,550200,2,2,0,1
4,2009,550200,7,6,1,3
5,2009,550200,4,4,0,0
6,2009,550200,4,4,0,1
7,2009,550200,4,4,0,1
8,2009,550200,1,1,0,1
9,2009,550200,7,6,1,0
10,2009,550200,11,10,1,2
11,2009,550200,5,5,0,0
12,2009,550200,5,5,0,1
1,2010,550200,7,5,2,0
2,2010,550200,5,5,0,1
3,2010,550200,6,5,1,3
4,2010,550200,8,7,1,1
5,2010,550200,6,6,0,0
6,2010,550200,9,7,2,2
7,2010,550200,5,5,0,0
8,2010,550200,8,8,0,0
9,2010,550200,9,9,0,0
10,2010,550200,4,4,0,1
11,2010,550200,14,14,0,2
12,2010,550200,10,10,0,2
1,2011,550200,4,4,0,0
2,2011,550200,5,4,1,0
1,1999,540102,17,12,5,3
2,1999,540102,27,20,7,4
3,1999,540102,20,17,3,5
4,1999,540102,26,18,8,5
5,1999,540102,15,12,3,5
6,1999,540102,25,11,14,9
7,1999,540102,37,23,14,9
8,1999,540102,24,15,9,5
9,1999,540102,27,24,3,10
10,1999,540102,21,12,9,10
11,1999,540102,20,17,3,6
12,1999,540102,23,14,9,7
1,2000,540102,25,21,4,13
2,2000,540102,21,16,5,6
3,2000,540102,33,23,10,2
4,2000,540102,34,22,12,8
5,2000,540102,31,25,6,7
6,2000,540102,34,17,17,3
7,2000,540102,32,22,10,8
8,2000,540102,13,9,4,8
9,2000,540102,19,15,4,7
10,2000,540102,32,29,3,10
11,2000,540102,18,14,4,8
12,2000,540102,19,15,4,12
1,2001,540102,10,8,2,13
2,2001,540102,18,13,5,10
3,2001,540102,19,11,8,17
4,2001,540102,21,11,10,9
5,2001,540102,22,13,9,6
6,2001,540102,20,13,7,2
7,2001,540102,27,22,5,7
8,2001,540102,25,14,11,4
9,2001,540102,26,19,7,11
10,2001,540102,13,12,1,9
11,2001,540102,20,11,9,3
12,2001,540102,20,13,7,7
1,2002,540102,15,6,9,6
2,2002,540102,16,11,5,11
3,2002,540102,23,15,8,11
4,2002,540102,22,12,10,11
5,2002,540102,18,7,11,5
6,2002,540102,23,20,3,7
7,2002,540102,23,20,3,3
8,2002,540102,27,20,7,0
9,2002,540102,21,11,10,1
10,2002,540102,33,21,12,2
11,2002,540102,13,9,4,5
12,2002,540102,11,8,3,4
1,2003,540102,21,13,8,5
2,2003,540102,9,7,2,1
3,2003,540102,21,17,4,3
4,2003,540102,14,10,4,6
5,2003,540102,22,16,6,6
6,2003,540102,18,11,7,2
7,2003,540102,41,32,9,1
8,2003,540102,31,23,8,6
9,2003,540102,29,25,4,2
10,2003,540102,17,14,3,3
11,2003,540102,21,14,7,6
12,2003,540102,21,16,5,2
1,2004,540102,12,10,2,3
2,2004,540102,17,14,3,7
3,2004,540102,20,14,6,4
4,2004,540102,18,13,5,4
5,2004,540102,13,8,5,7
6,2004,540102,20,13,7,7
7,2004,540102,23,14,9,2
8,2004,540102,26,20,6,4
9,2004,540102,14,13,1,2
10,2004,540102,21,18,3,3
11,2004,540102,18,16,2,9
12,2004,540102,15,12,3,5
1,2005,540102,17,15,2,7
2,2005,540102,13,11,2,4
3,2005,540102,12,10,2,6
4,2005,540102,15,12,3,3
5,2005,540102,18,15,3,5
6,2005,540102,20,15,5,6
7,2005,540102,18,17,1,6
8,2005,540102,20,17,3,3
9,2005,540102,12,10,2,7
10,2005,540102,14,11,3,5
11,2005,540102,19,16,3,2
12,2005,540102,20,18,2,12
1,2006,540102,17,15,2,2
2,2006,540102,13,11,2,2
3,2006,540102,17,11,6,6
4,2006,540102,12,8,4,4
5,2006,540102,9,7,2,1
6,2006,540102,20,15,5,3
7,2006,540102,12,10,2,9
8,2006,540102,16,11,5,7
9,2006,540102,18,17,1,4
10,2006,540102,18,15,3,6
11,2006,540102,12,10,2,20
12,2006,540102,16,14,2,5
1,2007,540102,8,7,1,21
2,2007,540102,5,5,0,9
3,2007,540102,8,7,1,4
4,2007,540102,16,11,5,6
5,2007,540102,18,12,6,7
6,2007,540102,21,16,5,2
7,2007,540102,18,14,4,4
8,2007,540102,20,16,4,4
9,2007,540102,12,6,6,7
10,2007,540102,8,6,2,1
11,2007,540102,23,19,4,1
12,2007,540102,14,13,1,4
1,2008,540102,23,15,8,6
2,2008,540102,10,7,3,6
3,2008,540102,11,8,3,6
4,2008,540102,18,13,5,15
5,2008,540102,12,7,5,6
6,2008,540102,14,9,5,9
7,2008,540102,9,0,9,8
8,2008,540102,22,17,5,4
9,2008,540102,24,19,5,3
10,2008,540102,12,9,3,4
11,2008,540102,15,11,4,6
12,2008,540102,9,6,3,18
1,2009,540102,11,6,5,5
2,2009,540102,10,8,2,7
3,2009,540102,11,6,5,8
4,2009,540102,13,9,4,3
5,2009,540102,17,10,7,6
6,2009,540102,28,18,10,0
7,2009,540102,16,11,5,0
8,2009,540102,25,18,7,5
9,2009,540102,14,10,4,4
10,2009,540102,16,12,4,7
11,2009,540102,18,15,3,3
12,2009,540102,17,14,3,6
1,2010,540102,12,9,3,6
2,2010,540102,4,3,1,10
3,2010,540102,14,13,1,3
4,2010,540102,18,13,5,1
5,2010,540102,12,10,2,2
6,2010,540102,19,14,5,4
7,2010,540102,20,17,3,5
8,2010,540102,25,19,6,2
9,2010,540102,10,8,2,5
10,2010,540102,12,9,3,6
11,2010,540102,12,10,2,4
12,2010,540102,16,8,8,8
1,2011,540102,19,16,3,4
2,2011,540102,7,5,2,1
1,1999,530503,23,17,6,1
2,1999,530503,23,20,3,2
3,1999,530503,23,22,1,8
4,1999,530503,38,27,11,1
5,1999,530503,26,19,7,6
6,1999,530503,24,17,7,5
7,1999,530503,34,31,3,4
8,1999,530503,34,27,7,6
9,1999,530503,30,26,4,3
10,1999,530503,27,24,3,3
11,1999,530503,29,21,8,6
12,1999,530503,34,29,5,1
1,2000,530503,30,24,6,3
2,2000,530503,27,18,9,2
3,2000,530503,39,31,8,3
4,2000,530503,29,21,8,5
5,2000,530503,34,27,7,6
6,2000,530503,30,21,9,4
7,2000,530503,37,33,4,2
8,2000,530503,46,34,12,6
9,2000,530503,38,28,10,4
10,2000,530503,21,13,8,3
11,2000,530503,28,21,7,3
12,2000,530503,21,18,3,3
1,2001,530503,22,17,5,0
2,2001,530503,11,8,3,2
3,2001,530503,29,22,7,1
4,2001,530503,20,20,0,7
5,2001,530503,33,29,4,1
6,2001,530503,35,30,5,4
7,2001,530503,48,39,9,3
8,2001,530503,28,20,8,8
9,2001,530503,40,33,7,5
10,2001,530503,43,36,7,1
11,2001,530503,23,21,2,4
12,2001,530503,25,18,7,2
1,2002,530503,21,13,8,3
2,2002,530503,16,15,1,4
3,2002,530503,23,18,5,9
4,2002,530503,23,10,13,4
5,2002,530503,20,16,4,3
6,2002,530503,28,23,5,8
7,2002,530503,32,27,5,4
8,2002,530503,35,24,11,6
9,2002,530503,26,21,5,9
10,2002,530503,35,28,7,4
11,2002,530503,29,22,7,2
12,2002,530503,26,23,3,4
1,2003,530503,20,15,5,3
2,2003,530503,19,15,4,7
3,2003,530503,23,15,8,8
4,2003,530503,18,14,4,9
5,2003,530503,23,20,3,7
6,2003,530503,30,21,9,11
7,2003,530503,23,17,6,7
8,2003,530503,31,25,6,11
9,2003,530503,17,14,3,12
10,2003,530503,30,23,7,13
11,2003,530503,22,16,6,15
12,2003,530503,18,12,6,14
1,2004,530503,20,15,5,14
2,2004,530503,15,13,2,8
3,2004,530503,28,23,5,11
4,2004,530503,23,16,7,10
5,2004,530503,19,16,3,13
6,2004,530503,37,28,9,19
7,2004,530503,27,18,9,5
8,2004,530503,34,20,14,17
9,2004,530503,28,24,4,8
10,2004,530503,31,27,4,4
11,2004,530503,43,37,6,6
12,2004,530503,21,18,3,13
1,2005,530503,25,20,5,15
2,2005,530503,16,15,1,12
3,2005,530503,25,20,5,12
4,2005,530503,40,30,10,11
5,2005,530503,28,19,9,8
6,2005,530503,24,18,6,11
7,2005,530503,37,31,6,9
8,2005,530503,22,19,3,21
9,2005,530503,27,24,3,2
10,2005,530503,33,25,8,14
11,2005,530503,25,21,4,19
12,2005,530503,31,23,8,10
1,2006,530503,32,27,5,23
2,2006,530503,19,14,5,13
3,2006,530503,24,17,7,8
4,2006,530503,26,21,5,15
5,2006,530503,27,19,8,18
6,2006,530503,22,16,6,9
7,2006,530503,23,19,4,6
8,2006,530503,29,26,3,6
9,2006,530503,28,27,1,9
10,2006,530503,34,32,2,5
11,2006,530503,34,30,4,7
12,2006,530503,19,19,0,4
1,2007,530503,25,23,2,2
2,2007,530503,22,20,2,14
3,2007,530503,20,15,5,21
4,2007,530503,18,16,2,8
5,2007,530503,32,24,8,10
6,2007,530503,30,25,5,15
7,2007,530503,21,15,6,8
8,2007,530503,43,37,6,13
9,2007,530503,32,27,5,10
10,2007,530503,20,14,6,7
11,2007,530503,22,17,5,4
12,2007,530503,21,21,0,5
1,2008,530503,30,26,4,4
2,2008,530503,26,19,7,8
3,2008,530503,12,6,6,3
4,2008,530503,39,36,3,5
5,2008,530503,27,18,9,2
6,2008,530503,24,21,3,1
7,2008,530503,39,34,5,4
8,2008,530503,38,33,5,7
9,2008,530503,39,35,4,1
10,2008,530503,26,24,2,1
11,2008,530503,29,22,7,3
12,2008,530503,32,31,1,4
1,2009,530503,26,22,4,1
2,2009,530503,20,17,3,5
3,2009,530503,21,21,0,5
4,2009,530503,29,20,9,2
5,2009,530503,31,26,5,4
6,2009,530503,32,29,3,6
7,2009,530503,31,28,3,5
8,2009,530503,36,29,7,10
9,2009,530503,26,20,6,4
10,2009,530503,31,26,5,1
11,2009,530503,27,25,2,0
12,2009,530503,23,19,4,1
1,2010,530503,26,21,5,3
2,2010,530503,17,14,3,1
3,2010,530503,24,21,3,4
4,2010,530503,34,27,7,1
5,2010,530503,36,31,5,2
6,2010,530503,34,30,4,4
7,2010,530503,34,30,4,1
8,2010,530503,48,39,9,6
9,2010,530503,22,19,3,5
10,2010,530503,27,25,2,9
11,2010,530503,26,23,3,1
12,2010,530503,34,31,3,2
1,2011,530503,26,23,3,2
2,2011,530503,13,10,3,1
1,1999,838800,27,25,2,9
2,1999,838800,17,11,6,4
3,1999,838800,37,22,15,7
4,1999,838800,31,28,3,11
5,1999,838800,24,20,4,4
6,1999,838800,26,18,8,12
7,1999,838800,45,30,15,9
8,1999,838800,27,15,12,9
9,1999,838800,37,32,5,9
10,1999,838800,32,21,11,7
11,1999,838800,23,20,3,8
12,1999,838800,23,19,4,9
1,2000,838800,27,26,1,7
2,2000,838800,21,17,4,5
3,2000,838800,22,16,6,12
4,2000,838800,31,25,6,7
5,2000,838800,22,15,7,7
6,2000,838800,31,20,11,6
7,2000,838800,43,31,12,12
8,2000,838800,39,28,11,11
9,2000,838800,45,33,12,1
10,2000,838800,26,20,6,7
11,2000,838800,31,26,5,7
12,2000,838800,30,24,6,4
1,2001,838800,25,22,3,3
2,2001,838800,20,16,4,11
3,2001,838800,19,15,4,10
4,2001,838800,27,22,5,9
5,2001,838800,25,19,6,8
6,2001,838800,39,28,11,8
7,2001,838800,38,30,8,5
8,2001,838800,36,27,9,10
9,2001,838800,18,12,6,5
10,2001,838800,26,19,7,12
11,2001,838800,33,24,9,10
12,2001,838800,19,13,6,6
1,2002,838800,25,21,4,1
2,2002,838800,22,15,7,7
3,2002,838800,19,15,4,7
4,2002,838800,28,21,7,6
5,2002,838800,36,23,13,7
6,2002,838800,38,27,11,6
7,2002,838800,36,29,7,9
8,2002,838800,36,29,7,4
9,2002,838800,35,26,9,4
10,2002,838800,34,26,8,4
11,2002,838800,25,20,5,4
12,2002,838800,29,24,5,1
1,2003,838800,22,21,1,10
2,2003,838800,23,17,6,6
3,2003,838800,29,23,6,9
4,2003,838800,33,29,4,6
5,2003,838800,30,26,4,4
6,2003,838800,32,23,9,6
7,2003,838800,26,24,2,5
8,2003,838800,35,30,5,5
9,2003,838800,28,26,2,6
10,2003,838800,29,23,6,14
11,2003,838800,26,19,7,6
12,2003,838800,25,15,10,6
1,2004,838800,21,15,6,6
2,2004,838800,13,9,4,9
3,2004,838800,23,19,4,13
4,2004,838800,24,21,3,11
5,2004,838800,23,19,4,5
6,2004,838800,19,16,3,4
7,2004,838800,34,24,10,8
8,2004,838800,34,29,5,1
9,2004,838800,33,27,6,3
10,2004,838800,21,13,8,5
11,2004,838800,17,15,2,4
12,2004,838800,19,17,2,8
1,2005,838800,23,20,3,18
2,2005,838800,17,14,3,7
3,2005,838800,18,16,2,5
4,2005,838800,15,14,1,4
5,2005,838800,28,26,2,10
6,2005,838800,13,8,5,6
7,2005,838800,20,16,4,3
8,2005,838800,29,26,3,10
9,2005,838800,14,14,0,5
10,2005,838800,18,16,2,6
11,2005,838800,14,12,2,5
12,2005,838800,22,21,1,7
1,2006,838800,19,16,3,6
2,2006,838800,18,16,2,5
3,2006,838800,24,21,3,11
4,2006,838800,20,15,5,9
5,2006,838800,19,14,5,10
6,2006,838800,18,17,1,11
7,2006,838800,22,14,8,6
8,2006,838800,27,18,9,4
9,2006,838800,27,24,3,5
10,2006,838800,22,15,7,5
11,2006,838800,14,10,4,9
12,2006,838800,22,22,0,8
1,2007,838800,15,14,1,5
2,2007,838800,11,10,1,7
3,2007,838800,29,18,11,9
4,2007,838800,19,17,2,11
5,2007,838800,16,13,3,6
6,2007,838800,20,16,4,4
7,2007,838800,23,18,5,4
8,2007,838800,29,26,3,10
9,2007,838800,20,19,1,4
10,2007,838800,26,16,10,14
11,2007,838800,23,19,4,6
12,2007,838800,14,12,2,6
1,2008,838800,25,23,2,6
2,2008,838800,22,19,3,5
3,2008,838800,17,15,2,5
4,2008,838800,19,17,2,4
5,2008,838800,20,18,2,2
6,2008,838800,25,21,4,3
7,2008,838800,42,35,7,4
8,2008,838800,33,24,9,8
9,2008,838800,22,18,4,5
10,2008,838800,20,16,4,6
11,2008,838800,17,14,3,2
12,2008,838800,15,11,4,6
1,2009,838800,15,14,1,0
2,2009,838800,16,12,4,5
3,2009,838800,27,23,4,16
4,2009,838800,29,21,8,7
5,2009,838800,36,30,6,7
6,2009,838800,34,28,6,2
7,2009,838800,38,35,3,4
8,2009,838800,34,28,6,10
9,2009,838800,32,26,6,9
10,2009,838800,36,29,7,8
11,2009,838800,37,32,5,4
12,2009,838800,39,37,2,9
1,2010,838800,36,28,8,1
2,2010,838800,23,22,1,12
3,2010,838800,30,28,2,9
4,2010,838800,27,25,2,15
5,2010,838800,30,27,3,4
6,2010,838800,31,25,6,7
7,2010,838800,24,21,3,6
8,2010,838800,26,22,4,5
9,2010,838800,23,20,3,5
10,2010,838800,32,22,10,4
11,2010,838800,26,21,5,4
12,2010,838800,22,19,3,3
1,2011,838800,22,19,3,11
2,2011,838800,7,7,0,14
1,1999,530600,22,17,5,9
2,1999,530600,8,7,1,14
3,1999,530600,19,15,4,10
4,1999,530600,17,10,7,7
5,1999,530600,25,21,4,7
6,1999,530600,25,23,2,5
7,1999,530600,22,19,3,7
8,1999,530600,32,21,11,8
9,1999,530600,15,7,8,3
10,1999,530600,16,16,0,8
11,1999,530600,24,19,5,4
12,1999,530600,21,20,1,6
1,2000,530600,15,11,4,1
2,2000,530600,10,8,2,4
3,2000,530600,20,15,5,8
4,2000,530600,11,7,4,8
5,2000,530600,26,21,5,9
6,2000,530600,15,8,7,5
7,2000,530600,21,13,8,7
8,2000,530600,21,15,6,7
9,2000,530600,19,13,6,8
10,2000,530600,31,26,5,9
11,2000,530600,21,14,7,3
12,2000,530600,18,9,9,5
1,2001,530600,19,16,3,10
2,2001,530600,17,12,5,7
3,2001,530600,19,9,10,4
4,2001,530600,22,15,7,3
5,2001,530600,28,20,8,7
6,2001,530600,18,17,1,9
7,2001,530600,24,16,8,5
8,2001,530600,21,16,5,8
9,2001,530600,30,15,15,1
10,2001,530600,19,13,6,3
11,2001,530600,25,18,7,3
12,2001,530600,17,14,3,4
1,2002,530600,22,19,3,6
2,2002,530600,12,11,1,7
3,2002,530600,20,16,4,5
4,2002,530600,18,15,3,9
5,2002,530600,26,21,5,4
6,2002,530600,23,17,6,9
7,2002,530600,29,22,7,6
8,2002,530600,32,23,9,7
9,2002,530600,24,15,9,0
10,2002,530600,19,12,7,2
11,2002,530600,10,9,1,2
12,2002,530600,20,14,6,4
1,2003,530600,17,12,5,6
2,2003,530600,13,13,0,3
3,2003,530600,14,11,3,2
4,2003,530600,28,17,11,4
5,2003,530600,21,11,10,5
6,2003,530600,21,10,11,4
7,2003,530600,36,24,12,5
8,2003,530600,26,20,6,3
9,2003,530600,24,19,5,2
10,2003,530600,18,14,4,9
11,2003,530600,25,21,4,4
12,2003,530600,20,17,3,8
1,2004,530600,19,16,3,7
2,2004,530600,17,13,4,4
3,2004,530600,21,20,1,7
4,2004,530600,25,19,6,5
5,2004,530600,17,12,5,7
6,2004,530600,19,16,3,9
7,2004,530600,27,20,7,17
8,2004,530600,34,28,6,6
9,2004,530600,22,18,4,7
10,2004,530600,17,14,3,4
11,2004,530600,26,18,8,4
12,2004,530600,17,16,1,4
1,2005,530600,22,21,1,9
2,2005,530600,22,20,2,8
3,2005,530600,17,15,2,13
4,2005,530600,19,19,0,6
5,2005,530600,25,23,2,22
6,2005,530600,23,19,4,4
7,2005,530600,25,18,7,4
8,2005,530600,26,19,7,4
9,2005,530600,32,27,5,7
10,2005,530600,25,19,6,16
11,2005,530600,30,25,5,13
12,2005,530600,25,20,5,8
1,2006,530600,20,19,1,8
2,2006,530600,19,17,2,8
3,2006,530600,38,35,3,4
4,2006,530600,26,22,4,7
5,2006,530600,21,15,6,10
6,2006,530600,31,22,9,4
7,2006,530600,20,17,3,7
8,2006,530600,24,22,2,7
9,2006,530600,23,17,6,2
10,2006,530600,21,17,4,2
11,2006,530600,22,18,4,6
12,2006,530600,23,22,1,11
1,2007,530600,23,23,0,8
2,2007,530600,15,13,2,16
3,2007,530600,15,9,6,15
4,2007,530600,19,17,2,7
5,2007,530600,37,35,2,8
6,2007,530600,33,28,5,4
7,2007,530600,38,36,2,3
8,2007,530600,31,26,5,7
9,2007,530600,25,18,7,9
10,2007,530600,17,12,5,12
11,2007,530600,14,14,0,5
12,2007,530600,11,8,3,14
1,2008,530600,21,20,1,2
2,2008,530600,20,20,0,1
3,2008,530600,11,10,1,6
4,2008,530600,19,13,6,3
5,2008,530600,27,22,5,4
6,2008,530600,19,15,4,5
7,2008,530600,34,29,5,4
8,2008,530600,40,37,3,1
9,2008,530600,23,17,6,5
10,2008,530600,22,17,5,4
11,2008,530600,15,15,0,0
12,2008,530600,16,14,2,2
1,2009,530600,20,18,2,7
2,2009,530600,18,16,2,5
3,2009,530600,20,15,5,6
4,2009,530600,17,15,2,5
5,2009,530600,21,16,5,8
6,2009,530600,15,13,2,5
7,2009,530600,31,25,6,6
8,2009,530600,36,31,5,3
9,2009,530600,13,11,2,5
10,2009,530600,13,11,2,5
11,2009,530600,14,14,0,10
12,2009,530600,17,15,2,4
1,2010,530600,13,9,4,5
2,2010,530600,18,18,0,7
3,2010,530600,27,20,7,6
4,2010,530600,18,15,3,2
5,2010,530600,23,17,6,2
6,2010,530600,17,14,3,1
7,2010,530600,27,20,7,4
8,2010,530600,27,24,3,4
9,2010,530600,12,9,3,9
10,2010,530600,18,15,3,6
11,2010,530600,13,11,2,5
12,2010,530600,19,16,3,6
1,2011,530600,17,15,2,12
2,2011,530600,19,14,5,7
1,1999,530502,2,1,1,1
2,1999,530502,6,6,0,0
3,1999,530502,6,6,0,1
4,1999,530502,5,4,1,2
5,1999,530502,6,4,2,2
6,1999,530502,8,7,1,1
7,1999,530502,14,4,10,0
8,1999,530502,9,9,0,2
9,1999,530502,13,9,4,4
10,1999,530502,11,8,3,0
11,1999,530502,3,2,1,0
12,1999,530502,4,3,1,2
1,2000,530502,7,5,2,1
2,2000,530502,13,11,2,2
3,2000,530502,5,4,1,0
4,2000,530502,11,9,2,1
5,2000,530502,9,4,5,2
6,2000,530502,3,3,0,2
7,2000,530502,13,10,3,3
8,2000,530502,7,6,1,1
9,2000,530502,14,12,2,3
10,2000,530502,8,4,4,0
11,2000,530502,10,8,2,0
12,2000,530502,9,7,2,0
1,2001,530502,2,2,0,1
2,2001,530502,2,2,0,0
3,2001,530502,9,5,4,2
4,2001,530502,3,2,1,1
5,2001,530502,12,8,4,0
6,2001,530502,5,2,3,1
7,2001,530502,3,1,2,0
8,2001,530502,6,4,2,3
9,2001,530502,12,9,3,0
10,2001,530502,8,8,0,1
11,2001,530502,7,5,2,0
12,2001,530502,12,10,2,3
1,2002,530502,6,6,0,1
2,2002,530502,3,2,1,2
3,2002,530502,6,6,0,1
4,2002,530502,9,5,4,2
5,2002,530502,8,6,2,4
6,2002,530502,8,6,2,6
7,2002,530502,11,9,2,2
8,2002,530502,10,8,2,2
9,2002,530502,8,7,1,0
10,2002,530502,10,7,3,1
11,2002,530502,5,5,0,0
12,2002,530502,8,7,1,3
1,2003,530502,3,2,1,0
2,2003,530502,7,6,1,0
3,2003,530502,9,6,3,2
4,2003,530502,4,1,3,4
5,2003,530502,7,5,2,4
6,2003,530502,18,11,7,2
7,2003,530502,9,6,3,1
8,2003,530502,6,5,1,1
9,2003,530502,10,7,3,0
10,2003,530502,11,6,5,0
11,2003,530502,3,3,0,0
12,2003,530502,6,5,1,0
1,2004,530502,5,4,1,2
2,2004,530502,2,2,0,0
3,2004,530502,3,3,0,4
4,2004,530502,8,5,3,0
5,2004,530502,3,3,0,0
6,2004,530502,6,5,1,0
7,2004,530502,9,6,3,2
8,2004,530502,7,7,0,1
9,2004,530502,8,6,2,1
10,2004,530502,6,5,1,0
11,2004,530502,6,6,0,3
12,2004,530502,6,6,0,1
1,2005,530502,8,6,2,4
2,2005,530502,5,5,0,0
3,2005,530502,4,4,0,1
4,2005,530502,8,7,1,2
5,2005,530502,11,8,3,1
6,2005,530502,5,3,2,0
7,2005,530502,9,7,2,3
8,2005,530502,9,4,5,0
9,2005,530502,7,4,3,1
10,2005,530502,9,7,2,1
11,2005,530502,6,5,1,3
12,2005,530502,4,3,1,2
1,2006,530502,9,8,1,1
2,2006,530502,5,4,1,0
3,2006,530502,6,6,0,0
4,2006,530502,9,8,1,2
5,2006,530502,9,9,0,2
6,2006,530502,4,4,0,4
7,2006,530502,6,6,0,1
8,2006,530502,6,6,0,1
9,2006,530502,4,4,0,2
10,2006,530502,8,4,4,1
11,2006,530502,7,6,1,1
12,2006,530502,4,4,0,2
1,2007,530502,8,8,0,2
2,2007,530502,4,3,1,3
3,2007,530502,6,4,2,3
4,2007,530502,3,3,0,0
5,2007,530502,6,5,1,0
6,2007,530502,9,6,3,5
7,2007,530502,7,6,1,2
8,2007,530502,15,12,3,0
9,2007,530502,4,4,0,0
10,2007,530502,6,6,0,0
11,2007,530502,5,4,1,0
12,2007,530502,8,5,3,0
1,2008,530502,7,7,0,0
2,2008,530502,5,5,0,1
3,2008,530502,6,6,0,1
4,2008,530502,5,4,1,0
5,2008,530502,6,6,0,0
6,2008,530502,8,5,3,3
7,2008,530502,13,10,3,6
8,2008,530502,10,9,1,1
9,2008,530502,17,13,4,2
10,2008,530502,9,8,1,3
11,2008,530502,8,7,1,0
12,2008,530502,12,11,1,0
1,2009,530502,12,11,1,0
2,2009,530502,9,7,2,2
3,2009,530502,13,11,2,2
4,2009,530502,4,2,2,1
5,2009,530502,4,4,0,0
6,2009,530502,6,4,2,1
7,2009,530502,15,14,1,3
8,2009,530502,8,8,0,1
9,2009,530502,12,11,1,0
10,2009,530502,14,12,2,1
11,2009,530502,8,6,2,0
12,2009,530502,12,12,0,2
1,2010,530502,6,6,0,2
2,2010,530502,4,4,0,1
3,2010,530502,7,6,1,1
4,2010,530502,14,13,1,1
5,2010,530502,9,6,3,0
6,2010,530502,11,11,0,0
7,2010,530502,7,6,1,0
8,2010,530502,6,6,0,0
9,2010,530502,7,7,0,1
10,2010,530502,14,13,1,0
11,2010,530502,4,4,0,2
12,2010,530502,8,8,0,0
1,2011,530502,8,6,2,2
2,2011,530502,5,5,0,0
1,1999,821402,1,1,0,0
2,1999,821402,0,0,0,0
3,1999,821402,5,5,0,0
4,1999,821402,3,3,0,1
5,1999,821402,3,3,0,0
6,1999,821402,3,3,0,0
7,1999,821402,2,2,0,0
8,1999,821402,2,2,0,0
9,1999,821402,5,5,0,0
10,1999,821402,1,1,0,1
11,1999,821402,1,1,0,0
12,1999,821402,2,2,0,0
1,2000,821402,2,2,0,0
2,2000,821402,0,0,0,0
3,2000,821402,3,3,0,0
4,2000,821402,0,0,0,0
5,2000,821402,3,3,0,0
6,2000,821402,4,4,0,0
7,2000,821402,2,2,0,0
8,2000,821402,1,1,0,0
9,2000,821402,2,2,0,0
10,2000,821402,0,0,0,0
11,2000,821402,6,5,1,0
12,2000,821402,4,4,0,0
1,2001,821402,1,1,0,0
2,2001,821402,2,2,0,0
3,2001,821402,1,1,0,0
4,2001,821402,0,0,0,0
5,2001,821402,3,3,0,0
6,2001,821402,1,1,0,0
7,2001,821402,1,1,0,1
8,2001,821402,3,3,0,0
9,2001,821402,0,0,0,0
10,2001,821402,1,1,0,0
11,2001,821402,0,0,0,0
12,2001,821402,0,0,0,0
1,2002,821402,1,1,0,0
2,2002,821402,1,1,0,1
3,2002,821402,2,2,0,0
4,2002,821402,2,2,0,0
5,2002,821402,3,3,0,0
6,2002,821402,1,1,0,0
7,2002,821402,4,4,0,0
8,2002,821402,7,7,0,0
9,2002,821402,1,1,0,0
10,2002,821402,1,1,0,0
11,2002,821402,8,8,0,0
12,2002,821402,2,2,0,0
1,2003,821402,2,2,0,0
2,2003,821402,1,1,0,0
3,2003,821402,2,2,0,0
4,2003,821402,1,1,0,0
5,2003,821402,3,3,0,0
6,2003,821402,2,2,0,0
7,2003,821402,0,0,0,0
8,2003,821402,2,2,0,1
9,2003,821402,0,0,0,0
10,2003,821402,5,5,0,1
11,2003,821402,4,4,0,0
12,2003,821402,1,1,0,2
1,2004,821402,0,0,0,1
2,2004,821402,0,0,0,0
3,2004,821402,1,1,0,0
4,2004,821402,1,1,0,0
5,2004,821402,0,0,0,0
6,2004,821402,0,0,0,2
7,2004,821402,7,6,1,0
8,2004,821402,2,2,0,0
9,2004,821402,2,2,0,0
10,2004,821402,1,1,0,0
11,2004,821402,0,0,0,0
12,2004,821402,1,1,0,0
1,2005,821402,2,2,0,0
2,2005,821402,3,3,0,1
3,2005,821402,1,1,0,0
4,2005,821402,0,0,0,0
5,2005,821402,1,1,0,0
6,2005,821402,0,0,0,0
7,2005,821402,0,0,0,2
8,2005,821402,0,0,0,1
9,2005,821402,2,2,0,0
10,2005,821402,1,1,0,0
11,2005,821402,3,3,0,2
12,2005,821402,3,3,0,0
1,2006,821402,1,1,0,0
2,2006,821402,4,4,0,0
3,2006,821402,5,5,0,1
4,2006,821402,0,0,0,0
5,2006,821402,4,4,0,0
6,2006,821402,2,2,0,0
7,2006,821402,2,1,1,0
8,2006,821402,3,3,0,0
9,2006,821402,3,3,0,0
10,2006,821402,4,4,0,0
11,2006,821402,2,2,0,0
12,2006,821402,0,0,0,0
1,2007,821402,0,0,0,0
2,2007,821402,0,0,0,2
3,2007,821402,1,1,0,0
4,2007,821402,1,1,0,0
5,2007,821402,1,1,0,0
6,2007,821402,1,1,0,2
7,2007,821402,0,0,0,0
8,2007,821402,0,0,0,0
9,2007,821402,0,0,0,0
10,2007,821402,1,1,0,0
11,2007,821402,0,0,0,0
12,2007,821402,0,0,0,0
1,2008,821402,0,0,0,0
2,2008,821402,1,1,0,0
3,2008,821402,0,0,0,0
4,2008,821402,0,0,0,0
5,2008,821402,0,0,0,0
6,2008,821402,0,0,0,0
7,2008,821402,0,0,0,0
8,2008,821402,0,0,0,0
9,2008,821402,0,0,0,0
10,2008,821402,0,0,0,0
11,2008,821402,0,0,0,0
12,2008,821402,0,0,0,0
1,2009,821402,0,0,0,1
2,2009,821402,0,0,0,1
3,2009,821402,1,1,0,0
4,2009,821402,0,0,0,0
5,2009,821402,0,0,0,0
6,2009,821402,0,0,0,0
7,2009,821402,0,0,0,0
8,2009,821402,3,3,0,0
9,2009,821402,0,0,0,0
10,2009,821402,0,0,0,0
11,2009,821402,2,2,0,0
12,2009,821402,0,0,0,0
1,2010,821402,3,3,0,0
2,2010,821402,0,0,0,0
3,2010,821402,0,0,0,0
4,2010,821402,0,0,0,0
5,2010,821402,0,0,0,0
6,2010,821402,0,0,0,0
7,2010,821402,0,0,0,0
8,2010,821402,2,1,1,0
9,2010,821402,0,0,0,0
10,2010,821402,0,0,0,0
11,2010,821402,1,1,0,0
12,2010,821402,3,3,0,0
1,2011,821402,1,1,0,0
2,2011,821402,0,0,0,0
1,1999,530400,9,8,1,0
2,1999,530400,3,3,0,0
3,1999,530400,6,6,0,1
4,1999,530400,10,10,0,0
5,1999,530400,13,11,2,1
6,1999,530400,8,5,3,0
7,1999,530400,14,9,5,2
8,1999,530400,17,14,3,0
9,1999,530400,14,12,2,1
10,1999,530400,8,7,1,6
11,1999,530400,8,7,1,3
12,1999,530400,10,9,1,3
1,2000,530400,18,18,0,3
2,2000,530400,14,13,1,3
3,2000,530400,16,14,2,2
4,2000,530400,15,14,1,3
5,2000,530400,18,17,1,1
6,2000,530400,17,13,4,0
7,2000,530400,21,18,3,0
8,2000,530400,25,24,1,3
9,2000,530400,15,12,3,0
10,2000,530400,30,29,1,0
11,2000,530400,11,10,1,4
12,2000,530400,14,11,3,0
1,2001,530400,12,11,1,1
2,2001,530400,10,9,1,3
3,2001,530400,12,9,3,2
4,2001,530400,7,6,1,2
5,2001,530400,15,11,4,0
6,2001,530400,7,4,3,3
7,2001,530400,12,9,3,2
8,2001,530400,18,13,5,4
9,2001,530400,8,7,1,9
10,2001,530400,14,11,3,5
11,2001,530400,10,7,3,5
12,2001,530400,10,7,3,5
1,2002,530400,12,10,2,9
2,2002,530400,9,9,0,10
3,2002,530400,15,15,0,3
4,2002,530400,6,4,2,4
5,2002,530400,19,16,3,3
6,2002,530400,13,7,6,2
7,2002,530400,11,8,3,1
8,2002,530400,7,6,1,8
9,2002,530400,14,9,5,3
10,2002,530400,15,14,1,2
11,2002,530400,11,9,2,2
12,2002,530400,16,14,2,1
1,2003,530400,13,9,4,1
2,2003,530400,12,9,3,1
3,2003,530400,10,8,2,2
4,2003,530400,14,10,4,10
5,2003,530400,11,10,1,1
6,2003,530400,10,7,3,4
7,2003,530400,14,7,7,2
8,2003,530400,13,9,4,3
9,2003,530400,11,10,1,5
10,2003,530400,21,17,4,3
11,2003,530400,5,4,1,4
12,2003,530400,8,3,5,3
1,2004,530400,13,12,1,11
2,2004,530400,9,9,0,2
3,2004,530400,10,8,2,4
4,2004,530400,11,10,1,3
5,2004,530400,10,10,0,3
6,2004,530400,9,6,3,6
7,2004,530400,15,11,4,5
8,2004,530400,15,12,3,8
9,2004,530400,10,10,0,5
10,2004,530400,13,9,4,3
11,2004,530400,17,15,2,2
12,2004,530400,11,11,0,4
1,2005,530400,11,8,3,9
2,2005,530400,10,10,0,2
3,2005,530400,17,15,2,8
4,2005,530400,7,6,1,2
5,2005,530400,12,10,2,4
6,2005,530400,8,8,0,3
7,2005,530400,11,10,1,10
8,2005,530400,15,11,4,3
9,2005,530400,8,7,1,2
10,2005,530400,7,7,0,3
11,2005,530400,4,4,0,2
12,2005,530400,10,6,4,1
1,2006,530400,14,12,2,6
2,2006,530400,11,9,2,1
3,2006,530400,14,13,1,5
4,2006,530400,8,7,1,6
5,2006,530400,13,12,1,2
6,2006,530400,13,11,2,3
7,2006,530400,10,8,2,3
8,2006,530400,5,5,0,2
9,2006,530400,11,8,3,1
10,2006,530400,10,8,2,2
11,2006,530400,8,8,0,2
12,2006,530400,10,8,2,2
1,2007,530400,7,5,2,3
2,2007,530400,5,4,1,3
3,2007,530400,13,12,1,9
4,2007,530400,8,7,1,4
5,2007,530400,20,12,8,3
6,2007,530400,16,12,4,5
7,2007,530400,16,13,3,8
8,2007,530400,15,10,5,4
9,2007,530400,16,13,3,2
10,2007,530400,10,10,0,5
11,2007,530400,7,7,0,1
12,2007,530400,11,9,2,2
1,2008,530400,10,8,2,0
2,2008,530400,9,9,0,4
3,2008,530400,16,12,4,4
4,2008,530400,9,6,3,4
5,2008,530400,10,8,2,0
6,2008,530400,10,8,2,0
7,2008,530400,16,13,3,2
8,2008,530400,11,9,2,3
9,2008,530400,10,10,0,2
10,2008,530400,11,10,1,2
11,2008,530400,9,8,1,0
12,2008,530400,7,5,2,1
1,2009,530400,4,3,1,1
2,2009,530400,6,3,3,0
3,2009,530400,9,9,0,2
4,2009,530400,6,5,1,3
5,2009,530400,11,8,3,1
6,2009,530400,13,13,0,5
7,2009,530400,9,7,2,0
8,2009,530400,12,11,1,1
9,2009,530400,13,11,2,0
10,2009,530400,15,15,0,2
11,2009,530400,2,2,0,0
12,2009,530400,9,8,1,0
1,2010,530400,7,7,0,1
2,2010,530400,5,5,0,2
3,2010,530400,9,7,2,1
4,2010,530400,8,6,2,1
5,2010,530400,7,7,0,0
6,2010,530400,10,7,3,0
7,2010,530400,11,7,4,1
8,2010,530400,7,6,1,3
9,2010,530400,9,6,3,1
10,2010,530400,6,5,1,2
11,2010,530400,7,7,0,0
12,2010,530400,5,4,1,1
1,2011,530400,7,4,3,4
2,2011,530400,3,3,0,2
1,1999,823304,0,0,0,0
2,1999,823304,0,0,0,0
3,1999,823304,2,2,0,0
4,1999,823304,0,0,0,0
5,1999,823304,1,1,0,0
6,1999,823304,0,0,0,0
7,1999,823304,0,0,0,0
8,1999,823304,0,0,0,0
9,1999,823304,1,1,0,0
10,1999,823304,0,0,0,0
11,1999,823304,1,1,0,0
12,1999,823304,1,1,0,0
1,2000,823304,0,0,0,0
2,2000,823304,0,0,0,0
3,2000,823304,0,0,0,0
4,2000,823304,0,0,0,0
5,2000,823304,0,0,0,0
6,2000,823304,0,0,0,0
7,2000,823304,0,0,0,0
8,2000,823304,0,0,0,0
9,2000,823304,0,0,0,0
10,2000,823304,3,3,0,0
11,2000,823304,0,0,0,0
12,2000,823304,1,1,0,0
1,2001,823304,0,0,0,0
2,2001,823304,0,0,0,0
3,2001,823304,2,2,0,0
4,2001,823304,0,0,0,0
5,2001,823304,2,2,0,0
6,2001,823304,0,0,0,0
7,2001,823304,0,0,0,0
8,2001,823304,0,0,0,0
9,2001,823304,1,1,0,0
10,2001,823304,0,0,0,0
11,2001,823304,0,0,0,0
12,2001,823304,3,2,1,0
1,2002,823304,1,1,0,0
2,2002,823304,0,0,0,0
3,2002,823304,0,0,0,0
4,2002,823304,0,0,0,0
5,2002,823304,1,1,0,0
6,2002,823304,3,3,0,1
7,2002,823304,0,0,0,0
8,2002,823304,0,0,0,0
9,2002,823304,0,0,0,0
10,2002,823304,3,3,0,0
11,2002,823304,0,0,0,0
12,2002,823304,0,0,0,0
1,2003,823304,0,0,0,1
2,2003,823304,0,0,0,0
3,2003,823304,0,0,0,0
4,2003,823304,0,0,0,0
5,2003,823304,0,0,0,1
6,2003,823304,1,0,1,0
7,2003,823304,1,1,0,0
8,2003,823304,1,1,0,0
9,2003,823304,2,2,0,1
10,2003,823304,0,0,0,0
11,2003,823304,0,0,0,0
12,2003,823304,0,0,0,0
1,2004,823304,0,0,0,0
2,2004,823304,0,0,0,0
3,2004,823304,1,1,0,0
4,2004,823304,0,0,0,0
5,2004,823304,0,0,0,1
6,2004,823304,1,1,0,1
7,2004,823304,1,1,0,1
8,2004,823304,0,0,0,0
9,2004,823304,0,0,0,0
10,2004,823304,1,1,0,2
11,2004,823304,0,0,0,0
12,2004,823304,0,0,0,0
1,2005,823304,0,0,0,0
2,2005,823304,0,0,0,0
3,2005,823304,0,0,0,0
4,2005,823304,0,0,0,0
5,2005,823304,0,0,0,0
6,2005,823304,1,1,0,0
7,2005,823304,0,0,0,0
8,2005,823304,1,1,0,0
9,2005,823304,2,1,1,0
10,2005,823304,0,0,0,0
11,2005,823304,1,0,1,0
12,2005,823304,0,0,0,0
1,2006,823304,0,0,0,0
2,2006,823304,0,0,0,0
3,2006,823304,0,0,0,0
4,2006,823304,3,2,1,0
5,2006,823304,1,1,0,0
6,2006,823304,0,0,0,0
7,2006,823304,1,1,0,0
8,2006,823304,0,0,0,0
9,2006,823304,0,0,0,1
10,2006,823304,1,1,0,1
11,2006,823304,0,0,0,0
12,2006,823304,0,0,0,0
1,2007,823304,0,0,0,0
2,2007,823304,0,0,0,0
3,2007,823304,0,0,0,0
4,2007,823304,0,0,0,0
5,2007,823304,0,0,0,0
6,2007,823304,1,1,0,0
7,2007,823304,0,0,0,0
8,2007,823304,0,0,0,0
9,2007,823304,0,0,0,0
10,2007,823304,2,2,0,0
11,2007,823304,1,1,0,0
12,2007,823304,0,0,0,0
1,2008,823304,0,0,0,0
2,2008,823304,0,0,0,0
3,2008,823304,0,0,0,0
4,2008,823304,1,1,0,0
5,2008,823304,1,1,0,0
6,2008,823304,0,0,0,0
7,2008,823304,2,2,0,0
8,2008,823304,1,1,0,0
9,2008,823304,0,0,0,0
10,2008,823304,1,1,0,0
11,2008,823304,0,0,0,0
12,2008,823304,0,0,0,0
1,2009,823304,1,1,0,0
2,2009,823304,0,0,0,0
3,2009,823304,0,0,0,0
4,2009,823304,1,1,0,0
5,2009,823304,1,0,1,0
6,2009,823304,1,1,0,0
7,2009,823304,0,0,0,1
8,2009,823304,0,0,0,0
9,2009,823304,0,0,0,0
10,2009,823304,2,2,0,0
11,2009,823304,1,1,0,0
12,2009,823304,0,0,0,0
1,2010,823304,2,1,1,0
2,2010,823304,0,0,0,0
3,2010,823304,0,0,0,0
4,2010,823304,2,2,0,0
5,2010,823304,1,1,0,0
6,2010,823304,3,3,0,0
7,2010,823304,1,1,0,0
8,2010,823304,0,0,0,0
9,2010,823304,0,0,0,0
10,2010,823304,0,0,0,0
11,2010,823304,0,0,0,0
12,2010,823304,0,0,0,0
1,2011,823304,0,0,0,0
2,2011,823304,1,1,0,0
1,1999,530501,14,11,3,3
2,1999,530501,24,19,5,10
3,1999,530501,21,16,5,8
4,1999,530501,28,24,4,10
5,1999,530501,35,24,11,9
6,1999,530501,36,28,8,5
7,1999,530501,39,31,8,10
8,1999,530501,45,31,14,10
9,1999,530501,30,21,9,8
10,1999,530501,40,30,10,9
11,1999,530501,32,22,10,8
12,1999,530501,23,21,2,13
1,2000,530501,28,21,7,17
2,2000,530501,18,12,6,11
3,2000,530501,24,20,4,5
4,2000,530501,31,20,11,6
5,2000,530501,24,14,10,12
6,2000,530501,36,26,10,11
7,2000,530501,37,29,8,15
8,2000,530501,48,40,8,4
9,2000,530501,28,18,10,10
10,2000,530501,26,19,7,4
11,2000,530501,20,14,6,7
12,2000,530501,21,17,4,7
1,2001,530501,32,27,5,16
2,2001,530501,22,18,4,7
3,2001,530501,28,23,5,5
4,2001,530501,22,15,7,7
5,2001,530501,30,23,7,3
6,2001,530501,24,14,10,7
7,2001,530501,28,16,12,8
8,2001,530501,40,32,8,10
9,2001,530501,39,30,9,9
10,2001,530501,34,26,8,4
11,2001,530501,22,17,5,11
12,2001,530501,16,12,4,14
1,2002,530501,19,11,8,16
2,2002,530501,18,11,7,13
3,2002,530501,19,13,6,6
4,2002,530501,23,18,5,12
5,2002,530501,30,19,11,8
6,2002,530501,26,19,7,3
7,2002,530501,30,14,16,6
8,2002,530501,41,34,7,3
9,2002,530501,22,16,6,5
10,2002,530501,30,22,8,9
11,2002,530501,28,20,8,16
12,2002,530501,20,16,4,7
1,2003,530501,23,18,5,13
2,2003,530501,22,17,5,4
3,2003,530501,17,12,5,10
4,2003,530501,23,18,5,7
5,2003,530501,21,15,6,11
6,2003,530501,31,25,6,7
7,2003,530501,24,13,11,3
8,2003,530501,28,23,5,3
9,2003,530501,24,13,11,11
10,2003,530501,21,17,4,12
11,2003,530501,27,21,6,7
12,2003,530501,14,11,3,7
1,2004,530501,11,10,1,12
2,2004,530501,19,12,7,16
3,2004,530501,20,12,8,20
4,2004,530501,21,14,7,9
5,2004,530501,24,16,8,16
6,2004,530501,31,24,7,12
7,2004,530501,28,17,11,8
8,2004,530501,25,16,9,13
9,2004,530501,26,19,7,18
10,2004,530501,25,19,6,17
11,2004,530501,25,22,3,13
12,2004,530501,17,16,1,12
1,2005,530501,17,11,6,20
2,2005,530501,27,22,5,13
3,2005,530501,21,19,2,27
4,2005,530501,26,22,4,11
5,2005,530501,18,12,6,12
6,2005,530501,20,16,4,11
7,2005,530501,33,22,11,22
8,2005,530501,51,43,8,8
9,2005,530501,22,19,3,7
10,2005,530501,37,35,2,15
11,2005,530501,24,21,3,22
12,2005,530501,22,20,2,11
1,2006,530501,34,29,5,21
2,2006,530501,19,13,6,10
3,2006,530501,18,11,7,4
4,2006,530501,22,14,8,20
5,2006,530501,25,20,5,9
6,2006,530501,36,28,8,13
7,2006,530501,29,25,4,13
8,2006,530501,31,26,5,8
9,2006,530501,20,17,3,15
10,2006,530501,28,26,2,10
11,2006,530501,20,15,5,10
12,2006,530501,16,15,1,12
1,2007,530501,22,19,3,14
2,2007,530501,17,14,3,16
3,2007,530501,18,17,1,32
4,2007,530501,13,11,2,12
5,2007,530501,20,16,4,13
6,2007,530501,26,24,2,27
7,2007,530501,36,28,8,15
8,2007,530501,29,19,10,5
9,2007,530501,27,22,5,7
10,2007,530501,25,22,3,12
11,2007,530501,15,12,3,9
12,2007,530501,33,27,6,14
1,2008,530501,23,20,3,9
2,2008,530501,32,29,3,6
3,2008,530501,17,15,2,7
4,2008,530501,33,27,6,7
5,2008,530501,30,27,3,3
6,2008,530501,22,19,3,10
7,2008,530501,28,22,6,6
8,2008,530501,30,23,7,4
9,2008,530501,28,23,5,1
10,2008,530501,22,22,0,5
11,2008,530501,29,25,4,3
12,2008,530501,23,22,1,5
1,2009,530501,34,32,2,5
2,2009,530501,16,14,2,8
3,2009,530501,25,23,2,6
4,2009,530501,28,23,5,6
5,2009,530501,41,32,9,10
6,2009,530501,35,29,6,6
7,2009,530501,26,20,6,9
8,2009,530501,33,29,4,3
9,2009,530501,33,30,3,7
10,2009,530501,22,21,1,2
11,2009,530501,24,20,4,10
12,2009,530501,23,20,3,7
1,2010,530501,19,18,1,5
2,2010,530501,21,18,3,11
3,2010,530501,25,15,10,6
4,2010,530501,24,19,5,8
5,2010,530501,26,21,5,10
6,2010,530501,33,27,6,8
7,2010,530501,29,22,7,3
8,2010,530501,25,22,3,8
9,2010,530501,24,20,4,8
10,2010,530501,26,23,3,11
11,2010,530501,37,33,4,9
12,2010,530501,20,16,4,5
1,2011,530501,33,25,8,7
2,2011,530501,22,19,3,12
1,1999,750500,31,26,5,4
2,1999,750500,21,18,3,6
3,1999,750500,34,30,4,3
4,1999,750500,39,33,6,7
5,1999,750500,38,33,5,7
6,1999,750500,42,29,13,7
7,1999,750500,31,25,6,9
8,1999,750500,32,28,4,9
9,1999,750500,40,32,8,10
10,1999,750500,49,44,5,12
11,1999,750500,38,29,9,21
12,1999,750500,24,20,4,8
1,2000,750500,28,26,2,15
2,2000,750500,22,18,4,14
3,2000,750500,31,27,4,1
4,2000,750500,35,30,5,11
5,2000,750500,31,24,7,7
6,2000,750500,33,29,4,8
7,2000,750500,37,35,2,6
8,2000,750500,28,26,2,12
9,2000,750500,41,33,8,3
10,2000,750500,29,23,6,7
11,2000,750500,30,22,8,9
12,2000,750500,20,20,0,5
1,2001,750500,28,25,3,15
2,2001,750500,22,20,2,3
3,2001,750500,40,36,4,8
4,2001,750500,22,16,6,6
5,2001,750500,30,25,5,9
6,2001,750500,30,28,2,10
7,2001,750500,27,22,5,9
8,2001,750500,30,26,4,10
9,2001,750500,32,29,3,10
10,2001,750500,64,57,7,16
11,2001,750500,36,31,5,16
12,2001,750500,37,34,3,9
1,2002,750500,30,28,2,5
2,2002,750500,34,29,5,14
3,2002,750500,39,37,2,11
4,2002,750500,39,32,7,13
5,2002,750500,44,42,2,15
6,2002,750500,37,29,8,5
7,2002,750500,44,38,6,7
8,2002,750500,38,35,3,7
9,2002,750500,41,38,3,5
10,2002,750500,46,41,5,5
11,2002,750500,43,37,6,13
12,2002,750500,32,30,2,17
1,2003,750500,31,29,2,11
2,2003,750500,17,16,1,10
3,2003,750500,39,32,7,14
4,2003,750500,27,23,4,8
5,2003,750500,40,34,6,9
6,2003,750500,44,41,3,5
7,2003,750500,38,34,4,4
8,2003,750500,23,21,2,5
9,2003,750500,37,32,5,14
10,2003,750500,45,41,4,11
11,2003,750500,19,14,5,11
12,2003,750500,22,20,2,5
1,2004,750500,34,31,3,5
2,2004,750500,19,16,3,7
3,2004,750500,33,31,2,6
4,2004,750500,31,28,3,5
5,2004,750500,22,18,4,3
6,2004,750500,24,20,4,3
7,2004,750500,31,26,5,7
8,2004,750500,41,38,3,14
9,2004,750500,30,23,7,11
10,2004,750500,23,22,1,13
11,2004,750500,18,17,1,8
12,2004,750500,29,26,3,7
1,2005,750500,22,19,3,14
2,2005,750500,18,17,1,7
3,2005,750500,26,24,2,13
4,2005,750500,19,16,3,2
5,2005,750500,29,22,7,6
6,2005,750500,32,31,1,7
7,2005,750500,27,22,5,4
8,2005,750500,31,27,4,3
9,2005,750500,37,32,5,10
10,2005,750500,34,32,2,9
11,2005,750500,26,23,3,6
12,2005,750500,20,17,3,16
1,2006,750500,24,19,5,7
2,2006,750500,27,25,2,6
3,2006,750500,21,18,3,10
4,2006,750500,22,18,4,6
5,2006,750500,31,30,1,6
6,2006,750500,26,23,3,7
7,2006,750500,22,18,4,4
8,2006,750500,25,23,2,8
9,2006,750500,41,34,7,8
10,2006,750500,37,31,6,5
11,2006,750500,28,25,3,10
12,2006,750500,19,19,0,9
1,2007,750500,20,18,2,10
2,2007,750500,24,20,4,6
3,2007,750500,27,24,3,6
4,2007,750500,34,29,5,2
5,2007,750500,39,33,6,6
6,2007,750500,34,31,3,8
7,2007,750500,30,24,6,8
8,2007,750500,25,22,3,7
9,2007,750500,43,40,3,7
10,2007,750500,39,36,3,9
11,2007,750500,33,31,2,8
12,2007,750500,32,31,1,9
1,2008,750500,29,28,1,7
2,2008,750500,9,9,0,7
3,2008,750500,27,24,3,11
4,2008,750500,33,30,3,10
5,2008,750500,39,35,4,6
6,2008,750500,32,26,6,2
7,2008,750500,32,27,5,8
8,2008,750500,45,37,8,5
9,2008,750500,37,31,6,7
10,2008,750500,36,31,5,6
11,2008,750500,17,15,2,9
12,2008,750500,30,26,4,6
1,2009,750500,19,17,2,10
2,2009,750500,21,16,5,6
3,2009,750500,26,20,6,7
4,2009,750500,24,24,0,3
5,2009,750500,41,36,5,10
6,2009,750500,36,32,4,8
7,2009,750500,35,29,6,11
8,2009,750500,28,25,3,2
9,2009,750500,32,30,2,4
10,2009,750500,25,19,6,6
11,2009,750500,26,21,5,4
12,2009,750500,23,20,3,0
1,2010,750500,21,18,3,4
2,2010,750500,20,18,2,8
3,2010,750500,28,24,4,6
4,2010,750500,37,30,7,2
5,2010,750500,30,27,3,5
6,2010,750500,35,30,5,7
7,2010,750500,26,21,5,5
8,2010,750500,19,15,4,4
9,2010,750500,18,17,1,2
10,2010,750500,23,20,3,4
11,2010,750500,34,29,5,7
12,2010,750500,28,28,0,10
1,2011,750500,28,27,1,5
2,2011,750500,12,8,4,4
1,1999,530300,16,13,3,0
2,1999,530300,13,10,3,5
3,1999,530300,19,15,4,3
4,1999,530300,20,14,6,7
5,1999,530300,22,17,5,7
6,1999,530300,17,12,5,7
7,1999,530300,25,18,7,2
8,1999,530300,21,19,2,2
9,1999,530300,28,24,4,3
10,1999,530300,24,18,6,9
11,1999,530300,19,12,7,5
12,1999,530300,24,21,3,3
1,2000,530300,25,20,5,3
2,2000,530300,17,12,5,4
3,2000,530300,22,20,2,6
4,2000,530300,27,20,7,3
5,2000,530300,21,16,5,10
6,2000,530300,21,15,6,4
7,2000,530300,33,29,4,7
8,2000,530300,33,24,9,3
9,2000,530300,31,27,4,4
10,2000,530300,31,27,4,3
11,2000,530300,24,17,7,5
12,2000,530300,19,15,4,1
1,2001,530300,20,16,4,3
2,2001,530300,7,5,2,9
3,2001,530300,12,10,2,3
4,2001,530300,21,16,5,3
5,2001,530300,21,14,7,2
6,2001,530300,24,22,2,5
7,2001,530300,30,24,6,1
8,2001,530300,16,12,4,3
9,2001,530300,21,15,6,4
10,2001,530300,29,23,6,2
11,2001,530300,31,27,4,4
12,2001,530300,16,12,4,7
1,2002,530300,25,21,4,7
2,2002,530300,12,11,1,8
3,2002,530300,16,11,5,5
4,2002,530300,24,20,4,4
5,2002,530300,25,19,6,2
6,2002,530300,20,12,8,4
7,2002,530300,36,29,7,2
8,2002,530300,23,19,4,4
9,2002,530300,27,24,3,3
10,2002,530300,26,19,7,6
11,2002,530300,12,9,3,3
12,2002,530300,22,19,3,4
1,2003,530300,13,13,0,4
2,2003,530300,20,19,1,9
3,2003,530300,16,11,5,3
4,2003,530300,10,8,2,5
5,2003,530300,27,21,6,3
6,2003,530300,23,15,8,0
7,2003,530300,25,25,0,2
8,2003,530300,13,8,5,5
9,2003,530300,25,15,10,4
10,2003,530300,26,20,6,4
11,2003,530300,18,15,3,8
12,2003,530300,14,14,0,4
1,2004,530300,14,12,2,11
2,2004,530300,12,10,2,16
3,2004,530300,19,13,6,6
4,2004,530300,21,17,4,8
5,2004,530300,17,15,2,6
6,2004,530300,17,14,3,9
7,2004,530300,18,14,4,2
8,2004,530300,18,10,8,10
9,2004,530300,24,18,6,14
10,2004,530300,16,13,3,7
11,2004,530300,25,22,3,3
12,2004,530300,30,26,4,2
1,2005,530300,18,17,1,3
2,2005,530300,16,16,0,4
3,2005,530300,23,21,2,5
4,2005,530300,29,21,8,15
5,2005,530300,28,20,8,9
6,2005,530300,17,10,7,5
7,2005,530300,16,15,1,6
8,2005,530300,23,17,6,4
9,2005,530300,18,15,3,2
10,2005,530300,17,15,2,7
11,2005,530300,12,11,1,6
12,2005,530300,22,21,1,6
1,2006,530300,23,21,2,6
2,2006,530300,13,12,1,6
3,2006,530300,22,18,4,5
4,2006,530300,16,13,3,4
5,2006,530300,16,13,3,7
6,2006,530300,27,24,3,3
7,2006,530300,19,16,3,13
8,2006,530300,20,18,2,5
9,2006,530300,17,15,2,8
10,2006,530300,20,18,2,5
11,2006,530300,21,20,1,5
12,2006,530300,19,19,0,1
1,2007,530300,12,11,1,2
2,2007,530300,7,6,1,0
3,2007,530300,10,8,2,7
4,2007,530300,12,11,1,6
5,2007,530300,27,25,2,0
6,2007,530300,29,27,2,2
7,2007,530300,38,34,4,1
8,2007,530300,19,16,3,5
9,2007,530300,26,20,6,5
10,2007,530300,21,19,2,8
11,2007,530300,33,31,2,12
12,2007,530300,18,16,2,2
1,2008,530300,19,14,5,2
2,2008,530300,15,12,3,1
3,2008,530300,17,14,3,2
4,2008,530300,15,13,2,0
5,2008,530300,30,26,4,3
6,2008,530300,21,16,5,1
7,2008,530300,28,25,3,0
8,2008,530300,28,23,5,5
9,2008,530300,25,16,9,3
10,2008,530300,25,18,7,2
11,2008,530300,24,20,4,4
12,2008,530300,15,9,6,1
1,2009,530300,13,10,3,5
2,2009,530300,14,11,3,0
3,2009,530300,22,17,5,5
4,2009,530300,23,18,5,2
5,2009,530300,23,21,2,1
6,2009,530300,27,21,6,2
7,2009,530300,30,24,6,3
8,2009,530300,37,31,6,1
9,2009,530300,28,26,2,4
10,2009,530300,33,30,3,2
11,2009,530300,33,31,2,1
12,2009,530300,18,16,2,0
1,2010,530300,12,10,2,3
2,2010,530300,11,11,0,2
3,2010,530300,17,17,0,4
4,2010,530300,25,20,5,4
5,2010,530300,29,26,3,6
6,2010,530300,36,31,5,2
7,2010,530300,18,9,9,2
8,2010,530300,23,20,3,4
9,2010,530300,24,22,2,2
10,2010,530300,23,18,5,3
11,2010,530300,24,22,2,2
12,2010,530300,21,15,6,4
1,2011,530300,21,19,2,6
2,2011,530300,9,7,2,3
1,1999,530200,42,33,9,29
2,1999,530200,48,40,8,36
3,1999,530200,35,28,7,37
4,1999,530200,42,30,12,29
5,1999,530200,69,52,17,12
6,1999,530200,71,51,20,24
7,1999,530200,72,50,22,15
8,1999,530200,72,60,12,32
9,1999,530200,77,52,25,24
10,1999,530200,55,46,9,20
11,1999,530200,57,41,16,23
12,1999,530200,53,44,9,26
1,2000,530200,49,35,14,17
2,2000,530200,42,31,11,27
3,2000,530200,44,34,10,15
4,2000,530200,54,40,14,21
5,2000,530200,80,61,19,18
6,2000,530200,69,57,12,23
7,2000,530200,51,38,13,24
8,2000,530200,65,52,13,22
9,2000,530200,78,63,15,23
10,2000,530200,60,39,21,28
11,2000,530200,66,45,21,30
12,2000,530200,45,38,7,34
1,2001,530200,50,40,10,21
2,2001,530200,51,35,16,31
3,2001,530200,48,37,11,44
4,2001,530200,51,36,15,27
5,2001,530200,67,41,26,22
6,2001,530200,55,37,18,28
7,2001,530200,66,47,19,26
8,2001,530200,60,41,19,30
9,2001,530200,69,50,19,42
10,2001,530200,58,46,12,38
11,2001,530200,60,51,9,29
12,2001,530200,49,37,12,43
1,2002,530200,45,33,12,46
2,2002,530200,46,36,10,80
3,2002,530200,46,27,19,43
4,2002,530200,59,49,10,35
5,2002,530200,46,32,14,26
6,2002,530200,50,32,18,17
7,2002,530200,63,48,15,20
8,2002,530200,76,52,24,11
9,2002,530200,75,52,23,8
10,2002,530200,67,53,14,23
11,2002,530200,47,35,12,17
12,2002,530200,57,43,14,22
1,2003,530200,51,44,7,31
2,2003,530200,43,25,18,24
3,2003,530200,53,34,19,34
4,2003,530200,47,34,13,24
5,2003,530200,48,34,14,16
6,2003,530200,57,35,22,26
7,2003,530200,43,30,13,17
8,2003,530200,55,42,13,28
9,2003,530200,54,42,12,24
10,2003,530200,64,52,12,35
11,2003,530200,34,26,8,40
12,2003,530200,46,36,10,50
1,2004,530200,44,39,5,40
2,2004,530200,33,31,2,51
3,2004,530200,54,36,18,36
4,2004,530200,37,26,11,20
5,2004,530200,55,41,14,27
6,2004,530200,55,30,25,24
7,2004,530200,45,36,9,27
8,2004,530200,69,51,18,67
9,2004,530200,76,51,25,47
10,2004,530200,73,53,20,66
11,2004,530200,61,50,11,24
12,2004,530200,56,42,14,39
1,2005,530200,46,40,6,56
2,2005,530200,47,39,8,50
3,2005,530200,58,41,17,23
4,2005,530200,73,59,14,35
5,2005,530200,59,44,15,37
6,2005,530200,64,48,16,46
7,2005,530200,54,43,11,38
8,2005,530200,60,47,13,53
9,2005,530200,70,54,16,28
10,2005,530200,55,48,7,46
11,2005,530200,50,40,10,58
12,2005,530200,48,43,5,21
1,2006,530200,54,48,6,54
2,2006,530200,61,48,13,17
3,2006,530200,61,49,12,31
4,2006,530200,57,39,18,69
5,2006,530200,68,46,22,13
6,2006,530200,69,47,22,51
7,2006,530200,80,51,29,37
8,2006,530200,52,42,10,29
9,2006,530200,66,55,11,28
10,2006,530200,89,73,16,31
11,2006,530200,58,41,17,43
12,2006,530200,59,48,11,62
1,2007,530200,38,25,13,44
2,2007,530200,35,25,10,47
3,2007,530200,47,33,14,70
4,2007,530200,55,42,13,60
5,2007,530200,64,48,16,42
6,2007,530200,56,45,11,67
7,2007,530200,87,61,26,45
8,2007,530200,82,68,14,29
9,2007,530200,56,44,12,45
10,2007,530200,65,55,10,42
11,2007,530200,49,35,14,21
12,2007,530200,61,48,13,22
1,2008,530200,50,39,11,15
2,2008,530200,40,35,5,18
3,2008,530200,57,40,17,28
4,2008,530200,61,46,15,13
5,2008,530200,69,54,15,13
6,2008,530200,79,56,23,29
7,2008,530200,98,67,31,14
8,2008,530200,75,51,24,30
9,2008,530200,77,61,16,26
10,2008,530200,75,62,13,13
11,2008,530200,61,52,9,17
12,2008,530200,59,54,5,18
1,2009,530200,61,51,10,26
2,2009,530200,43,33,10,19
3,2009,530200,53,45,8,23
4,2009,530200,57,42,15,16
5,2009,530200,63,52,11,25
6,2009,530200,72,52,20,22
7,2009,530200,58,48,10,21
8,2009,530200,63,48,15,23
9,2009,530200,60,49,11,24
10,2009,530200,55,47,8,20
11,2009,530200,46,39,7,16
12,2009,530200,48,38,10,14
1,2010,530200,33,29,4,15
2,2010,530200,36,27,9,22
3,2010,530200,43,37,6,24
4,2010,530200,64,53,11,16
5,2010,530200,60,49,11,20
6,2010,530200,42,29,13,10
7,2010,530200,54,47,7,10
8,2010,530200,51,45,6,22
9,2010,530200,45,35,10,27
10,2010,530200,72,56,16,18
11,2010,530200,47,42,5,19
12,2010,530200,40,37,3,14
1,2011,530200,55,48,7,27
2,2011,530200,31,24,7,29
1,1999,530100,24,20,4,16
2,1999,530100,31,23,8,13
3,1999,530100,24,22,2,4
4,1999,530100,26,20,6,13
5,1999,530100,38,26,12,4
6,1999,530100,34,25,9,5
7,1999,530100,51,32,19,5
8,1999,530100,44,34,10,11
9,1999,530100,40,32,8,4
10,1999,530100,40,29,11,9
11,1999,530100,29,22,7,9
12,1999,530100,34,27,7,11
1,2000,530100,37,28,9,12
2,2000,530100,22,18,4,9
3,2000,530100,43,37,6,5
4,2000,530100,38,32,6,9
5,2000,530100,33,24,9,7
6,2000,530100,34,21,13,5
7,2000,530100,36,26,10,14
8,2000,530100,35,24,11,9
9,2000,530100,31,22,9,14
10,2000,530100,46,36,10,11
11,2000,530100,34,22,12,7
12,2000,530100,38,27,11,6
1,2001,530100,20,15,5,15
2,2001,530100,22,13,9,9
3,2001,530100,26,20,6,6
4,2001,530100,41,27,14,3
5,2001,530100,43,33,10,4
6,2001,530100,46,37,9,11
7,2001,530100,24,13,11,1
8,2001,530100,44,28,16,4
9,2001,530100,49,37,12,4
10,2001,530100,44,38,6,7
11,2001,530100,34,25,9,6
12,2001,530100,47,34,13,6
1,2002,530100,27,22,5,3
2,2002,530100,21,17,4,5
3,2002,530100,44,30,14,9
4,2002,530100,45,30,15,7
5,2002,530100,24,16,8,10
6,2002,530100,30,19,11,6
7,2002,530100,37,27,10,6
8,2002,530100,37,29,8,6
9,2002,530100,45,29,16,11
10,2002,530100,37,26,11,12
11,2002,530100,28,22,6,2
12,2002,530100,16,13,3,6
1,2003,530100,24,21,3,8
2,2003,530100,18,14,4,8
3,2003,530100,37,29,8,4
4,2003,530100,48,37,11,8
5,2003,530100,32,19,13,2
6,2003,530100,35,27,8,10
7,2003,530100,29,18,11,3
8,2003,530100,30,18,12,11
9,2003,530100,26,17,9,8
10,2003,530100,27,22,5,16
11,2003,530100,26,21,5,9
12,2003,530100,31,26,5,4
1,2004,530100,26,16,10,11
2,2004,530100,25,16,9,9
3,2004,530100,36,25,11,9
4,2004,530100,24,23,1,8
5,2004,530100,26,17,9,10
6,2004,530100,31,21,10,10
7,2004,530100,31,19,12,14
8,2004,530100,20,15,5,14
9,2004,530100,34,25,9,18
10,2004,530100,30,22,8,11
11,2004,530100,27,19,8,3
12,2004,530100,21,18,3,7
1,2005,530100,15,14,1,12
2,2005,530100,25,21,4,11
3,2005,530100,19,14,5,8
4,2005,530100,26,17,9,13
5,2005,530100,28,23,5,17
6,2005,530100,26,20,6,13
7,2005,530100,25,19,6,17
8,2005,530100,32,26,6,15
9,2005,530100,37,29,8,7
10,2005,530100,28,26,2,21
11,2005,530100,29,23,6,25
12,2005,530100,19,14,5,13
1,2006,530100,32,29,3,5
2,2006,530100,23,21,2,7
3,2006,530100,33,26,7,10
4,2006,530100,26,19,7,22
5,2006,530100,23,18,5,12
6,2006,530100,18,14,4,17
7,2006,530100,29,21,8,18
8,2006,530100,19,15,4,24
9,2006,530100,29,24,5,6
10,2006,530100,28,24,4,18
11,2006,530100,32,23,9,14
12,2006,530100,24,21,3,16
1,2007,530100,29,26,3,22
2,2007,530100,20,14,6,34
3,2007,530100,35,29,6,29
4,2007,530100,35,30,5,21
5,2007,530100,32,26,6,19
6,2007,530100,42,32,10,20
7,2007,530100,43,39,4,31
8,2007,530100,50,39,11,17
9,2007,530100,36,29,7,28
10,2007,530100,30,25,5,34
11,2007,530100,29,23,6,16
12,2007,530100,23,19,4,22
1,2008,530100,39,35,4,7
2,2008,530100,21,15,6,8
3,2008,530100,29,24,5,27
4,2008,530100,26,20,6,9
5,2008,530100,33,19,14,6
6,2008,530100,35,25,10,8
7,2008,530100,38,28,10,7
8,2008,530100,50,48,2,16
9,2008,530100,47,38,9,20
10,2008,530100,35,29,6,10
11,2008,530100,31,23,8,9
12,2008,530100,31,23,8,15
1,2009,530100,27,18,9,19
2,2009,530100,15,12,3,8
3,2009,530100,24,19,5,14
4,2009,530100,35,28,7,11
5,2009,530100,22,15,7,7
6,2009,530100,37,27,10,12
7,2009,530100,33,26,7,9
8,2009,530100,32,26,6,7
9,2009,530100,30,24,6,5
10,2009,530100,28,23,5,10
11,2009,530100,22,18,4,10
12,2009,530100,16,15,1,7
1,2010,530100,23,20,3,8
2,2010,530100,16,12,4,30
3,2010,530100,25,25,0,19
4,2010,530100,20,13,7,3
5,2010,530100,23,18,5,8
6,2010,530100,22,18,4,8
7,2010,530100,31,27,4,2
8,2010,530100,34,27,7,7
9,2010,530100,23,21,2,15
10,2010,530100,22,17,5,6
11,2010,530100,16,14,2,10
12,2010,530100,15,12,3,4
1,2011,530100,17,15,2,3
2,2011,530100,11,9,2,6
1,1999,750400,0,0,0,1
2,1999,750400,3,3,0,0
3,1999,750400,3,2,1,1
4,1999,750400,2,2,0,0
5,1999,750400,7,6,1,0
6,1999,750400,3,3,0,0
7,1999,750400,4,3,1,0
8,1999,750400,6,4,2,0
9,1999,750400,7,7,0,2
10,1999,750400,7,6,1,1
11,1999,750400,3,3,0,0
12,1999,750400,2,2,0,1
1,2000,750400,4,3,1,0
2,2000,750400,3,3,0,0
3,2000,750400,0,0,0,0
4,2000,750400,7,7,0,0
5,2000,750400,5,4,1,0
6,2000,750400,5,5,0,0
7,2000,750400,5,5,0,2
8,2000,750400,5,5,0,0
9,2000,750400,3,3,0,0
10,2000,750400,6,6,0,2
11,2000,750400,2,1,1,0
12,2000,750400,3,2,1,0
1,2001,750400,4,4,0,1
2,2001,750400,11,10,1,0
3,2001,750400,1,1,0,1
4,2001,750400,3,2,1,1
5,2001,750400,8,8,0,0
6,2001,750400,3,3,0,0
7,2001,750400,5,5,0,1
8,2001,750400,8,7,1,0
9,2001,750400,5,5,0,0
10,2001,750400,8,6,2,0
11,2001,750400,11,10,1,1
12,2001,750400,7,7,0,0
1,2002,750400,3,3,0,1
2,2002,750400,3,3,0,0
3,2002,750400,5,5,0,0
4,2002,750400,4,4,0,1
5,2002,750400,3,3,0,2
6,2002,750400,7,6,1,0
7,2002,750400,12,11,1,1
8,2002,750400,9,7,2,2
9,2002,750400,7,6,1,0
10,2002,750400,4,4,0,1
11,2002,750400,3,3,0,0
12,2002,750400,7,7,0,0
1,2003,750400,3,3,0,0
2,2003,750400,3,3,0,0
3,2003,750400,5,5,0,0
4,2003,750400,3,3,0,2
5,2003,750400,6,5,1,3
6,2003,750400,2,2,0,0
7,2003,750400,9,8,1,0
8,2003,750400,15,15,0,0
9,2003,750400,2,2,0,0
10,2003,750400,4,3,1,0
11,2003,750400,2,2,0,0
12,2003,750400,5,5,0,0
1,2004,750400,6,6,0,0
2,2004,750400,4,4,0,0
3,2004,750400,5,5,0,0
4,2004,750400,3,3,0,2
5,2004,750400,5,5,0,0
6,2004,750400,2,2,0,0
7,2004,750400,9,9,0,1
8,2004,750400,4,4,0,1
9,2004,750400,0,0,0,0
10,2004,750400,2,2,0,0
11,2004,750400,7,7,0,0
12,2004,750400,2,2,0,0
1,2005,750400,2,2,0,0
2,2005,750400,6,6,0,1
3,2005,750400,6,6,0,0
4,2005,750400,4,4,0,0
5,2005,750400,4,4,0,0
6,2005,750400,4,4,0,0
7,2005,750400,5,5,0,1
8,2005,750400,7,7,0,0
9,2005,750400,5,5,0,0
10,2005,750400,8,7,1,0
11,2005,750400,2,2,0,0
12,2005,750400,5,5,0,0
1,2006,750400,2,2,0,0
2,2006,750400,2,1,1,0
3,2006,750400,5,5,0,0
4,2006,750400,7,7,0,0
5,2006,750400,3,3,0,0
6,2006,750400,6,6,0,0
7,2006,750400,11,11,0,0
8,2006,750400,11,11,0,0
9,2006,750400,6,6,0,0
10,2006,750400,6,6,0,0
11,2006,750400,4,3,1,0
12,2006,750400,5,5,0,0
1,2007,750400,0,0,0,0
2,2007,750400,0,0,0,0
3,2007,750400,8,8,0,0
4,2007,750400,5,5,0,0
5,2007,750400,3,3,0,0
6,2007,750400,8,7,1,0
7,2007,750400,6,6,0,0
8,2007,750400,6,6,0,1
9,2007,750400,9,8,1,0
10,2007,750400,7,7,0,0
11,2007,750400,5,5,0,0
12,2007,750400,2,2,0,0
1,2008,750400,5,5,0,0
2,2008,750400,2,2,0,0
3,2008,750400,4,4,0,0
4,2008,750400,3,3,0,1
5,2008,750400,5,5,0,0
6,2008,750400,6,5,1,1
7,2008,750400,7,7,0,1
8,2008,750400,13,13,0,1
9,2008,750400,1,1,0,0
10,2008,750400,3,3,0,0
11,2008,750400,4,4,0,0
12,2008,750400,4,4,0,0
1,2009,750400,2,2,0,0
2,2009,750400,4,4,0,0
3,2009,750400,3,3,0,1
4,2009,750400,2,2,0,0
5,2009,750400,4,4,0,0
6,2009,750400,9,9,0,0
7,2009,750400,6,6,0,0
8,2009,750400,3,3,0,0
9,2009,750400,10,10,0,0
10,2009,750400,7,7,0,1
11,2009,750400,8,8,0,0
12,2009,750400,3,3,0,0
1,2010,750400,9,9,0,0
2,2010,750400,3,3,0,0
3,2010,750400,6,6,0,0
4,2010,750400,7,7,0,0
5,2010,750400,6,6,0,0
6,2010,750400,5,5,0,0
7,2010,750400,6,6,0,0
8,2010,750400,13,13,0,1
9,2010,750400,6,6,0,0
10,2010,750400,9,9,0,1
11,2010,750400,5,5,0,0
12,2010,750400,4,4,0,0
1,2011,750400,0,0,0,0
2,2011,750400,1,1,0,0
1,1999,740400,2,2,0,0
2,1999,740400,6,5,1,0
3,1999,740400,6,6,0,1
4,1999,740400,0,0,0,0
5,1999,740400,5,5,0,0
6,1999,740400,5,4,1,1
7,1999,740400,4,4,0,0
8,1999,740400,9,6,3,0
9,1999,740400,5,3,2,0
10,1999,740400,6,5,1,0
11,1999,740400,3,3,0,1
12,1999,740400,5,5,0,1
1,2000,740400,7,5,2,0
2,2000,740400,7,7,0,1
3,2000,740400,11,8,3,0
4,2000,740400,5,4,1,0
5,2000,740400,7,6,1,0
6,2000,740400,4,3,1,0
7,2000,740400,4,4,0,0
8,2000,740400,7,4,3,0
9,2000,740400,2,2,0,1
10,2000,740400,2,2,0,0
11,2000,740400,6,6,0,0
12,2000,740400,1,1,0,0
1,2001,740400,6,6,0,1
2,2001,740400,9,8,1,1
3,2001,740400,0,0,0,0
4,2001,740400,7,5,2,0
5,2001,740400,7,7,0,0
6,2001,740400,4,4,0,1
7,2001,740400,4,2,2,0
8,2001,740400,3,2,1,1
9,2001,740400,3,2,1,0
10,2001,740400,7,7,0,0
11,2001,740400,2,2,0,0
12,2001,740400,2,2,0,0
1,2002,740400,4,3,1,0
2,2002,740400,3,3,0,3
3,2002,740400,4,4,0,2
4,2002,740400,5,3,2,0
5,2002,740400,12,10,2,1
6,2002,740400,2,2,0,1
7,2002,740400,6,6,0,0
8,2002,740400,4,4,0,0
9,2002,740400,5,3,2,0
10,2002,740400,2,1,1,0
11,2002,740400,1,0,1,1
12,2002,740400,3,2,1,2
1,2003,740400,3,3,0,0
2,2003,740400,2,1,1,0
3,2003,740400,9,9,0,1
4,2003,740400,9,7,2,0
5,2003,740400,4,3,1,0
6,2003,740400,5,5,0,0
7,2003,740400,5,5,0,0
8,2003,740400,4,2,2,1
9,2003,740400,5,5,0,0
10,2003,740400,12,11,1,1
11,2003,740400,9,7,2,1
12,2003,740400,3,3,0,0
1,2004,740400,2,2,0,1
2,2004,740400,5,3,2,0
3,2004,740400,9,6,3,2
4,2004,740400,8,8,0,5
5,2004,740400,7,7,0,0
6,2004,740400,10,10,0,0
7,2004,740400,6,6,0,0
8,2004,740400,4,3,1,0
9,2004,740400,4,4,0,0
10,2004,740400,6,6,0,5
11,2004,740400,4,4,0,3
12,2004,740400,5,5,0,0
1,2005,740400,1,1,0,0
2,2005,740400,5,4,1,0
3,2005,740400,5,3,2,1
4,2005,740400,6,3,3,2
5,2005,740400,5,5,0,0
6,2005,740400,4,4,0,1
7,2005,740400,4,4,0,1
8,2005,740400,6,6,0,1
9,2005,740400,9,9,0,0
10,2005,740400,2,2,0,1
11,2005,740400,3,2,1,1
12,2005,740400,6,5,1,0
1,2006,740400,5,5,0,2
2,2006,740400,5,5,0,0
3,2006,740400,6,5,1,1
4,2006,740400,3,2,1,1
5,2006,740400,4,4,0,0
6,2006,740400,4,4,0,0
7,2006,740400,4,4,0,1
8,2006,740400,4,3,1,2
9,2006,740400,13,13,0,0
10,2006,740400,9,9,0,1
11,2006,740400,4,4,0,1
12,2006,740400,4,4,0,0
1,2007,740400,3,2,1,0
2,2007,740400,5,5,0,1
3,2007,740400,5,5,0,0
4,2007,740400,6,5,1,0
5,2007,740400,6,6,0,2
6,2007,740400,2,2,0,1
7,2007,740400,5,5,0,0
8,2007,740400,8,7,1,0
9,2007,740400,8,7,1,0
10,2007,740400,7,6,1,0
11,2007,740400,1,1,0,1
12,2007,740400,2,2,0,0
1,2008,740400,3,3,0,1
2,2008,740400,5,4,1,0
3,2008,740400,4,4,0,1
4,2008,740400,8,8,0,0
5,2008,740400,2,2,0,0
6,2008,740400,12,11,1,3
7,2008,740400,13,12,1,0
8,2008,740400,5,4,1,3
9,2008,740400,8,7,1,1
10,2008,740400,4,4,0,1
11,2008,740400,7,6,1,0
12,2008,740400,4,3,1,1
1,2009,740400,2,2,0,0
2,2009,740400,3,3,0,0
3,2009,740400,3,3,0,0
4,2009,740400,5,5,0,0
5,2009,740400,3,3,0,0
6,2009,740400,14,14,0,0
7,2009,740400,4,4,0,1
8,2009,740400,6,5,1,0
9,2009,740400,9,9,0,0
10,2009,740400,4,4,0,1
11,2009,740400,6,6,0,0
12,2009,740400,3,3,0,1
1,2010,740400,1,1,0,0
2,2010,740400,3,3,0,0
3,2010,740400,5,5,0,0
4,2010,740400,8,8,0,0
5,2010,740400,6,6,0,1
6,2010,740400,4,4,0,0
7,2010,740400,5,4,1,3
8,2010,740400,7,7,0,2
9,2010,740400,2,2,0,0
10,2010,740400,6,6,0,0
11,2010,740400,10,8,2,1
12,2010,740400,3,3,0,0
1,2011,740400,4,4,0,1
2,2011,740400,3,3,0,0
1,1999,520600,13,11,2,2
2,1999,520600,16,15,1,4
3,1999,520600,17,14,3,4
4,1999,520600,14,10,4,3
5,1999,520600,11,8,3,2
6,1999,520600,14,13,1,3
7,1999,520600,11,10,1,2
8,1999,520600,14,12,2,3
9,1999,520600,22,20,2,5
10,1999,520600,10,9,1,1
11,1999,520600,15,13,2,0
12,1999,520600,8,8,0,2
1,2000,520600,6,6,0,3
2,2000,520600,13,12,1,1
3,2000,520600,7,5,2,8
4,2000,520600,10,7,3,2
5,2000,520600,11,8,3,0
6,2000,520600,7,5,2,2
7,2000,520600,8,6,2,0
8,2000,520600,7,3,4,2
9,2000,520600,9,7,2,4
10,2000,520600,9,6,3,3
11,2000,520600,4,1,3,2
12,2000,520600,7,4,3,3
1,2001,520600,5,5,0,0
2,2001,520600,6,5,1,6
3,2001,520600,3,3,0,4
4,2001,520600,11,8,3,3
5,2001,520600,10,7,3,1
6,2001,520600,9,8,1,3
7,2001,520600,8,8,0,1
8,2001,520600,6,6,0,1
9,2001,520600,9,5,4,3
10,2001,520600,10,10,0,6
11,2001,520600,5,4,1,3
12,2001,520600,6,6,0,0
1,2002,520600,5,5,0,5
2,2002,520600,9,8,1,3
3,2002,520600,6,3,3,4
4,2002,520600,10,9,1,3
5,2002,520600,5,4,1,5
6,2002,520600,10,9,1,0
7,2002,520600,7,6,1,2
8,2002,520600,10,8,2,0
9,2002,520600,14,13,1,0
10,2002,520600,13,11,2,2
11,2002,520600,11,8,3,3
12,2002,520600,12,11,1,1
1,2003,520600,10,9,1,3
2,2003,520600,8,7,1,7
3,2003,520600,10,6,4,2
4,2003,520600,11,9,2,5
5,2003,520600,12,11,1,2
6,2003,520600,9,7,2,5
7,2003,520600,10,10,0,3
8,2003,520600,8,7,1,1
9,2003,520600,12,10,2,2
10,2003,520600,10,6,4,0
11,2003,520600,9,8,1,5
12,2003,520600,7,5,2,4
1,2004,520600,8,6,2,3
2,2004,520600,4,3,1,3
3,2004,520600,10,9,1,4
4,2004,520600,12,10,2,2
5,2004,520600,9,7,2,1
6,2004,520600,9,5,4,0
7,2004,520600,6,5,1,2
8,2004,520600,6,6,0,4
9,2004,520600,9,5,4,3
10,2004,520600,3,2,1,2
11,2004,520600,3,3,0,4
12,2004,520600,12,12,0,2
1,2005,520600,7,7,0,8
2,2005,520600,4,4,0,4
3,2005,520600,13,12,1,8
4,2005,520600,12,11,1,1
5,2005,520600,8,6,2,5
6,2005,520600,10,10,0,3
7,2005,520600,9,8,1,1
8,2005,520600,8,6,2,0
9,2005,520600,12,10,2,3
10,2005,520600,10,10,0,7
11,2005,520600,8,7,1,4
12,2005,520600,11,10,1,3
1,2006,520600,12,8,4,2
2,2006,520600,2,2,0,5
3,2006,520600,7,7,0,6
4,2006,520600,12,11,1,4
5,2006,520600,9,8,1,8
6,2006,520600,7,4,3,2
7,2006,520600,6,6,0,2
8,2006,520600,9,7,2,2
9,2006,520600,3,3,0,1
10,2006,520600,6,5,1,2
11,2006,520600,4,4,0,6
12,2006,520600,5,4,1,4
1,2007,520600,2,1,1,2
2,2007,520600,8,6,2,1
3,2007,520600,5,5,0,6
4,2007,520600,6,6,0,5
5,2007,520600,7,6,1,5
6,2007,520600,5,3,2,4
7,2007,520600,8,7,1,3
8,2007,520600,5,3,2,4
9,2007,520600,6,5,1,8
10,2007,520600,8,7,1,6
11,2007,520600,7,7,0,5
12,2007,520600,16,15,1,6
1,2008,520600,14,13,1,8
2,2008,520600,11,8,3,11
3,2008,520600,13,11,2,3
4,2008,520600,8,8,0,6
5,2008,520600,15,15,0,4
6,2008,520600,5,4,1,0
7,2008,520600,5,3,2,3
8,2008,520600,9,9,0,3
9,2008,520600,5,5,0,4
10,2008,520600,11,11,0,5
11,2008,520600,5,5,0,3
12,2008,520600,11,9,2,3
1,2009,520600,12,10,2,6
2,2009,520600,10,9,1,9
3,2009,520600,7,4,3,5
4,2009,520600,3,2,1,2
5,2009,520600,13,12,1,8
6,2009,520600,11,11,0,3
7,2009,520600,6,6,0,3
8,2009,520600,13,11,2,1
9,2009,520600,8,7,1,5
10,2009,520600,9,9,0,5
11,2009,520600,10,9,1,2
12,2009,520600,10,8,2,2
1,2010,520600,6,5,1,1
2,2010,520600,6,6,0,4
3,2010,520600,6,6,0,4
4,2010,520600,3,3,0,2
5,2010,520600,7,7,0,2
6,2010,520600,10,9,1,1
7,2010,520600,2,1,1,2
8,2010,520600,10,9,1,2
9,2010,520600,7,6,1,1
10,2010,520600,12,11,1,3
11,2010,520600,4,4,0,2
12,2010,520600,7,5,2,5
1,2011,520600,7,5,2,4
2,2011,520600,5,5,0,4
1,1999,520500,2,2,0,0
2,1999,520500,8,8,0,0
3,1999,520500,4,3,1,1
4,1999,520500,10,9,1,0
5,1999,520500,7,7,0,0
6,1999,520500,10,10,0,1
7,1999,520500,9,7,2,4
8,1999,520500,10,9,1,0
9,1999,520500,16,15,1,0
10,1999,520500,7,6,1,2
11,1999,520500,8,7,1,0
12,1999,520500,6,6,0,3
1,2000,520500,10,10,0,1
2,2000,520500,4,4,0,1
3,2000,520500,10,8,2,1
4,2000,520500,6,5,1,0
5,2000,520500,6,5,1,1
6,2000,520500,9,7,2,0
7,2000,520500,8,7,1,1
8,2000,520500,8,7,1,0
9,2000,520500,7,7,0,0
10,2000,520500,11,8,3,0
11,2000,520500,4,4,0,0
12,2000,520500,7,5,2,0
1,2001,520500,2,2,0,0
2,2001,520500,2,1,1,2
3,2001,520500,7,7,0,1
4,2001,520500,3,2,1,0
5,2001,520500,2,2,0,0
6,2001,520500,6,5,1,0
7,2001,520500,3,3,0,3
8,2001,520500,3,3,0,0
9,2001,520500,6,4,2,1
10,2001,520500,5,5,0,0
11,2001,520500,6,5,1,0
12,2001,520500,4,4,0,0
1,2002,520500,5,5,0,0
2,2002,520500,1,1,0,2
3,2002,520500,5,5,0,1
4,2002,520500,3,3,0,1
5,2002,520500,10,6,4,0
6,2002,520500,3,3,0,0
7,2002,520500,6,6,0,0
8,2002,520500,9,8,1,0
9,2002,520500,5,5,0,0
10,2002,520500,3,2,1,0
11,2002,520500,4,4,0,0
12,2002,520500,4,4,0,2
1,2003,520500,13,11,2,1
2,2003,520500,3,3,0,0
3,2003,520500,8,7,1,2
4,2003,520500,13,12,1,0
5,2003,520500,3,3,0,0
6,2003,520500,6,6,0,1
7,2003,520500,9,7,2,1
8,2003,520500,6,6,0,0
9,2003,520500,6,6,0,3
10,2003,520500,8,8,0,4
11,2003,520500,1,1,0,2
12,2003,520500,9,8,1,0
1,2004,520500,2,2,0,0
2,2004,520500,5,5,0,0
3,2004,520500,3,3,0,1
4,2004,520500,7,7,0,0
5,2004,520500,5,2,3,0
6,2004,520500,3,3,0,0
7,2004,520500,5,4,1,0
8,2004,520500,7,5,2,0
9,2004,520500,2,2,0,1
10,2004,520500,10,8,2,0
11,2004,520500,7,6,1,0
12,2004,520500,10,9,1,0
1,2005,520500,5,4,1,0
2,2005,520500,3,3,0,1
3,2005,520500,6,6,0,0
4,2005,520500,12,9,3,2
5,2005,520500,7,4,3,0
6,2005,520500,4,4,0,0
7,2005,520500,6,6,0,0
8,2005,520500,7,6,1,0
9,2005,520500,10,10,0,1
10,2005,520500,10,9,1,0
11,2005,520500,9,8,1,2
12,2005,520500,4,4,0,1
1,2006,520500,5,4,1,1
2,2006,520500,5,5,0,0
3,2006,520500,3,2,1,0
4,2006,520500,4,4,0,1
5,2006,520500,7,6,1,0
6,2006,520500,6,5,1,0
7,2006,520500,6,4,2,3
8,2006,520500,8,8,0,0
9,2006,520500,15,14,1,1
10,2006,520500,4,4,0,0
11,2006,520500,6,5,1,7
12,2006,520500,6,6,0,2
1,2007,520500,6,4,2,2
2,2007,520500,5,5,0,0
3,2007,520500,8,6,2,4
4,2007,520500,3,3,0,2
5,2007,520500,2,2,0,2
6,2007,520500,7,4,3,0
7,2007,520500,4,4,0,2
8,2007,520500,7,4,3,0
9,2007,520500,10,9,1,2
10,2007,520500,8,6,2,1
11,2007,520500,8,7,1,0
12,2007,520500,13,13,0,0
1,2008,520500,5,5,0,3
2,2008,520500,7,6,1,2
3,2008,520500,5,4,1,0
4,2008,520500,5,5,0,0
5,2008,520500,3,3,0,1
6,2008,520500,8,7,1,1
7,2008,520500,6,5,1,2
8,2008,520500,9,8,1,0
9,2008,520500,12,10,2,0
10,2008,520500,9,8,1,1
11,2008,520500,4,3,1,1
12,2008,520500,8,8,0,1
1,2009,520500,3,3,0,2
2,2009,520500,2,2,0,0
3,2009,520500,6,5,1,0
4,2009,520500,4,4,0,3
5,2009,520500,7,5,2,0
6,2009,520500,12,11,1,2
7,2009,520500,11,11,0,1
8,2009,520500,10,9,1,2
9,2009,520500,8,6,2,1
10,2009,520500,7,7,0,1
11,2009,520500,4,4,0,0
12,2009,520500,6,5,1,0
1,2010,520500,2,2,0,0
2,2010,520500,6,6,0,2
3,2010,520500,6,6,0,1
4,2010,520500,7,6,1,2
5,2010,520500,11,11,0,1
6,2010,520500,8,8,0,0
7,2010,520500,4,4,0,0
8,2010,520500,10,8,2,1
9,2010,520500,6,5,1,1
10,2010,520500,5,5,0,0
11,2010,520500,6,6,0,1
12,2010,520500,10,9,1,0
1,2011,520500,2,2,0,1
2,2011,520500,2,2,0,0
1,1999,750600,22,13,9,6
2,1999,750600,25,20,5,8
3,1999,750600,14,10,4,8
4,1999,750600,28,22,6,10
5,1999,750600,26,20,6,2
6,1999,750600,28,24,4,1
7,1999,750600,33,25,8,3
8,1999,750600,21,20,1,4
9,1999,750600,20,15,5,7
10,1999,750600,40,31,9,8
11,1999,750600,35,30,5,5
12,1999,750600,18,14,4,3
1,2000,750600,27,22,5,9
2,2000,750600,19,16,3,17
3,2000,750600,20,14,6,7
4,2000,750600,19,11,8,9
5,2000,750600,22,13,9,6
6,2000,750600,24,19,5,1
7,2000,750600,23,15,8,4
8,2000,750600,36,31,5,5
9,2000,750600,34,27,7,5
10,2000,750600,37,30,7,5
11,2000,750600,31,27,4,7
12,2000,750600,18,17,1,3
1,2001,750600,22,20,2,8
2,2001,750600,15,13,2,10
3,2001,750600,26,19,7,14
4,2001,750600,21,18,3,10
5,2001,750600,26,18,8,7
6,2001,750600,22,15,7,15
7,2001,750600,20,19,1,5
8,2001,750600,28,24,4,13
9,2001,750600,31,25,6,8
10,2001,750600,26,21,5,24
11,2001,750600,26,19,7,17
12,2001,750600,17,15,2,13
1,2002,750600,16,13,3,15
2,2002,750600,6,6,0,14
3,2002,750600,16,12,4,17
4,2002,750600,20,14,6,9
5,2002,750600,20,15,5,8
6,2002,750600,23,16,7,10
7,2002,750600,19,12,7,10
8,2002,750600,29,20,9,3
9,2002,750600,28,20,8,5
10,2002,750600,32,26,6,8
11,2002,750600,22,20,2,9
12,2002,750600,19,15,4,12
1,2003,750600,15,13,2,6
2,2003,750600,12,11,1,11
3,2003,750600,13,12,1,10
4,2003,750600,14,10,4,9
5,2003,750600,37,30,7,7
6,2003,750600,31,25,6,9
7,2003,750600,22,15,7,11
8,2003,750600,20,13,7,8
9,2003,750600,11,10,1,13
10,2003,750600,20,15,5,18
11,2003,750600,13,11,2,13
12,2003,750600,24,21,3,6
1,2004,750600,22,20,2,11
2,2004,750600,17,12,5,28
3,2004,750600,19,15,4,18
4,2004,750600,23,21,2,20
5,2004,750600,18,16,2,5
6,2004,750600,20,17,3,11
7,2004,750600,23,16,7,5
8,2004,750600,25,21,4,18
9,2004,750600,22,18,4,4
10,2004,750600,17,15,2,23
11,2004,750600,19,15,4,1
12,2004,750600,17,15,2,9
1,2005,750600,15,14,1,5
2,2005,750600,14,12,2,14
3,2005,750600,19,17,2,13
4,2005,750600,18,14,4,3
5,2005,750600,22,21,1,7
6,2005,750600,17,15,2,7
7,2005,750600,35,30,5,1
8,2005,750600,31,22,9,2
9,2005,750600,22,19,3,6
10,2005,750600,31,29,2,8
11,2005,750600,24,21,3,12
12,2005,750600,21,21,0,6
1,2006,750600,22,20,2,9
2,2006,750600,24,20,4,6
3,2006,750600,27,26,1,5
4,2006,750600,20,18,2,10
5,2006,750600,30,26,4,13
6,2006,750600,24,20,4,7
7,2006,750600,40,32,8,5
8,2006,750600,30,19,11,5
9,2006,750600,31,24,7,11
10,2006,750600,30,27,3,1
11,2006,750600,28,25,3,9
12,2006,750600,22,21,1,14
1,2007,750600,31,28,3,11
2,2007,750600,17,16,1,10
3,2007,750600,27,21,6,6
4,2007,750600,27,25,2,7
5,2007,750600,36,34,2,3
6,2007,750600,30,26,4,5
7,2007,750600,39,33,6,2
8,2007,750600,53,45,8,12
9,2007,750600,52,46,6,10
10,2007,750600,37,31,6,14
11,2007,750600,33,28,5,9
12,2007,750600,16,14,2,10
1,2008,750600,29,23,6,5
2,2008,750600,29,28,1,6
3,2008,750600,19,16,3,3
4,2008,750600,20,17,3,3
5,2008,750600,24,19,5,4
6,2008,750600,34,23,11,6
7,2008,750600,37,30,7,7
8,2008,750600,25,21,4,7
9,2008,750600,24,22,2,9
10,2008,750600,24,21,3,2
11,2008,750600,18,14,4,6
12,2008,750600,20,18,2,2
1,2009,750600,18,15,3,10
2,2009,750600,17,11,6,4
3,2009,750600,16,11,5,8
4,2009,750600,17,13,4,7
5,2009,750600,27,20,7,4
6,2009,750600,30,27,3,5
7,2009,750600,41,39,2,13
8,2009,750600,38,35,3,12
9,2009,750600,29,22,7,9
10,2009,750600,19,15,4,10
11,2009,750600,31,27,4,8
12,2009,750600,22,14,8,7
1,2010,750600,12,10,2,7
2,2010,750600,17,12,5,5
3,2010,750600,24,19,5,13
4,2010,750600,21,18,3,7
5,2010,750600,25,23,2,12
6,2010,750600,21,18,3,8
7,2010,750600,26,19,7,10
8,2010,750600,27,22,5,9
9,2010,750600,24,19,5,6
10,2010,750600,20,15,5,13
11,2010,750600,16,15,1,4
12,2010,750600,10,9,1,9
1,2011,750600,23,20,3,10
2,2011,750600,14,13,1,8
1,1999,491200,29,24,5,5
2,1999,491200,31,24,7,5
3,1999,491200,36,28,8,6
4,1999,491200,32,26,6,4
5,1999,491200,42,37,5,5
6,1999,491200,44,38,6,9
7,1999,491200,48,41,7,4
8,1999,491200,52,49,3,5
9,1999,491200,40,36,4,3
10,1999,491200,49,44,5,9
11,1999,491200,40,38,2,8
12,1999,491200,30,28,2,5
1,2000,491200,38,33,5,4
2,2000,491200,33,30,3,1
3,2000,491200,35,33,2,3
4,2000,491200,28,25,3,3
5,2000,491200,48,43,5,3
6,2000,491200,34,30,4,3
7,2000,491200,37,34,3,2
8,2000,491200,40,36,4,7
9,2000,491200,50,48,2,6
10,2000,491200,48,41,7,5
11,2000,491200,27,20,7,7
12,2000,491200,27,26,1,6
1,2001,491200,26,24,2,9
2,2001,491200,26,22,4,6
3,2001,491200,28,26,2,10
4,2001,491200,35,25,10,5
5,2001,491200,41,32,9,8
6,2001,491200,38,33,5,5
7,2001,491200,34,31,3,4
8,2001,491200,35,31,4,7
9,2001,491200,48,46,2,9
10,2001,491200,43,39,4,5
11,2001,491200,38,33,5,4
12,2001,491200,31,26,5,12
1,2002,491200,27,25,2,6
2,2002,491200,19,16,3,9
3,2002,491200,40,33,7,9
4,2002,491200,25,23,2,11
5,2002,491200,40,31,9,3
6,2002,491200,22,18,4,4
7,2002,491200,23,19,4,9
8,2002,491200,24,22,2,3
9,2002,491200,34,31,3,2
10,2002,491200,41,31,10,6
11,2002,491200,23,20,3,5
12,2002,491200,44,37,7,6
1,2003,491200,20,17,3,17
2,2003,491200,30,28,2,3
3,2003,491200,30,25,5,6
4,2003,491200,32,31,1,2
5,2003,491200,31,28,3,3
6,2003,491200,22,18,4,7
7,2003,491200,41,36,5,5
8,2003,491200,32,28,4,2
9,2003,491200,55,51,4,10
10,2003,491200,38,32,6,10
11,2003,491200,31,29,2,5
12,2003,491200,37,34,3,11
1,2004,491200,29,19,10,5
2,2004,491200,26,23,3,14
3,2004,491200,34,25,9,11
4,2004,491200,32,30,2,11
5,2004,491200,30,26,4,14
6,2004,491200,32,28,4,12
7,2004,491200,35,34,1,3
8,2004,491200,40,37,3,8
9,2004,491200,44,35,9,21
10,2004,491200,45,37,8,21
11,2004,491200,43,38,5,5
12,2004,491200,27,22,5,6
1,2005,491200,27,24,3,9
2,2005,491200,34,30,4,12
3,2005,491200,29,29,0,5
4,2005,491200,33,26,7,4
5,2005,491200,42,36,6,7
6,2005,491200,26,22,4,11
7,2005,491200,27,22,5,6
8,2005,491200,21,20,1,10
9,2005,491200,34,25,9,10
10,2005,491200,21,20,1,4
11,2005,491200,40,33,7,15
12,2005,491200,26,20,6,5
1,2006,491200,31,29,2,9
2,2006,491200,35,33,2,12
3,2006,491200,35,33,2,11
4,2006,491200,25,21,4,5
5,2006,491200,40,34,6,10
6,2006,491200,26,23,3,8
7,2006,491200,39,34,5,6
8,2006,491200,29,20,9,5
9,2006,491200,47,43,4,11
10,2006,491200,37,34,3,7
11,2006,491200,23,21,2,4
12,2006,491200,28,22,6,19
1,2007,491200,27,25,2,8
2,2007,491200,29,26,3,8
3,2007,491200,24,20,4,12
4,2007,491200,33,32,1,12
5,2007,491200,36,30,6,2
6,2007,491200,35,27,8,6
7,2007,491200,34,29,5,5
8,2007,491200,44,39,5,4
9,2007,491200,35,30,5,7
10,2007,491200,37,33,4,14
11,2007,491200,23,21,2,12
12,2007,491200,18,13,5,7
1,2008,491200,35,31,4,8
2,2008,491200,27,25,2,11
3,2008,491200,25,20,5,7
4,2008,491200,27,26,1,11
5,2008,491200,40,36,4,3
6,2008,491200,27,23,4,9
7,2008,491200,26,20,6,5
8,2008,491200,41,33,8,6
9,2008,491200,31,27,4,3
10,2008,491200,35,30,5,6
11,2008,491200,31,27,4,5
12,2008,491200,30,28,2,5
1,2009,491200,34,29,5,8
2,2009,491200,27,21,6,4
3,2009,491200,44,38,6,8
4,2009,491200,30,22,8,10
5,2009,491200,31,27,4,6
6,2009,491200,29,25,4,7
7,2009,491200,27,24,3,3
8,2009,491200,24,21,3,6
9,2009,491200,27,20,7,10
10,2009,491200,32,28,4,5
11,2009,491200,28,25,3,6
12,2009,491200,20,18,2,7
1,2010,491200,32,29,3,12
2,2010,491200,14,11,3,19
3,2010,491200,22,17,5,33
4,2010,491200,25,22,3,8
5,2010,491200,14,14,0,11
6,2010,491200,26,21,5,8
7,2010,491200,23,21,2,4
8,2010,491200,25,22,3,4
9,2010,491200,19,18,1,6
10,2010,491200,23,21,2,5
11,2010,491200,11,11,0,10
12,2010,491200,13,10,3,2
1,2011,491200,22,21,1,6
2,2011,491200,13,13,0,8
1,1999,491300,20,13,7,8
2,1999,491300,25,22,3,11
3,1999,491300,17,13,4,6
4,1999,491300,28,22,6,7
5,1999,491300,32,19,13,3
6,1999,491300,32,23,9,6
7,1999,491300,31,21,10,5
8,1999,491300,23,18,5,6
9,1999,491300,31,22,9,14
10,1999,491300,39,29,10,15
11,1999,491300,27,23,4,14
12,1999,491300,16,10,6,2
1,2000,491300,22,14,8,3
2,2000,491300,23,16,7,7
3,2000,491300,25,20,5,6
4,2000,491300,23,20,3,6
5,2000,491300,22,16,6,15
6,2000,491300,24,15,9,13
7,2000,491300,25,20,5,7
8,2000,491300,35,26,9,16
9,2000,491300,32,26,6,3
10,2000,491300,28,21,7,7
11,2000,491300,32,26,6,5
12,2000,491300,31,24,7,16
1,2001,491300,24,19,5,21
2,2001,491300,24,16,8,10
3,2001,491300,19,12,7,15
4,2001,491300,23,18,5,14
5,2001,491300,25,16,9,7
6,2001,491300,27,18,9,8
7,2001,491300,31,23,8,6
8,2001,491300,33,25,8,12
9,2001,491300,28,19,9,10
10,2001,491300,37,32,5,15
11,2001,491300,18,13,5,12
12,2001,491300,21,12,9,11
1,2002,491300,18,13,5,9
2,2002,491300,14,11,3,10
3,2002,491300,10,8,2,14
4,2002,491300,25,16,9,9
5,2002,491300,24,12,12,7
6,2002,491300,22,14,8,6
7,2002,491300,21,13,8,6
8,2002,491300,22,22,0,11
9,2002,491300,25,17,8,8
10,2002,491300,35,27,8,6
11,2002,491300,32,22,10,11
12,2002,491300,22,18,4,10
1,2003,491300,16,14,2,20
2,2003,491300,27,16,11,4
3,2003,491300,24,14,10,12
4,2003,491300,22,18,4,8
5,2003,491300,25,19,6,10
6,2003,491300,32,20,12,9
7,2003,491300,31,27,4,7
8,2003,491300,29,22,7,9
9,2003,491300,22,12,10,10
10,2003,491300,25,17,8,16
11,2003,491300,27,22,5,22
12,2003,491300,23,22,1,24
1,2004,491300,12,11,1,18
2,2004,491300,11,6,5,38
3,2004,491300,22,16,6,11
4,2004,491300,13,10,3,14
5,2004,491300,26,20,6,10
6,2004,491300,29,21,8,8
7,2004,491300,28,23,5,10
8,2004,491300,27,21,6,12
9,2004,491300,27,20,7,7
10,2004,491300,36,27,9,13
11,2004,491300,18,15,3,12
12,2004,491300,16,13,3,10
1,2005,491300,12,10,2,28
2,2005,491300,16,12,4,15
3,2005,491300,28,22,6,45
4,2005,491300,20,11,9,18
5,2005,491300,24,11,13,22
6,2005,491300,18,14,4,15
7,2005,491300,22,13,9,16
8,2005,491300,24,22,2,22
9,2005,491300,29,23,6,15
10,2005,491300,16,11,5,20
11,2005,491300,25,20,5,10
12,2005,491300,14,9,5,14
1,2006,491300,26,21,5,9
2,2006,491300,18,13,5,15
3,2006,491300,18,16,2,21
4,2006,491300,21,17,4,32
5,2006,491300,21,17,4,13
6,2006,491300,26,18,8,20
7,2006,491300,28,23,5,23
8,2006,491300,30,25,5,17
9,2006,491300,16,14,2,23
10,2006,491300,29,25,4,19
11,2006,491300,20,16,4,21
12,2006,491300,14,12,2,23
1,2007,491300,27,23,4,32
2,2007,491300,16,14,2,29
3,2007,491300,14,9,5,19
4,2007,491300,31,22,9,22
5,2007,491300,18,11,7,6
6,2007,491300,21,16,5,23
7,2007,491300,34,22,12,16
8,2007,491300,38,27,11,21
9,2007,491300,28,17,11,31
10,2007,491300,34,25,9,31
11,2007,491300,21,14,7,17
12,2007,491300,24,22,2,16
1,2008,491300,28,24,4,14
2,2008,491300,21,18,3,17
3,2008,491300,20,14,6,16
4,2008,491300,31,24,7,10
5,2008,491300,39,30,9,9
6,2008,491300,30,23,7,4
7,2008,491300,34,28,6,7
8,2008,491300,31,25,6,4
9,2008,491300,24,17,7,11
10,2008,491300,16,12,4,5
11,2008,491300,26,20,6,13
12,2008,491300,15,12,3,17
1,2009,491300,20,18,2,6
2,2009,491300,13,11,2,5
3,2009,491300,24,18,6,3
4,2009,491300,21,15,6,4
5,2009,491300,22,13,9,9
6,2009,491300,19,13,6,8
7,2009,491300,28,22,6,11
8,2009,491300,37,32,5,6
9,2009,491300,26,21,5,10
10,2009,491300,21,16,5,19
11,2009,491300,17,15,2,15
12,2009,491300,22,20,2,6
1,2010,491300,14,13,1,7
2,2010,491300,9,5,4,14
3,2010,491300,14,10,4,16
4,2010,491300,19,13,6,8
5,2010,491300,26,17,9,19
6,2010,491300,19,13,6,8
7,2010,491300,26,15,11,8
8,2010,491300,29,23,6,7
9,2010,491300,14,8,6,2
10,2010,491300,18,15,3,4
11,2010,491300,18,16,2,5
12,2010,491300,27,25,2,2
1,2011,491300,22,21,1,4
2,2011,491300,10,9,1,6
1,1999,500300,11,10,1,7
2,1999,500300,10,8,2,2
3,1999,500300,12,9,3,5
4,1999,500300,14,11,3,12
5,1999,500300,19,15,4,4
6,1999,500300,29,23,6,7
7,1999,500300,19,12,7,2
8,1999,500300,15,10,5,5
9,1999,500300,15,13,2,2
10,1999,500300,18,11,7,3
11,1999,500300,21,14,7,8
12,1999,500300,13,11,2,3
1,2000,500300,10,7,3,4
2,2000,500300,10,9,1,2
3,2000,500300,16,15,1,4
4,2000,500300,7,7,0,6
5,2000,500300,13,11,2,4
6,2000,500300,16,12,4,5
7,2000,500300,12,10,2,7
8,2000,500300,5,3,2,9
9,2000,500300,13,9,4,6
10,2000,500300,10,8,2,9
11,2000,500300,9,6,3,4
12,2000,500300,9,8,1,2
1,2001,500300,7,5,2,6
2,2001,500300,6,6,0,8
3,2001,500300,7,3,4,12
4,2001,500300,10,8,2,5
5,2001,500300,13,12,1,7
6,2001,500300,20,17,3,4
7,2001,500300,14,10,4,3
8,2001,500300,12,11,1,5
9,2001,500300,15,14,1,7
10,2001,500300,12,8,4,0
11,2001,500300,7,6,1,1
12,2001,500300,7,5,2,1
1,2002,500300,8,7,1,3
2,2002,500300,1,0,1,2
3,2002,500300,11,7,4,2
4,2002,500300,16,13,3,1
5,2002,500300,16,15,1,1
6,2002,500300,9,8,1,2
7,2002,500300,17,16,1,4
8,2002,500300,12,12,0,0
9,2002,500300,8,7,1,1
10,2002,500300,12,8,4,0
11,2002,500300,12,10,2,2
12,2002,500300,11,10,1,2
1,2003,500300,7,7,0,1
2,2003,500300,7,7,0,1
3,2003,500300,11,9,2,1
4,2003,500300,5,4,1,2
5,2003,500300,9,9,0,1
6,2003,500300,7,7,0,1
7,2003,500300,5,5,0,1
8,2003,500300,13,10,3,2
9,2003,500300,7,6,1,2
10,2003,500300,6,5,1,1
11,2003,500300,12,11,1,0
12,2003,500300,13,12,1,2
1,2004,500300,7,6,1,2
2,2004,500300,17,14,3,2
3,2004,500300,11,10,1,3
4,2004,500300,9,9,0,6
5,2004,500300,9,8,1,1
6,2004,500300,4,4,0,3
7,2004,500300,6,4,2,3
8,2004,500300,11,9,2,2
9,2004,500300,7,5,2,2
10,2004,500300,11,11,0,0
11,2004,500300,12,11,1,1
12,2004,500300,13,12,1,2
1,2005,500300,4,4,0,2
2,2005,500300,10,6,4,1
3,2005,500300,8,6,2,0
4,2005,500300,11,10,1,0
5,2005,500300,14,12,2,1
6,2005,500300,6,5,1,0
7,2005,500300,7,5,2,3
8,2005,500300,8,8,0,1
9,2005,500300,7,7,0,0
10,2005,500300,12,11,1,1
11,2005,500300,9,9,0,3
12,2005,500300,12,11,1,1
1,2006,500300,10,9,1,1
2,2006,500300,9,7,2,0
3,2006,500300,3,2,1,0
4,2006,500300,6,5,1,2
5,2006,500300,13,13,0,1
6,2006,500300,15,14,1,0
7,2006,500300,15,11,4,2
8,2006,500300,7,6,1,1
9,2006,500300,8,8,0,1
10,2006,500300,9,9,0,1
11,2006,500300,11,10,1,1
12,2006,500300,12,10,2,3
1,2007,500300,17,16,1,1
2,2007,500300,11,11,0,1
3,2007,500300,13,10,3,3
4,2007,500300,9,6,3,0
5,2007,500300,10,6,4,4
6,2007,500300,9,9,0,2
7,2007,500300,13,12,1,5
8,2007,500300,17,17,0,1
9,2007,500300,12,11,1,3
10,2007,500300,8,8,0,3
11,2007,500300,9,7,2,2
12,2007,500300,6,5,1,1
1,2008,500300,8,6,2,2
2,2008,500300,7,7,0,1
3,2008,500300,9,8,1,3
4,2008,500300,9,4,5,0
5,2008,500300,6,5,1,0
6,2008,500300,7,6,1,3
7,2008,500300,22,21,1,3
8,2008,500300,11,10,1,1
9,2008,500300,12,11,1,2
10,2008,500300,11,8,3,1
11,2008,500300,5,4,1,0
12,2008,500300,7,7,0,0
1,2009,500300,3,3,0,1
2,2009,500300,6,4,2,3
3,2009,500300,2,2,0,5
4,2009,500300,14,13,1,1
5,2009,500300,9,8,1,2
6,2009,500300,12,11,1,0
7,2009,500300,13,13,0,0
8,2009,500300,7,5,2,2
9,2009,500300,3,2,1,4
10,2009,500300,7,7,0,2
11,2009,500300,8,7,1,0
12,2009,500300,9,8,1,2
1,2010,500300,6,6,0,1
2,2010,500300,6,6,0,2
3,2010,500300,3,2,1,3
4,2010,500300,9,9,0,2
5,2010,500300,4,3,1,3
6,2010,500300,8,7,1,3
7,2010,500300,8,7,1,2
8,2010,500300,5,5,0,1
9,2010,500300,9,7,2,0
10,2010,500300,9,9,0,2
11,2010,500300,8,7,1,0
12,2010,500300,13,13,0,4
1,2011,500300,6,6,0,1
2,2011,500300,2,2,0,0
1,1999,491400,30,23,7,6
2,1999,491400,45,39,6,8
3,1999,491400,26,21,5,12
4,1999,491400,37,27,10,9
5,1999,491400,44,35,9,2
6,1999,491400,48,38,10,6
7,1999,491400,50,37,13,6
8,1999,491400,37,32,5,6
9,1999,491400,43,34,9,20
10,1999,491400,38,27,11,10
11,1999,491400,34,20,14,13
12,1999,491400,35,26,9,11
1,2000,491400,36,30,6,8
2,2000,491400,24,20,4,8
3,2000,491400,46,39,7,9
4,2000,491400,27,22,5,11
5,2000,491400,56,43,13,7
6,2000,491400,38,25,13,6
7,2000,491400,39,24,15,7
8,2000,491400,50,38,12,9
9,2000,491400,49,40,9,7
10,2000,491400,46,34,12,16
11,2000,491400,29,26,3,12
12,2000,491400,24,19,5,8
1,2001,491400,19,12,7,9
2,2001,491400,20,18,2,9
3,2001,491400,27,20,7,6
4,2001,491400,46,27,19,9
5,2001,491400,43,36,7,8
6,2001,491400,24,18,6,8
7,2001,491400,37,28,9,10
8,2001,491400,32,25,7,6
9,2001,491400,42,34,8,3
10,2001,491400,37,28,9,7
11,2001,491400,32,25,7,13
12,2001,491400,30,25,5,10
1,2002,491400,34,25,9,8
2,2002,491400,26,20,6,8
3,2002,491400,29,24,5,15
4,2002,491400,37,27,10,9
5,2002,491400,43,31,12,9
6,2002,491400,29,18,11,11
7,2002,491400,32,21,11,7
8,2002,491400,40,30,10,4
9,2002,491400,39,27,12,11
10,2002,491400,33,27,6,6
11,2002,491400,32,23,9,9
12,2002,491400,41,30,11,9
1,2003,491400,29,25,4,13
2,2003,491400,23,18,5,10
3,2003,491400,30,22,8,5
4,2003,491400,35,24,11,4
5,2003,491400,34,22,12,4
6,2003,491400,36,25,11,7
7,2003,491400,36,28,8,9
8,2003,491400,44,35,9,18
9,2003,491400,34,25,9,6
10,2003,491400,36,30,6,15
11,2003,491400,38,31,7,18
12,2003,491400,29,27,2,16
1,2004,491400,17,16,1,9
2,2004,491400,31,30,1,16
3,2004,491400,32,28,4,9
4,2004,491400,43,36,7,7
5,2004,491400,40,30,10,18
6,2004,491400,28,20,8,2
7,2004,491400,32,25,7,12
8,2004,491400,31,23,8,16
9,2004,491400,27,19,8,14
10,2004,491400,36,30,6,13
11,2004,491400,24,19,5,12
12,2004,491400,32,25,7,8
1,2005,491400,23,22,1,11
2,2005,491400,23,17,6,9
3,2005,491400,26,17,9,10
4,2005,491400,27,21,6,11
5,2005,491400,37,27,10,7
6,2005,491400,31,27,4,7
7,2005,491400,43,37,6,8
8,2005,491400,33,31,2,16
9,2005,491400,31,26,5,13
10,2005,491400,36,28,8,11
11,2005,491400,28,22,6,15
12,2005,491400,29,27,2,20
1,2006,491400,27,20,7,18
2,2006,491400,29,28,1,10
3,2006,491400,31,23,8,9
4,2006,491400,31,21,10,17
5,2006,491400,31,25,6,10
6,2006,491400,27,23,4,16
7,2006,491400,40,30,10,18
8,2006,491400,44,35,9,13
9,2006,491400,41,29,12,15
10,2006,491400,47,40,7,15
11,2006,491400,28,27,1,10
12,2006,491400,32,30,2,19
1,2007,491400,24,23,1,25
2,2007,491400,18,16,2,19
3,2007,491400,27,23,4,12
4,2007,491400,32,30,2,17
5,2007,491400,25,19,6,12
6,2007,491400,35,28,7,8
7,2007,491400,47,42,5,20
8,2007,491400,36,26,10,34
9,2007,491400,37,26,11,23
10,2007,491400,38,26,12,21
11,2007,491400,33,29,4,19
12,2007,491400,33,28,5,20
1,2008,491400,28,24,4,17
2,2008,491400,24,19,5,15
3,2008,491400,29,20,9,10
4,2008,491400,45,35,10,10
5,2008,491400,32,24,8,12
6,2008,491400,36,27,9,13
7,2008,491400,45,33,12,7
8,2008,491400,52,42,10,16
9,2008,491400,31,26,5,10
10,2008,491400,39,30,9,8
11,2008,491400,28,24,4,9
12,2008,491400,33,27,6,6
1,2009,491400,24,20,4,6
2,2009,491400,25,20,5,8
3,2009,491400,38,27,11,5
4,2009,491400,43,37,6,13
5,2009,491400,33,27,6,10
6,2009,491400,35,27,8,12
7,2009,491400,49,41,8,14
8,2009,491400,41,31,10,7
9,2009,491400,36,33,3,9
10,2009,491400,17,13,4,10
11,2009,491400,29,26,3,4
12,2009,491400,28,25,3,5
1,2010,491400,31,27,4,7
2,2010,491400,23,18,5,8
3,2010,491400,42,31,11,18
4,2010,491400,29,24,5,8
5,2010,491400,35,32,3,5
6,2010,491400,26,24,2,12
7,2010,491400,36,31,5,8
8,2010,491400,21,17,4,4
9,2010,491400,42,33,9,11
10,2010,491400,38,32,6,1
11,2010,491400,38,35,3,8
12,2010,491400,33,31,2,3
1,2011,491400,30,27,3,8
2,2011,491400,11,9,2,3
1,1999,740100,6,6,0,0
2,1999,740100,7,6,1,2
3,1999,740100,5,5,0,4
4,1999,740100,18,18,0,0
5,1999,740100,9,8,1,0
6,1999,740100,13,12,1,0
7,1999,740100,16,15,1,0
8,1999,740100,14,13,1,0
9,1999,740100,12,12,0,0
10,1999,740100,11,10,1,1
11,1999,740100,15,15,0,1
12,1999,740100,7,7,0,0
1,2000,740100,6,6,0,0
2,2000,740100,6,6,0,1
3,2000,740100,12,12,0,0
4,2000,740100,11,11,0,1
5,2000,740100,10,9,1,2
6,2000,740100,11,11,0,0
7,2000,740100,9,9,0,1
8,2000,740100,10,9,1,1
9,2000,740100,16,14,2,1
10,2000,740100,10,10,0,1
11,2000,740100,6,5,1,0
12,2000,740100,3,1,2,0
1,2001,740100,12,12,0,0
2,2001,740100,7,7,0,1
3,2001,740100,7,7,0,0
4,2001,740100,9,8,1,1
5,2001,740100,10,10,0,2
6,2001,740100,14,12,2,1
7,2001,740100,16,14,2,0
8,2001,740100,15,12,3,0
9,2001,740100,17,14,3,0
10,2001,740100,13,11,2,1
11,2001,740100,16,15,1,3
12,2001,740100,11,11,0,2
1,2002,740100,6,5,1,1
2,2002,740100,7,5,2,1
3,2002,740100,7,7,0,1
4,2002,740100,12,12,0,2
5,2002,740100,10,9,1,0
6,2002,740100,12,12,0,4
7,2002,740100,12,11,1,2
8,2002,740100,4,4,0,0
9,2002,740100,9,8,1,2
10,2002,740100,15,14,1,2
11,2002,740100,5,5,0,1
12,2002,740100,11,11,0,0
1,2003,740100,3,3,0,2
2,2003,740100,5,5,0,0
3,2003,740100,6,6,0,3
4,2003,740100,12,11,1,0
5,2003,740100,16,16,0,2
6,2003,740100,15,13,2,1
7,2003,740100,11,9,2,0
8,2003,740100,16,14,2,0
9,2003,740100,6,4,2,0
10,2003,740100,8,7,1,1
11,2003,740100,8,8,0,2
12,2003,740100,5,4,1,0
1,2004,740100,9,9,0,1
2,2004,740100,5,5,0,3
3,2004,740100,6,6,0,2
4,2004,740100,9,9,0,2
5,2004,740100,11,10,1,9
6,2004,740100,9,8,1,3
7,2004,740100,4,4,0,2
8,2004,740100,12,11,1,1
9,2004,740100,7,6,1,0
10,2004,740100,9,8,1,4
11,2004,740100,6,5,1,2
12,2004,740100,9,9,0,2
1,2005,740100,6,6,0,1
2,2005,740100,6,6,0,1
3,2005,740100,6,6,0,0
4,2005,740100,7,5,2,0
5,2005,740100,8,7,1,0
6,2005,740100,8,8,0,1
7,2005,740100,10,9,1,0
8,2005,740100,7,7,0,2
9,2005,740100,9,7,2,0
10,2005,740100,8,6,2,2
11,2005,740100,5,5,0,1
12,2005,740100,9,9,0,0
1,2006,740100,7,7,0,0
2,2006,740100,4,4,0,0
3,2006,740100,13,12,1,0
4,2006,740100,3,3,0,0
5,2006,740100,9,8,1,3
6,2006,740100,4,4,0,1
7,2006,740100,1,1,0,3
8,2006,740100,13,12,1,1
9,2006,740100,7,7,0,3
10,2006,740100,6,5,1,1
11,2006,740100,5,5,0,1
12,2006,740100,2,2,0,3
1,2007,740100,10,9,1,0
2,2007,740100,5,4,1,0
3,2007,740100,5,3,2,3
4,2007,740100,10,10,0,0
5,2007,740100,9,8,1,1
6,2007,740100,2,1,1,0
7,2007,740100,12,11,1,1
8,2007,740100,6,6,0,0
9,2007,740100,4,4,0,0
10,2007,740100,6,5,1,1
11,2007,740100,6,5,1,0
12,2007,740100,6,6,0,2
1,2008,740100,2,1,1,2
2,2008,740100,6,6,0,1
3,2008,740100,9,8,1,0
4,2008,740100,6,4,2,0
5,2008,740100,6,6,0,0
6,2008,740100,7,7,0,0
7,2008,740100,9,9,0,1
8,2008,740100,7,7,0,0
9,2008,740100,15,15,0,0
10,2008,740100,9,8,1,0
11,2008,740100,5,5,0,0
12,2008,740100,6,6,0,0
1,2009,740100,7,6,1,1
2,2009,740100,5,5,0,0
3,2009,740100,12,10,2,0
4,2009,740100,7,7,0,0
5,2009,740100,6,6,0,0
6,2009,740100,7,7,0,1
7,2009,740100,6,5,1,0
8,2009,740100,10,10,0,0
9,2009,740100,5,5,0,4
10,2009,740100,8,8,0,0
11,2009,740100,4,4,0,0
12,2009,740100,11,10,1,1
1,2010,740100,5,5,0,2
2,2010,740100,3,3,0,0
3,2010,740100,5,5,0,3
4,2010,740100,6,6,0,1
5,2010,740100,10,10,0,2
6,2010,740100,5,5,0,4
7,2010,740100,11,9,2,2
8,2010,740100,12,12,0,3
9,2010,740100,10,10,0,3
10,2010,740100,6,5,1,1
11,2010,740100,8,6,2,0
12,2010,740100,6,5,1,1
1,2011,740100,3,3,0,0
2,2011,740100,4,3,1,1
1,1999,740300,5,4,1,0
2,1999,740300,11,11,0,1
3,1999,740300,4,3,1,0
4,1999,740300,4,4,0,1
5,1999,740300,7,6,1,0
6,1999,740300,6,4,2,0
7,1999,740300,10,8,2,0
8,1999,740300,9,7,2,0
9,1999,740300,10,7,3,0
10,1999,740300,12,11,1,0
11,1999,740300,5,5,0,0
12,1999,740300,7,7,0,0
1,2000,740300,11,11,0,0
2,2000,740300,4,4,0,1
3,2000,740300,8,8,0,0
4,2000,740300,9,9,0,1
5,2000,740300,9,7,2,2
6,2000,740300,8,6,2,0
7,2000,740300,5,4,1,0
8,2000,740300,6,5,1,0
9,2000,740300,7,5,2,0
10,2000,740300,8,6,2,0
11,2000,740300,6,5,1,0
12,2000,740300,5,4,1,1
1,2001,740300,6,5,1,0
2,2001,740300,4,4,0,2
3,2001,740300,3,2,1,1
4,2001,740300,5,5,0,3
5,2001,740300,11,9,2,0
6,2001,740300,7,6,1,1
7,2001,740300,4,4,0,0
8,2001,740300,10,9,1,1
9,2001,740300,17,15,2,0
10,2001,740300,11,11,0,6
11,2001,740300,11,11,0,0
12,2001,740300,7,7,0,5
1,2002,740300,2,2,0,2
2,2002,740300,3,3,0,4
3,2002,740300,13,12,1,4
4,2002,740300,13,11,2,1
5,2002,740300,11,10,1,2
6,2002,740300,13,12,1,0
7,2002,740300,6,6,0,1
8,2002,740300,10,10,0,0
9,2002,740300,10,10,0,0
10,2002,740300,15,13,2,0
11,2002,740300,11,11,0,0
12,2002,740300,7,5,2,0
1,2003,740300,7,6,1,0
2,2003,740300,6,4,2,0
3,2003,740300,8,8,0,0
4,2003,740300,8,8,0,3
5,2003,740300,14,13,1,3
6,2003,740300,9,8,1,0
7,2003,740300,13,12,1,4
8,2003,740300,14,14,0,1
9,2003,740300,10,8,2,2
10,2003,740300,6,5,1,3
11,2003,740300,6,5,1,1
12,2003,740300,7,6,1,2
1,2004,740300,10,9,1,3
2,2004,740300,8,8,0,2
3,2004,740300,15,12,3,3
4,2004,740300,6,6,0,6
5,2004,740300,3,3,0,5
6,2004,740300,6,6,0,0
7,2004,740300,10,10,0,0
8,2004,740300,3,3,0,0
9,2004,740300,11,11,0,0
10,2004,740300,12,12,0,0
11,2004,740300,5,5,0,0
12,2004,740300,9,6,3,2
1,2005,740300,4,4,0,1
2,2005,740300,7,7,0,1
3,2005,740300,9,9,0,1
4,2005,740300,5,5,0,0
5,2005,740300,8,7,1,1
6,2005,740300,16,14,2,1
7,2005,740300,10,10,0,1
8,2005,740300,14,14,0,0
9,2005,740300,9,8,1,0
10,2005,740300,10,9,1,1
11,2005,740300,13,11,2,1
12,2005,740300,8,8,0,0
1,2006,740300,5,5,0,2
2,2006,740300,9,9,0,0
3,2006,740300,3,3,0,1
4,2006,740300,3,3,0,3
5,2006,740300,8,7,1,3
6,2006,740300,6,5,1,3
7,2006,740300,11,8,3,0
8,2006,740300,9,8,1,4
9,2006,740300,14,13,1,1
10,2006,740300,6,6,0,0
11,2006,740300,14,14,0,2
12,2006,740300,5,3,2,0
1,2007,740300,5,5,0,2
2,2007,740300,2,2,0,0
3,2007,740300,9,8,1,0
4,2007,740300,8,7,1,2
5,2007,740300,15,14,1,2
6,2007,740300,5,5,0,0
7,2007,740300,7,4,3,1
8,2007,740300,4,4,0,0
9,2007,740300,6,5,1,0
10,2007,740300,11,11,0,2
11,2007,740300,10,10,0,0
12,2007,740300,9,8,1,0
1,2008,740300,7,7,0,2
2,2008,740300,10,9,1,1
3,2008,740300,12,10,2,1
4,2008,740300,8,8,0,1
5,2008,740300,6,6,0,0
6,2008,740300,7,7,0,0
7,2008,740300,10,8,2,1
8,2008,740300,4,4,0,0
9,2008,740300,11,9,2,0
10,2008,740300,14,11,3,0
11,2008,740300,9,7,2,0
12,2008,740300,5,5,0,1
1,2009,740300,5,4,1,0
2,2009,740300,7,7,0,2
3,2009,740300,6,5,1,0
4,2009,740300,6,5,1,0
5,2009,740300,7,7,0,0
6,2009,740300,7,5,2,0
7,2009,740300,4,4,0,0
8,2009,740300,7,4,3,0
9,2009,740300,13,10,3,0
10,2009,740300,1,1,0,0
11,2009,740300,7,6,1,2
12,2009,740300,1,1,0,6
1,2010,740300,9,9,0,0
2,2010,740300,3,3,0,2
3,2010,740300,11,11,0,0
4,2010,740300,10,8,2,4
5,2010,740300,9,8,1,5
6,2010,740300,5,4,1,0
7,2010,740300,7,7,0,3
8,2010,740300,6,5,1,4
9,2010,740300,5,5,0,5
10,2010,740300,5,5,0,2
11,2010,740300,3,3,0,2
12,2010,740300,3,3,0,0
1,2011,740300,12,11,1,3
2,2011,740300,2,2,0,0
1,1999,750300,11,9,2,0
2,1999,750300,3,3,0,0
3,1999,750300,1,1,0,1
4,1999,750300,6,5,1,0
5,1999,750300,5,4,1,0
6,1999,750300,3,3,0,0
7,1999,750300,8,7,1,1
8,1999,750300,6,5,1,0
9,1999,750300,3,3,0,1
10,1999,750300,12,11,1,4
11,1999,750300,10,7,3,0
12,1999,750300,3,3,0,0
1,2000,750300,5,5,0,0
2,2000,750300,3,3,0,0
3,2000,750300,2,1,1,0
4,2000,750300,4,4,0,0
5,2000,750300,1,1,0,0
6,2000,750300,2,2,0,0
7,2000,750300,9,8,1,0
8,2000,750300,4,4,0,0
9,2000,750300,3,2,1,1
10,2000,750300,5,5,0,0
11,2000,750300,2,2,0,0
12,2000,750300,3,2,1,1
1,2001,750300,4,4,0,0
2,2001,750300,4,2,2,0
3,2001,750300,1,1,0,0
4,2001,750300,6,6,0,0
5,2001,750300,4,3,1,0
6,2001,750300,6,5,1,0
7,2001,750300,8,7,1,1
8,2001,750300,3,3,0,1
9,2001,750300,7,6,1,1
10,2001,750300,3,3,0,1
11,2001,750300,6,6,0,0
12,2001,750300,2,2,0,1
1,2002,750300,7,7,0,1
2,2002,750300,5,5,0,0
3,2002,750300,0,0,0,0
4,2002,750300,4,3,1,2
5,2002,750300,5,5,0,0
6,2002,750300,4,4,0,0
7,2002,750300,8,7,1,2
8,2002,750300,10,10,0,0
9,2002,750300,4,3,1,1
10,2002,750300,7,7,0,0
11,2002,750300,3,3,0,0
12,2002,750300,1,1,0,0
1,2003,750300,4,4,0,0
2,2003,750300,2,2,0,0
3,2003,750300,6,6,0,4
4,2003,750300,0,0,0,1
5,2003,750300,3,3,0,0
6,2003,750300,2,2,0,0
7,2003,750300,6,6,0,0
8,2003,750300,12,12,0,0
9,2003,750300,5,4,1,0
10,2003,750300,9,8,1,1
11,2003,750300,1,1,0,0
12,2003,750300,4,4,0,0
1,2004,750300,6,6,0,0
2,2004,750300,4,4,0,0
3,2004,750300,6,6,0,0
4,2004,750300,6,5,1,0
5,2004,750300,14,13,1,1
6,2004,750300,9,9,0,0
7,2004,750300,6,6,0,0
8,2004,750300,4,4,0,1
9,2004,750300,2,2,0,0
10,2004,750300,11,10,1,1
11,2004,750300,4,4,0,1
12,2004,750300,4,4,0,1
1,2005,750300,3,3,0,0
2,2005,750300,5,5,0,1
3,2005,750300,4,4,0,1
4,2005,750300,4,4,0,0
5,2005,750300,7,7,0,2
6,2005,750300,8,7,1,0
7,2005,750300,1,1,0,0
8,2005,750300,10,10,0,1
9,2005,750300,2,2,0,0
10,2005,750300,6,6,0,0
11,2005,750300,11,9,2,0
12,2005,750300,5,5,0,0
1,2006,750300,5,5,0,0
2,2006,750300,3,3,0,2
3,2006,750300,4,2,2,0
4,2006,750300,2,2,0,0
5,2006,750300,3,3,0,1
6,2006,750300,7,5,2,0
7,2006,750300,3,3,0,1
8,2006,750300,9,8,1,0
9,2006,750300,11,10,1,0
10,2006,750300,4,4,0,0
11,2006,750300,1,1,0,2
12,2006,750300,6,5,1,0
1,2007,750300,4,4,0,1
2,2007,750300,5,5,0,0
3,2007,750300,2,2,0,0
4,2007,750300,4,3,1,0
5,2007,750300,7,6,1,0
6,2007,750300,8,7,1,0
7,2007,750300,8,8,0,1
8,2007,750300,8,8,0,0
9,2007,750300,3,3,0,4
10,2007,750300,7,6,1,1
11,2007,750300,5,5,0,0
12,2007,750300,4,4,0,0
1,2008,750300,9,9,0,0
2,2008,750300,3,3,0,0
3,2008,750300,1,0,1,1
4,2008,750300,8,7,1,0
5,2008,750300,1,1,0,0
6,2008,750300,6,6,0,1
7,2008,750300,7,7,0,0
8,2008,750300,7,6,1,1
9,2008,750300,8,7,1,0
10,2008,750300,9,9,0,0
11,2008,750300,5,4,1,0
12,2008,750300,4,4,0,0
1,2009,750300,2,2,0,1
2,2009,750300,4,4,0,0
3,2009,750300,5,4,1,1
4,2009,750300,4,4,0,0
5,2009,750300,4,4,0,0
6,2009,750300,5,5,0,0
7,2009,750300,9,8,1,0
8,2009,750300,7,6,1,1
9,2009,750300,7,7,0,0
10,2009,750300,3,3,0,1
11,2009,750300,7,7,0,0
12,2009,750300,7,7,0,1
1,2010,750300,2,2,0,0
2,2010,750300,3,3,0,0
3,2010,750300,4,4,0,0
4,2010,750300,2,2,0,0
5,2010,750300,3,3,0,1
6,2010,750300,8,7,1,0
7,2010,750300,7,6,1,3
8,2010,750300,5,5,0,0
9,2010,750300,5,5,0,0
10,2010,750300,3,3,0,0
11,2010,750300,3,3,0,0
12,2010,750300,7,6,1,1
1,2011,750300,6,6,0,1
2,2011,750300,2,2,0,0
1,1999,750200,10,9,1,1
2,1999,750200,11,9,2,2
3,1999,750200,14,9,5,2
4,1999,750200,24,21,3,6
5,1999,750200,16,11,5,0
6,1999,750200,11,9,2,0
7,1999,750200,20,18,2,1
8,1999,750200,29,26,3,4
9,1999,750200,21,18,3,0
10,1999,750200,21,18,3,0
11,1999,750200,10,7,3,2
12,1999,750200,16,14,2,4
1,2000,750200,11,10,1,6
2,2000,750200,11,11,0,6
3,2000,750200,11,10,1,4
4,2000,750200,14,11,3,9
5,2000,750200,18,16,2,4
6,2000,750200,15,12,3,2
7,2000,750200,20,17,3,1
8,2000,750200,20,18,2,3
9,2000,750200,14,14,0,2
10,2000,750200,19,18,1,4
11,2000,750200,14,12,2,2
12,2000,750200,11,9,2,0
1,2001,750200,20,18,2,4
2,2001,750200,10,8,2,5
3,2001,750200,20,16,4,4
4,2001,750200,15,13,2,2
5,2001,750200,20,19,1,1
6,2001,750200,16,14,2,2
7,2001,750200,13,13,0,1
8,2001,750200,15,15,0,5
9,2001,750200,20,19,1,0
10,2001,750200,30,27,3,6
11,2001,750200,7,5,2,4
12,2001,750200,17,17,0,3
1,2002,750200,19,18,1,3
2,2002,750200,16,15,1,5
3,2002,750200,13,12,1,5
4,2002,750200,25,21,4,0
5,2002,750200,21,21,0,3
6,2002,750200,15,13,2,0
7,2002,750200,28,27,1,1
8,2002,750200,24,21,3,3
9,2002,750200,23,21,2,4
10,2002,750200,22,22,0,8
11,2002,750200,18,16,2,2
12,2002,750200,8,8,0,3
1,2003,750200,11,10,1,0
2,2003,750200,15,15,0,2
3,2003,750200,17,16,1,2
4,2003,750200,23,22,1,0
5,2003,750200,10,6,4,1
6,2003,750200,26,25,1,1
7,2003,750200,16,14,2,0
8,2003,750200,17,15,2,2
9,2003,750200,21,21,0,3
10,2003,750200,12,12,0,3
11,2003,750200,16,15,1,2
12,2003,750200,10,10,0,0
1,2004,750200,9,7,2,4
2,2004,750200,10,10,0,3
3,2004,750200,9,9,0,0
4,2004,750200,19,16,3,3
5,2004,750200,13,11,2,4
6,2004,750200,18,15,3,2
7,2004,750200,13,12,1,0
8,2004,750200,13,13,0,4
9,2004,750200,10,9,1,1
10,2004,750200,12,11,1,2
11,2004,750200,13,13,0,1
12,2004,750200,11,10,1,1
1,2005,750200,20,19,1,1
2,2005,750200,6,6,0,0
3,2005,750200,14,14,0,1
4,2005,750200,12,11,1,3
5,2005,750200,12,10,2,1
6,2005,750200,16,14,2,6
7,2005,750200,17,17,0,1
8,2005,750200,18,18,0,1
9,2005,750200,15,15,0,2
10,2005,750200,21,19,2,2
11,2005,750200,13,13,0,7
12,2005,750200,10,10,0,3
1,2006,750200,16,14,2,4
2,2006,750200,11,10,1,4
3,2006,750200,9,7,2,2
4,2006,750200,11,11,0,4
5,2006,750200,11,9,2,7
6,2006,750200,9,9,0,2
7,2006,750200,7,7,0,3
8,2006,750200,17,14,3,3
9,2006,750200,14,13,1,3
10,2006,750200,17,14,3,3
11,2006,750200,18,15,3,1
12,2006,750200,12,12,0,1
1,2007,750200,9,5,4,0
2,2007,750200,8,7,1,1
3,2007,750200,9,8,1,4
4,2007,750200,11,9,2,0
5,2007,750200,23,22,1,4
6,2007,750200,15,12,3,3
7,2007,750200,18,16,2,3
8,2007,750200,13,13,0,3
9,2007,750200,22,20,2,3
10,2007,750200,18,17,1,3
11,2007,750200,14,13,1,1
12,2007,750200,15,14,1,1
1,2008,750200,13,13,0,1
2,2008,750200,8,8,0,2
3,2008,750200,13,12,1,2
4,2008,750200,11,10,1,1
5,2008,750200,8,7,1,2
6,2008,750200,18,17,1,1
7,2008,750200,12,11,1,0
8,2008,750200,7,6,1,6
9,2008,750200,10,8,2,0
10,2008,750200,20,18,2,1
11,2008,750200,13,11,2,0
12,2008,750200,5,5,0,0
1,2009,750200,8,8,0,4
2,2009,750200,5,5,0,0
3,2009,750200,7,5,2,0
4,2009,750200,14,13,1,1
5,2009,750200,14,13,1,1
6,2009,750200,13,11,2,0
7,2009,750200,6,5,1,1
8,2009,750200,22,21,1,0
9,2009,750200,6,5,1,2
10,2009,750200,15,13,2,0
11,2009,750200,6,6,0,6
12,2009,750200,12,12,0,0
1,2010,750200,7,7,0,1
2,2010,750200,4,4,0,0
3,2010,750200,5,5,0,1
4,2010,750200,10,10,0,1
5,2010,750200,6,4,2,1
6,2010,750200,14,13,1,1
7,2010,750200,19,18,1,5
8,2010,750200,14,13,1,3
9,2010,750200,11,11,0,1
10,2010,750200,11,11,0,2
11,2010,750200,12,6,6,4
12,2010,750200,4,4,0,1
1,2011,750200,7,7,0,3
2,2011,750200,4,4,0,1
1,1999,750100,28,20,8,7
2,1999,750100,22,18,4,8
3,1999,750100,28,21,7,12
4,1999,750100,17,16,1,10
5,1999,750100,29,20,9,3
6,1999,750100,30,19,11,8
7,1999,750100,20,12,8,13
8,1999,750100,28,20,8,9
9,1999,750100,29,23,6,8
10,1999,750100,16,13,3,10
11,1999,750100,30,26,4,10
12,1999,750100,16,13,3,9
1,2000,750100,20,16,4,13
2,2000,750100,18,14,4,20
3,2000,750100,22,15,7,9
4,2000,750100,19,13,6,8
5,2000,750100,15,13,2,14
6,2000,750100,25,20,5,5
7,2000,750100,25,19,6,17
8,2000,750100,27,21,6,9
9,2000,750100,27,21,6,2
10,2000,750100,27,21,6,10
11,2000,750100,12,9,3,9
12,2000,750100,21,21,0,15
1,2001,750100,14,9,5,13
2,2001,750100,11,8,3,11
3,2001,750100,12,10,2,15
4,2001,750100,19,14,5,8
5,2001,750100,18,13,5,9
6,2001,750100,14,11,3,8
7,2001,750100,23,16,7,6
8,2001,750100,37,21,16,7
9,2001,750100,18,13,5,11
10,2001,750100,20,16,4,10
11,2001,750100,10,7,3,6
12,2001,750100,21,16,5,8
1,2002,750100,21,19,2,11
2,2002,750100,11,10,1,13
3,2002,750100,18,17,1,7
4,2002,750100,12,6,6,5
5,2002,750100,24,15,9,10
6,2002,750100,20,14,6,13
7,2002,750100,19,14,5,11
8,2002,750100,27,18,9,9
9,2002,750100,25,20,5,4
10,2002,750100,19,13,6,11
11,2002,750100,12,10,2,11
12,2002,750100,22,19,3,6
1,2003,750100,18,14,4,11
2,2003,750100,10,9,1,11
3,2003,750100,16,11,5,9
4,2003,750100,16,13,3,11
5,2003,750100,24,16,8,7
6,2003,750100,20,12,8,6
7,2003,750100,17,10,7,1
8,2003,750100,21,14,7,6
9,2003,750100,14,12,2,7
10,2003,750100,14,12,2,3
11,2003,750100,8,6,2,9
12,2003,750100,6,4,2,5
1,2004,750100,11,10,1,10
2,2004,750100,13,10,3,5
3,2004,750100,18,14,4,10
4,2004,750100,15,10,5,3
5,2004,750100,17,15,2,14
6,2004,750100,28,21,7,7
7,2004,750100,40,29,11,8
8,2004,750100,28,22,6,16
9,2004,750100,19,14,5,9
10,2004,750100,22,19,3,7
11,2004,750100,20,18,2,6
12,2004,750100,26,24,2,10
1,2005,750100,19,13,6,7
2,2005,750100,25,22,3,8
3,2005,750100,18,17,1,14
4,2005,750100,20,15,5,9
5,2005,750100,17,13,4,2
6,2005,750100,22,16,6,13
7,2005,750100,33,25,8,9
8,2005,750100,24,22,2,6
9,2005,750100,22,19,3,7
10,2005,750100,19,16,3,7
11,2005,750100,11,9,2,15
12,2005,750100,19,17,2,6
1,2006,750100,30,24,6,6
2,2006,750100,20,19,1,5
3,2006,750100,24,17,7,13
4,2006,750100,31,27,4,8
5,2006,750100,17,13,4,9
6,2006,750100,34,25,9,10
7,2006,750100,22,16,6,9
8,2006,750100,17,9,8,7
9,2006,750100,35,29,6,6
10,2006,750100,17,15,2,6
11,2006,750100,20,13,7,12
12,2006,750100,16,14,2,6
1,2007,750100,11,8,3,8
2,2007,750100,16,13,3,5
3,2007,750100,18,18,0,7
4,2007,750100,18,14,4,5
5,2007,750100,17,14,3,6
6,2007,750100,30,20,10,18
7,2007,750100,32,30,2,7
8,2007,750100,36,34,2,4
9,2007,750100,27,21,6,8
10,2007,750100,36,33,3,8
11,2007,750100,28,28,0,5
12,2007,750100,16,15,1,4
1,2008,750100,30,27,3,5
2,2008,750100,15,15,0,9
3,2008,750100,22,18,4,17
4,2008,750100,30,24,6,4
5,2008,750100,31,24,7,5
6,2008,750100,18,12,6,3
7,2008,750100,42,36,6,9
8,2008,750100,32,25,7,5
9,2008,750100,24,22,2,9
10,2008,750100,38,36,2,5
11,2008,750100,34,30,4,7
12,2008,750100,20,16,4,7
1,2009,750100,20,17,3,9
2,2009,750100,18,14,4,13
3,2009,750100,24,21,3,12
4,2009,750100,28,22,6,7
5,2009,750100,20,15,5,2
6,2009,750100,20,18,2,5
7,2009,750100,27,25,2,9
8,2009,750100,35,30,5,9
9,2009,750100,22,16,6,12
10,2009,750100,27,22,5,16
11,2009,750100,31,28,3,19
12,2009,750100,19,17,2,5
1,2010,750100,23,19,4,6
2,2010,750100,20,17,3,12
3,2010,750100,20,17,3,11
4,2010,750100,19,12,7,11
5,2010,750100,21,17,4,12
6,2010,750100,23,18,5,9
7,2010,750100,16,11,5,9
8,2010,750100,28,27,1,9
9,2010,750100,26,20,6,5
10,2010,750100,21,15,6,9
11,2010,750100,25,23,2,9
12,2010,750100,16,11,5,8
1,2011,750100,18,13,5,6
2,2011,750100,13,10,3,3
1,1999,491100,28,26,2,2
2,1999,491100,36,31,5,5
3,1999,491100,41,38,3,9
4,1999,491100,36,28,8,7
5,1999,491100,30,23,7,0
6,1999,491100,41,33,8,3
7,1999,491100,33,25,8,4
8,1999,491100,37,31,6,12
9,1999,491100,38,33,5,6
10,1999,491100,34,26,8,11
11,1999,491100,40,33,7,6
12,1999,491100,34,29,5,3
1,2000,491100,27,22,5,11
2,2000,491100,28,23,5,7
3,2000,491100,24,21,3,9
4,2000,491100,29,21,8,12
5,2000,491100,41,37,4,10
6,2000,491100,35,25,10,7
7,2000,491100,43,32,11,12
8,2000,491100,48,42,6,14
9,2000,491100,49,41,8,8
10,2000,491100,32,26,6,1
11,2000,491100,37,30,7,8
12,2000,491100,24,23,1,2
1,2001,491100,25,23,2,4
2,2001,491100,18,14,4,7
3,2001,491100,25,21,4,7
4,2001,491100,30,23,7,5
5,2001,491100,41,33,8,11
6,2001,491100,45,40,5,6
7,2001,491100,49,41,8,8
8,2001,491100,36,32,4,5
9,2001,491100,33,29,4,10
10,2001,491100,43,35,8,4
11,2001,491100,26,22,4,4
12,2001,491100,30,27,3,3
1,2002,491100,32,28,4,5
2,2002,491100,30,29,1,10
3,2002,491100,19,17,2,11
4,2002,491100,28,24,4,2
5,2002,491100,30,22,8,2
6,2002,491100,34,29,5,3
7,2002,491100,45,41,4,12
8,2002,491100,34,31,3,7
9,2002,491100,33,30,3,2
10,2002,491100,48,40,8,9
11,2002,491100,38,31,7,8
12,2002,491100,32,30,2,11
1,2003,491100,26,26,0,8
2,2003,491100,26,24,2,10
3,2003,491100,18,18,0,3
4,2003,491100,32,28,4,4
5,2003,491100,42,38,4,12
6,2003,491100,41,37,4,7
7,2003,491100,50,39,11,8
8,2003,491100,60,48,12,6
9,2003,491100,32,31,1,7
10,2003,491100,40,36,4,17
11,2003,491100,29,23,6,14
12,2003,491100,21,19,2,8
1,2004,491100,23,21,2,12
2,2004,491100,40,35,5,10
3,2004,491100,31,26,5,27
4,2004,491100,29,26,3,12
5,2004,491100,40,33,7,23
6,2004,491100,37,34,3,14
7,2004,491100,46,44,2,6
8,2004,491100,50,49,1,12
9,2004,491100,42,38,4,9
10,2004,491100,41,41,0,21
11,2004,491100,31,27,4,10
12,2004,491100,34,33,1,6
1,2005,491100,24,24,0,18
2,2005,491100,21,18,3,8
3,2005,491100,47,42,5,8
4,2005,491100,33,30,3,9
5,2005,491100,35,31,4,3
6,2005,491100,25,23,2,14
7,2005,491100,46,41,5,10
8,2005,491100,39,37,2,8
9,2005,491100,35,31,4,15
10,2005,491100,41,36,5,4
11,2005,491100,28,26,2,6
12,2005,491100,27,25,2,4
1,2006,491100,24,22,2,10
2,2006,491100,27,26,1,15
3,2006,491100,27,22,5,16
4,2006,491100,40,32,8,4
5,2006,491100,22,20,2,4
6,2006,491100,23,19,4,5
7,2006,491100,43,38,5,6
8,2006,491100,38,35,3,8
9,2006,491100,41,31,10,9
10,2006,491100,25,23,2,4
11,2006,491100,29,25,4,8
12,2006,491100,24,23,1,10
1,2007,491100,17,17,0,13
2,2007,491100,17,14,3,5
3,2007,491100,34,25,9,9
4,2007,491100,30,25,5,12
5,2007,491100,33,28,5,6
6,2007,491100,32,30,2,4
7,2007,491100,29,24,5,7
8,2007,491100,42,38,4,14
9,2007,491100,42,36,6,10
10,2007,491100,32,27,5,5
11,2007,491100,30,26,4,10
12,2007,491100,22,21,1,5
1,2008,491100,27,24,3,10
2,2008,491100,22,19,3,9
3,2008,491100,30,30,0,7
4,2008,491100,29,26,3,6
5,2008,491100,37,30,7,4
6,2008,491100,36,28,8,11
7,2008,491100,50,46,4,5
8,2008,491100,50,45,5,8
9,2008,491100,47,43,4,13
10,2008,491100,38,33,5,6
11,2008,491100,37,32,5,7
12,2008,491100,28,28,0,4
1,2009,491100,32,28,4,2
2,2009,491100,21,17,4,4
3,2009,491100,47,41,6,10
4,2009,491100,46,40,6,4
5,2009,491100,21,20,1,5
6,2009,491100,27,23,4,4
7,2009,491100,30,28,2,3
8,2009,491100,42,41,1,8
9,2009,491100,39,32,7,4
10,2009,491100,37,34,3,11
11,2009,491100,35,33,2,5
12,2009,491100,30,29,1,7
1,2010,491100,24,21,3,4
2,2010,491100,22,20,2,9
3,2010,491100,36,29,7,17
4,2010,491100,34,27,7,15
5,2010,491100,31,25,6,6
6,2010,491100,23,20,3,13
7,2010,491100,44,42,2,8
8,2010,491100,37,34,3,6
9,2010,491100,47,45,2,7
10,2010,491100,37,36,1,7
11,2010,491100,39,34,5,15
12,2010,491100,20,20,0,7
1,2011,491100,28,23,5,6
2,2011,491100,19,18,1,10
1,1999,491000,27,23,4,47
2,1999,491000,23,16,7,24
3,1999,491000,31,24,7,44
4,1999,491000,40,25,15,16
5,1999,491000,43,31,12,24
6,1999,491000,42,24,18,36
7,1999,491000,46,31,15,40
8,1999,491000,45,26,19,46
9,1999,491000,42,29,13,45
10,1999,491000,40,27,13,27
11,1999,491000,31,17,14,36
12,1999,491000,39,30,9,28
1,2000,491000,33,24,9,34
2,2000,491000,27,23,4,29
3,2000,491000,32,22,10,29
4,2000,491000,30,20,10,22
5,2000,491000,38,28,10,19
6,2000,491000,26,17,9,14
7,2000,491000,56,32,24,17
8,2000,491000,47,32,15,29
9,2000,491000,36,29,7,29
10,2000,491000,41,25,16,33
11,2000,491000,31,24,7,21
12,2000,491000,17,11,6,12
1,2001,491000,20,18,2,28
2,2001,491000,27,16,11,30
3,2001,491000,23,14,9,34
4,2001,491000,33,23,10,26
5,2001,491000,43,24,19,23
6,2001,491000,42,32,10,16
7,2001,491000,53,40,13,16
8,2001,491000,37,27,10,55
9,2001,491000,45,30,15,15
10,2001,491000,42,28,14,23
11,2001,491000,38,22,16,23
12,2001,491000,17,11,6,24
1,2002,491000,27,18,9,45
2,2002,491000,26,20,6,40
3,2002,491000,34,22,12,28
4,2002,491000,36,20,16,25
5,2002,491000,31,19,12,20
6,2002,491000,38,22,16,18
7,2002,491000,60,37,23,23
8,2002,491000,60,38,22,19
9,2002,491000,50,32,18,12
10,2002,491000,50,41,9,37
11,2002,491000,36,29,7,19
12,2002,491000,32,24,8,23
1,2003,491000,32,28,4,18
2,2003,491000,22,12,10,20
3,2003,491000,23,15,8,10
4,2003,491000,37,28,9,7
5,2003,491000,37,23,14,11
6,2003,491000,49,35,14,9
7,2003,491000,41,32,9,6
8,2003,491000,50,34,16,17
9,2003,491000,43,27,16,11
10,2003,491000,44,34,10,18
11,2003,491000,30,22,8,22
12,2003,491000,35,25,10,30
1,2004,491000,30,24,6,49
2,2004,491000,28,23,5,40
3,2004,491000,32,22,10,18
4,2004,491000,33,19,14,17
5,2004,491000,36,21,15,19
6,2004,491000,36,23,13,14
7,2004,491000,40,25,15,27
8,2004,491000,33,24,9,37
9,2004,491000,33,25,8,17
10,2004,491000,43,31,12,20
11,2004,491000,36,28,8,19
12,2004,491000,25,19,6,29
1,2005,491000,17,14,3,20
2,2005,491000,23,15,8,10
3,2005,491000,28,23,5,29
4,2005,491000,36,28,8,18
5,2005,491000,46,33,13,23
6,2005,491000,45,35,10,18
7,2005,491000,46,34,12,25
8,2005,491000,38,31,7,12
9,2005,491000,35,29,6,15
10,2005,491000,39,30,9,19
11,2005,491000,36,28,8,12
12,2005,491000,34,31,3,14
1,2006,491000,40,32,8,39
2,2006,491000,31,23,8,33
3,2006,491000,33,24,9,16
4,2006,491000,31,18,13,21
5,2006,491000,32,19,13,19
6,2006,491000,43,33,10,21
7,2006,491000,41,29,12,20
8,2006,491000,41,29,12,15
9,2006,491000,55,43,12,12
10,2006,491000,38,27,11,24
11,2006,491000,38,31,7,20
12,2006,491000,39,24,15,48
1,2007,491000,32,26,6,33
2,2007,491000,33,28,5,23
3,2007,491000,49,34,15,23
4,2007,491000,25,17,8,45
5,2007,491000,52,34,18,27
6,2007,491000,48,38,10,22
7,2007,491000,54,38,16,13
8,2007,491000,38,27,11,24
9,2007,491000,51,39,12,29
10,2007,491000,40,29,11,23
11,2007,491000,35,31,4,44
12,2007,491000,32,28,4,47
1,2008,491000,33,27,6,21
2,2008,491000,32,23,9,23
3,2008,491000,42,34,8,16
4,2008,491000,42,29,13,10
5,2008,491000,60,53,7,9
6,2008,491000,44,27,17,10
7,2008,491000,53,40,13,17
8,2008,491000,55,43,12,18
9,2008,491000,46,39,7,9
10,2008,491000,42,35,7,19
11,2008,491000,31,26,5,16
12,2008,491000,43,36,7,16
1,2009,491000,24,15,9,17
2,2009,491000,22,15,7,12
3,2009,491000,39,24,15,17
4,2009,491000,38,32,6,12
5,2009,491000,28,18,10,12
6,2009,491000,28,15,13,17
7,2009,491000,44,37,7,16
8,2009,491000,44,30,14,15
9,2009,491000,45,37,8,14
10,2009,491000,47,39,8,15
11,2009,491000,41,30,11,10
12,2009,491000,25,21,4,13
1,2010,491000,22,18,4,11
2,2010,491000,23,16,7,17
3,2010,491000,38,30,8,21
4,2010,491000,28,21,7,12
5,2010,491000,35,26,9,12
6,2010,491000,35,21,14,14
7,2010,491000,44,34,10,3
8,2010,491000,36,28,8,7
9,2010,491000,19,14,5,7
10,2010,491000,34,29,5,1
11,2010,491000,35,25,10,11
12,2010,491000,24,19,5,5
1,2011,491000,40,34,6,16
2,2011,491000,19,14,5,8
1,1999,490901,32,28,4,6
2,1999,490901,45,40,5,3
3,1999,490901,36,29,7,10
4,1999,490901,43,39,4,1
5,1999,490901,42,40,2,6
6,1999,490901,47,44,3,1
7,1999,490901,45,41,4,8
8,1999,490901,45,42,3,4
9,1999,490901,53,41,12,6
10,1999,490901,40,33,7,1
11,1999,490901,36,32,4,6
12,1999,490901,40,31,9,5
1,2000,490901,56,41,15,2
2,2000,490901,45,39,6,6
3,2000,490901,45,34,11,3
4,2000,490901,50,40,10,4
5,2000,490901,50,46,4,5
6,2000,490901,53,42,11,7
7,2000,490901,47,37,10,7
8,2000,490901,39,32,7,6
9,2000,490901,35,32,3,4
10,2000,490901,43,33,10,3
11,2000,490901,33,25,8,3
12,2000,490901,27,25,2,4
1,2001,490901,29,25,4,7
2,2001,490901,30,26,4,12
3,2001,490901,28,21,7,7
4,2001,490901,42,30,12,9
5,2001,490901,41,33,8,8
6,2001,490901,44,36,8,4
7,2001,490901,54,41,13,2
8,2001,490901,46,37,9,7
9,2001,490901,55,45,10,4
10,2001,490901,49,36,13,6
11,2001,490901,53,41,12,5
12,2001,490901,31,23,8,4
1,2002,490901,36,27,9,5
2,2002,490901,27,22,5,6
3,2002,490901,33,22,11,1
4,2002,490901,37,33,4,8
5,2002,490901,34,25,9,11
6,2002,490901,32,27,5,6
7,2002,490901,41,28,13,11
8,2002,490901,54,47,7,7
9,2002,490901,45,32,13,1
10,2002,490901,51,40,11,2
11,2002,490901,23,21,2,5
12,2002,490901,28,23,5,5
1,2003,490901,41,34,7,16
2,2003,490901,23,20,3,7
3,2003,490901,41,29,12,3
4,2003,490901,35,23,12,4
5,2003,490901,32,28,4,3
6,2003,490901,29,22,7,7
7,2003,490901,53,38,15,4
8,2003,490901,41,36,5,2
9,2003,490901,34,30,4,2
10,2003,490901,33,22,11,18
11,2003,490901,26,21,5,15
12,2003,490901,39,34,5,16
1,2004,490901,27,21,6,16
2,2004,490901,24,24,0,11
3,2004,490901,40,38,2,7
4,2004,490901,34,32,2,8
5,2004,490901,34,23,11,10
6,2004,490901,42,36,6,6
7,2004,490901,39,34,5,6
8,2004,490901,46,36,10,11
9,2004,490901,35,32,3,6
10,2004,490901,29,25,4,7
11,2004,490901,35,29,6,8
12,2004,490901,50,39,11,7
1,2005,490901,26,25,1,12
2,2005,490901,27,26,1,21
3,2005,490901,22,14,8,10
4,2005,490901,28,23,5,7
5,2005,490901,33,24,9,10
6,2005,490901,45,38,7,15
7,2005,490901,48,43,5,7
8,2005,490901,48,40,8,13
9,2005,490901,24,21,3,19
10,2005,490901,24,19,5,14
11,2005,490901,28,24,4,21
12,2005,490901,28,25,3,18
1,2006,490901,27,24,3,13
2,2006,490901,16,13,3,3
3,2006,490901,30,24,6,7
4,2006,490901,36,30,6,5
5,2006,490901,37,30,7,20
6,2006,490901,30,23,7,12
7,2006,490901,44,40,4,14
8,2006,490901,33,26,7,13
9,2006,490901,39,33,6,12
10,2006,490901,31,26,5,15
11,2006,490901,33,30,3,22
12,2006,490901,43,36,7,21
1,2007,490901,32,29,3,22
2,2007,490901,29,28,1,17
3,2007,490901,34,30,4,11
4,2007,490901,38,32,6,26
5,2007,490901,27,23,4,19
6,2007,490901,32,26,6,24
7,2007,490901,39,36,3,13
8,2007,490901,29,23,6,19
9,2007,490901,37,28,9,22
10,2007,490901,42,36,6,22
11,2007,490901,52,42,10,23
12,2007,490901,41,29,12,19
1,2008,490901,32,31,1,21
2,2008,490901,26,22,4,13
3,2008,490901,25,18,7,15
4,2008,490901,28,24,4,14
5,2008,490901,29,22,7,7
6,2008,490901,30,24,6,9
7,2008,490901,31,28,3,7
8,2008,490901,41,36,5,13
9,2008,490901,42,37,5,17
10,2008,490901,45,37,8,8
11,2008,490901,32,31,1,16
12,2008,490901,24,18,6,5
1,2009,490901,27,24,3,12
2,2009,490901,23,22,1,8
3,2009,490901,20,15,5,4
4,2009,490901,40,34,6,7
5,2009,490901,30,29,1,14
6,2009,490901,34,26,8,9
7,2009,490901,29,26,3,14
8,2009,490901,46,41,5,14
9,2009,490901,38,32,6,14
10,2009,490901,25,23,2,10
11,2009,490901,45,35,10,4
12,2009,490901,21,20,1,5
1,2010,490901,19,18,1,8
2,2010,490901,22,18,4,15
3,2010,490901,22,18,4,23
4,2010,490901,29,22,7,3
5,2010,490901,36,25,11,4
6,2010,490901,53,48,5,8
7,2010,490901,42,34,8,6
8,2010,490901,26,23,3,10
9,2010,490901,23,20,3,6
10,2010,490901,33,27,6,7
11,2010,490901,33,30,3,7
12,2010,490901,40,37,3,7
1,2011,490901,27,22,5,8
2,2011,490901,16,13,3,10
1,1999,500200,17,15,2,2
2,1999,500200,13,13,0,2
3,1999,500200,15,9,6,0
4,1999,500200,15,14,1,4
5,1999,500200,20,17,3,12
6,1999,500200,23,22,1,2
7,1999,500200,21,12,9,2
8,1999,500200,18,12,6,4
9,1999,500200,12,8,4,5
10,1999,500200,13,9,4,3
11,1999,500200,9,6,3,4
12,1999,500200,15,12,3,4
1,2000,500200,14,9,5,4
2,2000,500200,9,7,2,7
3,2000,500200,15,11,4,4
4,2000,500200,17,14,3,3
5,2000,500200,21,15,6,3
6,2000,500200,16,13,3,2
7,2000,500200,15,7,8,4
8,2000,500200,13,9,4,6
9,2000,500200,27,23,4,8
10,2000,500200,11,9,2,4
11,2000,500200,11,8,3,1
12,2000,500200,15,14,1,1
1,2001,500200,11,10,1,1
2,2001,500200,5,5,0,3
3,2001,500200,8,6,2,1
4,2001,500200,14,12,2,1
5,2001,500200,24,17,7,4
6,2001,500200,14,9,5,3
7,2001,500200,16,14,2,2
8,2001,500200,17,15,2,1
9,2001,500200,17,16,1,2
10,2001,500200,16,16,0,4
11,2001,500200,8,7,1,1
12,2001,500200,12,10,2,3
1,2002,500200,13,10,3,7
2,2002,500200,10,9,1,0
3,2002,500200,10,8,2,2
4,2002,500200,10,5,5,9
5,2002,500200,16,15,1,4
6,2002,500200,14,12,2,3
7,2002,500200,18,16,2,0
8,2002,500200,25,19,6,6
9,2002,500200,25,19,6,8
10,2002,500200,11,8,3,7
11,2002,500200,9,7,2,0
12,2002,500200,9,4,5,12
1,2003,500200,16,12,4,9
2,2003,500200,6,4,2,6
3,2003,500200,16,11,5,4
4,2003,500200,13,10,3,0
5,2003,500200,19,16,3,0
6,2003,500200,12,9,3,2
7,2003,500200,12,10,2,2
8,2003,500200,8,6,2,2
9,2003,500200,16,16,0,3
10,2003,500200,18,17,1,2
11,2003,500200,12,11,1,6
12,2003,500200,15,12,3,5
1,2004,500200,10,9,1,12
2,2004,500200,13,8,5,3
3,2004,500200,17,13,4,1
4,2004,500200,16,12,4,3
5,2004,500200,17,12,5,8
6,2004,500200,18,17,1,7
7,2004,500200,14,7,7,3
8,2004,500200,18,15,3,3
9,2004,500200,11,9,2,2
10,2004,500200,16,13,3,8
11,2004,500200,10,10,0,1
12,2004,500200,7,6,1,4
1,2005,500200,13,9,4,2
2,2005,500200,9,8,1,4
3,2005,500200,11,9,2,11
4,2005,500200,15,12,3,3
5,2005,500200,14,9,5,3
6,2005,500200,11,7,4,8
7,2005,500200,20,11,9,3
8,2005,500200,18,14,4,8
9,2005,500200,21,15,6,3
10,2005,500200,12,8,4,4
11,2005,500200,12,6,6,1
12,2005,500200,9,7,2,4
1,2006,500200,9,8,1,6
2,2006,500200,9,7,2,5
3,2006,500200,9,7,2,7
4,2006,500200,6,5,1,8
5,2006,500200,11,8,3,5
6,2006,500200,15,14,1,8
7,2006,500200,19,15,4,7
8,2006,500200,16,10,6,2
9,2006,500200,5,4,1,4
10,2006,500200,9,8,1,6
11,2006,500200,11,10,1,1
12,2006,500200,16,13,3,8
1,2007,500200,9,6,3,7
2,2007,500200,9,9,0,3
3,2007,500200,12,9,3,4
4,2007,500200,16,13,3,9
5,2007,500200,20,16,4,6
6,2007,500200,22,15,7,6
7,2007,500200,17,12,5,6
8,2007,500200,20,12,8,2
9,2007,500200,22,22,0,3
10,2007,500200,19,14,5,4
11,2007,500200,18,15,3,3
12,2007,500200,6,4,2,4
1,2008,500200,10,8,2,3
2,2008,500200,10,7,3,4
3,2008,500200,8,5,3,4
4,2008,500200,8,6,2,5
5,2008,500200,9,5,4,1
6,2008,500200,19,16,3,2
7,2008,500200,18,14,4,1
8,2008,500200,17,14,3,1
9,2008,500200,11,7,4,2
10,2008,500200,11,7,4,4
11,2008,500200,11,10,1,1
12,2008,500200,9,9,0,2
1,2009,500200,8,5,3,0
2,2009,500200,5,4,1,5
3,2009,500200,7,5,2,3
4,2009,500200,14,9,5,2
5,2009,500200,14,7,7,5
6,2009,500200,9,5,4,8
7,2009,500200,17,14,3,6
8,2009,500200,15,11,4,3
9,2009,500200,12,10,2,1
10,2009,500200,15,13,2,1
11,2009,500200,4,2,2,4
12,2009,500200,13,10,3,1
1,2010,500200,8,4,4,0
2,2010,500200,5,4,1,1
3,2010,500200,14,9,5,4
4,2010,500200,14,12,2,1
5,2010,500200,8,6,2,3
6,2010,500200,14,13,1,1
7,2010,500200,8,7,1,0
8,2010,500200,15,13,2,3
9,2010,500200,9,9,0,2
10,2010,500200,12,11,1,1
11,2010,500200,16,10,6,0
12,2010,500200,10,10,0,0
1,2011,500200,12,10,2,0
2,2011,500200,5,3,2,2
1,1999,520300,15,14,1,1
2,1999,520300,8,6,2,0
3,1999,520300,18,12,6,0
4,1999,520300,15,14,1,1
5,1999,520300,21,16,5,1
6,1999,520300,17,16,1,2
7,1999,520300,17,17,0,2
8,1999,520300,16,13,3,1
9,1999,520300,18,15,3,1
10,1999,520300,19,18,1,1
11,1999,520300,15,12,3,0
12,1999,520300,18,16,2,3
1,2000,520300,17,15,2,1
2,2000,520300,20,18,2,0
3,2000,520300,21,20,1,3
4,2000,520300,12,12,0,2
5,2000,520300,17,14,3,0
6,2000,520300,10,9,1,0
7,2000,520300,23,19,4,3
8,2000,520300,16,15,1,1
9,2000,520300,16,14,2,3
10,2000,520300,24,18,6,3
11,2000,520300,13,12,1,5
12,2000,520300,12,8,4,0
1,2001,520300,21,20,1,5
2,2001,520300,22,19,3,1
3,2001,520300,16,13,3,5
4,2001,520300,20,16,4,0
5,2001,520300,23,20,3,2
6,2001,520300,11,10,1,0
7,2001,520300,14,12,2,5
8,2001,520300,18,15,3,7
9,2001,520300,17,15,2,5
10,2001,520300,24,19,5,1
11,2001,520300,14,12,2,3
12,2001,520300,15,14,1,4
1,2002,520300,12,10,2,2
2,2002,520300,6,5,1,5
3,2002,520300,13,10,3,1
4,2002,520300,16,16,0,5
5,2002,520300,17,13,4,7
6,2002,520300,17,13,4,6
7,2002,520300,14,13,1,2
8,2002,520300,19,14,5,3
9,2002,520300,20,17,3,5
10,2002,520300,14,14,0,4
11,2002,520300,13,9,4,0
12,2002,520300,20,16,4,0
1,2003,520300,12,8,4,1
2,2003,520300,9,8,1,3
3,2003,520300,15,13,2,3
4,2003,520300,20,18,2,3
5,2003,520300,14,13,1,2
6,2003,520300,16,13,3,1
7,2003,520300,18,14,4,3
8,2003,520300,16,16,0,3
9,2003,520300,16,11,5,3
10,2003,520300,17,14,3,5
11,2003,520300,13,12,1,4
12,2003,520300,16,13,3,3
1,2004,520300,10,9,1,4
2,2004,520300,21,14,7,6
3,2004,520300,23,20,3,5
4,2004,520300,18,14,4,5
5,2004,520300,16,10,6,2
6,2004,520300,15,13,2,3
7,2004,520300,16,13,3,2
8,2004,520300,18,13,5,6
9,2004,520300,18,16,2,2
10,2004,520300,9,8,1,1
11,2004,520300,13,12,1,1
12,2004,520300,20,19,1,2
1,2005,520300,13,12,1,4
2,2005,520300,13,13,0,1
3,2005,520300,18,16,2,0
4,2005,520300,9,8,1,6
5,2005,520300,11,9,2,3
6,2005,520300,18,12,6,11
7,2005,520300,16,14,2,0
8,2005,520300,18,17,1,5
9,2005,520300,10,10,0,5
10,2005,520300,20,18,2,1
11,2005,520300,12,11,1,2
12,2005,520300,15,13,2,1
1,2006,520300,15,13,2,4
2,2006,520300,12,11,1,7
3,2006,520300,18,17,1,9
4,2006,520300,7,6,1,7
5,2006,520300,20,17,3,3
6,2006,520300,10,9,1,4
7,2006,520300,12,9,3,1
8,2006,520300,23,19,4,2
9,2006,520300,18,14,4,3
10,2006,520300,10,6,4,6
11,2006,520300,6,5,1,5
12,2006,520300,12,11,1,6
1,2007,520300,6,6,0,2
2,2007,520300,9,8,1,5
3,2007,520300,5,4,1,9
4,2007,520300,8,8,0,3
5,2007,520300,15,13,2,2
6,2007,520300,9,8,1,3
7,2007,520300,19,19,0,2
8,2007,520300,6,6,0,2
9,2007,520300,11,10,1,2
10,2007,520300,13,10,3,1
11,2007,520300,10,10,0,2
12,2007,520300,11,11,0,2
1,2008,520300,9,7,2,1
2,2008,520300,6,6,0,1
3,2008,520300,19,15,4,0
4,2008,520300,19,17,2,1
5,2008,520300,15,13,2,1
6,2008,520300,13,12,1,2
7,2008,520300,22,19,3,2
8,2008,520300,15,11,4,1
9,2008,520300,13,13,0,4
10,2008,520300,13,10,3,3
11,2008,520300,19,17,2,1
12,2008,520300,17,16,1,1
1,2009,520300,15,14,1,0
2,2009,520300,17,17,0,1
3,2009,520300,16,14,2,1
4,2009,520300,8,6,2,1
5,2009,520300,14,11,3,3
6,2009,520300,19,16,3,3
7,2009,520300,11,6,5,2
8,2009,520300,13,12,1,0
9,2009,520300,18,16,2,2
10,2009,520300,16,15,1,4
11,2009,520300,10,10,0,1
12,2009,520300,19,19,0,6
1,2010,520300,15,12,3,2
2,2010,520300,9,8,1,2
3,2010,520300,11,8,3,1
4,2010,520300,13,11,2,4
5,2010,520300,14,12,2,1
6,2010,520300,11,9,2,3
7,2010,520300,20,15,5,1
8,2010,520300,22,20,2,0
9,2010,520300,8,8,0,2
10,2010,520300,9,8,1,3
11,2010,520300,11,10,1,0
12,2010,520300,20,17,3,1
1,2011,520300,9,8,1,4
2,2011,520300,7,5,2,1
1,1999,490902,36,27,9,10
2,1999,490902,35,23,12,14
3,1999,490902,35,25,10,11
4,1999,490902,29,25,4,16
5,1999,490902,41,28,13,10
6,1999,490902,48,36,12,13
7,1999,490902,42,32,10,11
8,1999,490902,45,40,5,13
9,1999,490902,50,40,10,8
10,1999,490902,39,27,12,6
11,1999,490902,42,35,7,21
12,1999,490902,41,32,9,9
1,2000,490902,31,23,8,7
2,2000,490902,46,35,11,11
3,2000,490902,39,29,10,10
4,2000,490902,38,29,9,11
5,2000,490902,41,34,7,12
6,2000,490902,35,25,10,11
7,2000,490902,44,34,10,11
8,2000,490902,57,42,15,12
9,2000,490902,50,40,10,8
10,2000,490902,37,24,13,6
11,2000,490902,36,24,12,10
12,2000,490902,39,30,9,5
1,2001,490902,26,17,9,16
2,2001,490902,34,25,9,12
3,2001,490902,24,19,5,4
4,2001,490902,41,27,14,12
5,2001,490902,33,26,7,17
6,2001,490902,33,22,11,6
7,2001,490902,46,33,13,9
8,2001,490902,48,33,15,12
9,2001,490902,46,40,6,7
10,2001,490902,49,36,13,20
11,2001,490902,24,21,3,15
12,2001,490902,23,19,4,7
1,2002,490902,36,28,8,17
2,2002,490902,27,23,4,16
3,2002,490902,36,30,6,6
4,2002,490902,29,25,4,10
5,2002,490902,37,30,7,6
6,2002,490902,37,26,11,7
7,2002,490902,45,34,11,16
8,2002,490902,41,37,4,3
9,2002,490902,42,26,16,9
10,2002,490902,37,28,9,14
11,2002,490902,30,20,10,4
12,2002,490902,38,30,8,8
1,2003,490902,33,31,2,4
2,2003,490902,34,28,6,5
3,2003,490902,36,20,16,12
4,2003,490902,31,27,4,8
5,2003,490902,25,21,4,8
6,2003,490902,39,29,10,3
7,2003,490902,23,16,7,4
8,2003,490902,38,29,9,11
9,2003,490902,39,33,6,6
10,2003,490902,36,24,12,20
11,2003,490902,34,28,6,14
12,2003,490902,28,24,4,19
1,2004,490902,29,23,6,14
2,2004,490902,29,19,10,13
3,2004,490902,27,25,2,7
4,2004,490902,29,25,4,17
5,2004,490902,26,20,6,12
6,2004,490902,37,28,9,7
7,2004,490902,28,19,9,11
8,2004,490902,35,28,7,12
9,2004,490902,33,25,8,9
10,2004,490902,33,27,6,11
11,2004,490902,28,21,7,19
12,2004,490902,30,24,6,2
1,2005,490902,27,21,6,11
2,2005,490902,27,23,4,19
3,2005,490902,36,30,6,23
4,2005,490902,33,26,7,8
5,2005,490902,37,31,6,8
6,2005,490902,59,48,11,15
7,2005,490902,49,38,11,6
8,2005,490902,48,39,9,10
9,2005,490902,41,35,6,9
10,2005,490902,38,33,5,7
11,2005,490902,40,32,8,10
12,2005,490902,28,24,4,13
1,2006,490902,24,16,8,10
2,2006,490902,26,23,3,13
3,2006,490902,33,26,7,14
4,2006,490902,43,33,10,10
5,2006,490902,23,21,2,26
6,2006,490902,39,32,7,10
7,2006,490902,41,31,10,20
8,2006,490902,55,39,16,14
9,2006,490902,42,34,8,7
10,2006,490902,37,30,7,15
11,2006,490902,34,30,4,10
12,2006,490902,38,30,8,21
1,2007,490902,33,29,4,15
2,2007,490902,25,20,5,9
3,2007,490902,34,30,4,9
4,2007,490902,39,32,7,25
5,2007,490902,43,36,7,24
6,2007,490902,52,46,6,9
7,2007,490902,43,36,7,7
8,2007,490902,39,32,7,19
9,2007,490902,42,36,6,16
10,2007,490902,58,45,13,20
11,2007,490902,47,34,13,12
12,2007,490902,30,25,5,16
1,2008,490902,34,29,5,28
2,2008,490902,23,20,3,28
3,2008,490902,35,25,10,12
4,2008,490902,45,39,6,12
5,2008,490902,53,51,2,8
6,2008,490902,52,43,9,10
7,2008,490902,51,42,9,15
8,2008,490902,44,38,6,12
9,2008,490902,46,36,10,15
10,2008,490902,42,37,5,17
11,2008,490902,33,27,6,14
12,2008,490902,31,26,5,3
1,2009,490902,25,22,3,6
2,2009,490902,19,16,3,14
3,2009,490902,44,36,8,14
4,2009,490902,48,43,5,9
5,2009,490902,34,27,7,13
6,2009,490902,30,26,4,8
7,2009,490902,39,37,2,10
8,2009,490902,49,45,4,11
9,2009,490902,50,44,6,15
10,2009,490902,29,23,6,20
11,2009,490902,48,47,1,11
12,2009,490902,31,28,3,10
1,2010,490902,29,27,2,15
2,2010,490902,23,22,1,7
3,2010,490902,28,23,5,16
4,2010,490902,29,23,6,6
5,2010,490902,35,27,8,4
6,2010,490902,29,24,5,9
7,2010,490902,39,29,10,8
8,2010,490902,28,23,5,9
9,2010,490902,26,22,4,15
10,2010,490902,36,29,7,10
11,2010,490902,33,29,4,10
12,2010,490902,31,25,6,6
1,2011,490902,24,19,5,7
2,2011,490902,21,17,4,8
1,1999,740200,6,6,0,0
2,1999,740200,2,2,0,1
3,1999,740200,3,2,1,0
4,1999,740200,5,5,0,0
5,1999,740200,2,2,0,0
6,1999,740200,5,4,1,0
7,1999,740200,5,4,1,1
8,1999,740200,8,8,0,0
9,1999,740200,8,8,0,0
10,1999,740200,11,11,0,0
11,1999,740200,6,6,0,0
12,1999,740200,7,7,0,0
1,2000,740200,4,4,0,0
2,2000,740200,5,4,1,2
3,2000,740200,5,5,0,0
4,2000,740200,10,10,0,0
5,2000,740200,1,1,0,0
6,2000,740200,0,0,0,0
7,2000,740200,4,4,0,0
8,2000,740200,6,5,1,0
9,2000,740200,4,3,1,0
10,2000,740200,6,6,0,0
11,2000,740200,8,8,0,0
12,2000,740200,2,2,0,1
1,2001,740200,9,9,0,0
2,2001,740200,5,5,0,0
3,2001,740200,2,2,0,0
4,2001,740200,9,9,0,1
5,2001,740200,5,5,0,1
6,2001,740200,8,7,1,0
7,2001,740200,4,4,0,0
8,2001,740200,4,4,0,1
9,2001,740200,5,5,0,0
10,2001,740200,5,3,2,0
11,2001,740200,7,7,0,0
12,2001,740200,7,5,2,0
1,2002,740200,7,6,1,2
2,2002,740200,4,4,0,0
3,2002,740200,7,7,0,1
4,2002,740200,7,7,0,1
5,2002,740200,6,6,0,0
6,2002,740200,3,3,0,0
7,2002,740200,4,4,0,0
8,2002,740200,7,7,0,0
9,2002,740200,4,4,0,1
10,2002,740200,8,8,0,0
11,2002,740200,9,9,0,0
12,2002,740200,10,10,0,0
1,2003,740200,3,2,1,0
2,2003,740200,4,3,1,1
3,2003,740200,8,8,0,0
4,2003,740200,7,6,1,4
5,2003,740200,4,2,2,2
6,2003,740200,7,7,0,0
7,2003,740200,4,3,1,0
8,2003,740200,3,3,0,0
9,2003,740200,3,3,0,1
10,2003,740200,10,9,1,0
11,2003,740200,8,8,0,0
12,2003,740200,4,3,1,0
1,2004,740200,7,7,0,0
2,2004,740200,3,3,0,1
3,2004,740200,6,5,1,1
4,2004,740200,5,5,0,2
5,2004,740200,6,5,1,3
6,2004,740200,8,7,1,0
7,2004,740200,6,5,1,0
8,2004,740200,9,9,0,0
9,2004,740200,12,11,1,0
10,2004,740200,8,7,1,0
11,2004,740200,5,4,1,3
12,2004,740200,4,4,0,0
1,2005,740200,6,5,1,0
2,2005,740200,4,4,0,0
3,2005,740200,2,2,0,1
4,2005,740200,7,6,1,0
5,2005,740200,4,4,0,0
6,2005,740200,7,7,0,0
7,2005,740200,7,7,0,1
8,2005,740200,8,8,0,0
9,2005,740200,9,9,0,0
10,2005,740200,4,4,0,0
11,2005,740200,8,8,0,0
12,2005,740200,6,5,1,1
1,2006,740200,5,5,0,0
2,2006,740200,4,4,0,0
3,2006,740200,2,2,0,1
4,2006,740200,5,5,0,1
5,2006,740200,3,3,0,0
6,2006,740200,5,5,0,0
7,2006,740200,1,1,0,0
8,2006,740200,8,8,0,0
9,2006,740200,4,4,0,0
10,2006,740200,7,7,0,0
11,2006,740200,3,3,0,0
12,2006,740200,7,7,0,0
1,2007,740200,7,7,0,0
2,2007,740200,5,5,0,2
3,2007,740200,10,10,0,1
4,2007,740200,1,1,0,2
5,2007,740200,4,4,0,1
6,2007,740200,5,5,0,0
7,2007,740200,3,3,0,0
8,2007,740200,4,4,0,0
9,2007,740200,4,4,0,0
10,2007,740200,6,5,1,1
11,2007,740200,4,3,1,0
12,2007,740200,6,6,0,0
1,2008,740200,3,3,0,0
2,2008,740200,6,6,0,0
3,2008,740200,6,6,0,0
4,2008,740200,6,6,0,0
5,2008,740200,6,4,2,0
6,2008,740200,6,6,0,0
7,2008,740200,11,9,2,0
8,2008,740200,7,7,0,2
9,2008,740200,2,2,0,0
10,2008,740200,6,6,0,0
11,2008,740200,3,3,0,1
12,2008,740200,5,5,0,2
1,2009,740200,3,3,0,1
2,2009,740200,5,5,0,0
3,2009,740200,5,5,0,0
4,2009,740200,6,6,0,0
5,2009,740200,2,2,0,1
6,2009,740200,3,2,1,0
7,2009,740200,5,4,1,0
8,2009,740200,6,6,0,0
9,2009,740200,7,6,1,0
10,2009,740200,4,4,0,0
11,2009,740200,9,8,1,1
12,2009,740200,9,8,1,0
1,2010,740200,3,3,0,0
2,2010,740200,3,2,1,1
3,2010,740200,5,5,0,0
4,2010,740200,8,8,0,3
5,2010,740200,4,4,0,0
6,2010,740200,3,3,0,0
7,2010,740200,4,4,0,0
8,2010,740200,10,10,0,2
9,2010,740200,6,5,1,2
10,2010,740200,6,6,0,2
11,2010,740200,4,4,0,2
12,2010,740200,5,4,1,0
1,2011,740200,2,2,0,0
2,2011,740200,2,2,0,5
1,1999,720500,1,1,0,0
2,1999,720500,2,2,0,0
3,1999,720500,4,4,0,0
4,1999,720500,1,0,1,0
5,1999,720500,1,1,0,0
6,1999,720500,8,7,1,0
7,1999,720500,10,9,1,0
8,1999,720500,4,3,1,0
9,1999,720500,5,5,0,0
10,1999,720500,1,1,0,0
11,1999,720500,2,2,0,0
12,1999,720500,3,2,1,0
1,2000,720500,2,2,0,0
2,2000,720500,1,1,0,0
3,2000,720500,3,3,0,0
4,2000,720500,5,4,1,0
5,2000,720500,6,6,0,0
6,2000,720500,2,1,1,0
7,2000,720500,2,2,0,0
8,2000,720500,4,4,0,0
9,2000,720500,4,4,0,0
10,2000,720500,3,3,0,0
11,2000,720500,0,0,0,0
12,2000,720500,0,0,0,0
1,2001,720500,1,1,0,0
2,2001,720500,0,0,0,0
3,2001,720500,1,1,0,0
4,2001,720500,0,0,0,0
5,2001,720500,4,3,1,0
6,2001,720500,3,3,0,0
7,2001,720500,6,6,0,0
8,2001,720500,2,2,0,0
9,2001,720500,3,3,0,0
10,2001,720500,1,1,0,0
11,2001,720500,0,0,0,0
12,2001,720500,3,3,0,1
1,2002,720500,1,1,0,0
2,2002,720500,3,3,0,0
3,2002,720500,3,3,0,0
4,2002,720500,2,2,0,0
5,2002,720500,3,3,0,0
6,2002,720500,1,1,0,0
7,2002,720500,5,5,0,0
8,2002,720500,2,2,0,2
9,2002,720500,1,1,0,0
10,2002,720500,3,3,0,0
11,2002,720500,0,0,0,0
12,2002,720500,2,2,0,0
1,2003,720500,0,0,0,0
2,2003,720500,4,4,0,0
3,2003,720500,0,0,0,0
4,2003,720500,2,2,0,2
5,2003,720500,3,3,0,0
6,2003,720500,5,4,1,1
7,2003,720500,4,4,0,0
8,2003,720500,2,2,0,0
9,2003,720500,1,1,0,0
10,2003,720500,9,7,2,0
11,2003,720500,3,3,0,0
12,2003,720500,1,1,0,0
1,2004,720500,1,1,0,1
2,2004,720500,1,1,0,0
3,2004,720500,1,1,0,0
4,2004,720500,1,1,0,0
5,2004,720500,1,1,0,2
6,2004,720500,3,3,0,0
7,2004,720500,3,3,0,0
8,2004,720500,4,4,0,1
9,2004,720500,3,2,1,1
10,2004,720500,5,5,0,0
11,2004,720500,2,1,1,0
12,2004,720500,1,1,0,1
1,2005,720500,1,1,0,1
2,2005,720500,1,1,0,0
3,2005,720500,1,1,0,0
4,2005,720500,2,1,1,0
5,2005,720500,2,1,1,0
6,2005,720500,1,1,0,0
7,2005,720500,3,3,0,2
8,2005,720500,2,2,0,0
9,2005,720500,6,6,0,2
10,2005,720500,1,1,0,1
11,2005,720500,2,2,0,0
12,2005,720500,2,2,0,0
1,2006,720500,2,1,1,1
2,2006,720500,0,0,0,0
3,2006,720500,1,1,0,2
4,2006,720500,1,1,0,1
5,2006,720500,1,1,0,0
6,2006,720500,2,2,0,0
7,2006,720500,2,2,0,0
8,2006,720500,1,1,0,0
9,2006,720500,3,2,1,0
10,2006,720500,5,5,0,0
11,2006,720500,3,3,0,0
12,2006,720500,0,0,0,1
1,2007,720500,5,5,0,0
2,2007,720500,4,4,0,0
3,2007,720500,1,1,0,0
4,2007,720500,0,0,0,0
5,2007,720500,2,2,0,0
6,2007,720500,6,6,0,2
7,2007,720500,3,2,1,0
8,2007,720500,4,4,0,0
9,2007,720500,1,1,0,1
10,2007,720500,2,2,0,0
11,2007,720500,2,2,0,0
12,2007,720500,0,0,0,0
1,2008,720500,0,0,0,2
2,2008,720500,1,1,0,0
3,2008,720500,5,5,0,0
4,2008,720500,1,1,0,0
5,2008,720500,1,1,0,0
6,2008,720500,3,3,0,1
7,2008,720500,1,1,0,0
8,2008,720500,6,6,0,0
9,2008,720500,5,5,0,0
10,2008,720500,2,2,0,0
11,2008,720500,2,1,1,0
12,2008,720500,2,2,0,0
1,2009,720500,0,0,0,0
2,2009,720500,2,2,0,0
3,2009,720500,6,6,0,0
4,2009,720500,0,0,0,0
5,2009,720500,2,2,0,0
6,2009,720500,1,1,0,0
7,2009,720500,1,1,0,0
8,2009,720500,2,2,0,0
9,2009,720500,2,2,0,0
10,2009,720500,4,4,0,0
11,2009,720500,1,0,1,0
12,2009,720500,5,3,2,0
1,2010,720500,7,7,0,0
2,2010,720500,2,2,0,0
3,2010,720500,0,0,0,1
4,2010,720500,2,2,0,0
5,2010,720500,1,1,0,0
6,2010,720500,1,1,0,2
7,2010,720500,4,4,0,0
8,2010,720500,3,3,0,0
9,2010,720500,1,1,0,0
10,2010,720500,3,3,0,1
11,2010,720500,3,3,0,0
12,2010,720500,0,0,0,0
1,2011,720500,0,0,0,0
2,2011,720500,0,0,0,0
1,1999,720600,4,4,0,0
2,1999,720600,4,4,0,0
3,1999,720600,6,6,0,0
4,1999,720600,9,9,0,1
5,1999,720600,10,10,0,1
6,1999,720600,7,7,0,1
7,1999,720600,6,5,1,0
8,1999,720600,25,25,0,0
9,1999,720600,9,9,0,1
10,1999,720600,1,0,1,0
11,1999,720600,5,5,0,0
12,1999,720600,6,6,0,0
1,2000,720600,9,7,2,0
2,2000,720600,3,3,0,1
3,2000,720600,9,9,0,0
4,2000,720600,12,12,0,0
5,2000,720600,6,6,0,0
6,2000,720600,7,7,0,0
7,2000,720600,13,12,1,1
8,2000,720600,7,7,0,0
9,2000,720600,4,2,2,0
10,2000,720600,10,10,0,1
11,2000,720600,8,8,0,0
12,2000,720600,4,3,1,1
1,2001,720600,4,3,1,0
2,2001,720600,4,3,1,1
3,2001,720600,6,6,0,0
4,2001,720600,7,7,0,0
5,2001,720600,5,4,1,1
6,2001,720600,6,5,1,0
7,2001,720600,9,8,1,0
8,2001,720600,10,9,1,0
9,2001,720600,8,8,0,1
10,2001,720600,5,5,0,1
11,2001,720600,5,5,0,2
12,2001,720600,9,9,0,1
1,2002,720600,5,5,0,0
2,2002,720600,1,1,0,0
3,2002,720600,5,5,0,0
4,2002,720600,5,5,0,0
5,2002,720600,7,7,0,2
6,2002,720600,6,6,0,0
7,2002,720600,12,12,0,0
8,2002,720600,10,10,0,0
9,2002,720600,4,3,1,0
10,2002,720600,2,2,0,1
11,2002,720600,10,9,1,0
12,2002,720600,7,7,0,0
1,2003,720600,3,2,1,0
2,2003,720600,3,3,0,0
3,2003,720600,11,10,1,1
4,2003,720600,6,6,0,0
5,2003,720600,5,5,0,0
6,2003,720600,6,6,0,0
7,2003,720600,8,8,0,1
8,2003,720600,7,7,0,0
9,2003,720600,4,4,0,0
10,2003,720600,9,9,0,1
11,2003,720600,2,2,0,1
12,2003,720600,2,2,0,0
1,2004,720600,1,1,0,0
2,2004,720600,1,1,0,0
3,2004,720600,3,2,1,0
4,2004,720600,2,2,0,0
5,2004,720600,5,5,0,0
6,2004,720600,9,9,0,0
7,2004,720600,2,2,0,0
8,2004,720600,1,1,0,0
9,2004,720600,5,5,0,0
10,2004,720600,1,1,0,1
11,2004,720600,4,4,0,1
12,2004,720600,3,3,0,0
1,2005,720600,4,4,0,1
2,2005,720600,5,5,0,1
3,2005,720600,5,4,1,0
4,2005,720600,7,7,0,0
5,2005,720600,2,2,0,0
6,2005,720600,6,6,0,2
7,2005,720600,12,11,1,0
8,2005,720600,7,6,1,1
9,2005,720600,4,4,0,0
10,2005,720600,6,6,0,1
11,2005,720600,7,7,0,0
12,2005,720600,6,6,0,1
1,2006,720600,4,3,1,0
2,2006,720600,6,6,0,1
3,2006,720600,5,4,1,0
4,2006,720600,3,3,0,0
5,2006,720600,3,2,1,0
6,2006,720600,3,3,0,0
7,2006,720600,3,3,0,1
8,2006,720600,2,2,0,2
9,2006,720600,5,3,2,0
10,2006,720600,6,5,1,1
11,2006,720600,6,6,0,0
12,2006,720600,1,1,0,0
1,2007,720600,1,1,0,1
2,2007,720600,3,3,0,2
3,2007,720600,4,4,0,0
4,2007,720600,3,3,0,1
5,2007,720600,2,2,0,0
6,2007,720600,9,8,1,1
7,2007,720600,5,5,0,0
8,2007,720600,6,6,0,0
9,2007,720600,8,8,0,1
10,2007,720600,7,6,1,0
11,2007,720600,3,3,0,1
12,2007,720600,2,2,0,1
1,2008,720600,13,13,0,1
2,2008,720600,5,5,0,2
3,2008,720600,8,6,2,2
4,2008,720600,4,4,0,1
5,2008,720600,7,4,3,0
6,2008,720600,6,6,0,0
7,2008,720600,8,8,0,0
8,2008,720600,4,3,1,0
9,2008,720600,7,6,1,0
10,2008,720600,9,8,1,0
11,2008,720600,8,8,0,0
12,2008,720600,3,3,0,0
1,2009,720600,0,0,0,0
2,2009,720600,0,0,0,0
3,2009,720600,4,4,0,1
4,2009,720600,2,2,0,3
5,2009,720600,5,5,0,0
6,2009,720600,6,6,0,0
7,2009,720600,6,6,0,0
8,2009,720600,5,5,0,1
9,2009,720600,3,3,0,0
10,2009,720600,4,4,0,1
11,2009,720600,4,4,0,0
12,2009,720600,7,7,0,1
1,2010,720600,2,2,0,0
2,2010,720600,0,0,0,1
3,2010,720600,5,5,0,0
4,2010,720600,3,3,0,0
5,2010,720600,2,2,0,2
6,2010,720600,2,2,0,2
7,2010,720600,8,8,0,1
8,2010,720600,8,7,1,0
9,2010,720600,3,3,0,1
10,2010,720600,4,4,0,2
11,2010,720600,5,5,0,3
12,2010,720600,4,4,0,0
1,2011,720600,5,4,1,0
2,2011,720600,3,3,0,1
1,1999,520400,7,5,2,3
2,1999,520400,5,4,1,2
3,1999,520400,9,9,0,1
4,1999,520400,6,4,2,2
5,1999,520400,12,10,2,0
6,1999,520400,19,14,5,2
7,1999,520400,12,10,2,1
8,1999,520400,11,10,1,1
9,1999,520400,21,18,3,0
10,1999,520400,15,13,2,2
11,1999,520400,3,3,0,3
12,1999,520400,7,7,0,0
1,2000,520400,9,6,3,1
2,2000,520400,9,7,2,1
3,2000,520400,9,7,2,0
4,2000,520400,6,6,0,3
5,2000,520400,6,6,0,2
6,2000,520400,15,15,0,1
7,2000,520400,11,9,2,0
8,2000,520400,12,11,1,2
9,2000,520400,7,7,0,0
10,2000,520400,8,8,0,0
11,2000,520400,4,4,0,0
12,2000,520400,3,2,1,0
1,2001,520400,6,5,1,5
2,2001,520400,6,5,1,1
3,2001,520400,10,7,3,1
4,2001,520400,10,8,2,3
5,2001,520400,7,7,0,2
6,2001,520400,10,7,3,2
7,2001,520400,5,4,1,1
8,2001,520400,7,5,2,2
9,2001,520400,10,9,1,0
10,2001,520400,4,3,1,1
11,2001,520400,10,7,3,2
12,2001,520400,11,10,1,1
1,2002,520400,8,7,1,0
2,2002,520400,1,1,0,0
3,2002,520400,6,5,1,1
4,2002,520400,7,6,1,1
5,2002,520400,17,10,7,3
6,2002,520400,9,8,1,0
7,2002,520400,10,8,2,2
8,2002,520400,15,15,0,1
9,2002,520400,9,7,2,0
10,2002,520400,5,5,0,2
11,2002,520400,8,7,1,0
12,2002,520400,9,9,0,2
1,2003,520400,17,14,3,0
2,2003,520400,6,5,1,1
3,2003,520400,9,9,0,1
4,2003,520400,9,8,1,1
5,2003,520400,12,11,1,3
6,2003,520400,15,14,1,0
7,2003,520400,9,7,2,0
8,2003,520400,10,9,1,0
9,2003,520400,6,3,3,1
10,2003,520400,12,11,1,2
11,2003,520400,8,8,0,1
12,2003,520400,10,10,0,1
1,2004,520400,6,6,0,0
2,2004,520400,5,3,2,0
3,2004,520400,13,11,2,3
4,2004,520400,4,4,0,1
5,2004,520400,15,12,3,1
6,2004,520400,22,21,1,1
7,2004,520400,9,9,0,2
8,2004,520400,6,6,0,4
9,2004,520400,11,10,1,0
10,2004,520400,8,8,0,0
11,2004,520400,11,9,2,0
12,2004,520400,14,13,1,2
1,2005,520400,10,10,0,1
2,2005,520400,9,7,2,2
3,2005,520400,3,3,0,0
4,2005,520400,3,3,0,4
5,2005,520400,5,5,0,1
6,2005,520400,3,3,0,2
7,2005,520400,11,10,1,3
8,2005,520400,8,7,1,2
9,2005,520400,8,8,0,4
10,2005,520400,10,7,3,3
11,2005,520400,5,5,0,0
12,2005,520400,6,6,0,0
1,2006,520400,8,8,0,5
2,2006,520400,3,2,1,4
3,2006,520400,12,12,0,3
4,2006,520400,6,3,3,0
5,2006,520400,4,3,1,0
6,2006,520400,9,8,1,0
7,2006,520400,4,4,0,0
8,2006,520400,9,9,0,0
9,2006,520400,8,6,2,1
10,2006,520400,10,9,1,2
11,2006,520400,9,8,1,1
12,2006,520400,6,4,2,6
1,2007,520400,10,8,2,6
2,2007,520400,5,5,0,0
3,2007,520400,12,12,0,4
4,2007,520400,7,7,0,2
5,2007,520400,6,6,0,5
6,2007,520400,6,6,0,1
7,2007,520400,5,4,1,1
8,2007,520400,8,7,1,2
9,2007,520400,6,5,1,0
10,2007,520400,7,7,0,0
11,2007,520400,6,5,1,1
12,2007,520400,6,6,0,1
1,2008,520400,4,4,0,1
2,2008,520400,8,8,0,0
3,2008,520400,12,12,0,0
4,2008,520400,6,6,0,2
5,2008,520400,14,12,2,0
6,2008,520400,6,5,1,0
7,2008,520400,12,12,0,1
8,2008,520400,12,10,2,0
9,2008,520400,13,10,3,5
10,2008,520400,11,8,3,3
11,2008,520400,9,8,1,0
12,2008,520400,2,2,0,2
1,2009,520400,16,15,1,0
2,2009,520400,2,1,1,0
3,2009,520400,6,5,1,0
4,2009,520400,8,5,3,0
5,2009,520400,6,5,1,0
6,2009,520400,12,11,1,1
7,2009,520400,13,12,1,1
8,2009,520400,8,6,2,2
9,2009,520400,11,9,2,2
10,2009,520400,13,10,3,5
11,2009,520400,16,14,2,4
12,2009,520400,7,6,1,4
1,2010,520400,9,8,1,1
2,2010,520400,3,3,0,2
3,2010,520400,6,5,1,2
4,2010,520400,6,6,0,2
5,2010,520400,2,2,0,2
6,2010,520400,11,11,0,0
7,2010,520400,3,3,0,0
8,2010,520400,11,9,2,0
9,2010,520400,11,10,1,2
10,2010,520400,8,7,1,1
11,2010,520400,8,8,0,1
12,2010,520400,7,7,0,1
1,2011,520400,7,7,0,6
2,2011,520400,2,2,0,0
1,1999,720700,5,4,1,0
2,1999,720700,10,10,0,1
3,1999,720700,2,1,1,0
4,1999,720700,6,5,1,0
5,1999,720700,12,12,0,0
6,1999,720700,4,3,1,1
7,1999,720700,8,8,0,4
8,1999,720700,9,8,1,5
9,1999,720700,4,4,0,0
10,1999,720700,9,7,2,0
11,1999,720700,10,9,1,1
12,1999,720700,5,5,0,0
1,2000,720700,5,4,1,0
2,2000,720700,13,13,0,3
3,2000,720700,13,12,1,0
4,2000,720700,10,9,1,3
5,2000,720700,11,10,1,0
6,2000,720700,10,9,1,0
7,2000,720700,14,13,1,0
8,2000,720700,14,14,0,5
9,2000,720700,7,6,1,0
10,2000,720700,10,9,1,0
11,2000,720700,8,6,2,0
12,2000,720700,11,8,3,0
1,2001,720700,6,6,0,1
2,2001,720700,7,7,0,1
3,2001,720700,12,11,1,1
4,2001,720700,6,6,0,1
5,2001,720700,6,6,0,2
6,2001,720700,18,15,3,2
7,2001,720700,12,9,3,1
8,2001,720700,12,12,0,2
9,2001,720700,12,12,0,0
10,2001,720700,15,15,0,1
11,2001,720700,8,7,1,1
12,2001,720700,15,15,0,0
1,2002,720700,3,3,0,4
2,2002,720700,16,16,0,2
3,2002,720700,8,8,0,2
4,2002,720700,8,8,0,2
5,2002,720700,5,5,0,1
6,2002,720700,11,10,1,0
7,2002,720700,19,16,3,2
8,2002,720700,15,14,1,0
9,2002,720700,12,10,2,0
10,2002,720700,13,12,1,1
11,2002,720700,8,8,0,0
12,2002,720700,6,6,0,0
1,2003,720700,6,6,0,0
2,2003,720700,9,7,2,0
3,2003,720700,12,11,1,0
4,2003,720700,3,3,0,0
5,2003,720700,6,6,0,1
6,2003,720700,11,11,0,0
7,2003,720700,13,12,1,0
8,2003,720700,13,13,0,0
9,2003,720700,14,14,0,0
10,2003,720700,4,4,0,0
11,2003,720700,9,8,1,1
12,2003,720700,9,9,0,0
1,2004,720700,5,4,1,0
2,2004,720700,5,5,0,0
3,2004,720700,5,5,0,0
4,2004,720700,6,5,1,2
5,2004,720700,1,1,0,1
6,2004,720700,8,7,1,0
7,2004,720700,6,6,0,0
8,2004,720700,5,5,0,1
9,2004,720700,6,5,1,3
10,2004,720700,7,6,1,0
11,2004,720700,9,9,0,4
12,2004,720700,12,12,0,1
1,2005,720700,17,15,2,0
2,2005,720700,6,6,0,0
3,2005,720700,4,4,0,1
4,2005,720700,13,10,3,4
5,2005,720700,4,3,1,2
6,2005,720700,10,10,0,0
7,2005,720700,14,14,0,0
8,2005,720700,14,13,1,0
9,2005,720700,8,8,0,0
10,2005,720700,11,11,0,2
11,2005,720700,5,5,0,1
12,2005,720700,7,7,0,0
1,2006,720700,5,5,0,1
2,2006,720700,4,4,0,1
3,2006,720700,10,8,2,1
4,2006,720700,7,5,2,1
5,2006,720700,3,3,0,0
6,2006,720700,9,7,2,2
7,2006,720700,9,9,0,1
8,2006,720700,8,8,0,1
9,2006,720700,6,5,1,0
10,2006,720700,6,6,0,0
11,2006,720700,8,6,2,0
12,2006,720700,4,3,1,0
1,2007,720700,3,3,0,0
2,2007,720700,6,5,1,0
3,2007,720700,8,7,1,0
4,2007,720700,9,9,0,0
5,2007,720700,8,5,3,0
6,2007,720700,11,10,1,1
7,2007,720700,18,18,0,1
8,2007,720700,9,9,0,2
9,2007,720700,15,15,0,0
10,2007,720700,12,12,0,0
11,2007,720700,9,7,2,0
12,2007,720700,3,2,1,0
1,2008,720700,3,3,0,0
2,2008,720700,8,8,0,2
3,2008,720700,5,5,0,0
4,2008,720700,12,11,1,2
5,2008,720700,12,12,0,0
6,2008,720700,7,7,0,0
7,2008,720700,11,11,0,0
8,2008,720700,5,5,0,2
9,2008,720700,15,13,2,1
10,2008,720700,11,8,3,0
11,2008,720700,9,9,0,0
12,2008,720700,9,9,0,0
1,2009,720700,7,7,0,0
2,2009,720700,6,4,2,1
3,2009,720700,2,2,0,0
4,2009,720700,13,12,1,0
5,2009,720700,18,18,0,0
6,2009,720700,10,10,0,0
7,2009,720700,7,7,0,0
8,2009,720700,19,16,3,0
9,2009,720700,10,10,0,0
10,2009,720700,7,6,1,0
11,2009,720700,8,7,1,0
12,2009,720700,9,9,0,1
1,2010,720700,9,8,1,0
2,2010,720700,3,3,0,0
3,2010,720700,5,4,1,0
4,2010,720700,5,5,0,0
5,2010,720700,6,6,0,0
6,2010,720700,9,9,0,0
7,2010,720700,11,11,0,0
8,2010,720700,5,5,0,0
9,2010,720700,5,4,1,1
10,2010,720700,9,9,0,1
11,2010,720700,8,8,0,2
12,2010,720700,5,4,1,0
1,2011,720700,1,1,0,1
2,2011,720700,5,5,0,0
1,1999,730700,4,3,1,2
2,1999,730700,14,12,2,7
3,1999,730700,14,12,2,1
4,1999,730700,13,12,1,3
5,1999,730700,12,6,6,5
6,1999,730700,16,8,8,3
7,1999,730700,10,7,3,6
8,1999,730700,12,11,1,1
9,1999,730700,20,16,4,4
10,1999,730700,11,10,1,6
11,1999,730700,12,10,2,4
12,1999,730700,8,8,0,11
1,2000,730700,12,9,3,6
2,2000,730700,9,7,2,5
3,2000,730700,25,18,7,10
4,2000,730700,9,5,4,12
5,2000,730700,11,6,5,4
6,2000,730700,7,5,2,4
7,2000,730700,16,7,9,10
8,2000,730700,18,15,3,13
9,2000,730700,13,13,0,1
10,2000,730700,12,9,3,7
11,2000,730700,11,11,0,6
12,2000,730700,6,6,0,10
1,2001,730700,9,8,1,9
2,2001,730700,13,10,3,6
3,2001,730700,11,9,2,8
4,2001,730700,13,9,4,6
5,2001,730700,3,2,1,1
6,2001,730700,16,13,3,7
7,2001,730700,18,15,3,3
8,2001,730700,21,19,2,9
9,2001,730700,18,16,2,6
10,2001,730700,17,16,1,1
11,2001,730700,10,8,2,10
12,2001,730700,5,5,0,3
1,2002,730700,7,3,4,8
2,2002,730700,9,6,3,8
3,2002,730700,12,9,3,8
4,2002,730700,35,31,4,13
5,2002,730700,24,18,6,8
6,2002,730700,9,7,2,4
7,2002,730700,15,12,3,3
8,2002,730700,22,19,3,10
9,2002,730700,13,10,3,5
10,2002,730700,11,9,2,8
11,2002,730700,13,9,4,6
12,2002,730700,16,15,1,6
1,2003,730700,8,6,2,7
2,2003,730700,13,11,2,10
3,2003,730700,15,13,2,8
4,2003,730700,10,7,3,8
5,2003,730700,20,17,3,5
6,2003,730700,8,4,4,6
7,2003,730700,24,18,6,6
8,2003,730700,14,11,3,4
9,2003,730700,9,9,0,8
10,2003,730700,8,3,5,3
11,2003,730700,8,5,3,5
12,2003,730700,10,7,3,6
1,2004,730700,6,5,1,1
2,2004,730700,11,7,4,6
3,2004,730700,9,7,2,7
4,2004,730700,13,10,3,0
5,2004,730700,21,14,7,5
6,2004,730700,11,7,4,7
7,2004,730700,11,6,5,4
8,2004,730700,23,20,3,2
9,2004,730700,20,18,2,3
10,2004,730700,16,11,5,3
11,2004,730700,17,14,3,9
12,2004,730700,12,11,1,6
1,2005,730700,15,13,2,13
2,2005,730700,10,10,0,13
3,2005,730700,12,11,1,21
4,2005,730700,16,10,6,4
5,2005,730700,16,16,0,7
6,2005,730700,17,14,3,6
7,2005,730700,15,13,2,7
8,2005,730700,10,9,1,3
9,2005,730700,7,7,0,8
10,2005,730700,14,11,3,6
11,2005,730700,8,6,2,14
12,2005,730700,12,11,1,8
1,2006,730700,8,7,1,14
2,2006,730700,13,10,3,7
3,2006,730700,14,11,3,8
4,2006,730700,10,9,1,5
5,2006,730700,13,9,4,7
6,2006,730700,10,8,2,6
7,2006,730700,22,18,4,7
8,2006,730700,14,12,2,10
9,2006,730700,17,12,5,9
10,2006,730700,13,11,2,9
11,2006,730700,13,10,3,13
12,2006,730700,15,14,1,10
1,2007,730700,8,6,2,3
2,2007,730700,7,6,1,6
3,2007,730700,15,13,2,12
4,2007,730700,12,9,3,5
5,2007,730700,17,13,4,5
6,2007,730700,21,16,5,10
7,2007,730700,19,15,4,12
8,2007,730700,22,18,4,6
9,2007,730700,35,28,7,8
10,2007,730700,20,17,3,10
11,2007,730700,11,9,2,6
12,2007,730700,7,6,1,5
1,2008,730700,14,12,2,3
2,2008,730700,11,10,1,3
3,2008,730700,14,12,2,9
4,2008,730700,9,9,0,3
5,2008,730700,18,14,4,9
6,2008,730700,10,8,2,1
7,2008,730700,17,12,5,5
8,2008,730700,17,13,4,4
9,2008,730700,21,19,2,3
10,2008,730700,23,22,1,5
11,2008,730700,15,14,1,4
12,2008,730700,11,10,1,2
1,2009,730700,11,7,4,5
2,2009,730700,8,7,1,6
3,2009,730700,12,10,2,5
4,2009,730700,12,8,4,5
5,2009,730700,13,13,0,10
6,2009,730700,16,15,1,1
7,2009,730700,33,28,5,2
8,2009,730700,24,20,4,4
9,2009,730700,13,11,2,5
10,2009,730700,18,15,3,4
11,2009,730700,8,7,1,5
12,2009,730700,14,13,1,5
1,2010,730700,9,7,2,5
2,2010,730700,6,6,0,7
3,2010,730700,20,14,6,2
4,2010,730700,11,10,1,9
5,2010,730700,7,7,0,5
6,2010,730700,13,10,3,2
7,2010,730700,14,12,2,2
8,2010,730700,12,12,0,2
9,2010,730700,9,7,2,8
10,2010,730700,11,11,0,6
11,2010,730700,14,10,4,1
12,2010,730700,8,7,1,6
1,2011,730700,11,9,2,6
2,2011,730700,8,8,0,5
1,1999,520100,8,8,0,1
2,1999,520100,5,2,3,2
3,1999,520100,7,7,0,1
4,1999,520100,7,5,2,1
5,1999,520100,11,10,1,3
6,1999,520100,3,3,0,3
7,1999,520100,8,7,1,3
8,1999,520100,8,6,2,0
9,1999,520100,16,14,2,0
10,1999,520100,4,4,0,0
11,1999,520100,5,5,0,2
12,1999,520100,4,4,0,0
1,2000,520100,10,9,1,0
2,2000,520100,5,5,0,4
3,2000,520100,9,8,1,0
4,2000,520100,9,6,3,1
5,2000,520100,9,5,4,3
6,2000,520100,11,11,0,2
7,2000,520100,13,11,2,1
8,2000,520100,10,9,1,0
9,2000,520100,9,9,0,0
10,2000,520100,13,11,2,1
11,2000,520100,5,5,0,1
12,2000,520100,2,2,0,0
1,2001,520100,4,4,0,3
2,2001,520100,7,6,1,1
3,2001,520100,8,8,0,5
4,2001,520100,6,4,2,4
5,2001,520100,12,10,2,0
6,2001,520100,6,5,1,3
7,2001,520100,9,7,2,0
8,2001,520100,7,6,1,1
9,2001,520100,6,6,0,1
10,2001,520100,6,4,2,1
11,2001,520100,6,6,0,0
12,2001,520100,5,3,2,1
1,2002,520100,3,3,0,0
2,2002,520100,6,4,2,1
3,2002,520100,2,2,0,0
4,2002,520100,4,2,2,0
5,2002,520100,3,3,0,2
6,2002,520100,6,6,0,1
7,2002,520100,10,7,3,1
8,2002,520100,11,11,0,0
9,2002,520100,6,4,2,3
10,2002,520100,7,6,1,3
11,2002,520100,4,4,0,0
12,2002,520100,8,8,0,0
1,2003,520100,4,3,1,0
2,2003,520100,2,2,0,2
3,2003,520100,3,3,0,5
4,2003,520100,5,5,0,0
5,2003,520100,5,5,0,0
6,2003,520100,14,12,2,1
7,2003,520100,8,6,2,4
8,2003,520100,8,8,0,0
9,2003,520100,4,4,0,1
10,2003,520100,6,4,2,0
11,2003,520100,5,5,0,0
12,2003,520100,4,3,1,0
1,2004,520100,8,7,1,1
2,2004,520100,6,6,0,0
3,2004,520100,10,10,0,0
4,2004,520100,9,8,1,0
5,2004,520100,10,9,1,5
6,2004,520100,8,7,1,2
7,2004,520100,9,8,1,5
8,2004,520100,10,10,0,2
9,2004,520100,11,11,0,0
10,2004,520100,8,6,2,1
11,2004,520100,8,7,1,0
12,2004,520100,4,4,0,0
1,2005,520100,10,9,1,1
2,2005,520100,6,5,1,0
3,2005,520100,12,11,1,1
4,2005,520100,10,10,0,4
5,2005,520100,8,6,2,3
6,2005,520100,5,4,1,1
7,2005,520100,6,5,1,5
8,2005,520100,8,8,0,1
9,2005,520100,8,7,1,3
10,2005,520100,5,3,2,2
11,2005,520100,7,5,2,0
12,2005,520100,1,1,0,0
1,2006,520100,9,9,0,0
2,2006,520100,10,9,1,2
3,2006,520100,10,9,1,2
4,2006,520100,5,5,0,0
5,2006,520100,5,5,0,5
6,2006,520100,8,4,4,4
7,2006,520100,8,6,2,2
8,2006,520100,8,8,0,0
9,2006,520100,6,6,0,3
10,2006,520100,4,4,0,0
11,2006,520100,4,4,0,3
12,2006,520100,2,2,0,3
1,2007,520100,3,3,0,1
2,2007,520100,0,0,0,3
3,2007,520100,5,5,0,3
4,2007,520100,11,10,1,0
5,2007,520100,6,6,0,0
6,2007,520100,9,8,1,1
7,2007,520100,3,3,0,3
8,2007,520100,10,10,0,3
9,2007,520100,4,4,0,2
10,2007,520100,4,4,0,4
11,2007,520100,9,8,1,0
12,2007,520100,9,9,0,0
1,2008,520100,6,6,0,0
2,2008,520100,3,3,0,1
3,2008,520100,7,7,0,0
4,2008,520100,6,5,1,1
5,2008,520100,6,5,1,1
6,2008,520100,2,2,0,4
7,2008,520100,5,4,1,1
8,2008,520100,10,7,3,2
9,2008,520100,10,9,1,1
10,2008,520100,6,6,0,1
11,2008,520100,4,3,1,3
12,2008,520100,6,6,0,2
1,2009,520100,9,8,1,0
2,2009,520100,6,5,1,3
3,2009,520100,4,2,2,2
4,2009,520100,10,8,2,0
5,2009,520100,10,8,2,1
6,2009,520100,7,6,1,3
7,2009,520100,4,3,1,4
8,2009,520100,4,2,2,1
9,2009,520100,5,4,1,0
10,2009,520100,6,6,0,1
11,2009,520100,5,5,0,1
12,2009,520100,4,4,0,0
1,2010,520100,8,8,0,1
2,2010,520100,4,4,0,2
3,2010,520100,5,5,0,1
4,2010,520100,3,3,0,1
5,2010,520100,4,4,0,2
6,2010,520100,4,4,0,2
7,2010,520100,7,7,0,1
8,2010,520100,6,5,1,0
9,2010,520100,8,8,0,2
10,2010,520100,9,9,0,0
11,2010,520100,3,3,0,0
12,2010,520100,9,8,1,0
1,2011,520100,3,3,0,0
2,2011,520100,3,2,1,1
1,1999,520200,16,13,3,2
2,1999,520200,13,8,5,6
3,1999,520200,12,7,5,3
4,1999,520200,17,12,5,0
5,1999,520200,10,8,2,1
6,1999,520200,11,10,1,3
7,1999,520200,14,13,1,3
8,1999,520200,16,15,1,0
9,1999,520200,8,7,1,1
10,1999,520200,11,11,0,1
11,1999,520200,11,9,2,0
12,1999,520200,14,10,4,2
1,2000,520200,15,15,0,0
2,2000,520200,14,11,3,5
3,2000,520200,14,9,5,3
4,2000,520200,12,8,4,3
5,2000,520200,16,11,5,2
6,2000,520200,10,10,0,0
7,2000,520200,11,8,3,0
8,2000,520200,10,5,5,2
9,2000,520200,7,6,1,2
10,2000,520200,17,15,2,4
11,2000,520200,10,7,3,3
12,2000,520200,9,7,2,3
1,2001,520200,7,6,1,2
2,2001,520200,5,4,1,5
3,2001,520200,10,8,2,4
4,2001,520200,13,11,2,5
5,2001,520200,13,11,2,5
6,2001,520200,12,7,5,7
7,2001,520200,12,10,2,6
8,2001,520200,20,19,1,2
9,2001,520200,18,14,4,5
10,2001,520200,18,12,6,6
11,2001,520200,22,19,3,1
12,2001,520200,13,13,0,4
1,2002,520200,12,9,3,3
2,2002,520200,9,8,1,4
3,2002,520200,17,10,7,8
4,2002,520200,17,13,4,3
5,2002,520200,10,6,4,7
6,2002,520200,12,8,4,3
7,2002,520200,11,9,2,4
8,2002,520200,15,13,2,4
9,2002,520200,12,9,3,0
10,2002,520200,10,6,4,2
11,2002,520200,18,16,2,4
12,2002,520200,20,16,4,9
1,2003,520200,13,10,3,2
2,2003,520200,9,8,1,3
3,2003,520200,14,10,4,2
4,2003,520200,12,9,3,6
5,2003,520200,15,10,5,7
6,2003,520200,17,12,5,3
7,2003,520200,15,8,7,2
8,2003,520200,12,10,2,2
9,2003,520200,13,11,2,3
10,2003,520200,12,8,4,4
11,2003,520200,16,14,2,3
12,2003,520200,8,8,0,1
1,2004,520200,16,14,2,2
2,2004,520200,12,7,5,2
3,2004,520200,15,11,4,4
4,2004,520200,21,17,4,0
5,2004,520200,17,16,1,4
6,2004,520200,12,11,1,4
7,2004,520200,13,13,0,10
8,2004,520200,10,7,3,7
9,2004,520200,17,13,4,5
10,2004,520200,11,6,5,2
11,2004,520200,6,6,0,3
12,2004,520200,9,9,0,4
1,2005,520200,10,9,1,3
2,2005,520200,9,9,0,4
3,2005,520200,13,13,0,6
4,2005,520200,14,11,3,4
5,2005,520200,6,4,2,3
6,2005,520200,20,19,1,3
7,2005,520200,9,5,4,2
8,2005,520200,13,10,3,2
9,2005,520200,7,5,2,4
10,2005,520200,17,13,4,7
11,2005,520200,13,11,2,8
12,2005,520200,7,7,0,3
1,2006,520200,14,12,2,4
2,2006,520200,12,11,1,7
3,2006,520200,10,9,1,8
4,2006,520200,7,4,3,6
5,2006,520200,7,6,1,5
6,2006,520200,16,13,3,1
7,2006,520200,16,14,2,5
8,2006,520200,12,11,1,5
9,2006,520200,7,5,2,3
10,2006,520200,13,11,2,9
11,2006,520200,12,11,1,7
12,2006,520200,8,7,1,3
1,2007,520200,10,10,0,10
2,2007,520200,13,12,1,2
3,2007,520200,11,10,1,5
4,2007,520200,20,15,5,4
5,2007,520200,6,6,0,3
6,2007,520200,7,6,1,2
7,2007,520200,17,13,4,2
8,2007,520200,16,15,1,4
9,2007,520200,11,9,2,4
10,2007,520200,12,10,2,5
11,2007,520200,14,12,2,4
12,2007,520200,6,4,2,0
1,2008,520200,11,10,1,5
2,2008,520200,8,7,1,1
3,2008,520200,18,16,2,2
4,2008,520200,13,12,1,0
5,2008,520200,11,10,1,1
6,2008,520200,17,15,2,3
7,2008,520200,8,6,2,5
8,2008,520200,11,9,2,1
9,2008,520200,10,8,2,2
10,2008,520200,18,15,3,3
11,2008,520200,12,11,1,0
12,2008,520200,12,10,2,2
1,2009,520200,14,11,3,1
2,2009,520200,7,6,1,1
3,2009,520200,6,4,2,3
4,2009,520200,8,6,2,1
5,2009,520200,16,12,4,0
6,2009,520200,10,6,4,1
7,2009,520200,11,9,2,4
8,2009,520200,11,9,2,4
9,2009,520200,8,7,1,4
10,2009,520200,8,7,1,2
11,2009,520200,15,14,1,5
12,2009,520200,11,11,0,2
1,2010,520200,15,11,4,0
2,2010,520200,7,5,2,7
3,2010,520200,15,13,2,2
4,2010,520200,9,8,1,1
5,2010,520200,11,11,0,2
6,2010,520200,8,7,1,3
7,2010,520200,17,12,5,3
8,2010,520200,11,8,3,2
9,2010,520200,14,14,0,2
10,2010,520200,17,15,2,1
11,2010,520200,13,10,3,3
12,2010,520200,8,4,4,0
1,2011,520200,3,3,0,5
2,2011,520200,7,3,4,2
1,1999,510200,17,15,2,6
2,1999,510200,13,11,2,10
3,1999,510200,15,13,2,3
4,1999,510200,15,11,4,3
5,1999,510200,20,17,3,3
6,1999,510200,24,20,4,5
7,1999,510200,25,18,7,3
8,1999,510200,22,19,3,3
9,1999,510200,13,10,3,1
10,1999,510200,23,17,6,0
11,1999,510200,20,17,3,8
12,1999,510200,13,13,0,2
1,2000,510200,23,18,5,5
2,2000,510200,16,14,2,3
3,2000,510200,16,15,1,2
4,2000,510200,12,11,1,0
5,2000,510200,19,16,3,4
6,2000,510200,24,20,4,4
7,2000,510200,18,15,3,3
8,2000,510200,18,16,2,9
9,2000,510200,16,14,2,3
10,2000,510200,13,12,1,0
11,2000,510200,19,15,4,4
12,2000,510200,12,10,2,1
1,2001,510200,9,9,0,7
2,2001,510200,11,10,1,4
3,2001,510200,19,17,2,5
4,2001,510200,13,9,4,4
5,2001,510200,16,13,3,5
6,2001,510200,11,9,2,0
7,2001,510200,18,12,6,6
8,2001,510200,19,15,4,3
9,2001,510200,28,27,1,0
10,2001,510200,15,14,1,4
11,2001,510200,18,12,6,2
12,2001,510200,16,15,1,1
1,2002,510200,18,14,4,2
2,2002,510200,4,4,0,3
3,2002,510200,14,12,2,1
4,2002,510200,14,11,3,4
5,2002,510200,13,8,5,7
6,2002,510200,18,16,2,3
7,2002,510200,27,22,5,2
8,2002,510200,21,19,2,1
9,2002,510200,19,19,0,1
10,2002,510200,19,14,5,0
11,2002,510200,13,13,0,2
12,2002,510200,17,14,3,3
1,2003,510200,15,13,2,5
2,2003,510200,8,7,1,2
3,2003,510200,7,6,1,1
4,2003,510200,11,9,2,3
5,2003,510200,8,8,0,5
6,2003,510200,15,13,2,2
7,2003,510200,31,26,5,2
8,2003,510200,20,18,2,8
9,2003,510200,13,12,1,2
10,2003,510200,11,10,1,7
11,2003,510200,18,16,2,1
12,2003,510200,15,13,2,1
1,2004,510200,23,21,2,5
2,2004,510200,17,16,1,5
3,2004,510200,15,15,0,5
4,2004,510200,8,5,3,4
5,2004,510200,18,13,5,3
6,2004,510200,13,10,3,3
7,2004,510200,15,12,3,3
8,2004,510200,19,13,6,5
9,2004,510200,15,13,2,1
10,2004,510200,7,4,3,1
11,2004,510200,13,12,1,0
12,2004,510200,11,10,1,2
1,2005,510200,12,10,2,5
2,2005,510200,7,5,2,1
3,2005,510200,11,7,4,9
4,2005,510200,16,14,2,3
5,2005,510200,11,9,2,4
6,2005,510200,21,19,2,6
7,2005,510200,18,13,5,2
8,2005,510200,18,14,4,2
9,2005,510200,12,12,0,2
10,2005,510200,17,16,1,2
11,2005,510200,14,13,1,0
12,2005,510200,11,10,1,3
1,2006,510200,14,12,2,0
2,2006,510200,9,8,1,2
3,2006,510200,14,13,1,5
4,2006,510200,13,11,2,2
5,2006,510200,17,13,4,8
6,2006,510200,13,10,3,1
7,2006,510200,15,13,2,2
8,2006,510200,19,14,5,2
9,2006,510200,6,4,2,4
10,2006,510200,13,12,1,9
11,2006,510200,13,13,0,4
12,2006,510200,14,12,2,2
1,2007,510200,13,12,1,1
2,2007,510200,3,3,0,5
3,2007,510200,15,14,1,2
4,2007,510200,12,9,3,2
5,2007,510200,12,8,4,4
6,2007,510200,13,4,9,5
7,2007,510200,18,17,1,1
8,2007,510200,32,30,2,0
9,2007,510200,21,17,4,4
10,2007,510200,20,17,3,3
11,2007,510200,16,15,1,2
12,2007,510200,16,15,1,0
1,2008,510200,10,10,0,3
2,2008,510200,10,9,1,3
3,2008,510200,6,4,2,1
4,2008,510200,20,17,3,3
5,2008,510200,17,17,0,3
6,2008,510200,19,16,3,2
7,2008,510200,17,15,2,3
8,2008,510200,19,18,1,5
9,2008,510200,16,14,2,1
10,2008,510200,7,7,0,1
11,2008,510200,15,13,2,2
12,2008,510200,15,14,1,3
1,2009,510200,9,9,0,3
2,2009,510200,10,9,1,2
3,2009,510200,16,5,11,3
4,2009,510200,7,5,2,1
5,2009,510200,11,8,3,5
6,2009,510200,9,9,0,2
7,2009,510200,19,17,2,1
8,2009,510200,10,9,1,2
9,2009,510200,20,17,3,3
10,2009,510200,14,14,0,2
11,2009,510200,16,15,1,1
12,2009,510200,14,13,1,7
1,2010,510200,16,15,1,4
2,2010,510200,9,9,0,0
3,2010,510200,14,13,1,4
4,2010,510200,14,13,1,2
5,2010,510200,11,9,2,3
6,2010,510200,12,11,1,5
7,2010,510200,26,24,2,1
8,2010,510200,22,20,2,0
9,2010,510200,20,19,1,4
10,2010,510200,19,16,3,5
11,2010,510200,27,21,6,3
12,2010,510200,11,9,2,0
1,2011,510200,18,17,1,1
2,2011,510200,6,5,1,0
1,1999,510100,14,13,1,2
2,1999,510100,7,6,1,2
3,1999,510100,16,15,1,1
4,1999,510100,9,8,1,0
5,1999,510100,22,18,4,1
6,1999,510100,15,14,1,0
7,1999,510100,13,11,2,3
8,1999,510100,12,10,2,4
9,1999,510100,25,24,1,1
10,1999,510100,17,14,3,4
11,1999,510100,11,11,0,1
12,1999,510100,9,6,3,0
1,2000,510100,10,7,3,0
2,2000,510100,7,7,0,2
3,2000,510100,14,14,0,4
4,2000,510100,11,8,3,7
5,2000,510100,12,10,2,3
6,2000,510100,15,11,4,2
7,2000,510100,13,10,3,2
8,2000,510100,10,7,3,7
9,2000,510100,14,13,1,1
10,2000,510100,7,7,0,3
11,2000,510100,6,6,0,0
12,2000,510100,3,3,0,2
1,2001,510100,10,9,1,5
2,2001,510100,5,3,2,2
3,2001,510100,12,11,1,1
4,2001,510100,10,9,1,2
5,2001,510100,11,8,3,4
6,2001,510100,10,7,3,1
7,2001,510100,8,7,1,1
8,2001,510100,12,10,2,0
9,2001,510100,17,13,4,4
10,2001,510100,6,6,0,1
11,2001,510100,13,10,3,1
12,2001,510100,11,9,2,1
1,2002,510100,12,9,3,0
2,2002,510100,4,3,1,3
3,2002,510100,7,4,3,4
4,2002,510100,7,5,2,0
5,2002,510100,15,11,4,0
6,2002,510100,14,11,3,1
7,2002,510100,16,15,1,6
8,2002,510100,15,11,4,3
9,2002,510100,12,5,7,1
10,2002,510100,6,5,1,0
11,2002,510100,11,9,2,1
12,2002,510100,9,9,0,0
1,2003,510100,13,10,3,1
2,2003,510100,8,6,2,2
3,2003,510100,9,5,4,1
4,2003,510100,9,7,2,1
5,2003,510100,12,8,4,0
6,2003,510100,12,10,2,3
7,2003,510100,13,13,0,2
8,2003,510100,11,9,2,1
9,2003,510100,20,16,4,0
10,2003,510100,8,8,0,2
11,2003,510100,11,10,1,0
12,2003,510100,7,7,0,0
1,2004,510100,9,7,2,2
2,2004,510100,6,5,1,1
3,2004,510100,9,7,2,1
4,2004,510100,9,7,2,6
5,2004,510100,19,17,2,0
6,2004,510100,13,13,0,1
7,2004,510100,8,7,1,0
8,2004,510100,6,6,0,2
9,2004,510100,5,4,1,0
10,2004,510100,7,7,0,4
11,2004,510100,14,12,2,1
12,2004,510100,13,13,0,2
1,2005,510100,5,5,0,1
2,2005,510100,4,2,2,2
3,2005,510100,8,8,0,0
4,2005,510100,7,7,0,3
5,2005,510100,9,6,3,1
6,2005,510100,7,6,1,6
7,2005,510100,12,8,4,2
8,2005,510100,4,4,0,2
9,2005,510100,8,7,1,4
10,2005,510100,5,4,1,1
11,2005,510100,7,7,0,2
12,2005,510100,13,12,1,2
1,2006,510100,5,5,0,5
2,2006,510100,5,5,0,4
3,2006,510100,10,10,0,8
4,2006,510100,9,8,1,4
5,2006,510100,12,12,0,2
6,2006,510100,12,8,4,4
7,2006,510100,5,4,1,1
8,2006,510100,13,10,3,4
9,2006,510100,4,3,1,2
10,2006,510100,11,9,2,5
11,2006,510100,5,5,0,1
12,2006,510100,11,8,3,5
1,2007,510100,5,5,0,5
2,2007,510100,8,6,2,4
3,2007,510100,6,5,1,2
4,2007,510100,10,7,3,5
5,2007,510100,10,7,3,0
6,2007,510100,9,8,1,0
7,2007,510100,5,5,0,4
8,2007,510100,4,2,2,0
9,2007,510100,10,9,1,5
10,2007,510100,17,16,1,1
11,2007,510100,3,2,1,1
12,2007,510100,12,8,4,0
1,2008,510100,12,12,0,0
2,2008,510100,9,8,1,1
3,2008,510100,9,7,2,3
4,2008,510100,9,9,0,5
5,2008,510100,5,4,1,2
6,2008,510100,8,7,1,3
7,2008,510100,6,3,3,6
8,2008,510100,9,5,4,6
9,2008,510100,16,13,3,0
10,2008,510100,12,10,2,1
11,2008,510100,6,5,1,2
12,2008,510100,7,7,0,2
1,2009,510100,7,6,1,3
2,2009,510100,3,3,0,0
3,2009,510100,9,9,0,1
4,2009,510100,12,11,1,0
5,2009,510100,8,7,1,2
6,2009,510100,3,3,0,0
7,2009,510100,7,6,1,0
8,2009,510100,6,5,1,4
9,2009,510100,4,4,0,2
10,2009,510100,5,4,1,1
11,2009,510100,10,9,1,1
12,2009,510100,7,7,0,4
1,2010,510100,4,3,1,3
2,2010,510100,6,4,2,3
3,2010,510100,6,5,1,2
4,2010,510100,3,1,2,4
5,2010,510100,13,9,4,4
6,2010,510100,8,7,1,3
7,2010,510100,13,9,4,4
8,2010,510100,11,11,0,0
9,2010,510100,7,6,1,2
10,2010,510100,7,7,0,1
11,2010,510100,8,8,0,3
12,2010,510100,3,3,0,2
1,2011,510100,6,5,1,2
2,2011,510100,4,4,0,0
1,1999,720400,0,0,0,1
2,1999,720400,0,0,0,0
3,1999,720400,0,0,0,2
4,1999,720400,0,0,0,0
5,1999,720400,1,1,0,1
6,1999,720400,2,2,0,1
7,1999,720400,1,1,0,1
8,1999,720400,3,3,0,0
9,1999,720400,3,3,0,1
10,1999,720400,1,1,0,1
11,1999,720400,0,0,0,1
12,1999,720400,0,0,0,0
1,2000,720400,4,4,0,0
2,2000,720400,0,0,0,0
3,2000,720400,2,2,0,0
4,2000,720400,5,5,0,0
5,2000,720400,2,2,0,1
6,2000,720400,7,7,0,1
7,2000,720400,4,4,0,2
8,2000,720400,5,4,1,4
9,2000,720400,5,5,0,0
10,2000,720400,5,5,0,0
11,2000,720400,1,1,0,0
12,2000,720400,4,3,1,0
1,2001,720400,1,1,0,0
2,2001,720400,0,0,0,1
3,2001,720400,1,1,0,0
4,2001,720400,1,0,1,0
5,2001,720400,4,4,0,0
6,2001,720400,5,5,0,2
7,2001,720400,3,3,0,0
8,2001,720400,2,2,0,0
9,2001,720400,1,1,0,2
10,2001,720400,3,3,0,0
11,2001,720400,5,5,0,0
12,2001,720400,5,5,0,0
1,2002,720400,1,1,0,0
2,2002,720400,2,2,0,0
3,2002,720400,1,1,0,1
4,2002,720400,6,5,1,0
5,2002,720400,1,0,1,0
6,2002,720400,4,4,0,0
7,2002,720400,4,3,1,2
8,2002,720400,3,3,0,0
9,2002,720400,4,4,0,0
10,2002,720400,3,3,0,0
11,2002,720400,0,0,0,0
12,2002,720400,4,3,1,0
1,2003,720400,1,1,0,1
2,2003,720400,1,1,0,1
3,2003,720400,1,1,0,1
4,2003,720400,1,1,0,0
5,2003,720400,1,1,0,0
6,2003,720400,3,3,0,0
7,2003,720400,2,2,0,1
8,2003,720400,7,6,1,0
9,2003,720400,2,2,0,1
10,2003,720400,5,4,1,2
11,2003,720400,5,5,0,0
12,2003,720400,3,3,0,1
1,2004,720400,5,5,0,1
2,2004,720400,2,2,0,0
3,2004,720400,2,2,0,0
4,2004,720400,3,3,0,0
5,2004,720400,4,3,1,0
6,2004,720400,5,3,2,0
7,2004,720400,4,3,1,0
8,2004,720400,1,1,0,1
9,2004,720400,4,4,0,0
10,2004,720400,5,4,1,0
11,2004,720400,3,3,0,0
12,2004,720400,4,4,0,0
1,2005,720400,2,2,0,3
2,2005,720400,2,2,0,0
3,2005,720400,2,2,0,1
4,2005,720400,0,0,0,0
5,2005,720400,3,3,0,1
6,2005,720400,5,5,0,1
7,2005,720400,8,7,1,3
8,2005,720400,3,3,0,2
9,2005,720400,3,3,0,1
10,2005,720400,5,3,2,1
11,2005,720400,5,5,0,0
12,2005,720400,2,2,0,0
1,2006,720400,1,1,0,0
2,2006,720400,1,1,0,1
3,2006,720400,1,1,0,1
4,2006,720400,0,0,0,0
5,2006,720400,4,4,0,31
6,2006,720400,3,3,0,3
7,2006,720400,4,4,0,1
8,2006,720400,0,0,0,0
9,2006,720400,4,4,0,0
10,2006,720400,4,4,0,0
11,2006,720400,4,4,0,0
12,2006,720400,3,3,0,0
1,2007,720400,3,3,0,0
2,2007,720400,4,3,1,0
3,2007,720400,2,2,0,2
4,2007,720400,5,4,1,1
5,2007,720400,4,3,1,0
6,2007,720400,6,6,0,0
7,2007,720400,3,3,0,1
8,2007,720400,5,5,0,1
9,2007,720400,1,1,0,0
10,2007,720400,5,4,1,0
11,2007,720400,3,3,0,2
12,2007,720400,1,1,0,6
1,2008,720400,1,1,0,1
2,2008,720400,0,0,0,0
3,2008,720400,5,5,0,2
4,2008,720400,2,2,0,0
5,2008,720400,3,3,0,1
6,2008,720400,5,4,1,0
7,2008,720400,11,10,1,2
8,2008,720400,5,5,0,1
9,2008,720400,5,5,0,1
10,2008,720400,3,2,1,2
11,2008,720400,2,2,0,0
12,2008,720400,1,0,1,0
1,2009,720400,0,0,0,3
2,2009,720400,2,2,0,0
3,2009,720400,1,1,0,0
4,2009,720400,0,0,0,2
5,2009,720400,0,0,0,0
6,2009,720400,4,4,0,0
7,2009,720400,2,2,0,0
8,2009,720400,3,3,0,0
9,2009,720400,4,4,0,2
10,2009,720400,3,3,0,0
11,2009,720400,1,0,1,0
12,2009,720400,2,2,0,0
1,2010,720400,3,2,1,0
2,2010,720400,4,4,0,0
3,2010,720400,2,2,0,0
4,2010,720400,1,1,0,1
5,2010,720400,3,3,0,0
6,2010,720400,3,2,1,0
7,2010,720400,1,0,1,2
8,2010,720400,8,8,0,0
9,2010,720400,1,1,0,1
10,2010,720400,2,2,0,0
11,2010,720400,3,2,1,1
12,2010,720400,2,2,0,0
1,2011,720400,2,2,0,0
2,2011,720400,0,0,0,0
1,1999,720300,5,4,1,0
2,1999,720300,12,11,1,0
3,1999,720300,11,10,1,1
4,1999,720300,21,20,1,0
5,1999,720300,25,21,4,0
6,1999,720300,25,22,3,1
7,1999,720300,27,27,0,1
8,1999,720300,32,30,2,0
9,1999,720300,16,16,0,0
10,1999,720300,11,11,0,0
11,1999,720300,14,14,0,1
12,1999,720300,14,14,0,0
1,2000,720300,5,5,0,0
2,2000,720300,14,11,3,1
3,2000,720300,7,7,0,0
4,2000,720300,15,15,0,0
5,2000,720300,20,20,0,0
6,2000,720300,19,19,0,1
7,2000,720300,18,17,1,0
8,2000,720300,16,16,0,0
9,2000,720300,12,10,2,2
10,2000,720300,11,10,1,0
11,2000,720300,10,10,0,1
12,2000,720300,16,16,0,1
1,2001,720300,13,12,1,0
2,2001,720300,9,9,0,0
3,2001,720300,10,8,2,1
4,2001,720300,11,8,3,0
5,2001,720300,9,8,1,1
6,2001,720300,18,18,0,1
7,2001,720300,12,11,1,1
8,2001,720300,11,11,0,0
9,2001,720300,17,15,2,1
10,2001,720300,18,16,2,1
11,2001,720300,11,11,0,4
12,2001,720300,13,12,1,0
1,2002,720300,7,6,1,3
2,2002,720300,7,7,0,1
3,2002,720300,10,10,0,0
4,2002,720300,11,10,1,0
5,2002,720300,10,6,4,1
6,2002,720300,14,14,0,2
7,2002,720300,24,23,1,0
8,2002,720300,24,23,1,2
9,2002,720300,13,11,2,0
10,2002,720300,10,10,0,0
11,2002,720300,10,10,0,2
12,2002,720300,11,11,0,0
1,2003,720300,18,17,1,1
2,2003,720300,11,11,0,0
3,2003,720300,15,14,1,1
4,2003,720300,7,6,1,0
5,2003,720300,14,13,1,0
6,2003,720300,9,8,1,2
7,2003,720300,20,18,2,0
8,2003,720300,20,18,2,0
9,2003,720300,12,12,0,1
10,2003,720300,9,9,0,0
11,2003,720300,11,10,1,2
12,2003,720300,6,5,1,0
1,2004,720300,7,6,1,0
2,2004,720300,9,9,0,0
3,2004,720300,6,6,0,1
4,2004,720300,6,6,0,1
5,2004,720300,14,13,1,1
6,2004,720300,24,23,1,0
7,2004,720300,14,13,1,1
8,2004,720300,16,16,0,0
9,2004,720300,13,13,0,1
10,2004,720300,8,8,0,0
11,2004,720300,10,10,0,1
12,2004,720300,11,10,1,2
1,2005,720300,4,4,0,0
2,2005,720300,12,11,1,0
3,2005,720300,15,15,0,0
4,2005,720300,13,13,0,0
5,2005,720300,13,12,1,2
6,2005,720300,14,13,1,0
7,2005,720300,22,22,0,0
8,2005,720300,14,14,0,1
9,2005,720300,16,16,0,1
10,2005,720300,10,8,2,2
11,2005,720300,7,7,0,0
12,2005,720300,10,10,0,0
1,2006,720300,11,11,0,0
2,2006,720300,10,9,1,2
3,2006,720300,11,11,0,0
4,2006,720300,7,7,0,0
5,2006,720300,9,9,0,1
6,2006,720300,9,9,0,0
7,2006,720300,12,12,0,0
8,2006,720300,12,11,1,1
9,2006,720300,19,19,0,0
10,2006,720300,12,12,0,1
11,2006,720300,15,15,0,1
12,2006,720300,11,11,0,2
1,2007,720300,16,16,0,1
2,2007,720300,9,9,0,2
3,2007,720300,13,13,0,0
4,2007,720300,9,8,1,1
5,2007,720300,14,12,2,0
6,2007,720300,12,12,0,0
7,2007,720300,11,11,0,1
8,2007,720300,16,16,0,2
9,2007,720300,13,13,0,0
10,2007,720300,10,10,0,0
11,2007,720300,14,13,1,1
12,2007,720300,4,4,0,0
1,2008,720300,10,10,0,2
2,2008,720300,11,11,0,0
3,2008,720300,21,21,0,1
4,2008,720300,10,8,2,1
5,2008,720300,6,6,0,0
6,2008,720300,9,9,0,0
7,2008,720300,6,6,0,1
8,2008,720300,11,10,1,0
9,2008,720300,15,13,2,1
10,2008,720300,13,11,2,0
11,2008,720300,11,11,0,0
12,2008,720300,6,6,0,1
1,2009,720300,11,10,1,4
2,2009,720300,8,6,2,0
3,2009,720300,9,9,0,1
4,2009,720300,9,8,1,1
5,2009,720300,9,8,1,0
6,2009,720300,6,6,0,1
7,2009,720300,9,9,0,0
8,2009,720300,3,3,0,1
9,2009,720300,12,11,1,1
10,2009,720300,11,10,1,1
11,2009,720300,10,9,1,0
12,2009,720300,10,10,0,0
1,2010,720300,4,4,0,0
2,2010,720300,6,6,0,1
3,2010,720300,6,6,0,2
4,2010,720300,7,7,0,0
5,2010,720300,7,6,1,2
6,2010,720300,7,7,0,0
7,2010,720300,12,11,1,0
8,2010,720300,21,21,0,1
9,2010,720300,10,10,0,1
10,2010,720300,14,14,0,1
11,2010,720300,7,7,0,1
12,2010,720300,6,6,0,1
1,2011,720300,3,3,0,0
2,2011,720300,4,3,1,0
1,1999,720200,8,8,0,0
2,1999,720200,10,10,0,0
3,1999,720200,13,13,0,1
4,1999,720200,16,16,0,0
5,1999,720200,29,27,2,3
6,1999,720200,15,14,1,6
7,1999,720200,26,25,1,3
8,1999,720200,25,22,3,1
9,1999,720200,20,18,2,3
10,1999,720200,15,14,1,0
11,1999,720200,11,10,1,0
12,1999,720200,13,13,0,0
1,2000,720200,13,12,1,1
2,2000,720200,11,10,1,2
3,2000,720200,10,9,1,2
4,2000,720200,10,10,0,2
5,2000,720200,25,23,2,1
6,2000,720200,15,14,1,1
7,2000,720200,19,15,4,2
8,2000,720200,14,13,1,0
9,2000,720200,29,27,2,0
10,2000,720200,13,11,2,1
11,2000,720200,11,11,0,0
12,2000,720200,10,9,1,3
1,2001,720200,12,12,0,0
2,2001,720200,16,15,1,0
3,2001,720200,11,11,0,0
4,2001,720200,8,7,1,0
5,2001,720200,11,11,0,1
6,2001,720200,19,18,1,6
7,2001,720200,21,21,0,1
8,2001,720200,16,14,2,0
9,2001,720200,14,13,1,1
10,2001,720200,14,14,0,3
11,2001,720200,16,16,0,4
12,2001,720200,11,11,0,0
1,2002,720200,13,12,1,0
2,2002,720200,5,5,0,1
3,2002,720200,22,20,2,2
4,2002,720200,28,28,0,1
5,2002,720200,29,29,0,1
6,2002,720200,12,11,1,2
7,2002,720200,32,29,3,0
8,2002,720200,23,22,1,2
9,2002,720200,30,29,1,1
10,2002,720200,31,31,0,2
11,2002,720200,14,13,1,0
12,2002,720200,14,14,0,0
1,2003,720200,18,16,2,1
2,2003,720200,10,10,0,1
3,2003,720200,8,8,0,1
4,2003,720200,17,16,1,3
5,2003,720200,14,13,1,0
6,2003,720200,13,13,0,1
7,2003,720200,21,18,3,3
8,2003,720200,13,12,1,0
9,2003,720200,16,14,2,0
10,2003,720200,14,13,1,0
11,2003,720200,15,14,1,0
12,2003,720200,11,11,0,1
1,2004,720200,7,5,2,0
2,2004,720200,9,7,2,0
3,2004,720200,12,10,2,3
4,2004,720200,22,19,3,1
5,2004,720200,24,21,3,1
6,2004,720200,22,20,2,0
7,2004,720200,20,20,0,3
8,2004,720200,21,21,0,2
9,2004,720200,23,23,0,0
10,2004,720200,34,33,1,1
11,2004,720200,27,26,1,0
12,2004,720200,16,14,2,0
1,2005,720200,11,10,1,0
2,2005,720200,13,12,1,1
3,2005,720200,13,13,0,2
4,2005,720200,18,17,1,0
5,2005,720200,14,10,4,2
6,2005,720200,17,15,2,0
7,2005,720200,24,21,3,4
8,2005,720200,19,17,2,0
9,2005,720200,19,19,0,10
10,2005,720200,21,20,1,0
11,2005,720200,9,8,1,3
12,2005,720200,12,11,1,0
1,2006,720200,8,8,0,0
2,2006,720200,8,8,0,0
3,2006,720200,14,14,0,0
4,2006,720200,13,12,1,0
5,2006,720200,17,16,1,1
6,2006,720200,14,13,1,0
7,2006,720200,11,9,2,4
8,2006,720200,19,18,1,0
9,2006,720200,9,8,1,1
10,2006,720200,18,17,1,1
11,2006,720200,11,10,1,1
12,2006,720200,17,16,1,2
1,2007,720200,19,16,3,2
2,2007,720200,7,7,0,1
3,2007,720200,11,11,0,0
4,2007,720200,9,8,1,1
5,2007,720200,12,12,0,2
6,2007,720200,28,25,3,0
7,2007,720200,15,13,2,2
8,2007,720200,20,18,2,0
9,2007,720200,17,17,0,0
10,2007,720200,13,13,0,3
11,2007,720200,9,9,0,0
12,2007,720200,11,11,0,1
1,2008,720200,12,12,0,0
2,2008,720200,6,6,0,3
3,2008,720200,11,11,0,1
4,2008,720200,16,16,0,0
5,2008,720200,13,12,1,2
6,2008,720200,17,15,2,0
7,2008,720200,14,13,1,0
8,2008,720200,26,22,4,1
9,2008,720200,19,17,2,3
10,2008,720200,22,20,2,2
11,2008,720200,26,26,0,0
12,2008,720200,18,18,0,0
1,2009,720200,11,11,0,1
2,2009,720200,12,11,1,0
3,2009,720200,18,16,2,0
4,2009,720200,7,7,0,0
5,2009,720200,16,16,0,0
6,2009,720200,15,14,1,0
7,2009,720200,20,20,0,0
8,2009,720200,14,13,1,0
9,2009,720200,11,9,2,2
10,2009,720200,14,13,1,0
11,2009,720200,8,7,1,1
12,2009,720200,10,8,2,2
1,2010,720200,8,6,2,2
2,2010,720200,11,11,0,1
3,2010,720200,13,12,1,1
4,2010,720200,7,7,0,2
5,2010,720200,5,4,1,2
6,2010,720200,15,13,2,1
7,2010,720200,15,14,1,2
8,2010,720200,13,12,1,0
9,2010,720200,12,12,0,1
10,2010,720200,13,12,1,0
11,2010,720200,15,14,1,0
12,2010,720200,12,12,0,0
1,2011,720200,7,7,0,0
2,2011,720200,6,6,0,0
1,1999,730600,13,11,2,4
2,1999,730600,13,10,3,7
3,1999,730600,15,9,6,8
4,1999,730600,15,13,2,6
5,1999,730600,23,16,7,2
6,1999,730600,26,20,6,3
7,1999,730600,14,10,4,5
8,1999,730600,22,19,3,1
9,1999,730600,22,21,1,8
10,1999,730600,11,9,2,4
11,1999,730600,17,15,2,3
12,1999,730600,18,17,1,3
1,2000,730600,16,12,4,7
2,2000,730600,5,3,2,8
3,2000,730600,11,8,3,6
4,2000,730600,14,12,2,8
5,2000,730600,15,11,4,8
6,2000,730600,24,19,5,0
7,2000,730600,12,10,2,5
8,2000,730600,22,18,4,6
9,2000,730600,16,15,1,7
10,2000,730600,17,14,3,8
11,2000,730600,16,13,3,8
12,2000,730600,15,12,3,3
1,2001,730600,17,15,2,3
2,2001,730600,13,9,4,6
3,2001,730600,13,11,2,8
4,2001,730600,14,12,2,4
5,2001,730600,10,9,1,4
6,2001,730600,14,11,3,4
7,2001,730600,24,17,7,8
8,2001,730600,15,11,4,6
9,2001,730600,13,12,1,6
10,2001,730600,19,18,1,2
11,2001,730600,25,18,7,5
12,2001,730600,17,17,0,2
1,2002,730600,10,9,1,4
2,2002,730600,15,13,2,16
3,2002,730600,13,11,2,3
4,2002,730600,20,20,0,9
5,2002,730600,24,19,5,8
6,2002,730600,22,19,3,15
7,2002,730600,20,14,6,7
8,2002,730600,16,12,4,10
9,2002,730600,23,18,5,18
10,2002,730600,25,19,6,7
11,2002,730600,19,18,1,5
12,2002,730600,15,13,2,4
1,2003,730600,15,13,2,9
2,2003,730600,19,14,5,5
3,2003,730600,14,13,1,11
4,2003,730600,12,11,1,6
5,2003,730600,15,12,3,6
6,2003,730600,14,12,2,2
7,2003,730600,22,17,5,6
8,2003,730600,16,11,5,4
9,2003,730600,17,12,5,7
10,2003,730600,13,10,3,11
11,2003,730600,21,18,3,15
12,2003,730600,17,15,2,4
1,2004,730600,16,13,3,2
2,2004,730600,18,17,1,10
3,2004,730600,17,12,5,8
4,2004,730600,10,8,2,4
5,2004,730600,16,15,1,3
6,2004,730600,26,21,5,7
7,2004,730600,19,18,1,9
8,2004,730600,16,15,1,8
9,2004,730600,18,17,1,12
10,2004,730600,18,16,2,7
11,2004,730600,16,13,3,11
12,2004,730600,19,16,3,4
1,2005,730600,8,8,0,4
2,2005,730600,20,20,0,5
3,2005,730600,19,17,2,5
4,2005,730600,22,20,2,7
5,2005,730600,20,17,3,5
6,2005,730600,14,12,2,16
7,2005,730600,10,9,1,13
8,2005,730600,13,12,1,7
9,2005,730600,16,16,0,7
10,2005,730600,24,20,4,17
11,2005,730600,20,18,2,23
12,2005,730600,17,17,0,11
1,2006,730600,16,11,5,23
2,2006,730600,11,9,2,26
3,2006,730600,23,21,2,12
4,2006,730600,14,13,1,3
5,2006,730600,20,18,2,7
6,2006,730600,13,7,6,10
7,2006,730600,22,17,5,19
8,2006,730600,13,12,1,5
9,2006,730600,28,23,5,8
10,2006,730600,22,19,3,12
11,2006,730600,22,19,3,5
12,2006,730600,17,14,3,8
1,2007,730600,19,15,4,14
2,2007,730600,8,8,0,8
3,2007,730600,18,15,3,7
4,2007,730600,14,13,1,5
5,2007,730600,15,13,2,9
6,2007,730600,21,17,4,6
7,2007,730600,14,12,2,4
8,2007,730600,19,16,3,3
9,2007,730600,15,13,2,8
10,2007,730600,33,29,4,4
11,2007,730600,9,7,2,4
12,2007,730600,22,20,2,8
1,2008,730600,14,12,2,6
2,2008,730600,16,16,0,7
3,2008,730600,18,18,0,4
4,2008,730600,15,15,0,4
5,2008,730600,12,11,1,6
6,2008,730600,21,15,6,2
7,2008,730600,18,14,4,4
8,2008,730600,20,19,1,3
9,2008,730600,29,26,3,3
10,2008,730600,31,24,7,3
11,2008,730600,20,16,4,5
12,2008,730600,21,18,3,10
1,2009,730600,19,17,2,4
2,2009,730600,23,21,2,5
3,2009,730600,16,15,1,4
4,2009,730600,22,19,3,3
5,2009,730600,16,13,3,8
6,2009,730600,18,14,4,1
7,2009,730600,13,13,0,3
8,2009,730600,13,11,2,3
9,2009,730600,10,9,1,4
10,2009,730600,18,15,3,3
11,2009,730600,9,7,2,4
12,2009,730600,10,10,0,5
1,2010,730600,12,12,0,3
2,2010,730600,19,16,3,9
3,2010,730600,18,13,5,7
4,2010,730600,23,21,2,8
5,2010,730600,20,17,3,6
6,2010,730600,16,14,2,7
7,2010,730600,10,6,4,4
8,2010,730600,16,14,2,3
9,2010,730600,15,13,2,5
10,2010,730600,17,13,4,8
11,2010,730600,16,16,0,4
12,2010,730600,16,14,2,6
1,2011,730600,7,6,1,3
2,2011,730600,12,12,0,4
1,1999,730500,31,26,5,8
2,1999,730500,21,18,3,5
3,1999,730500,31,28,3,5
4,1999,730500,40,31,9,5
5,1999,730500,30,26,4,3
6,1999,730500,32,21,11,5
7,1999,730500,50,36,14,5
8,1999,730500,37,34,3,11
9,1999,730500,35,31,4,13
10,1999,730500,24,23,1,11
11,1999,730500,32,29,3,9
12,1999,730500,34,25,9,17
1,2000,730500,22,20,2,6
2,2000,730500,17,16,1,20
3,2000,730500,28,23,5,16
4,2000,730500,21,18,3,23
5,2000,730500,31,26,5,9
6,2000,730500,33,26,7,5
7,2000,730500,29,27,2,8
8,2000,730500,48,43,5,8
9,2000,730500,35,31,4,6
10,2000,730500,35,32,3,12
11,2000,730500,38,33,5,15
12,2000,730500,23,20,3,6
1,2001,730500,26,24,2,12
2,2001,730500,22,21,1,19
3,2001,730500,23,19,4,13
4,2001,730500,20,15,5,1
5,2001,730500,36,31,5,4
6,2001,730500,17,12,5,7
7,2001,730500,41,34,7,4
8,2001,730500,32,25,7,9
9,2001,730500,38,32,6,11
10,2001,730500,31,29,2,19
11,2001,730500,37,31,6,10
12,2001,730500,38,34,4,11
1,2002,730500,33,28,5,27
2,2002,730500,21,19,2,24
3,2002,730500,33,28,5,17
4,2002,730500,32,29,3,11
5,2002,730500,37,29,8,14
6,2002,730500,33,28,5,16
7,2002,730500,32,25,7,20
8,2002,730500,38,34,4,13
9,2002,730500,31,28,3,6
10,2002,730500,42,39,3,17
11,2002,730500,23,20,3,22
12,2002,730500,39,36,3,13
1,2003,730500,29,28,1,16
2,2003,730500,19,15,4,18
3,2003,730500,20,16,4,5
4,2003,730500,24,17,7,13
5,2003,730500,37,32,5,17
6,2003,730500,34,30,4,7
7,2003,730500,34,27,7,5
8,2003,730500,41,35,6,8
9,2003,730500,35,30,5,9
10,2003,730500,36,33,3,6
11,2003,730500,26,23,3,10
12,2003,730500,27,22,5,7
1,2004,730500,28,25,3,10
2,2004,730500,21,18,3,12
3,2004,730500,38,35,3,7
4,2004,730500,34,30,4,4
5,2004,730500,32,24,8,8
6,2004,730500,30,20,10,10
7,2004,730500,49,43,6,8
8,2004,730500,52,42,10,2
9,2004,730500,39,37,2,7
10,2004,730500,33,30,3,5
11,2004,730500,38,35,3,8
12,2004,730500,28,28,0,6
1,2005,730500,25,23,2,11
2,2005,730500,21,19,2,8
3,2005,730500,51,47,4,6
4,2005,730500,42,34,8,15
5,2005,730500,43,38,5,10
6,2005,730500,39,37,2,4
7,2005,730500,40,30,10,9
8,2005,730500,26,24,2,15
9,2005,730500,29,26,3,1
10,2005,730500,28,20,8,11
11,2005,730500,30,29,1,6
12,2005,730500,25,22,3,5
1,2006,730500,36,36,0,8
2,2006,730500,31,29,2,14
3,2006,730500,26,24,2,7
4,2006,730500,42,39,3,8
5,2006,730500,31,28,3,5
6,2006,730500,38,31,7,6
7,2006,730500,45,40,5,8
8,2006,730500,28,24,4,16
9,2006,730500,32,29,3,12
10,2006,730500,36,34,2,15
11,2006,730500,27,22,5,11
12,2006,730500,37,32,5,5
1,2007,730500,26,24,2,15
2,2007,730500,12,11,1,5
3,2007,730500,27,23,4,9
4,2007,730500,30,27,3,6
5,2007,730500,36,26,10,8
6,2007,730500,35,30,5,3
7,2007,730500,39,34,5,7
8,2007,730500,37,33,4,8
9,2007,730500,31,29,2,4
10,2007,730500,41,36,5,7
11,2007,730500,26,25,1,7
12,2007,730500,28,23,5,5
1,2008,730500,36,27,9,6
2,2008,730500,18,17,1,11
3,2008,730500,40,35,5,8
4,2008,730500,24,23,1,2
5,2008,730500,54,51,3,4
6,2008,730500,31,27,4,3
7,2008,730500,46,38,8,7
8,2008,730500,31,27,4,7
9,2008,730500,33,28,5,6
10,2008,730500,31,27,4,10
11,2008,730500,24,22,2,4
12,2008,730500,23,21,2,2
1,2009,730500,16,14,2,9
2,2009,730500,16,15,1,7
3,2009,730500,31,28,3,4
4,2009,730500,21,19,2,1
5,2009,730500,25,20,5,5
6,2009,730500,26,21,5,1
7,2009,730500,39,34,5,3
8,2009,730500,27,24,3,7
9,2009,730500,37,33,4,3
10,2009,730500,39,36,3,2
11,2009,730500,19,17,2,6
12,2009,730500,28,25,3,10
1,2010,730500,11,10,1,10
2,2010,730500,18,16,2,11
3,2010,730500,25,22,3,7
4,2010,730500,26,26,0,7
5,2010,730500,34,32,2,10
6,2010,730500,34,31,3,7
7,2010,730500,30,28,2,5
8,2010,730500,29,28,1,5
9,2010,730500,40,36,4,8
10,2010,730500,36,31,5,6
11,2010,730500,23,21,2,6
12,2010,730500,26,24,2,5
1,2011,730500,34,34,0,7
2,2011,730500,12,12,0,3
1,1999,490700,17,12,5,5
2,1999,490700,20,17,3,4
3,1999,490700,18,15,3,11
4,1999,490700,30,25,5,11
5,1999,490700,21,13,8,1
6,1999,490700,22,17,5,7
7,1999,490700,26,20,6,5
8,1999,490700,28,19,9,4
9,1999,490700,16,15,1,5
10,1999,490700,32,27,5,8
11,1999,490700,30,25,5,8
12,1999,490700,19,13,6,4
1,2000,490700,16,10,6,6
2,2000,490700,31,24,7,7
3,2000,490700,21,18,3,2
4,2000,490700,22,16,6,11
5,2000,490700,26,22,4,9
6,2000,490700,16,13,3,5
7,2000,490700,19,13,6,9
8,2000,490700,19,14,5,7
9,2000,490700,20,16,4,5
10,2000,490700,16,12,4,16
11,2000,490700,16,13,3,5
12,2000,490700,17,11,6,3
1,2001,490700,20,13,7,5
2,2001,490700,8,6,2,3
3,2001,490700,14,12,2,5
4,2001,490700,16,11,5,6
5,2001,490700,18,10,8,3
6,2001,490700,17,13,4,4
7,2001,490700,26,18,8,4
8,2001,490700,27,15,12,9
9,2001,490700,15,10,5,3
10,2001,490700,17,15,2,12
11,2001,490700,24,18,6,6
12,2001,490700,23,21,2,7
1,2002,490700,19,11,8,13
2,2002,490700,18,12,6,9
3,2002,490700,17,14,3,3
4,2002,490700,15,11,4,11
5,2002,490700,20,13,7,9
6,2002,490700,26,21,5,6
7,2002,490700,28,21,7,4
8,2002,490700,29,25,4,9
9,2002,490700,20,16,4,4
10,2002,490700,16,10,6,4
11,2002,490700,19,17,2,7
12,2002,490700,13,10,3,12
1,2003,490700,11,9,2,10
2,2003,490700,3,2,1,11
3,2003,490700,14,7,7,5
4,2003,490700,16,12,4,3
5,2003,490700,21,13,8,7
6,2003,490700,27,20,7,5
7,2003,490700,23,13,10,8
8,2003,490700,21,16,5,8
9,2003,490700,18,14,4,4
10,2003,490700,14,8,6,12
11,2003,490700,19,14,5,17
12,2003,490700,22,17,5,29
1,2004,490700,10,8,2,15
2,2004,490700,10,10,0,14
3,2004,490700,18,15,3,20
4,2004,490700,14,11,3,18
5,2004,490700,22,15,7,18
6,2004,490700,25,19,6,13
7,2004,490700,28,15,13,11
8,2004,490700,18,16,2,13
9,2004,490700,16,11,5,13
10,2004,490700,17,15,2,10
11,2004,490700,11,9,2,10
12,2004,490700,13,12,1,17
1,2005,490700,6,5,1,4
2,2005,490700,12,9,3,12
3,2005,490700,20,15,5,7
4,2005,490700,9,5,4,9
5,2005,490700,13,12,1,4
6,2005,490700,17,12,5,10
7,2005,490700,17,13,4,5
8,2005,490700,22,19,3,9
9,2005,490700,7,6,1,6
10,2005,490700,16,10,6,15
11,2005,490700,13,10,3,12
12,2005,490700,15,12,3,9
1,2006,490700,9,8,1,19
2,2006,490700,10,8,2,13
3,2006,490700,20,19,1,8
4,2006,490700,13,12,1,10
5,2006,490700,14,10,4,5
6,2006,490700,27,20,7,20
7,2006,490700,22,20,2,4
8,2006,490700,14,10,4,12
9,2006,490700,14,11,3,7
10,2006,490700,17,15,2,11
11,2006,490700,13,10,3,6
12,2006,490700,11,8,3,12
1,2007,490700,10,9,1,14
2,2007,490700,10,8,2,14
3,2007,490700,12,9,3,24
4,2007,490700,14,11,3,11
5,2007,490700,12,12,0,7
6,2007,490700,25,19,6,11
7,2007,490700,37,33,4,4
8,2007,490700,35,32,3,18
9,2007,490700,36,30,6,9
10,2007,490700,35,28,7,11
11,2007,490700,22,20,2,12
12,2007,490700,23,21,2,9
1,2008,490700,18,15,3,9
2,2008,490700,27,25,2,10
3,2008,490700,14,11,3,12
4,2008,490700,19,13,6,6
5,2008,490700,30,25,5,5
6,2008,490700,16,10,6,6
7,2008,490700,23,18,5,5
8,2008,490700,18,13,5,7
9,2008,490700,19,16,3,9
10,2008,490700,25,20,5,16
11,2008,490700,13,9,4,20
12,2008,490700,22,21,1,13
1,2009,490700,18,15,3,14
2,2009,490700,8,5,3,9
3,2009,490700,17,13,4,11
4,2009,490700,17,11,6,9
5,2009,490700,18,15,3,13
6,2009,490700,10,4,6,8
7,2009,490700,24,22,2,9
8,2009,490700,26,21,5,10
9,2009,490700,23,21,2,12
10,2009,490700,17,14,3,15
11,2009,490700,13,10,3,9
12,2009,490700,11,10,1,10
1,2010,490700,12,11,1,14
2,2010,490700,14,12,2,9
3,2010,490700,21,13,8,17
4,2010,490700,18,14,4,13
5,2010,490700,18,15,3,5
6,2010,490700,10,6,4,12
7,2010,490700,9,8,1,6
8,2010,490700,21,16,5,8
9,2010,490700,17,12,5,15
10,2010,490700,17,15,2,6
11,2010,490700,11,8,3,11
12,2010,490700,22,19,3,7
1,2011,490700,20,16,4,11
2,2011,490700,7,7,0,10
1,1999,490800,36,25,11,2
2,1999,490800,27,27,0,8
3,1999,490800,28,21,7,13
4,1999,490800,31,17,14,7
5,1999,490800,37,27,10,3
6,1999,490800,28,24,4,13
7,1999,490800,39,32,7,4
8,1999,490800,26,20,6,10
9,1999,490800,52,43,9,11
10,1999,490800,39,32,7,8
11,1999,490800,23,18,5,7
12,1999,490800,32,26,6,6
1,2000,490800,34,30,4,4
2,2000,490800,21,17,4,6
3,2000,490800,38,33,5,9
4,2000,490800,30,25,5,4
5,2000,490800,45,39,6,4
6,2000,490800,40,37,3,7
7,2000,490800,51,42,9,6
8,2000,490800,40,34,6,4
9,2000,490800,36,30,6,1
10,2000,490800,38,34,4,7
11,2000,490800,42,39,3,2
12,2000,490800,31,28,3,2
1,2001,490800,34,29,5,1
2,2001,490800,34,26,8,3
3,2001,490800,38,34,4,6
4,2001,490800,42,37,5,3
5,2001,490800,22,17,5,2
6,2001,490800,44,35,9,3
7,2001,490800,37,33,4,5
8,2001,490800,52,47,5,2
9,2001,490800,53,43,10,4
10,2001,490800,30,28,2,5
11,2001,490800,24,18,6,8
12,2001,490800,28,24,4,5
1,2002,490800,34,31,3,4
2,2002,490800,28,26,2,11
3,2002,490800,24,18,6,9
4,2002,490800,29,23,6,3
5,2002,490800,25,19,6,11
6,2002,490800,28,17,11,8
7,2002,490800,32,29,3,4
8,2002,490800,38,32,6,6
9,2002,490800,24,17,7,0
10,2002,490800,34,29,5,5
11,2002,490800,22,20,2,1
12,2002,490800,30,27,3,9
1,2003,490800,27,23,4,4
2,2003,490800,24,23,1,9
3,2003,490800,23,20,3,2
4,2003,490800,26,20,6,5
5,2003,490800,29,26,3,1
6,2003,490800,30,29,1,1
7,2003,490800,38,31,7,3
8,2003,490800,31,24,7,4
9,2003,490800,32,22,10,5
10,2003,490800,26,23,3,4
11,2003,490800,37,30,7,7
12,2003,490800,24,20,4,12
1,2004,490800,27,25,2,8
2,2004,490800,21,19,2,12
3,2004,490800,41,33,8,9
4,2004,490800,30,20,10,8
5,2004,490800,30,21,9,10
6,2004,490800,24,19,5,11
7,2004,490800,25,18,7,10
8,2004,490800,27,25,2,5
9,2004,490800,31,30,1,11
10,2004,490800,32,28,4,15
11,2004,490800,21,18,3,12
12,2004,490800,16,13,3,5
1,2005,490800,19,16,3,5
2,2005,490800,21,17,4,15
3,2005,490800,18,17,1,11
4,2005,490800,26,23,3,12
5,2005,490800,37,29,8,9
6,2005,490800,45,42,3,9
7,2005,490800,34,29,5,9
8,2005,490800,31,28,3,2
9,2005,490800,20,17,3,7
10,2005,490800,35,27,8,10
11,2005,490800,31,29,2,13
12,2005,490800,27,24,3,13
1,2006,490800,24,23,1,9
2,2006,490800,16,13,3,13
3,2006,490800,26,22,4,11
4,2006,490800,26,22,4,13
5,2006,490800,29,23,6,16
6,2006,490800,41,34,7,9
7,2006,490800,38,30,8,9
8,2006,490800,26,24,2,7
9,2006,490800,29,26,3,20
10,2006,490800,38,31,7,10
11,2006,490800,35,34,1,17
12,2006,490800,30,27,3,11
1,2007,490800,30,26,4,13
2,2007,490800,20,17,3,10
3,2007,490800,22,20,2,7
4,2007,490800,27,25,2,18
5,2007,490800,33,24,9,13
6,2007,490800,44,36,8,25
7,2007,490800,30,25,5,20
8,2007,490800,36,33,3,18
9,2007,490800,32,27,5,19
10,2007,490800,26,19,7,16
11,2007,490800,26,23,3,12
12,2007,490800,21,20,1,13
1,2008,490800,28,24,4,13
2,2008,490800,19,18,1,9
3,2008,490800,32,29,3,7
4,2008,490800,31,26,5,9
5,2008,490800,46,40,6,7
6,2008,490800,32,25,7,11
7,2008,490800,42,34,8,21
8,2008,490800,39,33,6,11
9,2008,490800,34,33,1,11
10,2008,490800,31,28,3,9
11,2008,490800,25,24,1,12
12,2008,490800,30,27,3,15
1,2009,490800,31,26,5,13
2,2009,490800,28,23,5,16
3,2009,490800,41,38,3,9
4,2009,490800,30,27,3,5
5,2009,490800,28,22,6,8
6,2009,490800,35,31,4,7
7,2009,490800,52,47,5,15
8,2009,490800,48,45,3,7
9,2009,490800,37,33,4,6
10,2009,490800,33,29,4,10
11,2009,490800,26,21,5,10
12,2009,490800,30,30,0,3
1,2010,490800,27,24,3,16
2,2010,490800,35,31,4,13
3,2010,490800,17,16,1,18
4,2010,490800,41,38,3,8
5,2010,490800,32,29,3,8
6,2010,490800,36,28,8,7
7,2010,490800,34,30,4,9
8,2010,490800,30,27,3,7
9,2010,490800,28,20,8,13
10,2010,490800,30,26,4,11
11,2010,490800,26,22,4,12
12,2010,490800,27,27,0,11
1,2011,490800,26,25,1,16
2,2011,490800,15,14,1,4
1,1999,500100,25,20,5,4
2,1999,500100,28,25,3,3
3,1999,500100,27,22,5,5
4,1999,500100,24,19,5,5
5,1999,500100,31,25,6,4
6,1999,500100,23,21,2,1
7,1999,500100,34,27,7,0
8,1999,500100,25,24,1,1
9,1999,500100,24,22,2,4
10,1999,500100,28,24,4,4
11,1999,500100,21,16,5,4
12,1999,500100,30,27,3,1
1,2000,500100,24,23,1,0
2,2000,500100,37,32,5,5
3,2000,500100,33,29,4,4
4,2000,500100,25,22,3,1
5,2000,500100,24,20,4,4
6,2000,500100,28,25,3,1
7,2000,500100,25,20,5,2
8,2000,500100,34,32,2,1
9,2000,500100,33,29,4,7
10,2000,500100,29,22,7,7
11,2000,500100,19,14,5,4
12,2000,500100,25,21,4,3
1,2001,500100,28,20,8,0
2,2001,500100,19,19,0,2
3,2001,500100,26,21,5,3
4,2001,500100,35,33,2,2
5,2001,500100,28,22,6,2
6,2001,500100,16,14,2,2
7,2001,500100,32,23,9,0
8,2001,500100,25,22,3,0
9,2001,500100,42,35,7,3
10,2001,500100,32,29,3,4
11,2001,500100,33,25,8,3
12,2001,500100,20,17,3,1
1,2002,500100,36,31,5,3
2,2002,500100,26,25,1,3
3,2002,500100,21,17,4,4
4,2002,500100,26,18,8,6
5,2002,500100,27,23,4,4
6,2002,500100,33,29,4,1
7,2002,500100,33,28,5,3
8,2002,500100,33,29,4,4
9,2002,500100,37,32,5,6
10,2002,500100,31,26,5,0
11,2002,500100,44,34,10,1
12,2002,500100,20,17,3,3
1,2003,500100,32,27,5,2
2,2003,500100,33,27,6,4
3,2003,500100,37,33,4,3
4,2003,500100,32,27,5,3
5,2003,500100,32,28,4,3
6,2003,500100,23,20,3,1
7,2003,500100,32,31,1,2
8,2003,500100,30,27,3,2
9,2003,500100,47,42,5,3
10,2003,500100,43,34,9,7
11,2003,500100,30,22,8,2
12,2003,500100,32,28,4,2
1,2004,500100,28,25,3,2
2,2004,500100,28,26,2,2
3,2004,500100,40,36,4,10
4,2004,500100,24,22,2,7
5,2004,500100,24,20,4,3
6,2004,500100,32,24,8,3
7,2004,500100,32,28,4,3
8,2004,500100,23,21,2,4
9,2004,500100,43,35,8,5
10,2004,500100,30,27,3,7
11,2004,500100,26,21,5,1
12,2004,500100,27,25,2,1
1,2005,500100,26,24,2,7
2,2005,500100,21,17,4,5
3,2005,500100,16,14,2,5
4,2005,500100,32,28,4,5
5,2005,500100,26,24,2,2
6,2005,500100,21,19,2,2
7,2005,500100,33,24,9,3
8,2005,500100,18,18,0,2
9,2005,500100,23,23,0,2
10,2005,500100,36,30,6,6
11,2005,500100,36,31,5,2
12,2005,500100,19,16,3,1
1,2006,500100,14,13,1,5
2,2006,500100,12,10,2,6
3,2006,500100,38,36,2,3
4,2006,500100,19,19,0,3
5,2006,500100,23,20,3,2
6,2006,500100,24,22,2,4
7,2006,500100,27,27,0,0
8,2006,500100,16,12,4,2
9,2006,500100,24,21,3,2
10,2006,500100,28,24,4,3
11,2006,500100,27,24,3,3
12,2006,500100,22,19,3,1
1,2007,500100,23,22,1,1
2,2007,500100,20,18,2,4
3,2007,500100,21,14,7,2
4,2007,500100,19,18,1,6
5,2007,500100,34,30,4,3
6,2007,500100,21,17,4,3
7,2007,500100,34,31,3,7
8,2007,500100,33,29,4,4
9,2007,500100,28,22,6,2
10,2007,500100,34,32,2,3
11,2007,500100,33,31,2,2
12,2007,500100,23,20,3,3
1,2008,500100,25,19,6,7
2,2008,500100,23,18,5,6
3,2008,500100,21,17,4,5
4,2008,500100,22,18,4,5
5,2008,500100,26,22,4,6
6,2008,500100,22,19,3,1
7,2008,500100,21,19,2,3
8,2008,500100,18,17,1,0
9,2008,500100,21,19,2,2
10,2008,500100,37,33,4,1
11,2008,500100,26,23,3,4
12,2008,500100,17,14,3,1
1,2009,500100,18,14,4,1
2,2009,500100,20,18,2,4
3,2009,500100,16,14,2,2
4,2009,500100,18,17,1,3
5,2009,500100,23,22,1,8
6,2009,500100,17,13,4,5
7,2009,500100,13,13,0,3
8,2009,500100,20,17,3,3
9,2009,500100,21,19,2,1
10,2009,500100,23,20,3,6
11,2009,500100,22,21,1,4
12,2009,500100,25,23,2,2
1,2010,500100,17,17,0,1
2,2010,500100,21,20,1,4
3,2010,500100,19,16,3,3
4,2010,500100,21,19,2,6
5,2010,500100,20,17,3,4
6,2010,500100,28,25,3,2
7,2010,500100,22,20,2,0
8,2010,500100,16,16,0,1
9,2010,500100,18,15,3,1
10,2010,500100,19,19,0,1
11,2010,500100,19,19,0,0
12,2010,500100,24,20,4,0
1,2011,500100,17,16,1,1
2,2011,500100,6,5,1,1
1,1999,510300,10,9,1,3
2,1999,510300,17,12,5,3
3,1999,510300,21,18,3,3
4,1999,510300,26,18,8,1
5,1999,510300,24,22,2,5
6,1999,510300,32,21,11,4
7,1999,510300,39,30,9,3
8,1999,510300,32,26,6,3
9,1999,510300,21,19,2,2
10,1999,510300,25,23,2,2
11,1999,510300,23,17,6,2
12,1999,510300,10,7,3,4
1,2000,510300,15,15,0,3
2,2000,510300,23,21,2,6
3,2000,510300,22,17,5,6
4,2000,510300,30,26,4,5
5,2000,510300,28,24,4,5
6,2000,510300,24,17,7,2
7,2000,510300,18,11,7,3
8,2000,510300,36,30,6,6
9,2000,510300,33,24,9,8
10,2000,510300,30,24,6,3
11,2000,510300,19,18,1,9
12,2000,510300,21,19,2,7
1,2001,510300,12,11,1,9
2,2001,510300,20,15,5,7
3,2001,510300,30,23,7,7
4,2001,510300,25,19,6,4
5,2001,510300,18,15,3,3
6,2001,510300,31,28,3,4
7,2001,510300,21,17,4,1
8,2001,510300,38,30,8,5
9,2001,510300,18,15,3,3
10,2001,510300,31,27,4,6
11,2001,510300,21,15,6,2
12,2001,510300,34,30,4,4
1,2002,510300,29,24,5,7
2,2002,510300,28,24,4,2
3,2002,510300,30,23,7,5
4,2002,510300,30,19,11,7
5,2002,510300,25,19,6,4
6,2002,510300,32,26,6,8
7,2002,510300,35,28,7,5
8,2002,510300,26,16,10,5
9,2002,510300,27,23,4,4
10,2002,510300,22,16,6,8
11,2002,510300,26,21,5,6
12,2002,510300,17,14,3,9
1,2003,510300,29,25,4,3
2,2003,510300,19,16,3,2
3,2003,510300,21,19,2,5
4,2003,510300,29,29,0,12
5,2003,510300,17,10,7,4
6,2003,510300,23,18,5,5
7,2003,510300,25,13,12,5
8,2003,510300,24,20,4,1
9,2003,510300,23,17,6,3
10,2003,510300,24,17,7,9
11,2003,510300,19,13,6,7
12,2003,510300,22,18,4,3
1,2004,510300,21,15,6,12
2,2004,510300,17,9,8,12
3,2004,510300,21,18,3,5
4,2004,510300,24,18,6,8
5,2004,510300,10,8,2,13
6,2004,510300,25,17,8,3
7,2004,510300,22,15,7,2
8,2004,510300,32,28,4,3
9,2004,510300,31,27,4,3
10,2004,510300,36,30,6,8
11,2004,510300,24,18,6,7
12,2004,510300,22,16,6,7
1,2005,510300,21,18,3,7
2,2005,510300,21,18,3,6
3,2005,510300,28,23,5,6
4,2005,510300,35,31,4,6
5,2005,510300,22,18,4,4
6,2005,510300,20,14,6,6
7,2005,510300,16,16,0,5
8,2005,510300,23,19,4,2
9,2005,510300,23,14,9,2
10,2005,510300,18,13,5,0
11,2005,510300,15,11,4,3
12,2005,510300,8,7,1,4
1,2006,510300,24,22,2,4
2,2006,510300,19,14,5,3
3,2006,510300,25,23,2,5
4,2006,510300,24,20,4,6
5,2006,510300,21,14,7,2
6,2006,510300,26,20,6,6
7,2006,510300,28,22,6,8
8,2006,510300,24,19,5,8
9,2006,510300,21,14,7,7
10,2006,510300,26,23,3,4
11,2006,510300,21,18,3,3
12,2006,510300,23,21,2,5
1,2007,510300,27,23,4,10
2,2007,510300,16,14,2,7
3,2007,510300,22,19,3,10
4,2007,510300,23,18,5,12
5,2007,510300,19,19,0,9
6,2007,510300,29,22,7,5
7,2007,510300,33,25,8,11
8,2007,510300,37,28,9,5
9,2007,510300,33,24,9,7
10,2007,510300,27,21,6,5
11,2007,510300,19,16,3,4
12,2007,510300,34,34,0,7
1,2008,510300,34,32,2,7
2,2008,510300,30,26,4,7
3,2008,510300,17,15,2,7
4,2008,510300,48,37,11,2
5,2008,510300,41,31,10,5
6,2008,510300,32,30,2,3
7,2008,510300,26,21,5,5
8,2008,510300,41,36,5,6
9,2008,510300,36,32,4,5
10,2008,510300,32,28,4,2
11,2008,510300,28,22,6,4
12,2008,510300,11,9,2,6
1,2009,510300,19,17,2,8
2,2009,510300,17,13,4,4
3,2009,510300,25,18,7,5
4,2009,510300,27,24,3,4
5,2009,510300,35,28,7,5
6,2009,510300,29,24,5,1
7,2009,510300,37,30,7,7
8,2009,510300,32,27,5,6
9,2009,510300,36,30,6,5
10,2009,510300,20,19,1,10
11,2009,510300,26,23,3,7
12,2009,510300,25,23,2,3
1,2010,510300,26,25,1,5
2,2010,510300,14,12,2,10
3,2010,510300,22,19,3,5
4,2010,510300,26,21,5,5
5,2010,510300,35,27,8,16
6,2010,510300,47,42,5,8
7,2010,510300,34,26,8,4
8,2010,510300,27,22,5,4
9,2010,510300,25,22,3,1
10,2010,510300,26,21,5,4
11,2010,510300,24,20,4,2
12,2010,510300,26,25,1,1
1,2011,510300,15,12,3,6
2,2011,510300,12,11,1,7
1,1999,730400,15,13,2,4
2,1999,730400,13,10,3,5
3,1999,730400,14,11,3,5
4,1999,730400,22,18,4,1
5,1999,730400,28,21,7,4
6,1999,730400,9,7,2,10
7,1999,730400,21,17,4,3
8,1999,730400,14,8,6,4
9,1999,730400,22,16,6,10
10,1999,730400,9,8,1,10
11,1999,730400,16,14,2,9
12,1999,730400,19,17,2,5
1,2000,730400,19,15,4,9
2,2000,730400,10,10,0,10
3,2000,730400,18,17,1,13
4,2000,730400,19,18,1,8
5,2000,730400,15,14,1,3
6,2000,730400,15,12,3,3
7,2000,730400,28,23,5,9
8,2000,730400,20,15,5,4
9,2000,730400,26,23,3,5
10,2000,730400,29,27,2,6
11,2000,730400,26,22,4,6
12,2000,730400,15,12,3,8
1,2001,730400,9,9,0,9
2,2001,730400,6,5,1,3
3,2001,730400,19,15,4,6
4,2001,730400,17,12,5,3
5,2001,730400,26,25,1,7
6,2001,730400,28,22,6,10
7,2001,730400,18,15,3,7
8,2001,730400,21,15,6,3
9,2001,730400,27,21,6,7
10,2001,730400,29,24,5,5
11,2001,730400,13,10,3,8
12,2001,730400,23,21,2,3
1,2002,730400,14,13,1,6
2,2002,730400,14,10,4,3
3,2002,730400,13,11,2,5
4,2002,730400,12,10,2,5
5,2002,730400,21,16,5,1
6,2002,730400,23,18,5,7
7,2002,730400,20,17,3,2
8,2002,730400,15,11,4,9
9,2002,730400,23,20,3,5
10,2002,730400,23,18,5,12
11,2002,730400,14,10,4,4
12,2002,730400,12,8,4,2
1,2003,730400,15,14,1,10
2,2003,730400,14,12,2,4
3,2003,730400,14,10,4,11
4,2003,730400,17,15,2,6
5,2003,730400,19,16,3,5
6,2003,730400,13,12,1,7
7,2003,730400,12,8,4,6
8,2003,730400,13,11,2,4
9,2003,730400,16,13,3,2
10,2003,730400,13,9,4,4
11,2003,730400,14,10,4,5
12,2003,730400,16,13,3,10
1,2004,730400,20,16,4,5
2,2004,730400,6,5,1,6
3,2004,730400,14,13,1,12
4,2004,730400,20,18,2,7
5,2004,730400,18,14,4,3
6,2004,730400,21,14,7,2
7,2004,730400,19,14,5,9
8,2004,730400,29,25,4,15
9,2004,730400,15,10,5,4
10,2004,730400,22,21,1,3
11,2004,730400,17,15,2,4
12,2004,730400,19,17,2,3
1,2005,730400,11,10,1,5
2,2005,730400,13,9,4,7
3,2005,730400,25,22,3,7
4,2005,730400,19,19,0,3
5,2005,730400,19,16,3,9
6,2005,730400,24,20,4,6
7,2005,730400,18,14,4,9
8,2005,730400,15,13,2,5
9,2005,730400,23,18,5,6
10,2005,730400,18,16,2,16
11,2005,730400,13,12,1,9
12,2005,730400,13,10,3,8
1,2006,730400,22,16,6,9
2,2006,730400,10,10,0,9
3,2006,730400,15,11,4,6
4,2006,730400,19,15,4,4
5,2006,730400,20,16,4,8
6,2006,730400,24,17,7,15
7,2006,730400,23,19,4,7
8,2006,730400,20,16,4,7
9,2006,730400,16,16,0,9
10,2006,730400,14,13,1,9
11,2006,730400,16,13,3,7
12,2006,730400,24,18,6,5
1,2007,730400,13,9,4,7
2,2007,730400,12,9,3,4
3,2007,730400,16,13,3,6
4,2007,730400,12,10,2,6
5,2007,730400,23,19,4,7
6,2007,730400,11,9,2,6
7,2007,730400,13,12,1,5
8,2007,730400,36,33,3,7
9,2007,730400,15,9,6,5
10,2007,730400,18,16,2,2
11,2007,730400,18,15,3,4
12,2007,730400,15,12,3,2
1,2008,730400,18,16,2,3
2,2008,730400,9,8,1,3
3,2008,730400,16,12,4,6
4,2008,730400,13,11,2,8
5,2008,730400,22,17,5,4
6,2008,730400,25,20,5,7
7,2008,730400,31,26,5,3
8,2008,730400,22,19,3,2
9,2008,730400,17,11,6,3
10,2008,730400,16,14,2,4
11,2008,730400,22,20,2,7
12,2008,730400,16,14,2,3
1,2009,730400,13,13,0,9
2,2009,730400,13,12,1,4
3,2009,730400,12,9,3,2
4,2009,730400,14,13,1,7
5,2009,730400,14,10,4,2
6,2009,730400,19,14,5,1
7,2009,730400,26,23,3,1
8,2009,730400,23,20,3,9
9,2009,730400,26,25,1,10
10,2009,730400,31,30,1,7
11,2009,730400,17,16,1,2
12,2009,730400,15,13,2,4
1,2010,730400,14,14,0,5
2,2010,730400,13,12,1,3
3,2010,730400,18,15,3,9
4,2010,730400,23,20,3,5
5,2010,730400,25,21,4,5
6,2010,730400,22,17,5,7
7,2010,730400,25,20,5,5
8,2010,730400,21,20,1,2
9,2010,730400,21,18,3,4
10,2010,730400,24,18,6,2
11,2010,730400,16,15,1,3
12,2010,730400,12,11,1,7
1,2011,730400,18,18,0,6
2,2011,730400,5,5,0,8
1,1999,490600,21,21,0,1
2,1999,490600,18,18,0,3
3,1999,490600,5,5,0,1
4,1999,490600,14,10,4,6
5,1999,490600,14,10,4,2
6,1999,490600,13,11,2,3
7,1999,490600,21,20,1,0
8,1999,490600,8,7,1,3
9,1999,490600,13,10,3,5
10,1999,490600,10,6,4,1
11,1999,490600,8,6,2,0
12,1999,490600,9,9,0,4
1,2000,490600,12,12,0,2
2,2000,490600,7,7,0,2
3,2000,490600,9,9,0,5
4,2000,490600,10,6,4,1
5,2000,490600,8,7,1,5
6,2000,490600,6,4,2,4
7,2000,490600,16,14,2,2
8,2000,490600,15,13,2,3
9,2000,490600,15,14,1,2
10,2000,490600,16,14,2,1
11,2000,490600,10,9,1,3
12,2000,490600,4,2,2,4
1,2001,490600,9,8,1,2
2,2001,490600,6,4,2,8
3,2001,490600,8,7,1,2
4,2001,490600,12,10,2,5
5,2001,490600,7,5,2,6
6,2001,490600,4,4,0,6
7,2001,490600,17,13,4,10
8,2001,490600,22,18,4,5
9,2001,490600,18,14,4,3
10,2001,490600,16,14,2,6
11,2001,490600,14,11,3,4
12,2001,490600,8,7,1,3
1,2002,490600,12,11,1,4
2,2002,490600,16,13,3,4
3,2002,490600,17,16,1,2
4,2002,490600,14,12,2,3
5,2002,490600,11,9,2,4
6,2002,490600,11,9,2,4
7,2002,490600,15,11,4,4
8,2002,490600,7,5,2,0
9,2002,490600,3,3,0,3
10,2002,490600,16,11,5,3
11,2002,490600,5,4,1,7
12,2002,490600,7,5,2,16
1,2003,490600,10,10,0,0
2,2003,490600,7,6,1,10
3,2003,490600,22,20,2,3
4,2003,490600,8,8,0,4
5,2003,490600,4,4,0,5
6,2003,490600,10,9,1,1
7,2003,490600,13,9,4,1
8,2003,490600,5,4,1,2
9,2003,490600,10,9,1,2
10,2003,490600,10,10,0,7
11,2003,490600,10,8,2,7
12,2003,490600,16,13,3,2
1,2004,490600,7,6,1,3
2,2004,490600,5,4,1,5
3,2004,490600,3,3,0,1
4,2004,490600,11,8,3,8
5,2004,490600,11,9,2,4
6,2004,490600,12,9,3,2
7,2004,490600,9,8,1,1
8,2004,490600,11,8,3,4
9,2004,490600,2,2,0,3
10,2004,490600,10,8,2,4
11,2004,490600,10,8,2,7
12,2004,490600,8,6,2,8
1,2005,490600,5,5,0,7
2,2005,490600,8,7,1,4
3,2005,490600,8,6,2,8
4,2005,490600,12,11,1,2
5,2005,490600,13,11,2,6
6,2005,490600,12,10,2,1
7,2005,490600,14,12,2,1
8,2005,490600,8,8,0,2
9,2005,490600,15,10,5,3
10,2005,490600,14,10,4,4
11,2005,490600,10,9,1,5
12,2005,490600,11,10,1,6
1,2006,490600,15,14,1,8
2,2006,490600,8,4,4,6
3,2006,490600,6,3,3,7
4,2006,490600,7,6,1,3
5,2006,490600,6,5,1,7
6,2006,490600,16,16,0,3
7,2006,490600,14,12,2,3
8,2006,490600,7,7,0,4
9,2006,490600,13,9,4,5
10,2006,490600,10,7,3,2
11,2006,490600,6,6,0,2
12,2006,490600,13,11,2,4
1,2007,490600,3,3,0,4
2,2007,490600,7,4,3,8
3,2007,490600,11,9,2,4
4,2007,490600,11,9,2,3
5,2007,490600,6,4,2,1
6,2007,490600,3,3,0,12
7,2007,490600,13,11,2,11
8,2007,490600,13,12,1,6
9,2007,490600,10,8,2,4
10,2007,490600,11,8,3,5
11,2007,490600,12,11,1,7
12,2007,490600,11,11,0,19
1,2008,490600,9,8,1,6
2,2008,490600,8,7,1,3
3,2008,490600,13,12,1,2
4,2008,490600,9,8,1,1
5,2008,490600,8,6,2,2
6,2008,490600,23,22,1,4
7,2008,490600,21,19,2,2
8,2008,490600,13,12,1,6
9,2008,490600,8,6,2,4
10,2008,490600,14,12,2,0
11,2008,490600,9,8,1,4
12,2008,490600,17,12,5,4
1,2009,490600,7,6,1,11
2,2009,490600,5,5,0,3
3,2009,490600,15,11,4,10
4,2009,490600,8,6,2,4
5,2009,490600,14,14,0,5
6,2009,490600,18,15,3,3
7,2009,490600,14,14,0,2
8,2009,490600,16,10,6,5
9,2009,490600,17,14,3,3
10,2009,490600,16,15,1,3
11,2009,490600,5,4,1,0
12,2009,490600,8,7,1,7
1,2010,490600,14,12,2,2
2,2010,490600,9,7,2,3
3,2010,490600,8,6,2,2
4,2010,490600,10,9,1,4
5,2010,490600,10,8,2,5
6,2010,490600,8,5,3,2
7,2010,490600,12,11,1,3
8,2010,490600,8,6,2,4
9,2010,490600,13,9,4,7
10,2010,490600,8,7,1,2
11,2010,490600,14,13,1,1
12,2010,490600,14,13,1,2
1,2011,490600,12,10,2,4
2,2011,490600,6,3,3,5
1,1999,490500,5,5,0,0
2,1999,490500,6,4,2,1
3,1999,490500,7,5,2,4
4,1999,490500,7,6,1,3
5,1999,490500,10,8,2,1
6,1999,490500,7,6,1,0
7,1999,490500,12,11,1,0
8,1999,490500,11,9,2,0
9,1999,490500,14,11,3,0
10,1999,490500,8,8,0,4
11,1999,490500,6,4,2,2
12,1999,490500,5,4,1,3
1,2000,490500,9,8,1,0
2,2000,490500,15,13,2,2
3,2000,490500,6,6,0,0
4,2000,490500,9,9,0,4
5,2000,490500,6,6,0,0
6,2000,490500,5,4,1,0
7,2000,490500,10,8,2,0
8,2000,490500,17,15,2,0
9,2000,490500,12,12,0,1
10,2000,490500,14,14,0,2
11,2000,490500,12,11,1,1
12,2000,490500,7,6,1,4
1,2001,490500,12,11,1,0
2,2001,490500,8,8,0,7
3,2001,490500,3,3,0,1
4,2001,490500,11,9,2,2
5,2001,490500,11,10,1,1
6,2001,490500,13,11,2,1
7,2001,490500,10,8,2,0
8,2001,490500,16,14,2,2
9,2001,490500,12,11,1,0
10,2001,490500,11,10,1,3
11,2001,490500,9,8,1,0
12,2001,490500,14,12,2,1
1,2002,490500,15,12,3,0
2,2002,490500,12,11,1,5
3,2002,490500,10,9,1,2
4,2002,490500,10,9,1,0
5,2002,490500,12,10,2,0
6,2002,490500,17,15,2,2
7,2002,490500,11,8,3,0
8,2002,490500,22,19,3,0
9,2002,490500,10,6,4,1
10,2002,490500,7,7,0,0
11,2002,490500,10,10,0,0
12,2002,490500,8,5,3,0
1,2003,490500,5,4,1,3
2,2003,490500,5,5,0,1
3,2003,490500,10,8,2,0
4,2003,490500,13,10,3,0
5,2003,490500,9,9,0,0
6,2003,490500,10,9,1,0
7,2003,490500,19,16,3,1
8,2003,490500,8,7,1,0
9,2003,490500,11,10,1,1
10,2003,490500,11,10,1,1
11,2003,490500,7,7,0,2
12,2003,490500,9,8,1,0
1,2004,490500,10,6,4,0
2,2004,490500,8,8,0,0
3,2004,490500,7,7,0,5
4,2004,490500,4,4,0,0
5,2004,490500,13,10,3,0
6,2004,490500,5,5,0,1
7,2004,490500,5,5,0,0
8,2004,490500,11,8,3,0
9,2004,490500,17,14,3,0
10,2004,490500,17,16,1,2
11,2004,490500,14,13,1,0
12,2004,490500,9,9,0,0
1,2005,490500,6,6,0,2
2,2005,490500,8,8,0,0
3,2005,490500,16,13,3,2
4,2005,490500,11,8,3,5
5,2005,490500,11,11,0,0
6,2005,490500,15,14,1,2
7,2005,490500,17,15,2,2
8,2005,490500,18,17,1,0
9,2005,490500,11,10,1,3
10,2005,490500,9,8,1,4
11,2005,490500,12,12,0,1
12,2005,490500,12,10,2,2
1,2006,490500,14,13,1,0
2,2006,490500,29,25,4,1
3,2006,490500,10,9,1,2
4,2006,490500,6,5,1,2
5,2006,490500,7,6,1,4
6,2006,490500,9,9,0,1
7,2006,490500,10,10,0,1
8,2006,490500,10,9,1,0
9,2006,490500,8,7,1,3
10,2006,490500,17,16,1,4
11,2006,490500,13,12,1,0
12,2006,490500,7,6,1,3
1,2007,490500,6,6,0,0
2,2007,490500,7,7,0,1
3,2007,490500,10,10,0,1
4,2007,490500,8,6,2,1
5,2007,490500,14,13,1,1
6,2007,490500,8,8,0,0
7,2007,490500,9,8,1,6
8,2007,490500,16,15,1,0
9,2007,490500,10,9,1,3
10,2007,490500,13,13,0,4
11,2007,490500,9,8,1,1
12,2007,490500,8,8,0,5
1,2008,490500,19,18,1,4
2,2008,490500,16,15,1,4
3,2008,490500,9,8,1,0
4,2008,490500,13,11,2,0
5,2008,490500,8,8,0,1
6,2008,490500,19,17,2,1
7,2008,490500,17,16,1,1
8,2008,490500,13,10,3,1
9,2008,490500,14,14,0,4
10,2008,490500,18,18,0,0
11,2008,490500,10,9,1,1
12,2008,490500,13,10,3,3
1,2009,490500,11,10,1,2
2,2009,490500,8,8,0,1
3,2009,490500,7,6,1,4
4,2009,490500,19,19,0,1
5,2009,490500,13,12,1,0
6,2009,490500,8,7,1,1
7,2009,490500,12,12,0,0
8,2009,490500,14,13,1,0
9,2009,490500,19,17,2,0
10,2009,490500,10,9,1,1
11,2009,490500,17,17,0,4
12,2009,490500,9,8,1,3
1,2010,490500,13,13,0,1
2,2010,490500,6,6,0,4
3,2010,490500,14,13,1,4
4,2010,490500,13,11,2,3
5,2010,490500,13,13,0,1
6,2010,490500,14,13,1,0
7,2010,490500,10,10,0,1
8,2010,490500,5,5,0,0
9,2010,490500,5,4,1,1
10,2010,490500,7,7,0,3
11,2010,490500,8,7,1,2
12,2010,490500,16,16,0,2
1,2011,490500,9,9,0,2
2,2011,490500,7,5,2,6
1,1999,720100,10,10,0,0
2,1999,720100,5,5,0,1
3,1999,720100,9,8,1,0
4,1999,720100,8,7,1,0
5,1999,720100,16,16,0,2
6,1999,720100,17,13,4,0
7,1999,720100,32,32,0,2
8,1999,720100,10,9,1,0
9,1999,720100,16,15,1,0
10,1999,720100,9,9,0,0
11,1999,720100,9,9,0,0
12,1999,720100,7,6,1,1
1,2000,720100,13,12,1,0
2,2000,720100,10,10,0,0
3,2000,720100,15,15,0,1
4,2000,720100,9,8,1,0
5,2000,720100,11,11,0,0
6,2000,720100,20,20,0,0
7,2000,720100,15,14,1,1
8,2000,720100,25,25,0,0
9,2000,720100,35,35,0,2
10,2000,720100,5,5,0,0
11,2000,720100,2,1,1,0
12,2000,720100,11,11,0,0
1,2001,720100,10,9,1,0
2,2001,720100,4,4,0,0
3,2001,720100,8,8,0,0
4,2001,720100,11,10,1,2
5,2001,720100,9,9,0,0
6,2001,720100,4,2,2,0
7,2001,720100,9,9,0,0
8,2001,720100,14,14,0,0
9,2001,720100,15,13,2,0
10,2001,720100,14,14,0,0
11,2001,720100,11,11,0,0
12,2001,720100,6,6,0,0
1,2002,720100,11,11,0,0
2,2002,720100,9,9,0,0
3,2002,720100,17,17,0,2
4,2002,720100,20,20,0,0
5,2002,720100,7,7,0,0
6,2002,720100,12,12,0,0
7,2002,720100,25,25,0,0
8,2002,720100,15,15,0,0
9,2002,720100,12,11,1,0
10,2002,720100,7,7,0,0
11,2002,720100,6,6,0,0
12,2002,720100,6,5,1,0
1,2003,720100,5,5,0,0
2,2003,720100,1,1,0,0
3,2003,720100,8,7,1,0
4,2003,720100,4,4,0,0
5,2003,720100,5,5,0,0
6,2003,720100,8,8,0,1
7,2003,720100,10,10,0,1
8,2003,720100,8,7,1,2
9,2003,720100,11,11,0,0
10,2003,720100,8,7,1,0
11,2003,720100,6,5,1,0
12,2003,720100,5,5,0,0
1,2004,720100,3,3,0,0
2,2004,720100,7,7,0,1
3,2004,720100,6,6,0,1
4,2004,720100,11,11,0,2
5,2004,720100,6,6,0,0
6,2004,720100,20,20,0,0
7,2004,720100,5,5,0,1
8,2004,720100,6,6,0,2
9,2004,720100,11,11,0,0
10,2004,720100,6,6,0,0
11,2004,720100,10,10,0,0
12,2004,720100,8,8,0,1
1,2005,720100,7,7,0,0
2,2005,720100,8,7,1,0
3,2005,720100,10,10,0,1
4,2005,720100,12,12,0,0
5,2005,720100,11,11,0,0
6,2005,720100,8,8,0,0
7,2005,720100,13,13,0,2
8,2005,720100,11,11,0,2
9,2005,720100,6,6,0,0
10,2005,720100,12,12,0,0
11,2005,720100,10,9,1,1
12,2005,720100,5,5,0,0
1,2006,720100,12,12,0,0
2,2006,720100,7,7,0,0
3,2006,720100,5,5,0,5
4,2006,720100,7,6,1,2
5,2006,720100,5,5,0,0
6,2006,720100,10,9,1,2
7,2006,720100,14,14,0,3
8,2006,720100,9,9,0,2
9,2006,720100,9,8,1,1
10,2006,720100,5,4,1,1
11,2006,720100,8,8,0,0
12,2006,720100,8,6,2,2
1,2007,720100,3,3,0,3
2,2007,720100,5,3,2,2
3,2007,720100,6,6,0,2
4,2007,720100,3,3,0,1
5,2007,720100,6,6,0,0
6,2007,720100,10,9,1,4
7,2007,720100,9,9,0,1
8,2007,720100,13,13,0,1
9,2007,720100,10,10,0,3
10,2007,720100,11,11,0,0
11,2007,720100,10,10,0,1
12,2007,720100,21,21,0,3
1,2008,720100,15,15,0,2
2,2008,720100,13,13,0,2
3,2008,720100,11,10,1,3
4,2008,720100,4,4,0,1
5,2008,720100,13,12,1,3
6,2008,720100,12,12,0,3
7,2008,720100,15,14,1,1
8,2008,720100,12,12,0,3
9,2008,720100,6,6,0,3
10,2008,720100,6,6,0,2
11,2008,720100,8,8,0,0
12,2008,720100,5,5,0,4
1,2009,720100,2,2,0,2
2,2009,720100,1,1,0,1
3,2009,720100,4,4,0,4
4,2009,720100,6,6,0,1
5,2009,720100,8,8,0,1
6,2009,720100,12,12,0,4
7,2009,720100,13,13,0,4
8,2009,720100,16,16,0,4
9,2009,720100,4,3,1,4
10,2009,720100,9,9,0,2
11,2009,720100,6,5,1,1
12,2009,720100,10,10,0,1
1,2010,720100,8,8,0,0
2,2010,720100,5,4,1,1
3,2010,720100,4,3,1,3
4,2010,720100,3,3,0,4
5,2010,720100,6,6,0,1
6,2010,720100,15,15,0,0
7,2010,720100,10,10,0,2
8,2010,720100,21,21,0,1
9,2010,720100,11,11,0,0
10,2010,720100,12,11,1,1
11,2010,720100,10,9,1,0
12,2010,720100,4,4,0,2
1,2011,720100,6,6,0,2
2,2011,720100,4,4,0,0
1,1999,730201,40,28,12,4
2,1999,730201,31,24,7,10
3,1999,730201,24,19,5,17
4,1999,730201,40,36,4,14
5,1999,730201,26,23,3,17
6,1999,730201,30,27,3,15
7,1999,730201,40,35,5,17
8,1999,730201,38,32,6,8
9,1999,730201,38,36,2,5
10,1999,730201,39,38,1,16
11,1999,730201,41,37,4,15
12,1999,730201,30,27,3,11
1,2000,730201,38,36,2,12
2,2000,730201,34,24,10,24
3,2000,730201,29,21,8,10
4,2000,730201,37,34,3,9
5,2000,730201,30,26,4,7
6,2000,730201,35,29,6,9
7,2000,730201,34,32,2,6
8,2000,730201,56,48,8,14
9,2000,730201,42,34,8,9
10,2000,730201,44,33,11,9
11,2000,730201,41,35,6,5
12,2000,730201,32,29,3,3
1,2001,730201,35,29,6,10
2,2001,730201,26,25,1,12
3,2001,730201,32,29,3,11
4,2001,730201,38,33,5,6
5,2001,730201,32,27,5,12
6,2001,730201,47,40,7,9
7,2001,730201,44,32,12,6
8,2001,730201,27,21,6,5
9,2001,730201,47,39,8,9
10,2001,730201,42,38,4,11
11,2001,730201,32,28,4,10
12,2001,730201,48,45,3,10
1,2002,730201,52,50,2,12
2,2002,730201,28,25,3,11
3,2002,730201,39,37,2,7
4,2002,730201,26,23,3,7
5,2002,730201,33,29,4,12
6,2002,730201,34,32,2,4
7,2002,730201,45,40,5,5
8,2002,730201,51,48,3,18
9,2002,730201,32,29,3,7
10,2002,730201,46,44,2,3
11,2002,730201,40,37,3,9
12,2002,730201,37,34,3,3
1,2003,730201,32,30,2,9
2,2003,730201,34,30,4,12
3,2003,730201,43,39,4,13
4,2003,730201,33,28,5,8
5,2003,730201,38,30,8,3
6,2003,730201,35,32,3,13
7,2003,730201,37,32,5,2
8,2003,730201,39,34,5,3
9,2003,730201,29,26,3,5
10,2003,730201,33,27,6,4
11,2003,730201,40,32,8,6
12,2003,730201,36,36,0,6
1,2004,730201,26,23,3,5
2,2004,730201,17,16,1,7
3,2004,730201,18,13,5,6
4,2004,730201,26,25,1,8
5,2004,730201,27,24,3,1
6,2004,730201,27,24,3,19
7,2004,730201,45,40,5,15
8,2004,730201,44,40,4,19
9,2004,730201,44,41,3,15
10,2004,730201,45,43,2,5
11,2004,730201,18,14,4,15
12,2004,730201,30,25,5,11
1,2005,730201,35,31,4,6
2,2005,730201,36,32,4,14
3,2005,730201,26,24,2,4
4,2005,730201,35,29,6,15
5,2005,730201,31,30,1,13
6,2005,730201,29,26,3,5
7,2005,730201,40,35,5,9
8,2005,730201,39,31,8,13
9,2005,730201,28,25,3,3
10,2005,730201,30,24,6,16
11,2005,730201,30,29,1,10
12,2005,730201,42,40,2,8
1,2006,730201,24,23,1,11
2,2006,730201,15,15,0,14
3,2006,730201,27,25,2,6
4,2006,730201,24,17,7,14
5,2006,730201,39,30,9,4
6,2006,730201,29,26,3,14
7,2006,730201,39,31,8,19
8,2006,730201,39,25,14,13
9,2006,730201,32,30,2,8
10,2006,730201,37,31,6,8
11,2006,730201,28,24,4,9
12,2006,730201,44,43,1,3
1,2007,730201,33,29,4,12
2,2007,730201,25,23,2,8
3,2007,730201,28,24,4,21
4,2007,730201,44,40,4,18
5,2007,730201,37,30,7,10
6,2007,730201,42,37,5,8
7,2007,730201,45,38,7,7
8,2007,730201,41,37,4,7
9,2007,730201,35,27,8,2
10,2007,730201,31,27,4,6
11,2007,730201,44,34,10,12
12,2007,730201,29,26,3,2
1,2008,730201,22,19,3,7
2,2008,730201,23,19,4,5
3,2008,730201,33,26,7,1
4,2008,730201,40,36,4,5
5,2008,730201,47,42,5,4
6,2008,730201,41,38,3,3
7,2008,730201,41,37,4,5
8,2008,730201,35,26,9,9
9,2008,730201,23,23,0,5
10,2008,730201,30,24,6,8
11,2008,730201,31,25,6,2
12,2008,730201,25,23,2,7
1,2009,730201,25,21,4,5
2,2009,730201,12,10,2,8
3,2009,730201,28,26,2,13
4,2009,730201,31,27,4,4
5,2009,730201,39,35,4,5
6,2009,730201,43,38,5,3
7,2009,730201,31,22,9,3
8,2009,730201,37,32,5,14
9,2009,730201,45,37,8,10
10,2009,730201,28,27,1,6
11,2009,730201,25,22,3,9
12,2009,730201,40,38,2,6
1,2010,730201,16,14,2,7
2,2010,730201,20,18,2,5
3,2010,730201,37,35,2,9
4,2010,730201,25,25,0,7
5,2010,730201,40,35,5,10
6,2010,730201,29,25,4,9
7,2010,730201,30,27,3,7
8,2010,730201,30,30,0,4
9,2010,730201,32,25,7,8
10,2010,730201,38,31,7,6
11,2010,730201,27,23,4,4
12,2010,730201,14,11,3,6
1,2011,730201,26,22,4,5
2,2011,730201,13,12,1,5
1,1999,730202,15,13,2,1
2,1999,730202,19,17,2,5
3,1999,730202,13,11,2,5
4,1999,730202,16,12,4,5
5,1999,730202,16,12,4,6
6,1999,730202,25,17,8,5
7,1999,730202,21,19,2,3
8,1999,730202,27,24,3,6
9,1999,730202,15,14,1,4
10,1999,730202,17,15,2,5
11,1999,730202,14,13,1,2
12,1999,730202,13,10,3,4
1,2000,730202,18,17,1,4
2,2000,730202,12,10,2,2
3,2000,730202,14,13,1,5
4,2000,730202,15,13,2,10
5,2000,730202,18,16,2,18
6,2000,730202,22,16,6,4
7,2000,730202,13,10,3,5
8,2000,730202,19,15,4,5
9,2000,730202,20,16,4,2
10,2000,730202,14,12,2,5
11,2000,730202,9,9,0,9
12,2000,730202,13,11,2,3
1,2001,730202,16,15,1,6
2,2001,730202,13,11,2,14
3,2001,730202,15,12,3,12
4,2001,730202,13,10,3,6
5,2001,730202,15,13,2,9
6,2001,730202,22,17,5,3
7,2001,730202,15,12,3,5
8,2001,730202,15,12,3,2
9,2001,730202,18,16,2,7
10,2001,730202,15,12,3,3
11,2001,730202,15,13,2,9
12,2001,730202,11,7,4,5
1,2002,730202,9,8,1,4
2,2002,730202,7,6,1,1
3,2002,730202,13,11,2,3
4,2002,730202,12,11,1,5
5,2002,730202,12,10,2,2
6,2002,730202,17,15,2,3
7,2002,730202,12,10,2,0
8,2002,730202,17,11,6,3
9,2002,730202,10,9,1,1
10,2002,730202,12,11,1,6
11,2002,730202,19,18,1,1
12,2002,730202,13,13,0,2
1,2003,730202,11,7,4,6
2,2003,730202,14,12,2,1
3,2003,730202,10,6,4,2
4,2003,730202,19,16,3,3
5,2003,730202,13,9,4,3
6,2003,730202,16,12,4,6
7,2003,730202,13,10,3,0
8,2003,730202,7,6,1,5
9,2003,730202,11,10,1,2
10,2003,730202,15,13,2,0
11,2003,730202,14,12,2,3
12,2003,730202,10,8,2,2
1,2004,730202,9,7,2,0
2,2004,730202,11,11,0,1
3,2004,730202,8,6,2,2
4,2004,730202,9,7,2,1
5,2004,730202,8,8,0,3
6,2004,730202,26,17,9,4
7,2004,730202,15,13,2,17
8,2004,730202,18,15,3,9
9,2004,730202,8,8,0,7
10,2004,730202,8,6,2,4
11,2004,730202,8,6,2,6
12,2004,730202,13,11,2,2
1,2005,730202,11,8,3,3
2,2005,730202,10,10,0,7
3,2005,730202,15,11,4,4
4,2005,730202,11,10,1,11
5,2005,730202,14,13,1,6
6,2005,730202,14,14,0,2
7,2005,730202,19,14,5,6
8,2005,730202,14,10,4,4
9,2005,730202,14,13,1,3
10,2005,730202,16,14,2,3
11,2005,730202,14,13,1,2
12,2005,730202,10,9,1,0
1,2006,730202,7,6,1,6
2,2006,730202,18,17,1,8
3,2006,730202,19,15,4,1
4,2006,730202,17,11,6,7
5,2006,730202,24,20,4,8
6,2006,730202,13,13,0,7
7,2006,730202,26,22,4,4
8,2006,730202,21,18,3,3
9,2006,730202,17,12,5,1
10,2006,730202,22,18,4,4
11,2006,730202,8,4,4,4
12,2006,730202,23,20,3,2
1,2007,730202,13,12,1,7
2,2007,730202,6,4,2,3
3,2007,730202,13,12,1,4
4,2007,730202,13,10,3,4
5,2007,730202,19,17,2,6
6,2007,730202,21,16,5,4
7,2007,730202,19,17,2,6
8,2007,730202,16,16,0,2
9,2007,730202,16,15,1,4
10,2007,730202,13,10,3,4
11,2007,730202,24,21,3,2
12,2007,730202,14,14,0,1
1,2008,730202,6,6,0,1
2,2008,730202,10,9,1,0
3,2008,730202,12,11,1,0
4,2008,730202,15,11,4,3
5,2008,730202,15,13,2,3
6,2008,730202,17,14,3,4
7,2008,730202,21,19,2,3
8,2008,730202,21,19,2,6
9,2008,730202,23,18,5,3
10,2008,730202,18,16,2,2
11,2008,730202,19,17,2,4
12,2008,730202,18,18,0,5
1,2009,730202,7,5,2,7
2,2009,730202,10,9,1,4
3,2009,730202,21,20,1,1
4,2009,730202,8,7,1,4
5,2009,730202,16,13,3,2
6,2009,730202,15,12,3,5
7,2009,730202,19,15,4,3
8,2009,730202,20,17,3,7
9,2009,730202,28,27,1,3
10,2009,730202,9,9,0,3
11,2009,730202,10,9,1,2
12,2009,730202,11,10,1,4
1,2010,730202,20,17,3,3
2,2010,730202,13,11,2,2
3,2010,730202,10,9,1,5
4,2010,730202,12,10,2,2
5,2010,730202,28,26,2,2
6,2010,730202,16,14,2,3
7,2010,730202,11,9,2,2
8,2010,730202,16,14,2,2
9,2010,730202,11,10,1,0
10,2010,730202,14,12,2,2
11,2010,730202,13,12,1,0
12,2010,730202,8,8,0,1
1,2011,730202,19,19,0,1
2,2011,730202,6,5,1,1
1,1999,730100,10,9,1,2
2,1999,730100,10,9,1,0
3,1999,730100,8,8,0,3
4,1999,730100,15,13,2,0
5,1999,730100,15,14,1,2
6,1999,730100,13,12,1,0
7,1999,730100,29,25,4,4
8,1999,730100,23,23,0,2
9,1999,730100,19,17,2,2
10,1999,730100,26,22,4,7
11,1999,730100,14,14,0,3
12,1999,730100,19,17,2,3
1,2000,730100,7,7,0,3
2,2000,730100,10,9,1,7
3,2000,730100,7,7,0,6
4,2000,730100,6,5,1,6
5,2000,730100,10,9,1,1
6,2000,730100,9,8,1,0
7,2000,730100,25,17,8,2
8,2000,730100,15,11,4,4
9,2000,730100,14,13,1,1
10,2000,730100,16,15,1,5
11,2000,730100,17,14,3,2
12,2000,730100,13,11,2,2
1,2001,730100,8,8,0,6
2,2001,730100,7,7,0,0
3,2001,730100,4,3,1,2
4,2001,730100,9,9,0,3
5,2001,730100,11,11,0,1
6,2001,730100,7,7,0,5
7,2001,730100,16,13,3,6
8,2001,730100,11,10,1,3
9,2001,730100,10,10,0,2
10,2001,730100,13,10,3,2
11,2001,730100,15,14,1,0
12,2001,730100,12,11,1,4
1,2002,730100,14,13,1,3
2,2002,730100,8,5,3,5
3,2002,730100,13,12,1,4
4,2002,730100,17,15,2,0
5,2002,730100,13,13,0,3
6,2002,730100,21,15,6,1
7,2002,730100,9,8,1,5
8,2002,730100,19,13,6,5
9,2002,730100,16,16,0,3
10,2002,730100,9,9,0,3
11,2002,730100,10,8,2,2
12,2002,730100,19,16,3,1
1,2003,730100,13,11,2,3
2,2003,730100,7,5,2,2
3,2003,730100,11,10,1,2
4,2003,730100,15,12,3,3
5,2003,730100,10,10,0,10
6,2003,730100,11,9,2,4
7,2003,730100,10,9,1,3
8,2003,730100,13,12,1,2
9,2003,730100,12,12,0,0
10,2003,730100,13,13,0,1
11,2003,730100,4,4,0,1
12,2003,730100,11,10,1,3
1,2004,730100,12,12,0,1
2,2004,730100,7,6,1,2
3,2004,730100,21,20,1,0
4,2004,730100,9,8,1,8
5,2004,730100,9,7,2,4
6,2004,730100,12,10,2,6
7,2004,730100,15,12,3,1
8,2004,730100,17,16,1,1
9,2004,730100,8,6,2,2
10,2004,730100,10,10,0,4
11,2004,730100,7,7,0,6
12,2004,730100,7,7,0,0
1,2005,730100,8,8,0,4
2,2005,730100,12,10,2,0
3,2005,730100,10,8,2,0
4,2005,730100,15,12,3,1
5,2005,730100,18,17,1,3
6,2005,730100,19,14,5,1
7,2005,730100,15,12,3,1
8,2005,730100,14,13,1,2
9,2005,730100,10,8,2,3
10,2005,730100,8,5,3,3
11,2005,730100,10,6,4,3
12,2005,730100,6,4,2,3
1,2006,730100,22,21,1,3
2,2006,730100,10,9,1,0
3,2006,730100,11,10,1,1
4,2006,730100,10,9,1,6
5,2006,730100,14,13,1,7
6,2006,730100,11,11,0,3
7,2006,730100,16,15,1,2
8,2006,730100,15,14,1,9
9,2006,730100,15,12,3,4
10,2006,730100,18,15,3,2
11,2006,730100,7,7,0,3
12,2006,730100,9,7,2,3
1,2007,730100,10,9,1,9
2,2007,730100,7,7,0,4
3,2007,730100,13,9,4,2
4,2007,730100,14,10,4,5
5,2007,730100,14,12,2,6
6,2007,730100,16,15,1,3
7,2007,730100,9,7,2,7
8,2007,730100,18,16,2,5
9,2007,730100,12,11,1,3
10,2007,730100,13,12,1,0
11,2007,730100,8,7,1,6
12,2007,730100,15,14,1,2
1,2008,730100,12,12,0,2
2,2008,730100,11,10,1,3
3,2008,730100,18,18,0,7
4,2008,730100,12,9,3,3
5,2008,730100,18,18,0,2
6,2008,730100,22,20,2,1
7,2008,730100,15,11,4,0
8,2008,730100,15,14,1,2
9,2008,730100,10,9,1,2
10,2008,730100,27,22,5,4
11,2008,730100,12,11,1,1
12,2008,730100,13,11,2,2
1,2009,730100,13,12,1,0
2,2009,730100,14,13,1,1
3,2009,730100,11,10,1,0
4,2009,730100,12,11,1,1
5,2009,730100,12,10,2,0
6,2009,730100,13,13,0,2
7,2009,730100,20,19,1,3
8,2009,730100,13,11,2,3
9,2009,730100,10,10,0,1
10,2009,730100,18,15,3,4
11,2009,730100,11,11,0,5
12,2009,730100,22,21,1,2
1,2010,730100,11,8,3,2
2,2010,730100,9,9,0,4
3,2010,730100,14,14,0,1
4,2010,730100,13,12,1,2
5,2010,730100,22,18,4,0
6,2010,730100,18,16,2,4
7,2010,730100,8,7,1,2
8,2010,730100,14,12,2,1
9,2010,730100,26,23,3,3
10,2010,730100,12,12,0,4
11,2010,730100,10,9,1,1
12,2010,730100,9,8,1,0
1,2011,730100,7,5,2,1
2,2011,730100,6,5,1,1
1,1999,480500,20,16,4,0
2,1999,480500,15,12,3,4
3,1999,480500,23,19,4,4
4,1999,480500,19,13,6,4
5,1999,480500,15,11,4,4
6,1999,480500,15,11,4,4
7,1999,480500,26,22,4,4
8,1999,480500,21,19,2,2
9,1999,480500,15,12,3,2
10,1999,480500,19,18,1,3
11,1999,480500,7,6,1,7
12,1999,480500,16,14,2,6
1,2000,480500,17,14,3,7
2,2000,480500,14,13,1,1
3,2000,480500,12,10,2,7
4,2000,480500,10,7,3,2
5,2000,480500,19,15,4,1
6,2000,480500,13,12,1,5
7,2000,480500,26,20,6,2
8,2000,480500,18,14,4,4
9,2000,480500,16,12,4,0
10,2000,480500,15,11,4,8
11,2000,480500,14,10,4,2
12,2000,480500,16,13,3,6
1,2001,480500,7,6,1,0
2,2001,480500,5,5,0,1
3,2001,480500,11,9,2,5
4,2001,480500,14,13,1,8
5,2001,480500,9,5,4,0
6,2001,480500,16,14,2,2
7,2001,480500,23,21,2,3
8,2001,480500,25,21,4,1
9,2001,480500,14,10,4,1
10,2001,480500,14,11,3,1
11,2001,480500,29,25,4,0
12,2001,480500,14,12,2,6
1,2002,480500,15,15,0,5
2,2002,480500,17,16,1,2
3,2002,480500,9,7,2,5
4,2002,480500,14,12,2,2
5,2002,480500,17,14,3,4
6,2002,480500,18,14,4,1
7,2002,480500,18,16,2,1
8,2002,480500,18,18,0,1
9,2002,480500,14,12,2,1
10,2002,480500,18,14,4,8
11,2002,480500,13,11,2,5
12,2002,480500,19,16,3,8
1,2003,480500,11,9,2,1
2,2003,480500,10,7,3,2
3,2003,480500,16,16,0,2
4,2003,480500,19,19,0,0
5,2003,480500,16,15,1,1
6,2003,480500,14,12,2,2
7,2003,480500,25,24,1,7
8,2003,480500,17,15,2,3
9,2003,480500,15,14,1,1
10,2003,480500,14,12,2,0
11,2003,480500,19,16,3,1
12,2003,480500,14,13,1,1
1,2004,480500,15,12,3,0
2,2004,480500,26,23,3,1
3,2004,480500,16,14,2,6
4,2004,480500,17,17,0,6
5,2004,480500,21,20,1,5
6,2004,480500,21,11,10,8
7,2004,480500,27,22,5,1
8,2004,480500,22,20,2,6
9,2004,480500,39,38,1,6
10,2004,480500,37,34,3,8
11,2004,480500,28,28,0,3
12,2004,480500,31,29,2,4
1,2005,480500,17,17,0,3
2,2005,480500,29,28,1,1
3,2005,480500,20,19,1,2
4,2005,480500,27,26,1,12
5,2005,480500,22,16,6,10
6,2005,480500,30,28,2,9
7,2005,480500,20,17,3,6
8,2005,480500,14,10,4,3
9,2005,480500,13,12,1,9
10,2005,480500,28,25,3,2
11,2005,480500,15,15,0,2
12,2005,480500,21,20,1,4
1,2006,480500,20,18,2,3
2,2006,480500,14,13,1,0
3,2006,480500,13,11,2,7
4,2006,480500,28,24,4,7
5,2006,480500,16,15,1,1
6,2006,480500,34,31,3,6
7,2006,480500,23,23,0,2
8,2006,480500,21,20,1,3
9,2006,480500,22,18,4,5
10,2006,480500,27,26,1,4
11,2006,480500,23,21,2,4
12,2006,480500,26,25,1,2
1,2007,480500,18,18,0,7
2,2007,480500,6,6,0,5
3,2007,480500,17,14,3,9
4,2007,480500,25,24,1,8
5,2007,480500,21,17,4,6
6,2007,480500,18,16,2,1
7,2007,480500,18,16,2,6
8,2007,480500,23,20,3,10
9,2007,480500,32,31,1,8
10,2007,480500,23,22,1,5
11,2007,480500,17,17,0,4
12,2007,480500,19,17,2,1
1,2008,480500,29,27,2,5
2,2008,480500,31,27,4,6
3,2008,480500,18,14,4,4
4,2008,480500,20,16,4,6
5,2008,480500,26,21,5,4
6,2008,480500,19,16,3,4
7,2008,480500,18,16,2,6
8,2008,480500,16,14,2,5
9,2008,480500,16,15,1,4
10,2008,480500,22,22,0,5
11,2008,480500,16,15,1,5
12,2008,480500,8,8,0,3
1,2009,480500,9,8,1,5
2,2009,480500,13,13,0,6
3,2009,480500,8,3,5,9
4,2009,480500,11,10,1,1
5,2009,480500,12,10,2,4
6,2009,480500,27,25,2,3
7,2009,480500,13,12,1,7
8,2009,480500,19,19,0,8
9,2009,480500,14,10,4,6
10,2009,480500,13,11,2,11
11,2009,480500,19,19,0,4
12,2009,480500,4,3,1,2
1,2010,480500,17,14,3,5
2,2010,480500,10,9,1,4
3,2010,480500,9,8,1,8
4,2010,480500,19,14,5,4
5,2010,480500,14,14,0,4
6,2010,480500,21,14,7,3
7,2010,480500,5,3,2,3
8,2010,480500,13,12,1,2
9,2010,480500,23,20,3,4
10,2010,480500,17,14,3,3
11,2010,480500,18,16,2,1
12,2010,480500,15,14,1,1
1,2011,480500,23,22,1,2
2,2011,480500,7,5,2,3
1,1999,730300,2,2,0,1
2,1999,730300,2,1,1,0
3,1999,730300,2,2,0,0
4,1999,730300,6,5,1,0
5,1999,730300,10,9,1,0
6,1999,730300,11,9,2,2
7,1999,730300,6,6,0,0
8,1999,730300,6,6,0,2
9,1999,730300,4,3,1,1
10,1999,730300,6,5,1,1
11,1999,730300,6,6,0,0
12,1999,730300,5,5,0,1
1,2000,730300,3,2,1,0
2,2000,730300,3,2,1,7
3,2000,730300,8,7,1,1
4,2000,730300,7,7,0,3
5,2000,730300,4,3,1,4
6,2000,730300,7,7,0,1
7,2000,730300,9,8,1,1
8,2000,730300,8,8,0,0
9,2000,730300,4,4,0,1
10,2000,730300,7,7,0,2
11,2000,730300,6,6,0,1
12,2000,730300,5,5,0,1
1,2001,730300,2,2,0,0
2,2001,730300,2,2,0,2
3,2001,730300,6,4,2,1
4,2001,730300,2,2,0,0
5,2001,730300,2,2,0,2
6,2001,730300,11,7,4,2
7,2001,730300,8,7,1,0
8,2001,730300,7,5,2,0
9,2001,730300,7,7,0,2
10,2001,730300,3,3,0,3
11,2001,730300,2,2,0,1
12,2001,730300,9,9,0,0
1,2002,730300,5,5,0,5
2,2002,730300,3,3,0,1
3,2002,730300,6,6,0,1
4,2002,730300,1,0,1,0
5,2002,730300,5,5,0,0
6,2002,730300,6,6,0,0
7,2002,730300,7,6,1,1
8,2002,730300,12,11,1,1
9,2002,730300,7,7,0,1
10,2002,730300,4,4,0,2
11,2002,730300,5,5,0,0
12,2002,730300,7,7,0,0
1,2003,730300,2,2,0,1
2,2003,730300,4,4,0,0
3,2003,730300,6,4,2,1
4,2003,730300,10,8,2,4
5,2003,730300,2,1,1,0
6,2003,730300,3,2,1,1
7,2003,730300,5,5,0,0
8,2003,730300,2,1,1,0
9,2003,730300,3,3,0,2
10,2003,730300,2,2,0,0
11,2003,730300,4,4,0,2
12,2003,730300,4,3,1,0
1,2004,730300,4,4,0,2
2,2004,730300,3,3,0,0
3,2004,730300,5,5,0,0
4,2004,730300,7,7,0,3
5,2004,730300,5,4,1,1
6,2004,730300,5,4,1,0
7,2004,730300,4,4,0,1
8,2004,730300,5,4,1,2
9,2004,730300,4,4,0,0
10,2004,730300,9,9,0,0
11,2004,730300,3,2,1,0
12,2004,730300,3,3,0,0
1,2005,730300,7,7,0,0
2,2005,730300,1,1,0,2
3,2005,730300,4,4,0,3
4,2005,730300,4,4,0,0
5,2005,730300,4,4,0,0
6,2005,730300,3,3,0,0
7,2005,730300,2,1,1,2
8,2005,730300,5,3,2,2
9,2005,730300,5,3,2,0
10,2005,730300,2,2,0,1
11,2005,730300,7,7,0,2
12,2005,730300,3,3,0,0
1,2006,730300,2,2,0,0
2,2006,730300,5,5,0,0
3,2006,730300,3,2,1,0
4,2006,730300,12,11,1,0
5,2006,730300,6,6,0,3
6,2006,730300,6,5,1,1
7,2006,730300,3,2,1,1
8,2006,730300,4,4,0,4
9,2006,730300,4,3,1,1
10,2006,730300,7,6,1,1
11,2006,730300,5,4,1,2
12,2006,730300,2,2,0,0
1,2007,730300,7,7,0,1
2,2007,730300,1,1,0,0
3,2007,730300,2,2,0,0
4,2007,730300,6,5,1,2
5,2007,730300,7,6,1,1
6,2007,730300,16,15,1,1
7,2007,730300,5,5,0,4
8,2007,730300,14,12,2,0
9,2007,730300,9,6,3,1
10,2007,730300,15,11,4,6
11,2007,730300,10,10,0,1
12,2007,730300,4,4,0,0
1,2008,730300,2,2,0,0
2,2008,730300,6,6,0,4
3,2008,730300,4,4,0,0
4,2008,730300,6,5,1,1
5,2008,730300,7,7,0,0
6,2008,730300,10,10,0,1
7,2008,730300,9,9,0,0
8,2008,730300,5,5,0,0
9,2008,730300,5,5,0,1
10,2008,730300,5,3,2,1
11,2008,730300,7,6,1,2
12,2008,730300,3,2,1,1
1,2009,730300,2,2,0,3
2,2009,730300,3,3,0,0
3,2009,730300,4,4,0,2
4,2009,730300,4,2,2,4
5,2009,730300,3,2,1,1
6,2009,730300,3,3,0,2
7,2009,730300,5,4,1,0
8,2009,730300,11,8,3,4
9,2009,730300,6,6,0,2
10,2009,730300,8,6,2,1
11,2009,730300,7,6,1,1
12,2009,730300,6,6,0,1
1,2010,730300,2,2,0,1
2,2010,730300,3,3,0,1
3,2010,730300,6,5,1,0
4,2010,730300,12,10,2,2
5,2010,730300,8,7,1,2
6,2010,730300,4,4,0,2
7,2010,730300,8,7,1,0
8,2010,730300,14,14,0,0
9,2010,730300,4,4,0,0
10,2010,730300,9,9,0,4
11,2010,730300,7,6,1,1
12,2010,730300,11,11,0,0
1,2011,730300,5,4,1,0
2,2011,730300,6,6,0,0
1,1999,834000,23,15,8,5
2,1999,834000,14,11,3,4
3,1999,834000,15,13,2,3
4,1999,834000,20,16,4,0
5,1999,834000,19,14,5,5
6,1999,834000,20,14,6,3
7,1999,834000,23,20,3,3
8,1999,834000,22,20,2,3
9,1999,834000,29,23,6,12
10,1999,834000,17,15,2,8
11,1999,834000,11,11,0,9
12,1999,834000,34,31,3,6
1,2000,834000,13,11,2,3
2,2000,834000,13,12,1,2
3,2000,834000,8,7,1,4
4,2000,834000,26,26,0,6
5,2000,834000,17,12,5,4
6,2000,834000,17,16,1,6
7,2000,834000,37,31,6,3
8,2000,834000,19,15,4,11
9,2000,834000,30,22,8,6
10,2000,834000,24,21,3,9
11,2000,834000,21,20,1,6
12,2000,834000,14,13,1,4
1,2001,834000,10,7,3,8
2,2001,834000,11,10,1,5
3,2001,834000,11,10,1,0
4,2001,834000,14,12,2,4
5,2001,834000,20,8,12,2
6,2001,834000,20,17,3,10
7,2001,834000,21,19,2,5
8,2001,834000,25,20,5,9
9,2001,834000,15,13,2,11
10,2001,834000,20,17,3,3
11,2001,834000,17,15,2,5
12,2001,834000,27,23,4,9
1,2002,834000,21,20,1,2
2,2002,834000,15,14,1,9
3,2002,834000,18,17,1,6
4,2002,834000,12,10,2,7
5,2002,834000,20,18,2,3
6,2002,834000,16,13,3,4
7,2002,834000,17,13,4,10
8,2002,834000,28,18,10,14
9,2002,834000,17,14,3,5
10,2002,834000,14,14,0,8
11,2002,834000,24,22,2,9
12,2002,834000,15,12,3,21
1,2003,834000,14,11,3,7
2,2003,834000,19,14,5,7
3,2003,834000,18,16,2,6
4,2003,834000,18,13,5,5
5,2003,834000,18,14,4,13
6,2003,834000,8,7,1,5
7,2003,834000,24,20,4,7
8,2003,834000,14,10,4,9
9,2003,834000,19,15,4,13
10,2003,834000,14,12,2,30
11,2003,834000,13,11,2,26
12,2003,834000,17,12,5,26
1,2004,834000,15,13,2,8
2,2004,834000,15,12,3,5
3,2004,834000,14,12,2,4
4,2004,834000,13,10,3,11
5,2004,834000,16,12,4,28
6,2004,834000,18,15,3,3
7,2004,834000,11,9,2,5
8,2004,834000,25,19,6,8
9,2004,834000,15,12,3,23
10,2004,834000,9,8,1,23
11,2004,834000,7,6,1,18
12,2004,834000,14,11,3,7
1,2005,834000,17,15,2,3
2,2005,834000,11,11,0,3
3,2005,834000,15,12,3,5
4,2005,834000,12,8,4,2
5,2005,834000,15,13,2,6
6,2005,834000,17,15,2,2
7,2005,834000,17,15,2,8
8,2005,834000,20,18,2,10
9,2005,834000,10,9,1,2
10,2005,834000,10,8,2,7
11,2005,834000,15,11,4,6
12,2005,834000,12,12,0,6
1,2006,834000,14,11,3,5
2,2006,834000,10,9,1,7
3,2006,834000,9,8,1,5
4,2006,834000,16,10,6,4
5,2006,834000,15,12,3,0
6,2006,834000,18,16,2,5
7,2006,834000,11,9,2,5
8,2006,834000,15,12,3,2
9,2006,834000,20,20,0,5
10,2006,834000,22,19,3,8
11,2006,834000,11,10,1,10
12,2006,834000,10,8,2,4
1,2007,834000,15,11,4,6
2,2007,834000,14,14,0,11
3,2007,834000,9,8,1,12
4,2007,834000,15,14,1,5
5,2007,834000,12,9,3,5
6,2007,834000,19,14,5,8
7,2007,834000,19,15,4,9
8,2007,834000,27,24,3,12
9,2007,834000,13,9,4,9
10,2007,834000,22,15,7,11
11,2007,834000,10,9,1,12
12,2007,834000,13,12,1,11
1,2008,834000,25,23,2,14
2,2008,834000,16,15,1,8
3,2008,834000,6,2,4,19
4,2008,834000,12,8,4,8
5,2008,834000,9,7,2,5
6,2008,834000,18,14,4,7
7,2008,834000,35,28,7,14
8,2008,834000,15,11,4,9
9,2008,834000,16,13,3,17
10,2008,834000,17,14,3,7
11,2008,834000,19,17,2,8
12,2008,834000,22,19,3,5
1,2009,834000,17,14,3,9
2,2009,834000,12,12,0,7
3,2009,834000,10,9,1,5
4,2009,834000,15,11,4,8
5,2009,834000,5,4,1,3
6,2009,834000,14,11,3,2
7,2009,834000,18,16,2,5
8,2009,834000,11,8,3,7
9,2009,834000,10,8,2,1
10,2009,834000,14,14,0,9
11,2009,834000,19,17,2,10
12,2009,834000,12,9,3,3
1,2010,834000,15,13,2,6
2,2010,834000,13,10,3,2
3,2010,834000,22,18,4,6
4,2010,834000,19,15,4,6
5,2010,834000,21,21,0,4
6,2010,834000,15,10,5,3
7,2010,834000,12,10,2,6
8,2010,834000,20,17,3,4
9,2010,834000,14,12,2,5
10,2010,834000,16,13,3,4
11,2010,834000,21,20,1,13
12,2010,834000,12,11,1,3
1,2011,834000,16,14,2,7
2,2011,834000,5,5,0,4
1,1999,490400,4,4,0,0
2,1999,490400,3,2,1,0
3,1999,490400,3,1,2,0
4,1999,490400,0,0,0,0
5,1999,490400,8,8,0,0
6,1999,490400,1,1,0,0
7,1999,490400,4,4,0,0
8,1999,490400,6,6,0,0
9,1999,490400,4,3,1,0
10,1999,490400,8,7,1,0
11,1999,490400,4,4,0,0
12,1999,490400,8,8,0,0
1,2000,490400,9,8,1,0
2,2000,490400,3,3,0,0
3,2000,490400,8,8,0,0
4,2000,490400,6,6,0,2
5,2000,490400,5,3,2,0
6,2000,490400,6,6,0,2
7,2000,490400,4,2,2,0
8,2000,490400,7,7,0,0
9,2000,490400,5,3,2,1
10,2000,490400,7,6,1,0
11,2000,490400,6,4,2,0
12,2000,490400,5,5,0,0
1,2001,490400,4,3,1,0
2,2001,490400,6,4,2,0
3,2001,490400,3,1,2,1
4,2001,490400,4,3,1,0
5,2001,490400,6,6,0,0
6,2001,490400,5,4,1,0
7,2001,490400,3,2,1,2
8,2001,490400,10,8,2,1
9,2001,490400,9,7,2,0
10,2001,490400,8,8,0,0
11,2001,490400,6,5,1,2
12,2001,490400,8,8,0,0
1,2002,490400,4,3,1,0
2,2002,490400,3,3,0,0
3,2002,490400,3,3,0,0
4,2002,490400,1,0,1,0
5,2002,490400,10,6,4,0
6,2002,490400,2,2,0,1
7,2002,490400,6,5,1,2
8,2002,490400,2,2,0,0
9,2002,490400,10,5,5,1
10,2002,490400,9,9,0,0
11,2002,490400,8,8,0,4
12,2002,490400,2,2,0,0
1,2003,490400,0,0,0,0
2,2003,490400,3,3,0,0
3,2003,490400,2,2,0,2
4,2003,490400,2,1,1,2
5,2003,490400,9,4,5,1
6,2003,490400,1,1,0,2
7,2003,490400,2,2,0,4
8,2003,490400,3,3,0,0
9,2003,490400,6,2,4,3
10,2003,490400,6,5,1,2
11,2003,490400,2,1,1,0
12,2003,490400,5,4,1,0
1,2004,490400,3,2,1,0
2,2004,490400,2,2,0,0
3,2004,490400,5,5,0,0
4,2004,490400,0,0,0,0
5,2004,490400,0,0,0,0
6,2004,490400,5,4,1,2
7,2004,490400,1,1,0,1
8,2004,490400,2,1,1,2
9,2004,490400,0,0,0,2
10,2004,490400,8,7,1,4
11,2004,490400,4,4,0,0
12,2004,490400,3,3,0,3
1,2005,490400,6,5,1,0
2,2005,490400,7,6,1,0
3,2005,490400,4,3,1,0
4,2005,490400,5,5,0,4
5,2005,490400,5,5,0,2
6,2005,490400,3,2,1,0
7,2005,490400,4,4,0,2
8,2005,490400,6,5,1,3
9,2005,490400,6,6,0,0
10,2005,490400,7,7,0,3
11,2005,490400,3,1,2,4
12,2005,490400,3,2,1,0
1,2006,490400,5,5,0,1
2,2006,490400,1,1,0,2
3,2006,490400,5,5,0,2
4,2006,490400,1,1,0,0
5,2006,490400,2,2,0,2
6,2006,490400,7,7,0,4
7,2006,490400,7,4,3,6
8,2006,490400,4,3,1,1
9,2006,490400,1,1,0,10
10,2006,490400,7,7,0,3
11,2006,490400,0,0,0,1
12,2006,490400,1,1,0,5
1,2007,490400,3,3,0,1
2,2007,490400,4,4,0,0
3,2007,490400,3,2,1,4
4,2007,490400,2,2,0,3
5,2007,490400,4,3,1,3
6,2007,490400,3,3,0,3
7,2007,490400,2,2,0,0
8,2007,490400,4,4,0,1
9,2007,490400,3,3,0,1
10,2007,490400,4,3,1,2
11,2007,490400,5,5,0,0
12,2007,490400,7,6,1,0
1,2008,490400,7,6,1,1
2,2008,490400,4,3,1,2
3,2008,490400,2,1,1,2
4,2008,490400,1,1,0,0
5,2008,490400,4,3,1,1
6,2008,490400,4,4,0,1
7,2008,490400,4,4,0,1
8,2008,490400,4,3,1,1
9,2008,490400,2,2,0,3
10,2008,490400,3,2,1,2
11,2008,490400,3,2,1,1
12,2008,490400,5,5,0,1
1,2009,490400,1,1,0,4
2,2009,490400,3,2,1,1
3,2009,490400,2,2,0,1
4,2009,490400,5,4,1,1
5,2009,490400,5,4,1,1
6,2009,490400,3,3,0,2
7,2009,490400,2,2,0,3
8,2009,490400,4,3,1,3
9,2009,490400,5,4,1,2
10,2009,490400,4,3,1,3
11,2009,490400,7,6,1,0
12,2009,490400,2,2,0,0
1,2010,490400,2,2,0,1
2,2010,490400,2,1,1,1
3,2010,490400,6,6,0,1
4,2010,490400,1,1,0,0
5,2010,490400,7,7,0,4
6,2010,490400,4,4,0,2
7,2010,490400,2,2,0,0
8,2010,490400,4,3,1,0
9,2010,490400,3,3,0,1
10,2010,490400,3,3,0,0
11,2010,490400,3,3,0,1
12,2010,490400,6,5,1,0
1,2011,490400,2,2,0,0
2,2011,490400,1,0,1,0
1,1999,490300,14,12,2,1
2,1999,490300,11,9,2,1
3,1999,490300,12,9,3,2
4,1999,490300,13,10,3,5
5,1999,490300,12,9,3,2
6,1999,490300,16,12,4,1
7,1999,490300,21,19,2,3
8,1999,490300,21,18,3,3
9,1999,490300,18,16,2,2
10,1999,490300,17,15,2,2
11,1999,490300,7,6,1,3
12,1999,490300,13,11,2,1
1,2000,490300,14,13,1,2
2,2000,490300,14,12,2,3
3,2000,490300,19,17,2,1
4,2000,490300,11,11,0,1
5,2000,490300,15,11,4,4
6,2000,490300,13,13,0,1
7,2000,490300,26,25,1,1
8,2000,490300,23,20,3,0
9,2000,490300,12,11,1,1
10,2000,490300,23,20,3,0
11,2000,490300,22,17,5,1
12,2000,490300,9,8,1,1
1,2001,490300,13,10,3,1
2,2001,490300,10,9,1,4
3,2001,490300,14,11,3,0
4,2001,490300,8,7,1,1
5,2001,490300,14,12,2,0
6,2001,490300,8,7,1,0
7,2001,490300,17,15,2,0
8,2001,490300,23,21,2,2
9,2001,490300,17,16,1,2
10,2001,490300,18,16,2,1
11,2001,490300,16,12,4,1
12,2001,490300,10,10,0,0
1,2002,490300,10,9,1,0
2,2002,490300,15,13,2,0
3,2002,490300,11,11,0,3
4,2002,490300,15,12,3,1
5,2002,490300,14,10,4,1
6,2002,490300,10,9,1,0
7,2002,490300,22,20,2,1
8,2002,490300,14,12,2,1
9,2002,490300,13,12,1,1
10,2002,490300,19,14,5,2
11,2002,490300,11,11,0,1
12,2002,490300,12,10,2,0
1,2003,490300,15,12,3,2
2,2003,490300,11,8,3,2
3,2003,490300,11,10,1,1
4,2003,490300,8,8,0,1
5,2003,490300,20,15,5,2
6,2003,490300,16,14,2,2
7,2003,490300,22,18,4,1
8,2003,490300,14,11,3,0
9,2003,490300,16,13,3,3
10,2003,490300,13,12,1,1
11,2003,490300,11,6,5,0
12,2003,490300,9,7,2,0
1,2004,490300,11,10,1,1
2,2004,490300,5,3,2,0
3,2004,490300,21,20,1,2
4,2004,490300,12,10,2,1
5,2004,490300,17,15,2,1
6,2004,490300,11,6,5,3
7,2004,490300,10,10,0,3
8,2004,490300,17,14,3,1
9,2004,490300,19,19,0,2
10,2004,490300,13,10,3,0
11,2004,490300,13,12,1,1
12,2004,490300,6,4,2,1
1,2005,490300,13,12,1,1
2,2005,490300,16,14,2,7
3,2005,490300,14,12,2,0
4,2005,490300,12,11,1,3
5,2005,490300,13,9,4,5
6,2005,490300,11,10,1,2
7,2005,490300,15,14,1,9
8,2005,490300,12,12,0,1
9,2005,490300,6,5,1,2
10,2005,490300,11,8,3,3
11,2005,490300,11,8,3,2
12,2005,490300,14,14,0,0
1,2006,490300,7,7,0,4
2,2006,490300,17,17,0,2
3,2006,490300,16,11,5,3
4,2006,490300,6,5,1,2
5,2006,490300,12,11,1,0
6,2006,490300,13,12,1,2
7,2006,490300,20,16,4,1
8,2006,490300,10,10,0,5
9,2006,490300,18,18,0,4
10,2006,490300,15,13,2,5
11,2006,490300,11,10,1,1
12,2006,490300,13,13,0,6
1,2007,490300,6,4,2,11
2,2007,490300,6,5,1,6
3,2007,490300,12,10,2,5
4,2007,490300,3,3,0,3
5,2007,490300,10,8,2,1
6,2007,490300,11,10,1,4
7,2007,490300,18,14,4,10
8,2007,490300,10,9,1,3
9,2007,490300,11,7,4,9
10,2007,490300,17,13,4,7
11,2007,490300,9,8,1,3
12,2007,490300,11,11,0,5
1,2008,490300,16,15,1,9
2,2008,490300,13,10,3,10
3,2008,490300,13,13,0,12
4,2008,490300,10,10,0,0
5,2008,490300,17,16,1,3
6,2008,490300,9,7,2,7
7,2008,490300,27,22,5,6
8,2008,490300,24,23,1,5
9,2008,490300,16,16,0,5
10,2008,490300,14,13,1,5
11,2008,490300,7,6,1,3
12,2008,490300,9,9,0,8
1,2009,490300,14,13,1,6
2,2009,490300,6,6,0,4
3,2009,490300,12,11,1,6
4,2009,490300,10,7,3,3
5,2009,490300,8,7,1,2
6,2009,490300,13,10,3,0
7,2009,490300,15,11,4,5
8,2009,490300,18,15,3,2
9,2009,490300,11,9,2,3
10,2009,490300,10,9,1,4
11,2009,490300,15,14,1,5
12,2009,490300,9,7,2,7
1,2010,490300,7,6,1,1
2,2010,490300,7,6,1,4
3,2010,490300,19,19,0,9
4,2010,490300,19,18,1,2
5,2010,490300,17,16,1,4
6,2010,490300,14,13,1,7
7,2010,490300,15,14,1,3
8,2010,490300,10,9,1,1
9,2010,490300,10,9,1,5
10,2010,490300,20,16,4,7
11,2010,490300,12,12,0,5
12,2010,490300,11,9,2,4
1,2011,490300,10,8,2,6
2,2011,490300,2,2,0,5
1,1999,440900,9,7,2,1
2,1999,440900,17,13,4,2
3,1999,440900,21,17,4,1
4,1999,440900,11,9,2,1
5,1999,440900,19,13,6,1
6,1999,440900,22,18,4,4
7,1999,440900,14,8,6,3
8,1999,440900,15,12,3,3
9,1999,440900,15,14,1,15
10,1999,440900,14,10,4,2
11,1999,440900,11,9,2,1
12,1999,440900,14,9,5,6
1,2000,440900,9,8,1,8
2,2000,440900,17,17,0,2
3,2000,440900,27,17,10,3
4,2000,440900,16,12,4,2
5,2000,440900,14,12,2,6
6,2000,440900,13,11,2,9
7,2000,440900,15,12,3,1
8,2000,440900,16,12,4,2
9,2000,440900,15,12,3,3
10,2000,440900,10,9,1,1
11,2000,440900,14,12,2,2
12,2000,440900,11,9,2,0
1,2001,440900,6,6,0,0
2,2001,440900,8,7,1,3
3,2001,440900,10,9,1,1
4,2001,440900,11,8,3,4
5,2001,440900,7,3,4,3
6,2001,440900,12,7,5,1
7,2001,440900,22,14,8,1
8,2001,440900,14,14,0,0
9,2001,440900,12,9,3,4
10,2001,440900,11,11,0,1
11,2001,440900,13,12,1,3
12,2001,440900,10,7,3,2
1,2002,440900,13,12,1,0
2,2002,440900,5,5,0,1
3,2002,440900,8,8,0,1
4,2002,440900,23,13,10,3
5,2002,440900,7,5,2,1
6,2002,440900,13,8,5,2
7,2002,440900,17,14,3,0
8,2002,440900,11,9,2,2
9,2002,440900,10,7,3,4
10,2002,440900,15,12,3,1
11,2002,440900,8,7,1,4
12,2002,440900,17,15,2,1
1,2003,440900,6,5,1,0
2,2003,440900,7,5,2,0
3,2003,440900,13,10,3,1
4,2003,440900,10,9,1,0
5,2003,440900,18,14,4,5
6,2003,440900,16,13,3,0
7,2003,440900,14,9,5,4
8,2003,440900,14,10,4,4
9,2003,440900,18,12,6,7
10,2003,440900,10,9,1,3
11,2003,440900,8,5,3,1
12,2003,440900,15,13,2,0
1,2004,440900,11,8,3,0
2,2004,440900,13,10,3,0
3,2004,440900,10,7,3,2
4,2004,440900,20,13,7,5
5,2004,440900,17,14,3,5
6,2004,440900,11,10,1,4
7,2004,440900,25,24,1,3
8,2004,440900,21,17,4,5
9,2004,440900,20,15,5,1
10,2004,440900,11,11,0,2
11,2004,440900,14,12,2,1
12,2004,440900,9,8,1,2
1,2005,440900,11,9,2,2
2,2005,440900,8,7,1,0
3,2005,440900,15,14,1,2
4,2005,440900,16,14,2,8
5,2005,440900,11,11,0,1
6,2005,440900,12,7,5,1
7,2005,440900,11,9,2,6
8,2005,440900,19,14,5,3
9,2005,440900,14,13,1,0
10,2005,440900,21,19,2,3
11,2005,440900,10,9,1,3
12,2005,440900,11,11,0,0
1,2006,440900,12,11,1,2
2,2006,440900,7,7,0,1
3,2006,440900,12,11,1,1
4,2006,440900,12,10,2,1
5,2006,440900,6,3,3,2
6,2006,440900,15,11,4,1
7,2006,440900,16,16,0,3
8,2006,440900,12,7,5,3
9,2006,440900,16,12,4,7
10,2006,440900,8,5,3,0
11,2006,440900,17,12,5,3
12,2006,440900,12,11,1,3
1,2007,440900,7,7,0,1
2,2007,440900,3,2,1,0
3,2007,440900,14,10,4,3
4,2007,440900,10,7,3,1
5,2007,440900,14,11,3,11
6,2007,440900,10,9,1,2
7,2007,440900,13,8,5,6
8,2007,440900,13,9,4,7
9,2007,440900,12,6,6,4
10,2007,440900,9,9,0,2
11,2007,440900,13,10,3,6
12,2007,440900,19,15,4,0
1,2008,440900,17,15,2,2
2,2008,440900,16,15,1,1
3,2008,440900,8,7,1,4
4,2008,440900,14,12,2,3
5,2008,440900,10,7,3,6
6,2008,440900,9,4,5,4
7,2008,440900,12,9,3,2
8,2008,440900,10,5,5,2
9,2008,440900,14,11,3,0
10,2008,440900,12,8,4,1
11,2008,440900,15,14,1,1
12,2008,440900,8,6,2,0
1,2009,440900,8,6,2,4
2,2009,440900,12,7,5,3
3,2009,440900,9,9,0,3
4,2009,440900,10,9,1,0
5,2009,440900,16,14,2,2
6,2009,440900,8,6,2,1
7,2009,440900,16,12,4,2
8,2009,440900,15,13,2,2
9,2009,440900,19,13,6,0
10,2009,440900,9,9,0,1
11,2009,440900,17,14,3,3
12,2009,440900,10,8,2,3
1,2010,440900,12,10,2,1
2,2010,440900,5,3,2,2
3,2010,440900,13,12,1,1
4,2010,440900,16,12,4,3
5,2010,440900,3,2,1,3
6,2010,440900,7,6,1,0
7,2010,440900,19,12,7,3
8,2010,440900,8,6,2,3
9,2010,440900,17,16,1,1
10,2010,440900,6,4,2,2
11,2010,440900,6,6,0,2
12,2010,440900,18,17,1,0
1,2011,440900,15,14,1,2
2,2011,440900,5,4,1,0
1,1999,440800,6,5,1,0
2,1999,440800,4,1,3,0
3,1999,440800,8,6,2,0
4,1999,440800,5,3,2,2
5,1999,440800,4,4,0,0
6,1999,440800,6,4,2,3
7,1999,440800,4,2,2,0
8,1999,440800,2,2,0,3
9,1999,440800,4,4,0,2
10,1999,440800,5,4,1,2
11,1999,440800,7,5,2,1
12,1999,440800,6,6,0,2
1,2000,440800,4,3,1,0
2,2000,440800,11,8,3,0
3,2000,440800,6,3,3,2
4,2000,440800,7,5,2,1
5,2000,440800,5,5,0,0
6,2000,440800,8,5,3,1
7,2000,440800,8,7,1,2
8,2000,440800,10,7,3,0
9,2000,440800,16,12,4,0
10,2000,440800,7,7,0,1
11,2000,440800,10,7,3,0
12,2000,440800,7,4,3,1
1,2001,440800,11,9,2,0
2,2001,440800,3,3,0,4
3,2001,440800,4,3,1,1
4,2001,440800,9,6,3,3
5,2001,440800,4,3,1,2
6,2001,440800,7,7,0,4
7,2001,440800,12,11,1,3
8,2001,440800,13,9,4,2
9,2001,440800,4,3,1,2
10,2001,440800,10,9,1,1
11,2001,440800,9,8,1,0
12,2001,440800,7,7,0,0
1,2002,440800,4,4,0,1
2,2002,440800,4,4,0,2
3,2002,440800,7,6,1,1
4,2002,440800,4,2,2,0
5,2002,440800,11,9,2,0
6,2002,440800,13,10,3,0
7,2002,440800,15,9,6,1
8,2002,440800,12,9,3,2
9,2002,440800,13,12,1,0
10,2002,440800,15,15,0,1
11,2002,440800,8,7,1,4
12,2002,440800,11,9,2,2
1,2003,440800,10,8,2,0
2,2003,440800,7,6,1,1
3,2003,440800,16,15,1,1
4,2003,440800,15,13,2,2
5,2003,440800,11,8,3,4
6,2003,440800,22,16,6,4
7,2003,440800,13,10,3,6
8,2003,440800,27,18,9,1
9,2003,440800,13,10,3,8
10,2003,440800,9,7,2,6
11,2003,440800,14,13,1,7
12,2003,440800,10,8,2,1
1,2004,440800,8,6,2,2
2,2004,440800,17,13,4,1
3,2004,440800,20,16,4,2
4,2004,440800,14,14,0,3
5,2004,440800,18,14,4,1
6,2004,440800,16,15,1,2
7,2004,440800,17,14,3,6
8,2004,440800,17,16,1,2
9,2004,440800,13,9,4,1
10,2004,440800,17,17,0,3
11,2004,440800,7,5,2,3
12,2004,440800,19,14,5,1
1,2005,440800,10,10,0,0
2,2005,440800,18,14,4,2
3,2005,440800,17,13,4,1
4,2005,440800,9,7,2,7
5,2005,440800,12,9,3,3
6,2005,440800,14,11,3,2
7,2005,440800,19,14,5,1
8,2005,440800,9,9,0,1
9,2005,440800,19,15,4,3
10,2005,440800,15,11,4,4
11,2005,440800,10,10,0,0
12,2005,440800,8,6,2,3
1,2006,440800,13,10,3,4
2,2006,440800,8,6,2,2
3,2006,440800,9,6,3,8
4,2006,440800,13,9,4,4
5,2006,440800,13,10,3,5
6,2006,440800,18,14,4,2
7,2006,440800,14,11,3,2
8,2006,440800,12,8,4,2
9,2006,440800,10,5,5,8
10,2006,440800,18,15,3,1
11,2006,440800,15,13,2,15
12,2006,440800,17,11,6,11
1,2007,440800,13,10,3,11
2,2007,440800,6,4,2,4
3,2007,440800,5,2,3,6
4,2007,440800,12,10,2,15
5,2007,440800,14,13,1,16
6,2007,440800,15,9,6,7
7,2007,440800,20,15,5,7
8,2007,440800,20,16,4,3
9,2007,440800,13,11,2,9
10,2007,440800,20,14,6,2
11,2007,440800,11,8,3,5
12,2007,440800,20,16,4,6
1,2008,440800,10,7,3,2
2,2008,440800,15,12,3,5
3,2008,440800,13,10,3,7
4,2008,440800,14,10,4,11
5,2008,440800,12,9,3,4
6,2008,440800,16,12,4,11
7,2008,440800,9,9,0,4
8,2008,440800,13,12,1,4
9,2008,440800,13,10,3,6
10,2008,440800,8,6,2,2
11,2008,440800,13,10,3,7
12,2008,440800,7,5,2,5
1,2009,440800,4,2,2,10
2,2009,440800,2,1,1,9
3,2009,440800,13,7,6,10
4,2009,440800,7,4,3,8
5,2009,440800,11,10,1,7
6,2009,440800,10,5,5,11
7,2009,440800,16,13,3,6
8,2009,440800,16,9,7,2
9,2009,440800,15,14,1,3
10,2009,440800,11,11,0,2
11,2009,440800,11,9,2,5
12,2009,440800,11,10,1,7
1,2010,440800,17,15,2,6
2,2010,440800,10,9,1,1
3,2010,440800,7,6,1,8
4,2010,440800,7,6,1,4
5,2010,440800,8,7,1,6
6,2010,440800,9,8,1,2
7,2010,440800,4,4,0,2
8,2010,440800,9,8,1,4
9,2010,440800,9,7,2,3
10,2010,440800,17,14,3,4
11,2010,440800,16,14,2,3
12,2010,440800,4,3,1,2
1,2011,440800,10,5,5,1
2,2011,440800,7,6,1,2
1,1999,470100,19,15,4,4
2,1999,470100,14,11,3,9
3,1999,470100,28,23,5,1
4,1999,470100,14,10,4,2
5,1999,470100,20,12,8,1
6,1999,470100,24,19,5,2
7,1999,470100,19,14,5,2
8,1999,470100,24,20,4,0
9,1999,470100,13,9,4,4
10,1999,470100,20,15,5,3
11,1999,470100,18,12,6,5
12,1999,470100,15,10,5,4
1,2000,470100,13,10,3,3
2,2000,470100,14,10,4,7
3,2000,470100,19,11,8,3
4,2000,470100,16,9,7,6
5,2000,470100,13,7,6,8
6,2000,470100,26,15,11,9
7,2000,470100,17,11,6,14
8,2000,470100,27,25,2,7
9,2000,470100,21,17,4,7
10,2000,470100,13,7,6,15
11,2000,470100,16,12,4,5
12,2000,470100,20,15,5,6
1,2001,470100,17,13,4,15
2,2001,470100,9,7,2,7
3,2001,470100,24,21,3,4
4,2001,470100,21,18,3,5
5,2001,470100,20,13,7,8
6,2001,470100,21,12,9,3
7,2001,470100,33,22,11,10
8,2001,470100,31,22,9,3
9,2001,470100,25,17,8,6
10,2001,470100,25,19,6,4
11,2001,470100,25,22,3,10
12,2001,470100,16,15,1,8
1,2002,470100,15,10,5,11
2,2002,470100,13,11,2,4
3,2002,470100,18,14,4,4
4,2002,470100,30,23,7,7
5,2002,470100,26,21,5,7
6,2002,470100,29,26,3,3
7,2002,470100,25,19,6,9
8,2002,470100,18,13,5,11
9,2002,470100,13,10,3,2
10,2002,470100,20,17,3,3
11,2002,470100,20,15,5,7
12,2002,470100,17,16,1,5
1,2003,470100,20,18,2,9
2,2003,470100,15,13,2,6
3,2003,470100,20,14,6,1
4,2003,470100,20,16,4,3
5,2003,470100,33,24,9,2
6,2003,470100,14,9,5,12
7,2003,470100,25,18,7,4
8,2003,470100,35,27,8,2
9,2003,470100,20,20,0,5
10,2003,470100,15,12,3,4
11,2003,470100,25,23,2,14
12,2003,470100,19,15,4,15
1,2004,470100,19,14,5,9
2,2004,470100,18,15,3,7
3,2004,470100,10,10,0,10
4,2004,470100,27,22,5,11
5,2004,470100,23,21,2,8
6,2004,470100,20,11,9,6
7,2004,470100,24,20,4,3
8,2004,470100,25,22,3,20
9,2004,470100,39,31,8,8
10,2004,470100,30,26,4,5
11,2004,470100,18,14,4,17
12,2004,470100,25,21,4,11
1,2005,470100,24,17,7,13
2,2005,470100,11,9,2,11
3,2005,470100,19,16,3,4
4,2005,470100,27,19,8,8
5,2005,470100,34,27,7,9
6,2005,470100,20,15,5,7
7,2005,470100,23,16,7,6
8,2005,470100,17,14,3,5
9,2005,470100,17,14,3,5
10,2005,470100,24,21,3,6
11,2005,470100,9,8,1,16
12,2005,470100,15,12,3,6
1,2006,470100,7,6,1,4
2,2006,470100,14,12,2,1
3,2006,470100,20,17,3,7
4,2006,470100,32,23,9,6
5,2006,470100,23,21,2,1
6,2006,470100,22,20,2,3
7,2006,470100,40,36,4,16
8,2006,470100,26,23,3,6
9,2006,470100,27,25,2,10
10,2006,470100,30,25,5,8
11,2006,470100,21,18,3,3
12,2006,470100,18,16,2,8
1,2007,470100,13,11,2,17
2,2007,470100,17,13,4,13
3,2007,470100,15,9,6,17
4,2007,470100,28,18,10,9
5,2007,470100,20,14,6,4
6,2007,470100,25,20,5,2
7,2007,470100,38,29,9,6
8,2007,470100,36,30,6,4
9,2007,470100,26,21,5,7
10,2007,470100,17,16,1,1
11,2007,470100,22,19,3,16
12,2007,470100,19,15,4,6
1,2008,470100,37,35,2,6
2,2008,470100,19,14,5,10
3,2008,470100,24,21,3,2
4,2008,470100,21,20,1,5
5,2008,470100,42,36,6,3
6,2008,470100,24,19,5,11
7,2008,470100,18,14,4,7
8,2008,470100,31,26,5,1
9,2008,470100,29,24,5,8
10,2008,470100,36,35,1,5
11,2008,470100,27,25,2,5
12,2008,470100,26,21,5,5
1,2009,470100,15,10,5,23
2,2009,470100,14,11,3,5
3,2009,470100,12,9,3,14
4,2009,470100,20,11,9,13
5,2009,470100,22,16,6,3
6,2009,470100,15,14,1,6
7,2009,470100,28,23,5,8
8,2009,470100,28,25,3,7
9,2009,470100,21,17,4,3
10,2009,470100,22,19,3,7
11,2009,470100,22,20,2,3
12,2009,470100,19,16,3,4
1,2010,470100,16,14,2,5
2,2010,470100,7,4,3,5
3,2010,470100,7,6,1,1
4,2010,470100,18,14,4,5
5,2010,470100,15,12,3,7
6,2010,470100,22,19,3,4
7,2010,470100,15,15,0,6
8,2010,470100,15,13,2,1
9,2010,470100,24,19,5,7
10,2010,470100,20,16,4,6
11,2010,470100,14,9,5,5
12,2010,470100,7,6,1,10
1,2011,470100,15,10,5,4
2,2011,470100,10,9,1,1
1,1999,480300,0,0,0,1
2,1999,480300,2,1,1,7
3,1999,480300,10,7,3,1
4,1999,480300,9,7,2,2
5,1999,480300,6,4,2,2
6,1999,480300,9,5,4,3
7,1999,480300,7,5,2,1
8,1999,480300,10,10,0,0
9,1999,480300,10,9,1,1
10,1999,480300,9,8,1,0
11,1999,480300,8,5,3,3
12,1999,480300,7,5,2,2
1,2000,480300,7,6,1,6
2,2000,480300,10,9,1,2
3,2000,480300,8,7,1,10
4,2000,480300,6,6,0,0
5,2000,480300,6,2,4,2
6,2000,480300,9,6,3,1
7,2000,480300,5,5,0,2
8,2000,480300,7,6,1,3
9,2000,480300,9,7,2,1
10,2000,480300,12,11,1,1
11,2000,480300,2,1,1,4
12,2000,480300,4,2,2,2
1,2001,480300,7,6,1,4
2,2001,480300,10,7,3,6
3,2001,480300,4,4,0,4
4,2001,480300,10,5,5,0
5,2001,480300,8,6,2,2
6,2001,480300,6,4,2,3
7,2001,480300,18,14,4,0
8,2001,480300,8,6,2,5
9,2001,480300,8,5,3,0
10,2001,480300,10,7,3,1
11,2001,480300,4,2,2,1
12,2001,480300,6,6,0,5
1,2002,480300,6,4,2,4
2,2002,480300,5,4,1,1
3,2002,480300,6,3,3,1
4,2002,480300,4,3,1,0
5,2002,480300,3,2,1,0
6,2002,480300,7,5,2,0
7,2002,480300,6,5,1,1
8,2002,480300,9,6,3,2
9,2002,480300,4,4,0,1
10,2002,480300,3,3,0,1
11,2002,480300,5,4,1,2
12,2002,480300,6,4,2,2
1,2003,480300,5,5,0,2
2,2003,480300,3,2,1,1
3,2003,480300,2,2,0,4
4,2003,480300,9,8,1,3
5,2003,480300,5,4,1,8
6,2003,480300,6,6,0,2
7,2003,480300,19,17,2,2
8,2003,480300,11,11,0,2
9,2003,480300,18,17,1,4
10,2003,480300,10,8,2,2
11,2003,480300,10,9,1,0
12,2003,480300,5,5,0,5
1,2004,480300,6,5,1,4
2,2004,480300,8,6,2,5
3,2004,480300,3,3,0,1
4,2004,480300,3,3,0,4
5,2004,480300,7,7,0,1
6,2004,480300,4,3,1,1
7,2004,480300,6,5,1,0
8,2004,480300,11,9,2,1
9,2004,480300,9,8,1,26
10,2004,480300,8,8,0,3
11,2004,480300,7,5,2,7
12,2004,480300,8,7,1,7
1,2005,480300,12,11,1,5
2,2005,480300,5,5,0,12
3,2005,480300,5,5,0,6
4,2005,480300,12,10,2,4
5,2005,480300,9,7,2,5
6,2005,480300,5,4,1,0
7,2005,480300,1,1,0,3
8,2005,480300,10,8,2,1
9,2005,480300,8,6,2,3
10,2005,480300,6,5,1,2
11,2005,480300,2,1,1,2
12,2005,480300,1,1,0,1
1,2006,480300,12,10,2,3
2,2006,480300,6,6,0,3
3,2006,480300,9,7,2,2
4,2006,480300,7,7,0,0
5,2006,480300,6,5,1,2
6,2006,480300,4,3,1,1
7,2006,480300,6,3,3,0
8,2006,480300,5,4,1,0
9,2006,480300,8,7,1,2
10,2006,480300,5,4,1,3
11,2006,480300,9,7,2,0
12,2006,480300,12,12,0,1
1,2007,480300,2,1,1,3
2,2007,480300,4,3,1,1
3,2007,480300,7,5,2,1
4,2007,480300,10,7,3,3
5,2007,480300,9,8,1,3
6,2007,480300,7,6,1,7
7,2007,480300,4,4,0,4
8,2007,480300,14,13,1,1
9,2007,480300,5,4,1,5
10,2007,480300,8,7,1,5
11,2007,480300,4,3,1,1
12,2007,480300,8,8,0,4
1,2008,480300,10,8,2,6
2,2008,480300,6,6,0,8
3,2008,480300,9,6,3,0
4,2008,480300,15,13,2,1
5,2008,480300,4,4,0,2
6,2008,480300,7,6,1,4
7,2008,480300,7,5,2,4
8,2008,480300,8,8,0,2
9,2008,480300,17,14,3,1
10,2008,480300,8,6,2,0
11,2008,480300,15,14,1,3
12,2008,480300,9,7,2,0
1,2009,480300,4,4,0,1
2,2009,480300,5,5,0,0
3,2009,480300,5,3,2,1
4,2009,480300,9,8,1,1
5,2009,480300,4,3,1,3
6,2009,480300,14,10,4,4
7,2009,480300,10,10,0,3
8,2009,480300,7,6,1,3
9,2009,480300,8,6,2,4
10,2009,480300,6,6,0,3
11,2009,480300,6,6,0,2
12,2009,480300,6,6,0,2
1,2010,480300,6,5,1,1
2,2010,480300,5,2,3,1
3,2010,480300,9,8,1,3
4,2010,480300,3,1,2,6
5,2010,480300,11,10,1,0
6,2010,480300,4,3,1,5
7,2010,480300,8,6,2,2
8,2010,480300,15,15,0,0
9,2010,480300,4,3,1,3
10,2010,480300,8,6,2,1
11,2010,480300,7,6,1,3
12,2010,480300,2,2,0,1
1,2011,480300,8,7,1,1
2,2011,480300,1,1,0,0
1,1999,480400,29,26,3,3
2,1999,480400,22,17,5,4
3,1999,480400,42,38,4,4
4,1999,480400,38,33,5,3
5,1999,480400,41,34,7,2
6,1999,480400,28,24,4,3
7,1999,480400,54,50,4,7
8,1999,480400,49,43,6,7
9,1999,480400,38,33,5,3
10,1999,480400,61,53,8,2
11,1999,480400,48,44,4,2
12,1999,480400,45,43,2,9
1,2000,480400,41,39,2,13
2,2000,480400,28,27,1,9
3,2000,480400,55,50,5,8
4,2000,480400,43,38,5,3
5,2000,480400,29,23,6,6
6,2000,480400,46,38,8,9
7,2000,480400,46,36,10,6
8,2000,480400,42,36,6,7
9,2000,480400,38,30,8,8
10,2000,480400,43,31,12,2
11,2000,480400,39,31,8,6
12,2000,480400,26,23,3,6
1,2001,480400,36,33,3,2
2,2001,480400,24,22,2,2
3,2001,480400,32,30,2,3
4,2001,480400,31,25,6,5
5,2001,480400,37,29,8,7
6,2001,480400,50,42,8,5
7,2001,480400,56,43,13,6
8,2001,480400,41,35,6,5
9,2001,480400,41,34,7,3
10,2001,480400,41,40,1,3
11,2001,480400,36,34,2,2
12,2001,480400,32,28,4,4
1,2002,480400,22,21,1,5
2,2002,480400,26,22,4,3
3,2002,480400,24,20,4,1
4,2002,480400,31,29,2,7
5,2002,480400,27,22,5,13
6,2002,480400,37,25,12,1
7,2002,480400,51,42,9,5
8,2002,480400,37,28,9,3
9,2002,480400,36,29,7,1
10,2002,480400,34,28,6,4
11,2002,480400,30,22,8,11
12,2002,480400,37,33,4,5
1,2003,480400,43,37,6,5
2,2003,480400,30,27,3,4
3,2003,480400,22,19,3,2
4,2003,480400,40,37,3,4
5,2003,480400,22,18,4,3
6,2003,480400,38,29,9,15
7,2003,480400,53,43,10,11
8,2003,480400,45,37,8,1
9,2003,480400,31,29,2,12
10,2003,480400,35,32,3,6
11,2003,480400,29,26,3,1
12,2003,480400,29,26,3,14
1,2004,480400,31,23,8,8
2,2004,480400,23,18,5,7
3,2004,480400,28,25,3,17
4,2004,480400,33,31,2,5
5,2004,480400,34,30,4,3
6,2004,480400,28,26,2,2
7,2004,480400,32,27,5,1
8,2004,480400,34,31,3,2
9,2004,480400,30,26,4,2
10,2004,480400,44,40,4,1
11,2004,480400,34,32,2,4
12,2004,480400,22,20,2,3
1,2005,480400,21,20,1,6
2,2005,480400,30,27,3,8
3,2005,480400,40,35,5,3
4,2005,480400,34,28,6,1
5,2005,480400,31,24,7,3
6,2005,480400,24,21,3,4
7,2005,480400,28,25,3,1
8,2005,480400,29,27,2,4
9,2005,480400,26,22,4,2
10,2005,480400,24,24,0,3
11,2005,480400,21,19,2,2
12,2005,480400,34,33,1,2
1,2006,480400,40,37,3,8
2,2006,480400,18,15,3,7
3,2006,480400,32,30,2,11
4,2006,480400,37,35,2,1
5,2006,480400,32,27,5,2
6,2006,480400,33,31,2,6
7,2006,480400,29,25,4,2
8,2006,480400,53,47,6,2
9,2006,480400,38,34,4,5
10,2006,480400,34,34,0,2
11,2006,480400,17,15,2,5
12,2006,480400,25,23,2,12
1,2007,480400,32,30,2,2
2,2007,480400,11,9,2,3
3,2007,480400,32,27,5,2
4,2007,480400,33,31,2,4
5,2007,480400,33,31,2,7
6,2007,480400,48,44,4,5
7,2007,480400,36,34,2,2
8,2007,480400,52,47,5,8
9,2007,480400,34,31,3,9
10,2007,480400,32,27,5,8
11,2007,480400,43,39,4,8
12,2007,480400,25,24,1,1
1,2008,480400,21,19,2,6
2,2008,480400,25,24,1,8
3,2008,480400,28,24,4,4
4,2008,480400,34,31,3,11
5,2008,480400,32,27,5,5
6,2008,480400,34,31,3,8
7,2008,480400,42,36,6,1
8,2008,480400,44,40,4,0
9,2008,480400,33,31,2,1
10,2008,480400,41,37,4,3
11,2008,480400,24,20,4,3
12,2008,480400,21,21,0,1
1,2009,480400,28,25,3,10
2,2009,480400,17,16,1,4
3,2009,480400,23,22,1,3
4,2009,480400,30,26,4,3
5,2009,480400,25,24,1,4
6,2009,480400,36,27,9,6
7,2009,480400,31,29,2,0
8,2009,480400,25,23,2,4
9,2009,480400,26,24,2,2
10,2009,480400,24,22,2,3
11,2009,480400,24,22,2,5
12,2009,480400,28,27,1,5
1,2010,480400,27,27,0,2
2,2010,480400,23,20,3,7
3,2010,480400,25,22,3,4
4,2010,480400,25,23,2,2
5,2010,480400,49,45,4,3
6,2010,480400,23,21,2,5
7,2010,480400,31,27,4,4
8,2010,480400,38,35,3,1
9,2010,480400,42,38,4,3
10,2010,480400,41,37,4,1
11,2010,480400,37,35,2,1
12,2010,480400,39,37,2,2
1,2011,480400,28,26,2,6
2,2011,480400,14,12,2,6
1,1999,461000,41,37,4,1
2,1999,461000,34,31,3,1
3,1999,461000,24,21,3,1
4,1999,461000,23,21,2,3
5,1999,461000,42,37,5,2
6,1999,461000,28,25,3,2
7,1999,461000,27,21,6,1
8,1999,461000,45,40,5,2
9,1999,461000,22,22,0,2
10,1999,461000,44,37,7,5
11,1999,461000,26,23,3,5
12,1999,461000,22,18,4,5
1,2000,461000,24,23,1,6
2,2000,461000,24,24,0,3
3,2000,461000,24,23,1,7
4,2000,461000,19,18,1,2
5,2000,461000,16,15,1,3
6,2000,461000,14,13,1,1
7,2000,461000,20,19,1,4
8,2000,461000,21,20,1,3
9,2000,461000,28,24,4,1
10,2000,461000,25,23,2,6
11,2000,461000,22,19,3,0
12,2000,461000,13,13,0,3
1,2001,461000,17,15,2,0
2,2001,461000,19,18,1,2
3,2001,461000,25,23,2,5
4,2001,461000,31,30,1,4
5,2001,461000,28,26,2,0
6,2001,461000,17,17,0,0
7,2001,461000,34,32,2,1
8,2001,461000,30,26,4,2
9,2001,461000,17,15,2,0
10,2001,461000,22,22,0,2
11,2001,461000,20,20,0,1
12,2001,461000,20,19,1,1
1,2002,461000,18,14,4,0
2,2002,461000,17,14,3,1
3,2002,461000,17,16,1,3
4,2002,461000,20,15,5,1
5,2002,461000,20,16,4,1
6,2002,461000,19,16,3,1
7,2002,461000,23,20,3,5
8,2002,461000,14,12,2,0
9,2002,461000,17,16,1,2
10,2002,461000,15,13,2,3
11,2002,461000,20,19,1,4
12,2002,461000,17,13,4,1
1,2003,461000,19,17,2,1
2,2003,461000,18,16,2,1
3,2003,461000,24,22,2,1
4,2003,461000,25,24,1,5
5,2003,461000,19,16,3,3
6,2003,461000,24,20,4,0
7,2003,461000,27,22,5,0
8,2003,461000,12,12,0,1
9,2003,461000,27,25,2,0
10,2003,461000,15,13,2,1
11,2003,461000,17,14,3,2
12,2003,461000,19,15,4,3
1,2004,461000,17,16,1,1
2,2004,461000,22,21,1,2
3,2004,461000,23,23,0,3
4,2004,461000,21,19,2,1
5,2004,461000,10,10,0,2
6,2004,461000,20,18,2,3
7,2004,461000,22,21,1,3
8,2004,461000,21,20,1,8
9,2004,461000,44,40,4,2
10,2004,461000,31,26,5,0
11,2004,461000,31,29,2,3
12,2004,461000,17,17,0,3
1,2005,461000,16,16,0,1
2,2005,461000,11,10,1,1
3,2005,461000,12,11,1,2
4,2005,461000,14,14,0,3
5,2005,461000,19,17,2,3
6,2005,461000,18,15,3,4
7,2005,461000,16,15,1,1
8,2005,461000,17,16,1,1
9,2005,461000,18,17,1,3
10,2005,461000,7,5,2,2
11,2005,461000,20,18,2,3
12,2005,461000,19,18,1,2
1,2006,461000,24,22,2,3
2,2006,461000,16,16,0,8
3,2006,461000,26,22,4,5
4,2006,461000,19,18,1,2
5,2006,461000,15,13,2,1
6,2006,461000,30,28,2,4
7,2006,461000,20,18,2,5
8,2006,461000,21,17,4,3
9,2006,461000,19,18,1,2
10,2006,461000,22,19,3,2
11,2006,461000,19,19,0,2
12,2006,461000,11,10,1,1
1,2007,461000,20,19,1,8
2,2007,461000,12,10,2,1
3,2007,461000,21,20,1,7
4,2007,461000,25,22,3,0
5,2007,461000,23,23,0,4
6,2007,461000,31,27,4,1
7,2007,461000,20,17,3,1
8,2007,461000,23,22,1,0
9,2007,461000,22,22,0,2
10,2007,461000,27,23,4,1
11,2007,461000,20,20,0,2
12,2007,461000,21,20,1,0
1,2008,461000,17,17,0,2
2,2008,461000,16,13,3,3
3,2008,461000,13,13,0,1
4,2008,461000,16,13,3,2
5,2008,461000,15,14,1,5
6,2008,461000,23,22,1,2
7,2008,461000,46,40,6,3
8,2008,461000,29,26,3,1
9,2008,461000,16,16,0,3
10,2008,461000,22,19,3,2
11,2008,461000,15,14,1,5
12,2008,461000,18,17,1,3
1,2009,461000,11,10,1,3
2,2009,461000,15,13,2,4
3,2009,461000,15,12,3,7
4,2009,461000,15,14,1,2
5,2009,461000,11,10,1,4
6,2009,461000,15,15,0,2
7,2009,461000,12,12,0,2
8,2009,461000,11,11,0,4
9,2009,461000,17,14,3,6
10,2009,461000,18,17,1,2
11,2009,461000,17,17,0,4
12,2009,461000,17,15,2,0
1,2010,461000,13,10,3,3
2,2010,461000,5,5,0,3
3,2010,461000,14,11,3,3
4,2010,461000,10,8,2,0
5,2010,461000,12,12,0,4
6,2010,461000,30,29,1,4
7,2010,461000,29,28,1,4
8,2010,461000,23,22,1,3
9,2010,461000,22,20,2,1
10,2010,461000,26,26,0,1
11,2010,461000,14,14,0,1
12,2010,461000,37,35,2,1
1,2011,461000,16,15,1,2
2,2011,461000,10,7,3,1
1,1999,711500,26,20,6,7
2,1999,711500,9,8,1,7
3,1999,711500,23,18,5,13
4,1999,711500,13,8,5,11
5,1999,711500,15,10,5,7
6,1999,711500,19,13,6,7
7,1999,711500,24,21,3,2
8,1999,711500,15,13,2,4
9,1999,711500,33,27,6,5
10,1999,711500,12,11,1,12
11,1999,711500,15,12,3,7
12,1999,711500,14,12,2,5
1,2000,711500,12,10,2,20
2,2000,711500,11,8,3,9
3,2000,711500,11,9,2,9
4,2000,711500,18,11,7,8
5,2000,711500,17,16,1,11
6,2000,711500,16,14,2,5
7,2000,711500,19,15,4,6
8,2000,711500,18,15,3,13
9,2000,711500,11,8,3,3
10,2000,711500,27,22,5,5
11,2000,711500,19,18,1,10
12,2000,711500,13,12,1,6
1,2001,711500,15,14,1,17
2,2001,711500,15,12,3,8
3,2001,711500,9,9,0,5
4,2001,711500,22,19,3,6
5,2001,711500,15,13,2,3
6,2001,711500,9,8,1,5
7,2001,711500,24,15,9,2
8,2001,711500,11,10,1,7
9,2001,711500,19,14,5,8
10,2001,711500,15,11,4,9
11,2001,711500,22,21,1,8
12,2001,711500,18,16,2,3
1,2002,711500,15,15,0,10
2,2002,711500,15,13,2,6
3,2002,711500,10,7,3,8
4,2002,711500,9,9,0,9
5,2002,711500,21,15,6,8
6,2002,711500,25,18,7,5
7,2002,711500,14,10,4,3
8,2002,711500,9,6,3,7
9,2002,711500,19,15,4,2
10,2002,711500,14,13,1,6
11,2002,711500,19,18,1,9
12,2002,711500,17,12,5,3
1,2003,711500,12,8,4,9
2,2003,711500,13,12,1,4
3,2003,711500,11,9,2,6
4,2003,711500,20,16,4,8
5,2003,711500,17,11,6,7
6,2003,711500,19,16,3,4
7,2003,711500,29,23,6,8
8,2003,711500,20,15,5,5
9,2003,711500,25,24,1,2
10,2003,711500,31,25,6,5
11,2003,711500,20,19,1,7
12,2003,711500,31,27,4,3
1,2004,711500,18,15,3,3
2,2004,711500,20,17,3,2
3,2004,711500,14,12,2,3
4,2004,711500,21,18,3,4
5,2004,711500,15,13,2,4
6,2004,711500,16,14,2,1
7,2004,711500,16,13,3,4
8,2004,711500,21,21,0,1
9,2004,711500,25,20,5,6
10,2004,711500,10,9,1,7
11,2004,711500,20,20,0,7
12,2004,711500,12,10,2,3
1,2005,711500,13,11,2,3
2,2005,711500,11,9,2,3
3,2005,711500,15,11,4,0
4,2005,711500,23,22,1,2
5,2005,711500,23,20,3,5
6,2005,711500,13,11,2,7
7,2005,711500,20,18,2,1
8,2005,711500,22,19,3,6
9,2005,711500,16,14,2,1
10,2005,711500,28,26,2,0
11,2005,711500,14,13,1,3
12,2005,711500,15,14,1,1
1,2006,711500,14,12,2,3
2,2006,711500,22,21,1,2
3,2006,711500,18,16,2,4
4,2006,711500,11,10,1,7
5,2006,711500,11,6,5,14
6,2006,711500,14,11,3,5
7,2006,711500,24,21,3,4
8,2006,711500,22,19,3,4
9,2006,711500,22,19,3,11
10,2006,711500,11,10,1,4
11,2006,711500,23,22,1,4
12,2006,711500,17,16,1,5
1,2007,711500,13,12,1,11
2,2007,711500,3,3,0,14
3,2007,711500,12,11,1,8
4,2007,711500,18,14,4,9
5,2007,711500,20,17,3,9
6,2007,711500,15,14,1,10
7,2007,711500,20,18,2,5
8,2007,711500,23,19,4,10
9,2007,711500,29,22,7,6
10,2007,711500,27,25,2,8
11,2007,711500,24,21,3,3
12,2007,711500,17,17,0,3
1,2008,711500,26,21,5,5
2,2008,711500,15,14,1,3
3,2008,711500,29,26,3,3
4,2008,711500,22,18,4,2
5,2008,711500,21,19,2,3
6,2008,711500,22,21,1,2
7,2008,711500,29,24,5,3
8,2008,711500,15,12,3,5
9,2008,711500,22,18,4,1
10,2008,711500,22,17,5,2
11,2008,711500,22,21,1,4
12,2008,711500,9,9,0,1
1,2009,711500,21,17,4,7
2,2009,711500,13,10,3,6
3,2009,711500,18,18,0,2
4,2009,711500,12,10,2,5
5,2009,711500,26,25,1,8
6,2009,711500,29,27,2,2
7,2009,711500,16,14,2,2
8,2009,711500,31,26,5,9
9,2009,711500,13,13,0,13
10,2009,711500,24,23,1,8
11,2009,711500,16,13,3,6
12,2009,711500,12,12,0,5
1,2010,711500,14,12,2,2
2,2010,711500,9,9,0,3
3,2010,711500,14,11,3,2
4,2010,711500,16,14,2,6
5,2010,711500,21,19,2,5
6,2010,711500,13,11,2,6
7,2010,711500,20,17,3,7
8,2010,711500,16,14,2,0
9,2010,711500,16,14,2,2
10,2010,711500,15,13,2,4
11,2010,711500,14,13,1,5
12,2010,711500,13,12,1,3
1,2011,711500,7,7,0,2
2,2011,711500,8,8,0,0
1,1999,440600,30,28,2,0
2,1999,440600,39,38,1,0
3,1999,440600,30,29,1,0
4,1999,440600,30,28,2,3
5,1999,440600,31,27,4,0
6,1999,440600,47,45,2,1
7,1999,440600,38,34,4,1
8,1999,440600,43,39,4,2
9,1999,440600,42,39,3,1
10,1999,440600,43,43,0,0
11,1999,440600,43,39,4,1
12,1999,440600,37,34,3,1
1,2000,440600,32,32,0,0
2,2000,440600,30,26,4,1
3,2000,440600,29,27,2,0
4,2000,440600,34,33,1,3
5,2000,440600,31,29,2,0
6,2000,440600,35,31,4,1
7,2000,440600,36,31,5,3
8,2000,440600,38,32,6,0
9,2000,440600,40,36,4,0
10,2000,440600,57,56,1,2
11,2000,440600,40,39,1,1
12,2000,440600,30,28,2,0
1,2001,440600,29,29,0,0
2,2001,440600,25,22,3,1
3,2001,440600,43,41,2,2
4,2001,440600,41,38,3,5
5,2001,440600,50,48,2,3
6,2001,440600,36,34,2,3
7,2001,440600,32,32,0,3
8,2001,440600,49,43,6,3
9,2001,440600,47,44,3,1
10,2001,440600,39,37,2,2
11,2001,440600,28,24,4,1
12,2001,440600,27,27,0,4
1,2002,440600,24,24,0,2
2,2002,440600,17,16,1,1
3,2002,440600,41,39,2,2
4,2002,440600,28,26,2,2
5,2002,440600,30,28,2,1
6,2002,440600,30,28,2,0
7,2002,440600,37,35,2,2
8,2002,440600,39,38,1,1
9,2002,440600,27,22,5,0
10,2002,440600,24,23,1,0
11,2002,440600,33,31,2,0
12,2002,440600,23,21,2,1
1,2003,440600,20,20,0,0
2,2003,440600,26,24,2,0
3,2003,440600,27,24,3,4
4,2003,440600,21,20,1,0
5,2003,440600,37,35,2,1
6,2003,440600,34,29,5,0
7,2003,440600,41,39,2,5
8,2003,440600,35,31,4,1
9,2003,440600,26,25,1,1
10,2003,440600,26,24,2,1
11,2003,440600,26,24,2,3
12,2003,440600,34,32,2,0
1,2004,440600,18,18,0,4
2,2004,440600,17,15,2,0
3,2004,440600,32,30,2,2
4,2004,440600,18,16,2,1
5,2004,440600,22,18,4,1
6,2004,440600,26,24,2,1
7,2004,440600,29,25,4,0
8,2004,440600,35,31,4,0
9,2004,440600,22,17,5,2
10,2004,440600,19,18,1,2
11,2004,440600,21,21,0,2
12,2004,440600,23,20,3,3
1,2005,440600,15,13,2,0
2,2005,440600,23,20,3,0
3,2005,440600,23,23,0,4
4,2005,440600,16,16,0,1
5,2005,440600,32,27,5,5
6,2005,440600,19,18,1,1
7,2005,440600,34,33,1,3
8,2005,440600,40,36,4,3
9,2005,440600,23,18,5,1
10,2005,440600,23,20,3,2
11,2005,440600,28,28,0,2
12,2005,440600,33,32,1,3
1,2006,440600,21,18,3,0
2,2006,440600,14,14,0,3
3,2006,440600,14,14,0,3
4,2006,440600,29,26,3,2
5,2006,440600,26,24,2,2
6,2006,440600,27,25,2,6
7,2006,440600,28,23,5,5
8,2006,440600,10,7,3,7
9,2006,440600,24,21,3,13
10,2006,440600,25,24,1,1
11,2006,440600,26,23,3,2
12,2006,440600,20,17,3,3
1,2007,440600,13,12,1,8
2,2007,440600,5,3,2,5
3,2007,440600,24,20,4,7
4,2007,440600,9,9,0,12
5,2007,440600,20,16,4,5
6,2007,440600,28,26,2,3
7,2007,440600,22,21,1,7
8,2007,440600,36,34,2,3
9,2007,440600,24,24,0,5
10,2007,440600,31,29,2,10
11,2007,440600,21,19,2,3
12,2007,440600,29,27,2,2
1,2008,440600,25,23,2,6
2,2008,440600,22,21,1,4
3,2008,440600,24,23,1,3
4,2008,440600,23,22,1,4
5,2008,440600,33,32,1,5
6,2008,440600,19,19,0,9
7,2008,440600,31,30,1,3
8,2008,440600,34,31,3,5
9,2008,440600,31,28,3,2
10,2008,440600,23,21,2,2
11,2008,440600,17,17,0,5
12,2008,440600,24,23,1,8
1,2009,440600,15,13,2,8
2,2009,440600,14,14,0,4
3,2009,440600,10,9,1,6
4,2009,440600,22,21,1,3
5,2009,440600,26,24,2,1
6,2009,440600,19,19,0,8
7,2009,440600,28,27,1,2
8,2009,440600,38,37,1,3
9,2009,440600,26,22,4,6
10,2009,440600,25,22,3,11
11,2009,440600,22,22,0,6
12,2009,440600,16,15,1,2
1,2010,440600,16,16,0,5
2,2010,440600,14,13,1,6
3,2010,440600,30,30,0,6
4,2010,440600,33,31,2,4
5,2010,440600,34,31,3,10
6,2010,440600,19,18,1,0
7,2010,440600,18,18,0,2
8,2010,440600,19,17,2,6
9,2010,440600,24,23,1,3
10,2010,440600,22,21,1,4
11,2010,440600,23,21,2,8
12,2010,440600,21,19,2,5
1,2011,440600,10,9,1,8
2,2011,440600,12,10,2,4
1,1999,842400,69,63,6,6
2,1999,842400,84,72,12,3
3,1999,842400,101,96,5,11
4,1999,842400,124,114,10,6
5,1999,842400,124,113,11,5
6,1999,842400,110,105,5,9
7,1999,842400,108,101,7,6
8,1999,842400,122,114,8,10
9,1999,842400,94,86,8,0
10,1999,842400,92,88,4,7
11,1999,842400,103,95,8,14
12,1999,842400,107,99,8,15
1,2000,842400,125,115,10,9
2,2000,842400,92,87,5,11
3,2000,842400,106,102,4,21
4,2000,842400,113,105,8,7
5,2000,842400,153,144,9,22
6,2000,842400,138,132,6,10
7,2000,842400,152,148,4,15
8,2000,842400,170,162,8,14
9,2000,842400,191,183,8,11
10,2000,842400,185,179,6,7
11,2000,842400,155,150,5,7
12,2000,842400,134,130,4,11
1,2001,842400,134,131,3,7
2,2001,842400,92,82,10,9
3,2001,842400,99,91,8,8
4,2001,842400,112,109,3,10
5,2001,842400,133,126,7,15
6,2001,842400,117,106,11,13
7,2001,842400,122,116,6,7
8,2001,842400,124,118,6,15
9,2001,842400,123,115,8,11
10,2001,842400,115,103,12,12
11,2001,842400,106,102,4,20
12,2001,842400,122,112,10,9
1,2002,842400,102,95,7,25
2,2002,842400,97,95,2,7
3,2002,842400,106,101,5,9
4,2002,842400,104,96,8,7
5,2002,842400,87,83,4,14
6,2002,842400,99,93,6,10
7,2002,842400,111,105,6,7
8,2002,842400,130,127,3,4
9,2002,842400,118,113,5,6
10,2002,842400,102,96,6,14
11,2002,842400,115,105,10,14
12,2002,842400,118,110,8,16
1,2003,842400,102,100,2,4
2,2003,842400,104,100,4,12
3,2003,842400,105,96,9,14
4,2003,842400,104,97,7,8
5,2003,842400,116,109,7,2
6,2003,842400,98,92,6,3
7,2003,842400,118,109,9,8
8,2003,842400,112,107,5,6
9,2003,842400,74,70,4,7
10,2003,842400,81,79,2,5
11,2003,842400,96,88,8,15
12,2003,842400,90,89,1,10
1,2004,842400,76,68,8,7
2,2004,842400,64,56,8,14
3,2004,842400,88,83,5,9
4,2004,842400,77,74,3,5
5,2004,842400,79,73,6,8
6,2004,842400,81,73,8,7
7,2004,842400,94,88,6,4
8,2004,842400,94,84,10,5
9,2004,842400,79,72,7,6
10,2004,842400,76,71,5,8
11,2004,842400,73,69,4,7
12,2004,842400,89,82,7,17
1,2005,842400,56,53,3,4
2,2005,842400,66,61,5,6
3,2005,842400,85,80,5,8
4,2005,842400,106,97,9,11
5,2005,842400,74,71,3,8
6,2005,842400,100,94,6,6
7,2005,842400,94,89,5,2
8,2005,842400,89,85,4,8
9,2005,842400,96,86,10,20
10,2005,842400,95,88,7,12
11,2005,842400,70,67,3,10
12,2005,842400,107,104,3,15
1,2006,842400,76,74,2,26
2,2006,842400,54,47,7,7
3,2006,842400,77,70,7,21
4,2006,842400,64,58,6,6
5,2006,842400,65,61,4,8
6,2006,842400,65,62,3,6
7,2006,842400,49,43,6,5
8,2006,842400,53,44,9,4
9,2006,842400,59,54,5,9
10,2006,842400,62,57,5,13
11,2006,842400,76,71,5,8
12,2006,842400,58,54,4,21
1,2007,842400,80,66,14,9
2,2007,842400,49,46,3,20
3,2007,842400,51,46,5,16
4,2007,842400,68,65,3,14
5,2007,842400,73,66,7,17
6,2007,842400,80,72,8,12
7,2007,842400,87,83,4,12
8,2007,842400,62,53,9,24
9,2007,842400,61,55,6,20
10,2007,842400,71,65,6,16
11,2007,842400,67,60,7,12
12,2007,842400,88,87,1,14
1,2008,842400,96,89,7,6
2,2008,842400,55,50,5,16
3,2008,842400,76,69,7,15
4,2008,842400,64,58,6,7
5,2008,842400,91,88,3,20
6,2008,842400,68,64,4,7
7,2008,842400,79,73,6,14
8,2008,842400,73,69,4,9
9,2008,842400,47,43,4,20
10,2008,842400,58,57,1,15
11,2008,842400,65,64,1,12
12,2008,842400,67,66,1,10
1,2009,842400,52,47,5,9
2,2009,842400,53,50,3,24
3,2009,842400,59,49,10,21
4,2009,842400,62,60,2,7
5,2009,842400,66,60,6,13
6,2009,842400,78,76,2,8
7,2009,842400,95,87,8,8
8,2009,842400,72,68,4,8
9,2009,842400,67,63,4,14
10,2009,842400,85,74,11,11
11,2009,842400,72,65,7,8
12,2009,842400,56,53,3,10
1,2010,842400,61,55,6,14
2,2010,842400,38,37,1,12
3,2010,842400,55,46,9,17
4,2010,842400,70,68,2,10
5,2010,842400,72,67,5,23
6,2010,842400,65,58,7,19
7,2010,842400,65,60,5,14
8,2010,842400,74,72,2,12
9,2010,842400,61,57,4,10
10,2010,842400,47,43,4,11
11,2010,842400,57,55,2,8
12,2010,842400,65,61,4,7
1,2011,842400,38,32,6,7
2,2011,842400,19,16,3,12
1,1999,833900,19,12,7,7
2,1999,833900,14,8,6,9
3,1999,833900,23,18,5,8
4,1999,833900,19,11,8,4
5,1999,833900,15,10,5,7
6,1999,833900,25,22,3,6
7,1999,833900,19,16,3,6
8,1999,833900,22,19,3,6
9,1999,833900,19,13,6,2
10,1999,833900,21,17,4,4
11,1999,833900,26,21,5,7
12,1999,833900,14,12,2,5
1,2000,833900,17,15,2,7
2,2000,833900,14,14,0,13
3,2000,833900,16,12,4,8
4,2000,833900,13,10,3,2
5,2000,833900,15,11,4,9
6,2000,833900,18,11,7,6
7,2000,833900,26,24,2,11
8,2000,833900,21,13,8,3
9,2000,833900,16,12,4,9
10,2000,833900,24,19,5,9
11,2000,833900,18,12,6,10
12,2000,833900,12,9,3,9
1,2001,833900,9,6,3,7
2,2001,833900,10,5,5,12
3,2001,833900,16,10,6,11
4,2001,833900,17,11,6,4
5,2001,833900,21,15,6,8
6,2001,833900,16,10,6,4
7,2001,833900,12,8,4,6
8,2001,833900,10,9,1,3
9,2001,833900,8,5,3,4
10,2001,833900,11,9,2,6
11,2001,833900,11,9,2,5
12,2001,833900,13,11,2,7
1,2002,833900,8,6,2,4
2,2002,833900,11,10,1,11
3,2002,833900,16,15,1,11
4,2002,833900,15,13,2,2
5,2002,833900,24,15,9,6
6,2002,833900,26,17,9,8
7,2002,833900,24,17,7,4
8,2002,833900,17,17,0,3
9,2002,833900,21,14,7,1
10,2002,833900,16,13,3,6
11,2002,833900,24,16,8,5
12,2002,833900,14,10,4,4
1,2003,833900,15,12,3,3
2,2003,833900,16,10,6,9
3,2003,833900,13,8,5,5
4,2003,833900,16,14,2,5
5,2003,833900,15,13,2,3
6,2003,833900,19,12,7,6
7,2003,833900,28,24,4,7
8,2003,833900,22,17,5,2
9,2003,833900,17,12,5,7
10,2003,833900,26,19,7,16
11,2003,833900,9,7,2,9
12,2003,833900,17,14,3,2
1,2004,833900,19,17,2,6
2,2004,833900,10,7,3,5
3,2004,833900,20,15,5,16
4,2004,833900,25,21,4,11
5,2004,833900,19,15,4,8
6,2004,833900,15,11,4,6
7,2004,833900,23,16,7,13
8,2004,833900,27,25,2,15
9,2004,833900,17,16,1,19
10,2004,833900,14,13,1,15
11,2004,833900,12,10,2,5
12,2004,833900,16,14,2,6
1,2005,833900,17,12,5,11
2,2005,833900,15,11,4,5
3,2005,833900,14,11,3,7
4,2005,833900,18,14,4,11
5,2005,833900,16,14,2,3
6,2005,833900,26,20,6,5
7,2005,833900,13,9,4,2
8,2005,833900,16,13,3,6
9,2005,833900,24,20,4,8
10,2005,833900,20,19,1,5
11,2005,833900,24,22,2,4
12,2005,833900,20,17,3,9
1,2006,833900,21,13,8,4
2,2006,833900,15,13,2,9
3,2006,833900,29,25,4,15
4,2006,833900,18,13,5,7
5,2006,833900,33,21,12,10
6,2006,833900,21,17,4,6
7,2006,833900,30,24,6,10
8,2006,833900,19,16,3,8
9,2006,833900,19,12,7,10
10,2006,833900,21,15,6,12
11,2006,833900,29,22,7,3
12,2006,833900,27,25,2,8
1,2007,833900,13,9,4,5
2,2007,833900,22,20,2,11
3,2007,833900,26,25,1,24
4,2007,833900,24,22,2,8
5,2007,833900,25,22,3,9
6,2007,833900,16,14,2,2
7,2007,833900,19,13,6,2
8,2007,833900,26,16,10,5
9,2007,833900,29,24,5,8
10,2007,833900,22,16,6,7
11,2007,833900,23,15,8,12
12,2007,833900,15,14,1,6
1,2008,833900,15,14,1,7
2,2008,833900,11,8,3,5
3,2008,833900,9,4,5,2
4,2008,833900,16,12,4,3
5,2008,833900,28,22,6,3
6,2008,833900,25,15,10,4
7,2008,833900,18,15,3,7
8,2008,833900,19,16,3,2
9,2008,833900,12,9,3,3
10,2008,833900,13,12,1,5
11,2008,833900,21,18,3,14
12,2008,833900,13,10,3,3
1,2009,833900,13,12,1,3
2,2009,833900,10,9,1,11
3,2009,833900,20,18,2,10
4,2009,833900,11,8,3,5
5,2009,833900,18,13,5,6
6,2009,833900,16,15,1,7
7,2009,833900,12,11,1,5
8,2009,833900,27,22,5,3
9,2009,833900,12,9,3,10
10,2009,833900,14,10,4,9
11,2009,833900,13,12,1,6
12,2009,833900,9,6,3,3
1,2010,833900,16,13,3,4
2,2010,833900,9,5,4,7
3,2010,833900,16,14,2,12
4,2010,833900,17,14,3,2
5,2010,833900,20,18,2,2
6,2010,833900,21,18,3,5
7,2010,833900,22,15,7,7
8,2010,833900,25,19,6,1
9,2010,833900,20,18,2,3
10,2010,833900,20,15,5,5
11,2010,833900,16,14,2,3
12,2010,833900,20,17,3,5
1,2011,833900,12,12,0,4
2,2011,833900,8,6,2,2
1,1999,711300,3,3,0,0
2,1999,711300,4,4,0,0
3,1999,711300,3,2,1,2
4,1999,711300,5,5,0,0
5,1999,711300,9,9,0,1
6,1999,711300,10,8,2,0
7,1999,711300,6,6,0,0
8,1999,711300,2,2,0,0
9,1999,711300,5,5,0,3
10,1999,711300,4,3,1,4
11,1999,711300,8,7,1,1
12,1999,711300,4,3,1,0
1,2000,711300,1,1,0,1
2,2000,711300,2,1,1,0
3,2000,711300,5,4,1,2
4,2000,711300,6,6,0,0
5,2000,711300,7,5,2,2
6,2000,711300,5,5,0,4
7,2000,711300,11,10,1,0
8,2000,711300,6,5,1,3
9,2000,711300,10,10,0,0
10,2000,711300,9,7,2,1
11,2000,711300,6,5,1,2
12,2000,711300,1,1,0,0
1,2001,711300,6,5,1,0
2,2001,711300,2,2,0,1
3,2001,711300,7,6,1,4
4,2001,711300,8,7,1,1
5,2001,711300,5,4,1,0
6,2001,711300,2,1,1,1
7,2001,711300,8,7,1,2
8,2001,711300,2,1,1,2
9,2001,711300,7,6,1,0
10,2001,711300,4,4,0,0
11,2001,711300,2,2,0,1
12,2001,711300,2,2,0,0
1,2002,711300,5,4,1,3
2,2002,711300,6,3,3,0
3,2002,711300,4,3,1,1
4,2002,711300,5,5,0,3
5,2002,711300,6,5,1,1
6,2002,711300,7,3,4,0
7,2002,711300,3,2,1,2
8,2002,711300,5,4,1,0
9,2002,711300,4,4,0,1
10,2002,711300,2,2,0,0
11,2002,711300,7,6,1,0
12,2002,711300,3,3,0,1
1,2003,711300,4,2,2,3
2,2003,711300,0,0,0,2
3,2003,711300,6,4,2,0
4,2003,711300,4,3,1,5
5,2003,711300,4,2,2,2
6,2003,711300,3,2,1,0
7,2003,711300,9,7,2,0
8,2003,711300,2,1,1,3
9,2003,711300,2,2,0,1
10,2003,711300,6,6,0,0
11,2003,711300,8,7,1,0
12,2003,711300,6,6,0,1
1,2004,711300,3,3,0,0
2,2004,711300,5,5,0,1
3,2004,711300,10,8,2,4
4,2004,711300,10,10,0,0
5,2004,711300,8,6,2,1
6,2004,711300,6,5,1,0
7,2004,711300,10,10,0,2
8,2004,711300,6,6,0,0
9,2004,711300,9,9,0,1
10,2004,711300,8,7,1,0
11,2004,711300,5,5,0,0
12,2004,711300,8,8,0,0
1,2005,711300,9,9,0,0
2,2005,711300,7,7,0,0
3,2005,711300,8,8,0,3
4,2005,711300,6,4,2,1
5,2005,711300,6,6,0,2
6,2005,711300,6,6,0,1
7,2005,711300,14,14,0,1
8,2005,711300,4,4,0,1
9,2005,711300,8,6,2,2
10,2005,711300,6,5,1,1
11,2005,711300,11,9,2,3
12,2005,711300,3,3,0,0
1,2006,711300,5,4,1,2
2,2006,711300,3,3,0,1
3,2006,711300,8,8,0,0
4,2006,711300,5,5,0,2
5,2006,711300,5,5,0,0
6,2006,711300,3,0,3,2
7,2006,711300,4,4,0,1
8,2006,711300,6,5,1,2
9,2006,711300,1,1,0,1
10,2006,711300,5,5,0,2
11,2006,711300,3,2,1,1
12,2006,711300,4,4,0,2
1,2007,711300,4,4,0,0
2,2007,711300,4,4,0,1
3,2007,711300,7,6,1,2
4,2007,711300,10,8,2,2
5,2007,711300,6,5,1,3
6,2007,711300,11,10,1,0
7,2007,711300,6,6,0,3
8,2007,711300,11,10,1,0
9,2007,711300,8,8,0,0
10,2007,711300,10,6,4,1
11,2007,711300,5,5,0,2
12,2007,711300,4,4,0,0
1,2008,711300,10,9,1,2
2,2008,711300,7,7,0,0
3,2008,711300,4,4,0,0
4,2008,711300,9,8,1,1
5,2008,711300,6,6,0,0
6,2008,711300,11,10,1,1
7,2008,711300,14,14,0,0
8,2008,711300,8,8,0,5
9,2008,711300,8,8,0,0
10,2008,711300,8,7,1,1
11,2008,711300,8,8,0,0
12,2008,711300,2,2,0,0
1,2009,711300,5,5,0,0
2,2009,711300,2,2,0,0
3,2009,711300,4,3,1,0
4,2009,711300,7,6,1,2
5,2009,711300,6,4,2,1
6,2009,711300,6,6,0,0
7,2009,711300,6,5,1,0
8,2009,711300,7,6,1,2
9,2009,711300,5,4,1,4
10,2009,711300,5,5,0,2
11,2009,711300,5,5,0,1
12,2009,711300,4,3,1,1
1,2010,711300,2,1,1,0
2,2010,711300,7,6,1,0
3,2010,711300,3,3,0,0
4,2010,711300,5,3,2,0
5,2010,711300,6,3,3,0
6,2010,711300,5,5,0,0
7,2010,711300,6,5,1,1
8,2010,711300,2,1,1,0
9,2010,711300,10,9,1,1
10,2010,711300,5,4,1,0
11,2010,711300,5,5,0,0
12,2010,711300,2,2,0,0
1,2011,711300,1,1,0,1
2,2011,711300,2,1,1,2
1,1999,711400,20,17,3,10
2,1999,711400,21,19,2,6
3,1999,711400,18,15,3,6
4,1999,711400,32,24,8,14
5,1999,711400,25,20,5,4
6,1999,711400,39,33,6,3
7,1999,711400,31,25,6,3
8,1999,711400,31,26,5,3
9,1999,711400,23,18,5,4
10,1999,711400,26,25,1,4
11,1999,711400,23,18,5,11
12,1999,711400,15,13,2,9
1,2000,711400,21,19,2,8
2,2000,711400,20,17,3,6
3,2000,711400,22,18,4,3
4,2000,711400,29,29,0,9
5,2000,711400,15,15,0,6
6,2000,711400,27,22,5,8
7,2000,711400,30,28,2,7
8,2000,711400,21,16,5,1
9,2000,711400,33,27,6,7
10,2000,711400,30,26,4,8
11,2000,711400,33,31,2,5
12,2000,711400,11,10,1,12
1,2001,711400,23,20,3,9
2,2001,711400,17,13,4,14
3,2001,711400,15,14,1,9
4,2001,711400,32,27,5,10
5,2001,711400,19,16,3,11
6,2001,711400,29,22,7,7
7,2001,711400,30,24,6,12
8,2001,711400,21,18,3,8
9,2001,711400,26,24,2,8
10,2001,711400,35,32,3,12
11,2001,711400,29,28,1,11
12,2001,711400,27,23,4,9
1,2002,711400,27,21,6,17
2,2002,711400,25,23,2,9
3,2002,711400,29,27,2,6
4,2002,711400,22,19,3,6
5,2002,711400,15,9,6,7
6,2002,711400,31,24,7,11
7,2002,711400,33,29,4,9
8,2002,711400,24,20,4,12
9,2002,711400,32,23,9,6
10,2002,711400,27,24,3,3
11,2002,711400,29,29,0,9
12,2002,711400,17,16,1,9
1,2003,711400,17,17,0,18
2,2003,711400,12,11,1,6
3,2003,711400,35,30,5,17
4,2003,711400,25,20,5,8
5,2003,711400,21,17,4,13
6,2003,711400,11,8,3,14
7,2003,711400,32,29,3,6
8,2003,711400,26,23,3,7
9,2003,711400,46,45,1,6
10,2003,711400,27,26,1,4
11,2003,711400,23,20,3,5
12,2003,711400,20,17,3,5
1,2004,711400,18,18,0,4
2,2004,711400,19,18,1,16
3,2004,711400,30,28,2,9
4,2004,711400,23,22,1,12
5,2004,711400,20,19,1,7
6,2004,711400,28,27,1,2
7,2004,711400,35,33,2,5
8,2004,711400,34,33,1,9
9,2004,711400,40,37,3,4
10,2004,711400,54,51,3,9
11,2004,711400,24,22,2,27
12,2004,711400,34,31,3,15
1,2005,711400,29,26,3,11
2,2005,711400,18,16,2,13
3,2005,711400,19,16,3,8
4,2005,711400,12,11,1,21
5,2005,711400,21,18,3,17
6,2005,711400,19,15,4,8
7,2005,711400,28,26,2,16
8,2005,711400,27,25,2,18
9,2005,711400,30,30,0,5
10,2005,711400,31,27,4,13
11,2005,711400,20,20,0,7
12,2005,711400,23,20,3,7
1,2006,711400,24,19,5,5
2,2006,711400,17,15,2,7
3,2006,711400,20,20,0,4
4,2006,711400,22,19,3,7
5,2006,711400,28,25,3,16
6,2006,711400,18,14,4,8
7,2006,711400,23,22,1,9
8,2006,711400,31,23,8,7
9,2006,711400,20,17,3,5
10,2006,711400,24,22,2,14
11,2006,711400,23,20,3,8
12,2006,711400,27,24,3,7
1,2007,711400,17,17,0,15
2,2007,711400,17,13,4,12
3,2007,711400,22,19,3,6
4,2007,711400,24,20,4,8
5,2007,711400,33,32,1,13
6,2007,711400,38,35,3,11
7,2007,711400,25,24,1,4
8,2007,711400,36,29,7,15
9,2007,711400,18,13,5,6
10,2007,711400,27,22,5,8
11,2007,711400,31,29,2,9
12,2007,711400,29,27,2,4
1,2008,711400,26,20,6,7
2,2008,711400,16,14,2,4
3,2008,711400,15,12,3,9
4,2008,711400,21,19,2,7
5,2008,711400,27,20,7,1
6,2008,711400,28,26,2,4
7,2008,711400,26,22,4,7
8,2008,711400,25,20,5,13
9,2008,711400,21,17,4,5
10,2008,711400,27,23,4,5
11,2008,711400,28,25,3,14
12,2008,711400,19,17,2,8
1,2009,711400,12,11,1,6
2,2009,711400,25,22,3,9
3,2009,711400,19,17,2,12
4,2009,711400,20,18,2,5
5,2009,711400,22,22,0,9
6,2009,711400,23,21,2,4
7,2009,711400,27,22,5,11
8,2009,711400,17,14,3,13
9,2009,711400,18,18,0,17
10,2009,711400,19,15,4,10
11,2009,711400,21,17,4,10
12,2009,711400,22,20,2,9
1,2010,711400,15,14,1,9
2,2010,711400,16,15,1,7
3,2010,711400,17,13,4,12
4,2010,711400,18,15,3,6
5,2010,711400,21,18,3,9
6,2010,711400,18,16,2,9
7,2010,711400,21,19,2,9
8,2010,711400,24,22,2,3
9,2010,711400,14,13,1,5
10,2010,711400,17,14,3,12
11,2010,711400,15,15,0,6
12,2010,711400,11,9,2,6
1,2011,711400,21,19,2,1
2,2011,711400,9,8,1,7
1,1999,440700,5,4,1,0
2,1999,440700,9,9,0,0
3,1999,440700,9,9,0,1
4,1999,440700,12,10,2,0
5,1999,440700,15,13,2,2
6,1999,440700,15,12,3,0
7,1999,440700,8,7,1,0
8,1999,440700,5,4,1,1
9,1999,440700,8,6,2,0
10,1999,440700,8,7,1,1
11,1999,440700,12,12,0,0
12,1999,440700,7,6,1,0
1,2000,440700,7,5,2,1
2,2000,440700,7,6,1,1
3,2000,440700,13,13,0,0
4,2000,440700,7,7,0,0
5,2000,440700,13,12,1,2
6,2000,440700,12,9,3,0
7,2000,440700,21,17,4,2
8,2000,440700,9,6,3,0
9,2000,440700,15,11,4,2
10,2000,440700,13,11,2,1
11,2000,440700,13,10,3,1
12,2000,440700,15,14,1,1
1,2001,440700,10,10,0,1
2,2001,440700,15,13,2,3
3,2001,440700,12,11,1,2
4,2001,440700,5,3,2,2
5,2001,440700,10,9,1,3
6,2001,440700,12,9,3,1
7,2001,440700,27,25,2,1
8,2001,440700,19,16,3,5
9,2001,440700,5,4,1,2
10,2001,440700,13,12,1,1
11,2001,440700,2,2,0,4
12,2001,440700,11,10,1,4
1,2002,440700,9,8,1,2
2,2002,440700,6,6,0,7
3,2002,440700,5,5,0,0
4,2002,440700,7,7,0,0
5,2002,440700,11,10,1,3
6,2002,440700,9,6,3,1
7,2002,440700,17,13,4,0
8,2002,440700,11,7,4,1
9,2002,440700,7,4,3,0
10,2002,440700,10,10,0,5
11,2002,440700,13,9,4,5
12,2002,440700,16,14,2,5
1,2003,440700,10,9,1,2
2,2003,440700,6,5,1,2
3,2003,440700,14,11,3,3
4,2003,440700,5,5,0,5
5,2003,440700,11,10,1,1
6,2003,440700,9,8,1,0
7,2003,440700,17,14,3,1
8,2003,440700,11,9,2,4
9,2003,440700,7,7,0,1
10,2003,440700,7,3,4,7
11,2003,440700,8,8,0,3
12,2003,440700,9,9,0,3
1,2004,440700,9,8,1,0
2,2004,440700,13,10,3,2
3,2004,440700,12,9,3,0
4,2004,440700,13,10,3,1
5,2004,440700,9,9,0,2
6,2004,440700,13,11,2,3
7,2004,440700,17,12,5,1
8,2004,440700,16,12,4,6
9,2004,440700,12,12,0,1
10,2004,440700,9,8,1,6
11,2004,440700,8,8,0,0
12,2004,440700,10,10,0,0
1,2005,440700,5,5,0,3
2,2005,440700,11,7,4,6
3,2005,440700,15,12,3,1
4,2005,440700,12,11,1,4
5,2005,440700,18,16,2,3
6,2005,440700,11,7,4,4
7,2005,440700,19,11,8,2
8,2005,440700,21,21,0,6
9,2005,440700,15,12,3,0
10,2005,440700,11,8,3,2
11,2005,440700,10,9,1,2
12,2005,440700,9,9,0,4
1,2006,440700,8,7,1,1
2,2006,440700,16,14,2,2
3,2006,440700,12,10,2,2
4,2006,440700,14,11,3,3
5,2006,440700,11,6,5,1
6,2006,440700,5,4,1,9
7,2006,440700,13,10,3,1
8,2006,440700,10,6,4,1
9,2006,440700,10,9,1,3
10,2006,440700,8,6,2,0
11,2006,440700,13,10,3,1
12,2006,440700,12,11,1,2
1,2007,440700,11,6,5,1
2,2007,440700,8,6,2,3
3,2007,440700,4,3,1,1
4,2007,440700,10,10,0,11
5,2007,440700,12,10,2,5
6,2007,440700,4,3,1,2
7,2007,440700,7,6,1,4
8,2007,440700,6,3,3,3
9,2007,440700,11,10,1,1
10,2007,440700,9,7,2,0
11,2007,440700,13,12,1,1
12,2007,440700,10,9,1,1
1,2008,440700,7,6,1,8
2,2008,440700,20,17,3,4
3,2008,440700,8,8,0,1
4,2008,440700,13,11,2,4
5,2008,440700,15,11,4,1
6,2008,440700,18,16,2,1
7,2008,440700,18,17,1,1
8,2008,440700,18,16,2,1
9,2008,440700,14,11,3,4
10,2008,440700,7,6,1,4
11,2008,440700,14,13,1,2
12,2008,440700,14,10,4,3
1,2009,440700,6,5,1,5
2,2009,440700,6,3,3,3
3,2009,440700,10,8,2,2
4,2009,440700,10,7,3,0
5,2009,440700,11,7,4,0
6,2009,440700,11,6,5,3
7,2009,440700,10,9,1,2
8,2009,440700,16,13,3,4
9,2009,440700,10,10,0,1
10,2009,440700,9,8,1,4
11,2009,440700,8,6,2,2
12,2009,440700,6,6,0,1
1,2010,440700,11,9,2,0
2,2010,440700,9,8,1,1
3,2010,440700,10,8,2,1
4,2010,440700,14,11,3,5
5,2010,440700,11,10,1,1
6,2010,440700,10,10,0,2
7,2010,440700,13,11,2,2
8,2010,440700,14,13,1,3
9,2010,440700,12,12,0,3
10,2010,440700,10,9,1,0
11,2010,440700,6,4,2,4
12,2010,440700,18,14,4,1
1,2011,440700,6,5,1,5
2,2011,440700,1,1,0,3
1,1999,480200,2,2,0,0
2,1999,480200,7,6,1,0
3,1999,480200,7,7,0,0
4,1999,480200,5,5,0,0
5,1999,480200,4,3,1,0
6,1999,480200,10,9,1,0
7,1999,480200,8,6,2,0
8,1999,480200,3,2,1,0
9,1999,480200,10,10,0,0
10,1999,480200,4,4,0,0
11,1999,480200,6,5,1,0
12,1999,480200,12,12,0,0
1,2000,480200,6,6,0,0
2,2000,480200,3,2,1,0
3,2000,480200,7,7,0,0
4,2000,480200,8,8,0,0
5,2000,480200,3,2,1,0
6,2000,480200,3,2,1,2
7,2000,480200,5,5,0,1
8,2000,480200,7,7,0,0
9,2000,480200,10,10,0,0
10,2000,480200,7,7,0,0
11,2000,480200,4,3,1,0
12,2000,480200,3,3,0,0
1,2001,480200,8,8,0,0
2,2001,480200,4,4,0,1
3,2001,480200,5,3,2,0
4,2001,480200,8,7,1,0
5,2001,480200,7,7,0,0
6,2001,480200,9,9,0,0
7,2001,480200,9,9,0,1
8,2001,480200,10,9,1,0
9,2001,480200,12,12,0,0
10,2001,480200,9,9,0,0
11,2001,480200,7,7,0,0
12,2001,480200,8,7,1,0
1,2002,480200,6,6,0,0
2,2002,480200,8,7,1,0
3,2002,480200,9,9,0,0
4,2002,480200,7,6,1,0
5,2002,480200,9,9,0,1
6,2002,480200,8,8,0,0
7,2002,480200,15,13,2,0
8,2002,480200,7,6,1,0
9,2002,480200,3,2,1,0
10,2002,480200,10,9,1,0
11,2002,480200,11,10,1,0
12,2002,480200,6,6,0,0
1,2003,480200,7,7,0,0
2,2003,480200,3,2,1,0
3,2003,480200,3,3,0,3
4,2003,480200,6,6,0,0
5,2003,480200,8,7,1,0
6,2003,480200,8,8,0,0
7,2003,480200,16,16,0,0
8,2003,480200,2,2,0,0
9,2003,480200,7,6,1,0
10,2003,480200,5,5,0,0
11,2003,480200,8,8,0,0
12,2003,480200,5,5,0,0
1,2004,480200,9,9,0,0
2,2004,480200,6,4,2,0
3,2004,480200,6,6,0,1
4,2004,480200,7,6,1,0
5,2004,480200,15,15,0,0
6,2004,480200,10,10,0,0
7,2004,480200,12,12,0,0
8,2004,480200,10,9,1,0
9,2004,480200,6,5,1,0
10,2004,480200,16,16,0,1
11,2004,480200,11,10,1,0
12,2004,480200,9,8,1,0
1,2005,480200,10,10,0,0
2,2005,480200,6,6,0,0
3,2005,480200,12,12,0,0
4,2005,480200,20,18,2,2
5,2005,480200,8,8,0,2
6,2005,480200,9,8,1,1
7,2005,480200,6,6,0,0
8,2005,480200,9,7,2,0
9,2005,480200,7,6,1,0
10,2005,480200,10,9,1,3
11,2005,480200,6,5,1,0
12,2005,480200,11,9,2,0
1,2006,480200,6,6,0,0
2,2006,480200,5,5,0,0
3,2006,480200,11,11,0,1
4,2006,480200,10,10,0,0
5,2006,480200,10,9,1,0
6,2006,480200,7,6,1,2
7,2006,480200,6,6,0,0
8,2006,480200,9,7,2,0
9,2006,480200,9,9,0,0
10,2006,480200,9,7,2,0
11,2006,480200,4,4,0,0
12,2006,480200,4,4,0,0
1,2007,480200,5,5,0,0
2,2007,480200,4,4,0,0
3,2007,480200,7,7,0,2
4,2007,480200,3,3,0,1
5,2007,480200,4,4,0,0
6,2007,480200,7,7,0,1
7,2007,480200,8,6,2,1
8,2007,480200,6,5,1,2
9,2007,480200,3,1,2,0
10,2007,480200,6,5,1,0
11,2007,480200,5,5,0,2
12,2007,480200,7,7,0,1
1,2008,480200,7,6,1,1
2,2008,480200,3,2,1,0
3,2008,480200,15,13,2,1
4,2008,480200,3,3,0,0
5,2008,480200,5,5,0,1
6,2008,480200,5,5,0,0
7,2008,480200,8,6,2,0
8,2008,480200,8,7,1,0
9,2008,480200,10,9,1,0
10,2008,480200,7,7,0,0
11,2008,480200,10,8,2,2
12,2008,480200,9,9,0,1
1,2009,480200,2,1,1,4
2,2009,480200,3,3,0,0
3,2009,480200,6,5,1,1
4,2009,480200,10,10,0,0
5,2009,480200,8,8,0,0
6,2009,480200,7,7,0,0
7,2009,480200,6,6,0,2
8,2009,480200,11,10,1,0
9,2009,480200,9,8,1,0
10,2009,480200,6,6,0,0
11,2009,480200,8,8,0,0
12,2009,480200,6,6,0,0
1,2010,480200,6,6,0,0
2,2010,480200,3,3,0,0
3,2010,480200,7,7,0,1
4,2010,480200,5,5,0,1
5,2010,480200,2,2,0,1
6,2010,480200,5,5,0,1
7,2010,480200,5,5,0,0
8,2010,480200,7,6,1,1
9,2010,480200,7,6,1,2
10,2010,480200,7,6,1,3
11,2010,480200,3,3,0,0
12,2010,480200,2,2,0,1
1,2011,480200,9,9,0,2
2,2011,480200,2,1,1,0
1,1999,480100,10,9,1,0
2,1999,480100,14,14,0,0
3,1999,480100,6,6,0,3
4,1999,480100,12,12,0,0
5,1999,480100,7,6,1,0
6,1999,480100,19,16,3,0
7,1999,480100,20,19,1,0
8,1999,480100,16,16,0,1
9,1999,480100,13,13,0,1
10,1999,480100,16,14,2,0
11,1999,480100,18,18,0,0
12,1999,480100,13,13,0,0
1,2000,480100,13,11,2,2
2,2000,480100,9,7,2,1
3,2000,480100,10,10,0,3
4,2000,480100,12,11,1,1
5,2000,480100,10,10,0,0
6,2000,480100,14,12,2,1
7,2000,480100,14,13,1,1
8,2000,480100,18,18,0,1
9,2000,480100,22,19,3,0
10,2000,480100,17,16,1,0
11,2000,480100,16,14,2,1
12,2000,480100,13,13,0,0
1,2001,480100,8,8,0,1
2,2001,480100,5,4,1,0
3,2001,480100,22,17,5,1
4,2001,480100,13,13,0,1
5,2001,480100,20,20,0,0
6,2001,480100,11,6,5,2
7,2001,480100,16,14,2,2
8,2001,480100,27,26,1,0
9,2001,480100,19,18,1,4
10,2001,480100,28,26,2,0
11,2001,480100,15,15,0,2
12,2001,480100,13,12,1,2
1,2002,480100,15,15,0,6
2,2002,480100,18,16,2,0
3,2002,480100,15,12,3,2
4,2002,480100,16,12,4,2
5,2002,480100,10,7,3,1
6,2002,480100,12,9,3,0
7,2002,480100,19,14,5,1
8,2002,480100,12,12,0,0
9,2002,480100,16,14,2,1
10,2002,480100,6,5,1,1
11,2002,480100,20,19,1,0
12,2002,480100,14,12,2,2
1,2003,480100,10,10,0,3
2,2003,480100,8,8,0,0
3,2003,480100,17,14,3,0
4,2003,480100,3,2,1,0
5,2003,480100,13,12,1,1
6,2003,480100,20,16,4,0
7,2003,480100,17,15,2,0
8,2003,480100,16,13,3,6
9,2003,480100,17,15,2,2
10,2003,480100,14,12,2,1
11,2003,480100,22,19,3,3
12,2003,480100,19,19,0,1
1,2004,480100,12,12,0,0
2,2004,480100,19,16,3,3
3,2004,480100,14,10,4,5
4,2004,480100,14,13,1,2
5,2004,480100,13,11,2,3
6,2004,480100,15,14,1,3
7,2004,480100,14,14,0,0
8,2004,480100,18,18,0,0
9,2004,480100,17,15,2,4
10,2004,480100,16,14,2,1
11,2004,480100,11,10,1,2
12,2004,480100,13,12,1,0
1,2005,480100,14,13,1,0
2,2005,480100,8,8,0,1
3,2005,480100,11,11,0,5
4,2005,480100,12,12,0,1
5,2005,480100,10,8,2,4
6,2005,480100,12,10,2,5
7,2005,480100,15,13,2,0
8,2005,480100,10,10,0,3
9,2005,480100,17,16,1,4
10,2005,480100,7,7,0,1
11,2005,480100,20,19,1,1
12,2005,480100,15,14,1,2
1,2006,480100,22,20,2,1
2,2006,480100,11,11,0,4
3,2006,480100,11,10,1,7
4,2006,480100,12,10,2,0
5,2006,480100,17,15,2,4
6,2006,480100,13,13,0,0
7,2006,480100,13,9,4,3
8,2006,480100,10,9,1,4
9,2006,480100,20,17,3,4
10,2006,480100,9,8,1,2
11,2006,480100,9,8,1,2
12,2006,480100,11,11,0,4
1,2007,480100,11,9,2,3
2,2007,480100,9,9,0,3
3,2007,480100,14,13,1,6
4,2007,480100,10,10,0,1
5,2007,480100,15,15,0,2
6,2007,480100,12,12,0,1
7,2007,480100,15,14,1,4
8,2007,480100,14,11,3,2
9,2007,480100,15,15,0,8
10,2007,480100,13,7,6,0
11,2007,480100,5,5,0,5
12,2007,480100,17,13,4,2
1,2008,480100,12,11,1,0
2,2008,480100,8,7,1,1
3,2008,480100,13,13,0,1
4,2008,480100,16,12,4,0
5,2008,480100,24,23,1,2
6,2008,480100,12,10,2,0
7,2008,480100,11,10,1,8
8,2008,480100,21,17,4,1
9,2008,480100,17,15,2,0
10,2008,480100,19,17,2,2
11,2008,480100,4,3,1,3
12,2008,480100,16,14,2,0
1,2009,480100,11,7,4,0
2,2009,480100,7,7,0,4
3,2009,480100,14,12,2,0
4,2009,480100,15,14,1,2
5,2009,480100,17,16,1,0
6,2009,480100,13,12,1,5
7,2009,480100,19,16,3,1
8,2009,480100,16,16,0,1
9,2009,480100,15,15,0,0
10,2009,480100,21,19,2,0
11,2009,480100,11,11,0,3
12,2009,480100,11,11,0,0
1,2010,480100,19,18,1,1
2,2010,480100,14,13,1,2
3,2010,480100,9,9,0,3
4,2010,480100,8,8,0,4
5,2010,480100,13,10,3,0
6,2010,480100,11,10,1,0
7,2010,480100,11,9,2,1
8,2010,480100,13,12,1,0
9,2010,480100,17,15,2,1
10,2010,480100,14,13,1,0
11,2010,480100,20,19,1,0
12,2010,480100,11,10,1,0
1,2011,480100,12,12,0,0
2,2011,480100,7,7,0,1
1,1999,460600,2,2,0,1
2,1999,460600,5,4,1,1
3,1999,460600,8,8,0,3
4,1999,460600,0,0,0,0
5,1999,460600,3,2,1,0
6,1999,460600,1,0,1,1
7,1999,460600,8,5,3,1
8,1999,460600,6,4,2,0
9,1999,460600,5,2,3,0
10,1999,460600,3,2,1,1
11,1999,460600,6,5,1,0
12,1999,460600,4,3,1,0
1,2000,460600,0,0,0,2
2,2000,460600,2,2,0,2
3,2000,460600,0,0,0,0
4,2000,460600,2,2,0,0
5,2000,460600,6,0,6,2
6,2000,460600,7,2,5,0
7,2000,460600,0,0,0,0
8,2000,460600,4,3,1,2
9,2000,460600,8,5,3,1
10,2000,460600,1,1,0,2
11,2000,460600,2,2,0,1
12,2000,460600,4,3,1,0
1,2001,460600,2,2,0,1
2,2001,460600,3,3,0,1
3,2001,460600,8,7,1,1
4,2001,460600,1,1,0,1
5,2001,460600,0,0,0,1
6,2001,460600,2,2,0,0
7,2001,460600,3,2,1,0
8,2001,460600,3,2,1,0
9,2001,460600,1,0,1,3
10,2001,460600,2,1,1,0
11,2001,460600,0,0,0,0
12,2001,460600,3,2,1,1
1,2002,460600,3,2,1,1
2,2002,460600,2,1,1,1
3,2002,460600,0,0,0,0
4,2002,460600,4,2,2,0
5,2002,460600,4,2,2,0
6,2002,460600,4,2,2,2
7,2002,460600,2,1,1,0
8,2002,460600,2,1,1,1
9,2002,460600,6,3,3,0
10,2002,460600,2,2,0,0
11,2002,460600,4,4,0,1
12,2002,460600,4,4,0,1
1,2003,460600,1,0,1,1
2,2003,460600,0,0,0,0
3,2003,460600,2,2,0,1
4,2003,460600,2,1,1,0
5,2003,460600,3,2,1,0
6,2003,460600,4,2,2,0
7,2003,460600,3,3,0,1
8,2003,460600,3,2,1,1
9,2003,460600,4,4,0,2
10,2003,460600,2,1,1,1
11,2003,460600,1,1,0,0
12,2003,460600,1,1,0,0
1,2004,460600,1,1,0,1
2,2004,460600,2,2,0,0
3,2004,460600,0,0,0,7
4,2004,460600,0,0,0,7
5,2004,460600,3,2,1,2
6,2004,460600,2,1,1,2
7,2004,460600,1,1,0,3
8,2004,460600,2,2,0,1
9,2004,460600,2,2,0,5
10,2004,460600,4,3,1,3
11,2004,460600,0,0,0,0
12,2004,460600,2,1,1,0
1,2005,460600,1,1,0,0
2,2005,460600,2,2,0,1
3,2005,460600,3,3,0,0
4,2005,460600,0,0,0,2
5,2005,460600,3,1,2,0
6,2005,460600,1,1,0,1
7,2005,460600,1,1,0,0
8,2005,460600,0,0,0,0
9,2005,460600,2,2,0,0
10,2005,460600,3,3,0,5
11,2005,460600,1,0,1,1
12,2005,460600,2,1,1,0
1,2006,460600,1,1,0,0
2,2006,460600,0,0,0,3
3,2006,460600,1,1,0,4
4,2006,460600,1,1,0,0
5,2006,460600,0,0,0,0
6,2006,460600,0,0,0,0
7,2006,460600,5,4,1,0
8,2006,460600,2,2,0,0
9,2006,460600,5,4,1,0
10,2006,460600,1,1,0,0
11,2006,460600,0,0,0,0
12,2006,460600,1,1,0,1
1,2007,460600,1,1,0,0
2,2007,460600,0,0,0,0
3,2007,460600,6,5,1,0
4,2007,460600,3,2,1,0
5,2007,460600,0,0,0,2
6,2007,460600,1,1,0,1
7,2007,460600,0,0,0,0
8,2007,460600,3,3,0,0
9,2007,460600,2,1,1,1
10,2007,460600,1,0,1,0
11,2007,460600,2,2,0,0
12,2007,460600,2,1,1,1
1,2008,460600,0,0,0,0
2,2008,460600,2,2,0,3
3,2008,460600,0,0,0,0
4,2008,460600,5,4,1,0
5,2008,460600,1,0,1,1
6,2008,460600,4,4,0,4
7,2008,460600,4,3,1,1
8,2008,460600,2,2,0,0
9,2008,460600,5,4,1,0
10,2008,460600,4,3,1,0
11,2008,460600,4,4,0,1
12,2008,460600,3,3,0,1
1,2009,460600,4,4,0,0
2,2009,460600,2,2,0,4
3,2009,460600,1,1,0,1
4,2009,460600,2,2,0,0
5,2009,460600,0,0,0,2
6,2009,460600,2,2,0,0
7,2009,460600,4,3,1,2
8,2009,460600,1,1,0,6
9,2009,460600,4,3,1,0
10,2009,460600,0,0,0,1
11,2009,460600,2,2,0,5
12,2009,460600,5,5,0,4
1,2010,460600,2,2,0,0
2,2010,460600,0,0,0,4
3,2010,460600,4,2,2,7
4,2010,460600,2,1,1,0
5,2010,460600,6,5,1,0
6,2010,460600,7,5,2,1
7,2010,460600,2,2,0,1
8,2010,460600,2,1,1,1
9,2010,460600,3,2,1,0
10,2010,460600,5,4,1,0
11,2010,460600,3,3,0,1
12,2010,460600,1,1,0,1
1,2011,460600,5,5,0,0
2,2011,460600,3,3,0,0
1,1999,460700,18,11,7,1
2,1999,460700,19,12,7,3
3,1999,460700,18,13,5,11
4,1999,460700,25,13,12,1
5,1999,460700,26,16,10,15
6,1999,460700,29,20,9,6
7,1999,460700,28,18,10,3
8,1999,460700,25,16,9,9
9,1999,460700,22,18,4,6
10,1999,460700,16,7,9,4
11,1999,460700,20,14,6,5
12,1999,460700,23,15,8,12
1,2000,460700,33,27,6,5
2,2000,460700,19,15,4,18
3,2000,460700,23,13,10,17
4,2000,460700,33,19,14,3
5,2000,460700,20,16,4,13
6,2000,460700,29,22,7,11
7,2000,460700,34,25,9,15
8,2000,460700,43,31,12,19
9,2000,460700,27,19,8,6
10,2000,460700,39,31,8,6
11,2000,460700,33,26,7,16
12,2000,460700,16,11,5,9
1,2001,460700,25,15,10,13
2,2001,460700,16,13,3,12
3,2001,460700,17,10,7,8
4,2001,460700,36,24,12,6
5,2001,460700,29,23,6,17
6,2001,460700,24,18,6,15
7,2001,460700,27,20,7,12
8,2001,460700,29,19,10,11
9,2001,460700,20,13,7,11
10,2001,460700,30,20,10,9
11,2001,460700,36,28,8,6
12,2001,460700,16,9,7,14
1,2002,460700,25,20,5,7
2,2002,460700,12,10,2,5
3,2002,460700,33,24,9,5
4,2002,460700,25,15,10,9
5,2002,460700,31,21,10,5
6,2002,460700,25,15,10,9
7,2002,460700,41,26,15,5
8,2002,460700,30,20,10,4
9,2002,460700,17,9,8,3
10,2002,460700,21,17,4,16
11,2002,460700,24,19,5,4
12,2002,460700,18,13,5,4
1,2003,460700,13,10,3,5
2,2003,460700,11,8,3,6
3,2003,460700,18,12,6,10
4,2003,460700,19,16,3,12
5,2003,460700,34,21,13,15
6,2003,460700,21,11,10,5
7,2003,460700,40,28,12,8
8,2003,460700,44,35,9,18
9,2003,460700,21,13,8,7
10,2003,460700,33,28,5,26
11,2003,460700,13,8,5,10
12,2003,460700,26,22,4,6
1,2004,460700,19,17,2,16
2,2004,460700,20,15,5,17
3,2004,460700,23,17,6,12
4,2004,460700,15,11,4,11
5,2004,460700,26,16,10,16
6,2004,460700,30,19,11,13
7,2004,460700,29,21,8,21
8,2004,460700,26,17,9,14
9,2004,460700,30,20,10,29
10,2004,460700,18,13,5,21
11,2004,460700,26,20,6,8
12,2004,460700,29,27,2,10
1,2005,460700,18,15,3,14
2,2005,460700,21,16,5,21
3,2005,460700,16,8,8,19
4,2005,460700,17,12,5,17
5,2005,460700,23,18,5,14
6,2005,460700,22,13,9,9
7,2005,460700,34,21,13,14
8,2005,460700,22,19,3,6
9,2005,460700,26,20,6,8
10,2005,460700,21,16,5,1
11,2005,460700,26,26,0,9
12,2005,460700,25,23,2,11
1,2006,460700,27,21,6,12
2,2006,460700,17,12,5,8
3,2006,460700,23,19,4,12
4,2006,460700,24,20,4,6
5,2006,460700,30,23,7,17
6,2006,460700,32,24,8,6
7,2006,460700,27,22,5,3
8,2006,460700,38,26,12,12
9,2006,460700,21,16,5,3
10,2006,460700,21,15,6,15
11,2006,460700,26,21,5,7
12,2006,460700,19,18,1,16
1,2007,460700,24,20,4,10
2,2007,460700,18,12,6,8
3,2007,460700,26,19,7,17
4,2007,460700,49,38,11,5
5,2007,460700,33,21,12,17
6,2007,460700,33,25,8,6
7,2007,460700,29,20,9,6
8,2007,460700,19,14,5,10
9,2007,460700,26,20,6,5
10,2007,460700,29,24,5,8
11,2007,460700,23,19,4,11
12,2007,460700,33,31,2,5
1,2008,460700,27,20,7,4
2,2008,460700,22,17,5,8
3,2008,460700,31,19,12,3
4,2008,460700,22,12,10,4
5,2008,460700,36,25,11,1
6,2008,460700,33,25,8,10
7,2008,460700,24,21,3,10
8,2008,460700,30,20,10,11
9,2008,460700,28,21,7,5
10,2008,460700,25,21,4,8
11,2008,460700,26,21,5,13
12,2008,460700,14,11,3,13
1,2009,460700,16,12,4,8
2,2009,460700,19,13,6,23
3,2009,460700,23,17,6,20
4,2009,460700,18,14,4,14
5,2009,460700,22,18,4,9
6,2009,460700,31,19,12,14
7,2009,460700,20,15,5,8
8,2009,460700,26,19,7,10
9,2009,460700,29,24,5,10
10,2009,460700,14,13,1,17
11,2009,460700,22,16,6,5
12,2009,460700,21,15,6,7
1,2010,460700,17,12,5,6
2,2010,460700,14,8,6,14
3,2010,460700,17,15,2,7
4,2010,460700,23,18,5,8
5,2010,460700,28,23,5,6
6,2010,460700,27,16,11,12
7,2010,460700,23,18,5,4
8,2010,460700,23,17,6,7
9,2010,460700,23,16,7,12
10,2010,460700,31,25,6,6
11,2010,460700,22,19,3,6
12,2010,460700,32,29,3,4
1,2011,460700,16,14,2,11
2,2011,460700,15,10,5,4
1,1999,700302,6,5,1,0
2,1999,700302,11,11,0,0
3,1999,700302,6,5,1,0
4,1999,700302,2,2,0,0
5,1999,700302,6,6,0,0
6,1999,700302,7,6,1,1
7,1999,700302,8,7,1,1
8,1999,700302,8,7,1,0
9,1999,700302,11,11,0,0
10,1999,700302,6,5,1,1
11,1999,700302,11,10,1,0
12,1999,700302,4,4,0,0
1,2000,700302,11,11,0,0
2,2000,700302,11,10,1,0
3,2000,700302,3,3,0,0
4,2000,700302,10,9,1,0
5,2000,700302,4,4,0,4
6,2000,700302,8,7,1,1
7,2000,700302,7,7,0,0
8,2000,700302,4,4,0,0
9,2000,700302,9,9,0,1
10,2000,700302,7,7,0,1
11,2000,700302,8,8,0,0
12,2000,700302,7,7,0,0
1,2001,700302,12,12,0,0
2,2001,700302,7,7,0,0
3,2001,700302,5,4,1,0
4,2001,700302,13,12,1,0
5,2001,700302,1,1,0,0
6,2001,700302,5,5,0,0
7,2001,700302,9,6,3,0
8,2001,700302,16,16,0,0
9,2001,700302,14,14,0,0
10,2001,700302,15,15,0,0
11,2001,700302,11,11,0,2
12,2001,700302,19,17,2,0
1,2002,700302,14,14,0,2
2,2002,700302,8,8,0,0
3,2002,700302,4,3,1,1
4,2002,700302,8,7,1,0
5,2002,700302,12,12,0,0
6,2002,700302,9,9,0,0
7,2002,700302,14,12,2,0
8,2002,700302,10,9,1,0
9,2002,700302,6,6,0,0
10,2002,700302,14,14,0,1
11,2002,700302,8,8,0,0
12,2002,700302,10,10,0,0
1,2003,700302,4,3,1,0
2,2003,700302,3,3,0,1
3,2003,700302,3,2,1,0
4,2003,700302,7,7,0,0
5,2003,700302,16,15,1,0
6,2003,700302,5,4,1,0
7,2003,700302,15,15,0,2
8,2003,700302,5,5,0,0
9,2003,700302,15,14,1,0
10,2003,700302,22,21,1,0
11,2003,700302,14,13,1,1
12,2003,700302,3,2,1,0
1,2004,700302,6,6,0,0
2,2004,700302,5,4,1,4
3,2004,700302,6,5,1,0
4,2004,700302,8,7,1,1
5,2004,700302,12,11,1,1
6,2004,700302,8,8,0,3
7,2004,700302,11,11,0,0
8,2004,700302,12,11,1,0
9,2004,700302,11,9,2,1
10,2004,700302,16,12,4,0
11,2004,700302,10,8,2,1
12,2004,700302,11,10,1,0
1,2005,700302,10,9,1,0
2,2005,700302,2,2,0,0
3,2005,700302,17,16,1,0
4,2005,700302,8,7,1,0
5,2005,700302,7,6,1,0
6,2005,700302,6,5,1,0
7,2005,700302,9,8,1,0
8,2005,700302,6,6,0,1
9,2005,700302,7,6,1,2
10,2005,700302,10,10,0,0
11,2005,700302,5,5,0,2
12,2005,700302,15,14,1,0
1,2006,700302,8,8,0,0
2,2006,700302,5,5,0,0
3,2006,700302,10,9,1,1
4,2006,700302,14,14,0,0
5,2006,700302,5,4,1,5
6,2006,700302,6,6,0,2
7,2006,700302,13,13,0,1
8,2006,700302,9,7,2,0
9,2006,700302,8,7,1,0
10,2006,700302,9,9,0,1
11,2006,700302,7,6,1,0
12,2006,700302,6,6,0,2
1,2007,700302,7,7,0,1
2,2007,700302,4,4,0,3
3,2007,700302,9,9,0,1
4,2007,700302,2,2,0,0
5,2007,700302,12,10,2,1
6,2007,700302,6,6,0,0
7,2007,700302,10,8,2,2
8,2007,700302,14,14,0,0
9,2007,700302,13,12,1,0
10,2007,700302,14,10,4,1
11,2007,700302,4,4,0,2
12,2007,700302,7,7,0,0
1,2008,700302,7,7,0,0
2,2008,700302,3,3,0,0
3,2008,700302,11,10,1,0
4,2008,700302,10,9,1,0
5,2008,700302,9,8,1,2
6,2008,700302,12,10,2,1
7,2008,700302,11,10,1,0
8,2008,700302,7,6,1,0
9,2008,700302,9,9,0,0
10,2008,700302,7,6,1,0
11,2008,700302,11,11,0,1
12,2008,700302,11,10,1,1
1,2009,700302,11,9,2,1
2,2009,700302,3,3,0,0
3,2009,700302,4,4,0,1
4,2009,700302,6,6,0,1
5,2009,700302,7,7,0,0
6,2009,700302,9,9,0,0
7,2009,700302,10,10,0,0
8,2009,700302,14,11,3,4
9,2009,700302,9,8,1,0
10,2009,700302,2,2,0,3
11,2009,700302,9,9,0,0
12,2009,700302,7,7,0,1
1,2010,700302,11,11,0,0
2,2010,700302,6,5,1,2
3,2010,700302,9,8,1,1
4,2010,700302,10,8,2,1
5,2010,700302,9,9,0,1
6,2010,700302,8,7,1,0
7,2010,700302,6,6,0,0
8,2010,700302,7,4,3,4
9,2010,700302,5,3,2,3
10,2010,700302,13,11,2,4
11,2010,700302,3,1,2,0
12,2010,700302,5,5,0,2
1,2011,700302,1,1,0,0
2,2011,700302,3,3,0,0
1,1999,700402,14,14,0,0
2,1999,700402,10,10,0,1
3,1999,700402,13,12,1,0
4,1999,700402,11,11,0,0
5,1999,700402,13,12,1,0
6,1999,700402,10,10,0,0
7,1999,700402,19,16,3,0
8,1999,700402,15,14,1,0
9,1999,700402,13,13,0,0
10,1999,700402,8,8,0,1
11,1999,700402,16,14,2,1
12,1999,700402,14,14,0,0
1,2000,700402,9,7,2,1
2,2000,700402,22,22,0,0
3,2000,700402,17,17,0,1
4,2000,700402,15,15,0,0
5,2000,700402,25,24,1,2
6,2000,700402,16,15,1,0
7,2000,700402,12,12,0,0
8,2000,700402,17,17,0,0
9,2000,700402,30,30,0,0
10,2000,700402,17,17,0,1
11,2000,700402,9,8,1,0
12,2000,700402,16,15,1,0
1,2001,700402,19,18,1,0
2,2001,700402,11,10,1,0
3,2001,700402,19,19,0,0
4,2001,700402,15,13,2,0
5,2001,700402,12,11,1,1
6,2001,700402,10,9,1,0
7,2001,700402,22,18,4,0
8,2001,700402,14,11,3,0
9,2001,700402,27,26,1,0
10,2001,700402,12,12,0,0
11,2001,700402,11,11,0,0
12,2001,700402,18,18,0,0
1,2002,700402,15,15,0,0
2,2002,700402,9,8,1,1
3,2002,700402,18,16,2,2
4,2002,700402,11,11,0,1
5,2002,700402,13,12,1,3
6,2002,700402,16,15,1,0
7,2002,700402,15,13,2,0
8,2002,700402,14,13,1,0
9,2002,700402,11,10,1,0
10,2002,700402,24,22,2,0
11,2002,700402,18,18,0,0
12,2002,700402,21,20,1,0
1,2003,700402,10,10,0,1
2,2003,700402,13,12,1,0
3,2003,700402,14,14,0,1
4,2003,700402,12,12,0,0
5,2003,700402,13,12,1,2
6,2003,700402,11,9,2,0
7,2003,700402,16,16,0,0
8,2003,700402,13,13,0,0
9,2003,700402,16,14,2,0
10,2003,700402,10,9,1,2
11,2003,700402,13,11,2,0
12,2003,700402,15,15,0,1
1,2004,700402,18,18,0,0
2,2004,700402,11,10,1,0
3,2004,700402,14,13,1,0
4,2004,700402,11,11,0,0
5,2004,700402,9,9,0,0
6,2004,700402,15,14,1,2
7,2004,700402,11,11,0,0
8,2004,700402,16,15,1,0
9,2004,700402,12,11,1,1
10,2004,700402,9,9,0,1
11,2004,700402,8,8,0,0
12,2004,700402,14,13,1,0
1,2005,700402,10,10,0,1
2,2005,700402,11,10,1,0
3,2005,700402,14,12,2,1
4,2005,700402,6,6,0,1
5,2005,700402,19,17,2,1
6,2005,700402,9,9,0,0
7,2005,700402,9,9,0,1
8,2005,700402,13,10,3,0
9,2005,700402,14,14,0,0
10,2005,700402,14,13,1,0
11,2005,700402,13,12,1,0
12,2005,700402,10,9,1,0
1,2006,700402,15,13,2,0
2,2006,700402,11,10,1,0
3,2006,700402,18,18,0,2
4,2006,700402,12,11,1,0
5,2006,700402,9,9,0,0
6,2006,700402,11,6,5,0
7,2006,700402,15,15,0,2
8,2006,700402,12,12,0,1
9,2006,700402,9,8,1,2
10,2006,700402,12,10,2,0
11,2006,700402,11,11,0,2
12,2006,700402,6,5,1,0
1,2007,700402,4,3,1,1
2,2007,700402,7,7,0,0
3,2007,700402,10,8,2,1
4,2007,700402,18,18,0,1
5,2007,700402,12,12,0,2
6,2007,700402,15,15,0,0
7,2007,700402,15,13,2,0
8,2007,700402,8,7,1,1
9,2007,700402,11,11,0,0
10,2007,700402,13,12,1,0
11,2007,700402,15,14,1,0
12,2007,700402,13,12,1,0
1,2008,700402,9,9,0,1
2,2008,700402,7,6,1,1
3,2008,700402,9,9,0,0
4,2008,700402,15,14,1,0
5,2008,700402,11,10,1,1
6,2008,700402,8,8,0,0
7,2008,700402,14,14,0,0
8,2008,700402,12,10,2,2
9,2008,700402,13,12,1,1
10,2008,700402,13,13,0,0
11,2008,700402,9,9,0,1
12,2008,700402,11,10,1,0
1,2009,700402,10,8,2,1
2,2009,700402,13,13,0,0
3,2009,700402,9,9,0,0
4,2009,700402,13,12,1,6
5,2009,700402,11,11,0,0
6,2009,700402,19,19,0,2
7,2009,700402,17,16,1,0
8,2009,700402,15,15,0,0
9,2009,700402,21,19,2,0
10,2009,700402,18,16,2,2
11,2009,700402,13,13,0,1
12,2009,700402,15,14,1,0
1,2010,700402,13,12,1,0
2,2010,700402,12,12,0,1
3,2010,700402,10,10,0,1
4,2010,700402,10,8,2,1
5,2010,700402,11,10,1,1
6,2010,700402,13,10,3,0
7,2010,700402,10,10,0,1
8,2010,700402,9,9,0,3
9,2010,700402,16,16,0,1
10,2010,700402,11,11,0,0
11,2010,700402,7,7,0,1
12,2010,700402,11,11,0,0
1,2011,700402,12,12,0,2
2,2011,700402,8,8,0,0
1,1999,700502,12,12,0,8
2,1999,700502,12,12,0,8
3,1999,700502,19,18,1,9
4,1999,700502,17,14,3,1
5,1999,700502,12,9,3,4
6,1999,700502,13,12,1,6
7,1999,700502,24,20,4,5
8,1999,700502,17,16,1,4
9,1999,700502,13,11,2,9
10,1999,700502,8,7,1,5
11,1999,700502,10,10,0,4
12,1999,700502,14,13,1,2
1,2000,700502,9,8,1,2
2,2000,700502,9,8,1,1
3,2000,700502,9,7,2,6
4,2000,700502,15,14,1,2
5,2000,700502,11,10,1,4
6,2000,700502,16,15,1,1
7,2000,700502,13,11,2,3
8,2000,700502,16,14,2,3
9,2000,700502,8,6,2,0
10,2000,700502,12,12,0,0
11,2000,700502,4,2,2,0
12,2000,700502,11,10,1,2
1,2001,700502,11,9,2,1
2,2001,700502,7,6,1,6
3,2001,700502,9,9,0,1
4,2001,700502,5,5,0,3
5,2001,700502,7,6,1,1
6,2001,700502,16,13,3,2
7,2001,700502,13,12,1,3
8,2001,700502,12,11,1,5
9,2001,700502,5,5,0,5
10,2001,700502,16,13,3,3
11,2001,700502,7,5,2,6
12,2001,700502,10,9,1,2
1,2002,700502,15,12,3,2
2,2002,700502,9,9,0,4
3,2002,700502,8,6,2,4
4,2002,700502,10,9,1,4
5,2002,700502,11,8,3,0
6,2002,700502,13,11,2,0
7,2002,700502,13,11,2,4
8,2002,700502,11,11,0,0
9,2002,700502,7,6,1,0
10,2002,700502,12,11,1,1
11,2002,700502,11,10,1,0
12,2002,700502,7,7,0,0
1,2003,700502,12,9,3,0
2,2003,700502,3,3,0,0
3,2003,700502,4,4,0,1
4,2003,700502,6,3,3,1
5,2003,700502,7,7,0,2
6,2003,700502,6,6,0,0
7,2003,700502,12,12,0,0
8,2003,700502,15,14,1,1
9,2003,700502,12,12,0,1
10,2003,700502,12,11,1,0
11,2003,700502,11,11,0,0
12,2003,700502,10,9,1,0
1,2004,700502,5,4,1,0
2,2004,700502,4,3,1,0
3,2004,700502,9,8,1,0
4,2004,700502,14,12,2,1
5,2004,700502,4,4,0,0
6,2004,700502,10,8,2,1
7,2004,700502,15,14,1,0
8,2004,700502,8,8,0,0
9,2004,700502,10,10,0,0
10,2004,700502,12,12,0,0
11,2004,700502,15,15,0,0
12,2004,700502,9,8,1,0
1,2005,700502,6,6,0,0
2,2005,700502,7,7,0,0
3,2005,700502,7,6,1,0
4,2005,700502,11,10,1,0
5,2005,700502,9,6,3,1
6,2005,700502,12,11,1,0
7,2005,700502,10,7,3,0
8,2005,700502,14,13,1,1
9,2005,700502,14,14,0,0
10,2005,700502,12,12,0,0
11,2005,700502,3,3,0,2
12,2005,700502,8,7,1,1
1,2006,700502,8,8,0,0
2,2006,700502,4,4,0,0
3,2006,700502,5,5,0,3
4,2006,700502,12,10,2,2
5,2006,700502,7,6,1,0
6,2006,700502,10,10,0,2
7,2006,700502,10,7,3,1
8,2006,700502,15,14,1,2
9,2006,700502,9,6,3,0
10,2006,700502,13,10,3,0
11,2006,700502,12,12,0,2
12,2006,700502,9,7,2,3
1,2007,700502,11,9,2,0
2,2007,700502,4,3,1,0
3,2007,700502,15,15,0,1
4,2007,700502,6,6,0,1
5,2007,700502,11,10,1,0
6,2007,700502,15,14,1,0
7,2007,700502,10,9,1,0
8,2007,700502,12,12,0,1
9,2007,700502,14,13,1,0
10,2007,700502,10,10,0,2
11,2007,700502,9,9,0,0
12,2007,700502,4,4,0,2
1,2008,700502,5,5,0,1
2,2008,700502,11,10,1,0
3,2008,700502,12,10,2,0
4,2008,700502,6,4,2,1
5,2008,700502,12,11,1,0
6,2008,700502,19,18,1,1
7,2008,700502,12,9,3,0
8,2008,700502,13,12,1,1
9,2008,700502,7,7,0,1
10,2008,700502,7,7,0,1
11,2008,700502,14,14,0,1
12,2008,700502,6,5,1,0
1,2009,700502,7,6,1,0
2,2009,700502,6,6,0,1
3,2009,700502,10,9,1,1
4,2009,700502,9,8,1,2
5,2009,700502,7,7,0,3
6,2009,700502,11,8,3,3
7,2009,700502,12,11,1,2
8,2009,700502,11,8,3,0
9,2009,700502,17,17,0,1
10,2009,700502,12,11,1,1
11,2009,700502,16,12,4,1
12,2009,700502,4,4,0,2
1,2010,700502,6,5,1,3
2,2010,700502,7,6,1,1
3,2010,700502,14,14,0,1
4,2010,700502,5,5,0,1
5,2010,700502,9,9,0,0
6,2010,700502,11,9,2,0
7,2010,700502,11,11,0,1
8,2010,700502,13,11,2,5
9,2010,700502,8,8,0,0
10,2010,700502,6,6,0,0
11,2010,700502,8,6,2,1
12,2010,700502,6,6,0,0
1,2011,700502,13,12,1,2
2,2011,700502,6,6,0,0
1,1999,711200,21,17,4,4
2,1999,711200,26,21,5,2
3,1999,711200,19,14,5,2
4,1999,711200,31,26,5,4
5,1999,711200,37,31,6,5
6,1999,711200,31,24,7,1
7,1999,711200,19,17,2,2
8,1999,711200,20,16,4,4
9,1999,711200,28,18,10,3
10,1999,711200,40,36,4,1
11,1999,711200,17,13,4,6
12,1999,711200,29,28,1,5
1,2000,711200,22,16,6,4
2,2000,711200,20,13,7,6
3,2000,711200,23,14,9,6
4,2000,711200,18,15,3,4
5,2000,711200,21,17,4,3
6,2000,711200,30,25,5,3
7,2000,711200,27,26,1,5
8,2000,711200,43,41,2,2
9,2000,711200,34,33,1,3
10,2000,711200,27,23,4,1
11,2000,711200,19,16,3,3
12,2000,711200,16,9,7,3
1,2001,711200,10,9,1,6
2,2001,711200,18,16,2,6
3,2001,711200,11,9,2,1
4,2001,711200,19,17,2,5
5,2001,711200,39,30,9,2
6,2001,711200,26,21,5,4
7,2001,711200,29,23,6,3
8,2001,711200,23,19,4,5
9,2001,711200,25,22,3,2
10,2001,711200,28,26,2,2
11,2001,711200,19,18,1,9
12,2001,711200,18,17,1,0
1,2002,711200,20,18,2,5
2,2002,711200,15,15,0,8
3,2002,711200,15,11,4,3
4,2002,711200,21,20,1,6
5,2002,711200,30,25,5,2
6,2002,711200,27,21,6,3
7,2002,711200,22,15,7,4
8,2002,711200,38,35,3,4
9,2002,711200,23,18,5,5
10,2002,711200,28,24,4,1
11,2002,711200,17,16,1,2
12,2002,711200,19,19,0,3
1,2003,711200,21,17,4,2
2,2003,711200,14,10,4,4
3,2003,711200,21,17,4,2
4,2003,711200,16,16,0,1
5,2003,711200,16,14,2,5
6,2003,711200,20,18,2,4
7,2003,711200,25,23,2,2
8,2003,711200,31,27,4,6
9,2003,711200,35,30,5,3
10,2003,711200,28,22,6,4
11,2003,711200,29,24,5,11
12,2003,711200,27,24,3,1
1,2004,711200,36,32,4,1
2,2004,711200,20,17,3,6
3,2004,711200,24,22,2,5
4,2004,711200,15,11,4,4
5,2004,711200,22,19,3,3
6,2004,711200,28,24,4,4
7,2004,711200,29,28,1,7
8,2004,711200,29,27,2,6
9,2004,711200,29,28,1,6
10,2004,711200,29,25,4,5
11,2004,711200,25,22,3,3
12,2004,711200,20,17,3,7
1,2005,711200,9,7,2,2
2,2005,711200,20,17,3,3
3,2005,711200,21,19,2,7
4,2005,711200,22,21,1,2
5,2005,711200,20,18,2,1
6,2005,711200,27,23,4,4
7,2005,711200,22,20,2,2
8,2005,711200,28,21,7,5
9,2005,711200,32,29,3,4
10,2005,711200,16,14,2,3
11,2005,711200,41,36,5,5
12,2005,711200,22,22,0,5
1,2006,711200,19,17,2,4
2,2006,711200,18,15,3,5
3,2006,711200,20,17,3,3
4,2006,711200,30,21,9,5
5,2006,711200,20,12,8,7
6,2006,711200,28,24,4,3
7,2006,711200,24,18,6,3
8,2006,711200,18,18,0,4
9,2006,711200,25,18,7,3
10,2006,711200,29,24,5,4
11,2006,711200,19,16,3,3
12,2006,711200,21,17,4,5
1,2007,711200,22,19,3,10
2,2007,711200,15,13,2,0
3,2007,711200,21,19,2,8
4,2007,711200,23,22,1,9
5,2007,711200,20,16,4,4
6,2007,711200,26,25,1,1
7,2007,711200,22,18,4,7
8,2007,711200,32,30,2,8
9,2007,711200,18,16,2,4
10,2007,711200,17,15,2,2
11,2007,711200,20,15,5,2
12,2007,711200,17,15,2,1
1,2008,711200,17,17,0,3
2,2008,711200,15,14,1,7
3,2008,711200,19,16,3,5
4,2008,711200,25,21,4,2
5,2008,711200,32,27,5,4
6,2008,711200,31,25,6,7
7,2008,711200,38,37,1,4
8,2008,711200,27,24,3,9
9,2008,711200,18,15,3,5
10,2008,711200,27,25,2,4
11,2008,711200,14,11,3,3
12,2008,711200,11,10,1,3
1,2009,711200,11,10,1,6
2,2009,711200,14,14,0,2
3,2009,711200,22,19,3,3
4,2009,711200,20,18,2,0
5,2009,711200,23,22,1,5
6,2009,711200,26,24,2,5
7,2009,711200,29,25,4,4
8,2009,711200,27,24,3,9
9,2009,711200,21,19,2,1
10,2009,711200,21,19,2,2
11,2009,711200,25,24,1,3
12,2009,711200,26,25,1,4
1,2010,711200,22,18,4,1
2,2010,711200,15,14,1,2
3,2010,711200,24,19,5,0
4,2010,711200,27,22,5,2
5,2010,711200,23,18,5,4
6,2010,711200,39,32,7,3
7,2010,711200,19,13,6,0
8,2010,711200,29,26,3,1
9,2010,711200,18,18,0,5
10,2010,711200,19,15,4,2
11,2010,711200,21,21,0,2
12,2010,711200,11,9,2,2
1,2011,711200,14,12,2,3
2,2011,711200,11,11,0,2
1,1999,711100,32,28,4,3
2,1999,711100,21,16,5,3
3,1999,711100,21,19,2,11
4,1999,711100,35,31,4,5
5,1999,711100,34,29,5,7
6,1999,711100,36,31,5,6
7,1999,711100,32,27,5,8
8,1999,711100,31,24,7,13
9,1999,711100,25,20,5,10
10,1999,711100,27,20,7,17
11,1999,711100,21,19,2,6
12,1999,711100,27,20,7,11
1,2000,711100,19,14,5,10
2,2000,711100,21,17,4,10
3,2000,711100,22,19,3,10
4,2000,711100,30,23,7,7
5,2000,711100,37,27,10,7
6,2000,711100,24,17,7,3
7,2000,711100,35,28,7,4
8,2000,711100,28,23,5,6
9,2000,711100,26,23,3,8
10,2000,711100,34,32,2,14
11,2000,711100,25,20,5,9
12,2000,711100,16,13,3,6
1,2001,711100,17,15,2,10
2,2001,711100,10,7,3,10
3,2001,711100,16,15,1,10
4,2001,711100,20,16,4,4
5,2001,711100,20,15,5,7
6,2001,711100,23,17,6,11
7,2001,711100,32,25,7,4
8,2001,711100,29,24,5,8
9,2001,711100,31,26,5,10
10,2001,711100,35,32,3,5
11,2001,711100,20,18,2,3
12,2001,711100,23,20,3,8
1,2002,711100,24,22,2,6
2,2002,711100,21,20,1,4
3,2002,711100,19,16,3,1
4,2002,711100,29,22,7,7
5,2002,711100,25,21,4,5
6,2002,711100,26,24,2,12
7,2002,711100,31,26,5,2
8,2002,711100,24,19,5,2
9,2002,711100,21,18,3,4
10,2002,711100,22,22,0,8
11,2002,711100,24,22,2,8
12,2002,711100,29,29,0,20
1,2003,711100,21,18,3,4
2,2003,711100,19,14,5,10
3,2003,711100,26,22,4,5
4,2003,711100,18,16,2,7
5,2003,711100,32,24,8,8
6,2003,711100,16,10,6,7
7,2003,711100,33,25,8,3
8,2003,711100,30,25,5,4
9,2003,711100,31,29,2,6
10,2003,711100,29,26,3,2
11,2003,711100,24,20,4,35
12,2003,711100,44,40,4,4
1,2004,711100,19,15,4,6
2,2004,711100,33,28,5,14
3,2004,711100,30,28,2,4
4,2004,711100,18,17,1,3
5,2004,711100,35,34,1,8
6,2004,711100,29,26,3,1
7,2004,711100,38,36,2,27
8,2004,711100,39,33,6,16
9,2004,711100,38,34,4,3
10,2004,711100,53,49,4,11
11,2004,711100,47,42,5,7
12,2004,711100,31,30,1,17
1,2005,711100,23,21,2,8
2,2005,711100,15,13,2,9
3,2005,711100,22,19,3,10
4,2005,711100,19,17,2,13
5,2005,711100,29,26,3,6
6,2005,711100,20,20,0,4
7,2005,711100,27,20,7,6
8,2005,711100,28,27,1,8
9,2005,711100,33,30,3,16
10,2005,711100,31,29,2,5
11,2005,711100,28,27,1,7
12,2005,711100,29,26,3,4
1,2006,711100,28,23,5,7
2,2006,711100,24,23,1,5
3,2006,711100,25,20,5,3
4,2006,711100,24,22,2,2
5,2006,711100,31,24,7,10
6,2006,711100,31,27,4,7
7,2006,711100,25,20,5,14
8,2006,711100,36,30,6,6
9,2006,711100,18,16,2,18
10,2006,711100,22,18,4,10
11,2006,711100,28,26,2,6
12,2006,711100,35,28,7,8
1,2007,711100,28,24,4,11
2,2007,711100,15,12,3,14
3,2007,711100,24,21,3,7
4,2007,711100,26,24,2,3
5,2007,711100,16,16,0,18
6,2007,711100,18,17,1,6
7,2007,711100,38,26,12,7
8,2007,711100,32,24,8,11
9,2007,711100,33,25,8,12
10,2007,711100,39,31,8,9
11,2007,711100,30,26,4,18
12,2007,711100,35,33,2,12
1,2008,711100,23,23,0,8
2,2008,711100,18,17,1,12
3,2008,711100,27,22,5,2
4,2008,711100,25,22,3,21
5,2008,711100,26,25,1,4
6,2008,711100,28,20,8,6
7,2008,711100,33,25,8,6
8,2008,711100,16,11,5,10
9,2008,711100,21,18,3,8
10,2008,711100,23,23,0,14
11,2008,711100,22,21,1,10
12,2008,711100,17,16,1,4
1,2009,711100,12,11,1,6
2,2009,711100,14,12,2,5
3,2009,711100,18,14,4,7
4,2009,711100,27,23,4,4
5,2009,711100,21,17,4,10
6,2009,711100,22,17,5,10
7,2009,711100,30,24,6,2
8,2009,711100,25,23,2,9
9,2009,711100,22,20,2,4
10,2009,711100,19,18,1,8
11,2009,711100,16,13,3,3
12,2009,711100,16,11,5,9
1,2010,711100,18,18,0,8
2,2010,711100,11,11,0,6
3,2010,711100,9,9,0,9
4,2010,711100,22,18,4,5
5,2010,711100,26,24,2,11
6,2010,711100,17,14,3,5
7,2010,711100,16,13,3,13
8,2010,711100,21,20,1,10
9,2010,711100,22,20,2,6
10,2010,711100,26,16,10,12
11,2010,711100,17,15,2,3
12,2010,711100,8,6,2,7
1,2011,711100,15,15,0,5
2,2011,711100,6,5,1,1
1,1999,711000,31,29,2,5
2,1999,711000,38,28,10,3
3,1999,711000,29,27,2,4
4,1999,711000,17,13,4,9
5,1999,711000,36,32,4,8
6,1999,711000,29,21,8,9
7,1999,711000,34,29,5,6
8,1999,711000,38,34,4,4
9,1999,711000,32,21,11,3
10,1999,711000,27,18,9,8
11,1999,711000,27,19,8,3
12,1999,711000,26,21,5,5
1,2000,711000,36,29,7,8
2,2000,711000,19,14,5,4
3,2000,711000,28,23,5,7
4,2000,711000,14,7,7,4
5,2000,711000,17,13,4,2
6,2000,711000,26,18,8,2
7,2000,711000,39,36,3,5
8,2000,711000,32,26,6,2
9,2000,711000,35,27,8,3
10,2000,711000,51,42,9,8
11,2000,711000,26,20,6,2
12,2000,711000,25,19,6,7
1,2001,711000,23,19,4,13
2,2001,711000,19,13,6,8
3,2001,711000,26,21,5,6
4,2001,711000,23,16,7,14
5,2001,711000,34,24,10,8
6,2001,711000,38,31,7,6
7,2001,711000,36,29,7,4
8,2001,711000,30,25,5,11
9,2001,711000,38,30,8,4
10,2001,711000,41,35,6,6
11,2001,711000,38,33,5,8
12,2001,711000,24,19,5,13
1,2002,711000,35,29,6,4
2,2002,711000,26,23,3,7
3,2002,711000,26,20,6,4
4,2002,711000,17,17,0,10
5,2002,711000,27,24,3,8
6,2002,711000,34,27,7,12
7,2002,711000,23,21,2,13
8,2002,711000,29,23,6,2
9,2002,711000,25,18,7,20
10,2002,711000,26,22,4,6
11,2002,711000,36,30,6,7
12,2002,711000,36,33,3,7
1,2003,711000,21,20,1,8
2,2003,711000,27,20,7,9
3,2003,711000,22,18,4,9
4,2003,711000,42,34,8,3
5,2003,711000,23,22,1,11
6,2003,711000,30,23,7,5
7,2003,711000,30,24,6,7
8,2003,711000,33,27,6,1
9,2003,711000,25,22,3,2
10,2003,711000,28,21,7,4
11,2003,711000,19,17,2,7
12,2003,711000,32,30,2,6
1,2004,711000,25,21,4,14
2,2004,711000,23,15,8,22
3,2004,711000,33,25,8,14
4,2004,711000,33,23,10,8
5,2004,711000,21,18,3,10
6,2004,711000,34,27,7,8
7,2004,711000,37,31,6,8
8,2004,711000,27,21,6,12
9,2004,711000,28,20,8,11
10,2004,711000,45,39,6,5
11,2004,711000,26,22,4,12
12,2004,711000,34,27,7,9
1,2005,711000,27,24,3,4
2,2005,711000,38,31,7,4
3,2005,711000,32,30,2,10
4,2005,711000,28,21,7,11
5,2005,711000,23,19,4,9
6,2005,711000,29,25,4,7
7,2005,711000,34,28,6,3
8,2005,711000,55,45,10,10
9,2005,711000,35,27,8,5
10,2005,711000,24,19,5,13
11,2005,711000,31,25,6,3
12,2005,711000,16,15,1,9
1,2006,711000,24,17,7,1
2,2006,711000,14,9,5,5
3,2006,711000,24,19,5,7
4,2006,711000,33,28,5,12
5,2006,711000,19,14,5,11
6,2006,711000,27,21,6,7
7,2006,711000,14,8,6,8
8,2006,711000,30,23,7,8
9,2006,711000,22,19,3,9
10,2006,711000,26,24,2,7
11,2006,711000,28,22,6,8
12,2006,711000,21,17,4,5
1,2007,711000,16,15,1,14
2,2007,711000,17,13,4,1
3,2007,711000,20,15,5,9
4,2007,711000,26,20,6,14
5,2007,711000,35,27,8,25
6,2007,711000,18,14,4,11
7,2007,711000,30,24,6,11
8,2007,711000,16,13,3,15
9,2007,711000,23,18,5,6
10,2007,711000,26,23,3,7
11,2007,711000,26,22,4,18
12,2007,711000,28,25,3,7
1,2008,711000,26,24,2,12
2,2008,711000,22,20,2,5
3,2008,711000,25,20,5,12
4,2008,711000,32,25,7,6
5,2008,711000,29,26,3,6
6,2008,711000,32,21,11,14
7,2008,711000,35,28,7,14
8,2008,711000,31,23,8,14
9,2008,711000,27,20,7,9
10,2008,711000,25,23,2,11
11,2008,711000,31,26,5,11
12,2008,711000,24,20,4,7
1,2009,711000,21,19,2,7
2,2009,711000,21,20,1,8
3,2009,711000,13,11,2,13
4,2009,711000,31,26,5,3
5,2009,711000,22,19,3,7
6,2009,711000,28,22,6,4
7,2009,711000,26,20,6,14
8,2009,711000,35,32,3,6
9,2009,711000,26,18,8,9
10,2009,711000,21,19,2,8
11,2009,711000,25,17,8,8
12,2009,711000,15,11,4,9
1,2010,711000,22,18,4,11
2,2010,711000,10,6,4,11
3,2010,711000,13,11,2,6
4,2010,711000,24,22,2,11
5,2010,711000,19,15,4,16
6,2010,711000,18,15,3,6
7,2010,711000,26,23,3,12
8,2010,711000,26,23,3,9
9,2010,711000,20,18,2,11
10,2010,711000,22,19,3,9
11,2010,711000,17,17,0,13
12,2010,711000,15,14,1,6
1,2011,711000,23,23,0,15
2,2011,711000,15,13,2,7
1,1999,710900,21,20,1,3
2,1999,710900,20,17,3,6
3,1999,710900,27,24,3,5
4,1999,710900,15,12,3,4
5,1999,710900,25,17,8,5
6,1999,710900,19,16,3,3
7,1999,710900,22,20,2,9
8,1999,710900,28,22,6,2
9,1999,710900,15,13,2,6
10,1999,710900,20,14,6,3
11,1999,710900,18,17,1,5
12,1999,710900,18,14,4,6
1,2000,710900,23,21,2,7
2,2000,710900,18,17,1,6
3,2000,710900,21,19,2,7
4,2000,710900,16,13,3,14
5,2000,710900,27,24,3,2
6,2000,710900,11,7,4,8
7,2000,710900,24,21,3,9
8,2000,710900,19,13,6,5
9,2000,710900,27,26,1,3
10,2000,710900,21,16,5,4
11,2000,710900,16,14,2,1
12,2000,710900,17,15,2,8
1,2001,710900,15,14,1,11
2,2001,710900,11,11,0,2
3,2001,710900,10,9,1,5
4,2001,710900,21,13,8,8
5,2001,710900,25,15,10,4
6,2001,710900,40,34,6,5
7,2001,710900,22,19,3,9
8,2001,710900,17,14,3,1
9,2001,710900,21,17,4,9
10,2001,710900,30,25,5,2
11,2001,710900,24,20,4,6
12,2001,710900,13,13,0,13
1,2002,710900,21,18,3,5
2,2002,710900,15,13,2,6
3,2002,710900,17,12,5,6
4,2002,710900,19,14,5,4
5,2002,710900,21,15,6,7
6,2002,710900,29,21,8,0
7,2002,710900,23,19,4,4
8,2002,710900,33,29,4,5
9,2002,710900,16,11,5,2
10,2002,710900,29,28,1,5
11,2002,710900,29,29,0,6
12,2002,710900,18,13,5,13
1,2003,710900,20,19,1,14
2,2003,710900,21,19,2,8
3,2003,710900,24,20,4,6
4,2003,710900,29,28,1,17
5,2003,710900,25,17,8,3
6,2003,710900,23,19,4,4
7,2003,710900,25,18,7,10
8,2003,710900,29,22,7,7
9,2003,710900,23,21,2,15
10,2003,710900,19,18,1,9
11,2003,710900,19,15,4,6
12,2003,710900,17,15,2,9
1,2004,710900,19,15,4,7
2,2004,710900,19,14,5,14
3,2004,710900,28,21,7,5
4,2004,710900,21,18,3,5
5,2004,710900,14,9,5,11
6,2004,710900,28,21,7,6
7,2004,710900,24,19,5,6
8,2004,710900,20,13,7,7
9,2004,710900,18,14,4,8
10,2004,710900,28,24,4,9
11,2004,710900,20,16,4,9
12,2004,710900,15,11,4,7
1,2005,710900,15,12,3,2
2,2005,710900,21,17,4,6
3,2005,710900,21,20,1,10
4,2005,710900,26,24,2,8
5,2005,710900,32,23,9,5
6,2005,710900,17,11,6,2
7,2005,710900,21,21,0,6
8,2005,710900,20,16,4,7
9,2005,710900,20,17,3,7
10,2005,710900,15,12,3,14
11,2005,710900,25,20,5,5
12,2005,710900,17,13,4,13
1,2006,710900,21,17,4,8
2,2006,710900,15,9,6,4
3,2006,710900,16,14,2,13
4,2006,710900,16,12,4,17
5,2006,710900,25,23,2,7
6,2006,710900,17,14,3,7
7,2006,710900,22,19,3,7
8,2006,710900,22,18,4,4
9,2006,710900,33,27,6,14
10,2006,710900,18,13,5,19
11,2006,710900,25,21,4,12
12,2006,710900,24,18,6,10
1,2007,710900,20,15,5,11
2,2007,710900,15,13,2,11
3,2007,710900,24,21,3,4
4,2007,710900,26,19,7,15
5,2007,710900,18,16,2,18
6,2007,710900,35,29,6,15
7,2007,710900,25,18,7,14
8,2007,710900,16,15,1,21
9,2007,710900,17,12,5,11
10,2007,710900,20,19,1,5
11,2007,710900,20,18,2,12
12,2007,710900,14,13,1,8
1,2008,710900,9,7,2,5
2,2008,710900,10,7,3,17
3,2008,710900,10,9,1,12
4,2008,710900,22,16,6,7
5,2008,710900,20,18,2,12
6,2008,710900,26,22,4,10
7,2008,710900,26,17,9,9
8,2008,710900,18,14,4,12
9,2008,710900,21,17,4,11
10,2008,710900,15,11,4,9
11,2008,710900,9,5,4,21
12,2008,710900,22,19,3,8
1,2009,710900,15,11,4,8
2,2009,710900,10,8,2,5
3,2009,710900,17,13,4,13
4,2009,710900,23,16,7,13
5,2009,710900,18,10,8,7
6,2009,710900,20,16,4,6
7,2009,710900,14,10,4,4
8,2009,710900,22,19,3,10
9,2009,710900,20,17,3,8
10,2009,710900,15,15,0,15
11,2009,710900,18,14,4,8
12,2009,710900,18,16,2,9
1,2010,710900,12,10,2,6
2,2010,710900,7,6,1,7
3,2010,710900,12,11,1,15
4,2010,710900,15,12,3,10
5,2010,710900,24,20,4,8
6,2010,710900,17,13,4,9
7,2010,710900,17,12,5,11
8,2010,710900,22,18,4,10
9,2010,710900,21,18,3,10
10,2010,710900,18,16,2,8
11,2010,710900,15,14,1,9
12,2010,710900,16,15,1,7
1,2011,710900,16,12,4,7
2,2011,710900,4,4,0,2
1,1999,440300,27,26,1,1
2,1999,440300,18,17,1,0
3,1999,440300,23,20,3,0
4,1999,440300,15,15,0,2
5,1999,440300,31,26,5,5
6,1999,440300,27,27,0,0
7,1999,440300,36,32,4,0
8,1999,440300,23,21,2,1
9,1999,440300,24,21,3,0
10,1999,440300,40,34,6,0
11,1999,440300,31,26,5,2
12,1999,440300,21,19,2,2
1,2000,440300,32,28,4,2
2,2000,440300,23,22,1,2
3,2000,440300,23,22,1,0
4,2000,440300,24,21,3,0
5,2000,440300,36,33,3,5
6,2000,440300,32,29,3,1
7,2000,440300,45,42,3,0
8,2000,440300,44,41,3,1
9,2000,440300,39,38,1,3
10,2000,440300,46,38,8,1
11,2000,440300,28,27,1,1
12,2000,440300,24,23,1,0
1,2001,440300,32,29,3,2
2,2001,440300,18,16,2,1
3,2001,440300,19,18,1,3
4,2001,440300,28,25,3,0
5,2001,440300,33,31,2,1
6,2001,440300,40,37,3,1
7,2001,440300,33,30,3,0
8,2001,440300,32,29,3,1
9,2001,440300,32,31,1,0
10,2001,440300,21,19,2,0
11,2001,440300,29,28,1,0
12,2001,440300,39,35,4,4
1,2002,440300,31,26,5,0
2,2002,440300,28,27,1,0
3,2002,440300,28,26,2,0
4,2002,440300,21,19,2,1
5,2002,440300,19,17,2,1
6,2002,440300,25,22,3,3
7,2002,440300,30,27,3,1
8,2002,440300,29,26,3,0
9,2002,440300,25,24,1,1
10,2002,440300,25,25,0,0
11,2002,440300,27,23,4,2
12,2002,440300,23,22,1,1
1,2003,440300,28,23,5,1
2,2003,440300,16,14,2,2
3,2003,440300,16,12,4,0
4,2003,440300,23,22,1,0
5,2003,440300,26,23,3,2
6,2003,440300,29,21,8,0
7,2003,440300,42,41,1,0
8,2003,440300,24,24,0,1
9,2003,440300,22,20,2,0
10,2003,440300,26,25,1,2
11,2003,440300,26,23,3,1
12,2003,440300,31,28,3,0
1,2004,440300,16,16,0,2
2,2004,440300,25,21,4,1
3,2004,440300,34,33,1,1
4,2004,440300,24,21,3,1
5,2004,440300,33,32,1,1
6,2004,440300,33,29,4,4
7,2004,440300,33,25,8,2
8,2004,440300,41,37,4,0
9,2004,440300,32,30,2,1
10,2004,440300,28,26,2,1
11,2004,440300,18,16,2,4
12,2004,440300,21,20,1,2
1,2005,440300,18,17,1,1
2,2005,440300,21,19,2,1
3,2005,440300,21,20,1,9
4,2005,440300,28,24,4,3
5,2005,440300,22,21,1,6
6,2005,440300,36,36,0,2
7,2005,440300,34,28,6,1
8,2005,440300,41,38,3,3
9,2005,440300,21,19,2,0
10,2005,440300,36,33,3,1
11,2005,440300,32,31,1,0
12,2005,440300,24,22,2,7
1,2006,440300,30,27,3,3
2,2006,440300,11,10,1,5
3,2006,440300,20,18,2,0
4,2006,440300,31,31,0,2
5,2006,440300,23,20,3,3
6,2006,440300,45,41,4,1
7,2006,440300,29,26,3,6
8,2006,440300,29,28,1,2
9,2006,440300,32,28,4,1
10,2006,440300,25,24,1,3
11,2006,440300,38,36,2,2
12,2006,440300,22,17,5,2
1,2007,440300,34,32,2,1
2,2007,440300,16,16,0,2
3,2007,440300,24,21,3,3
4,2007,440300,28,27,1,1
5,2007,440300,30,25,5,3
6,2007,440300,23,23,0,3
7,2007,440300,31,28,3,2
8,2007,440300,31,30,1,4
9,2007,440300,20,19,1,2
10,2007,440300,37,37,0,3
11,2007,440300,24,21,3,5
12,2007,440300,25,21,4,3
1,2008,440300,23,22,1,3
2,2008,440300,26,22,4,3
3,2008,440300,25,23,2,3
4,2008,440300,22,19,3,4
5,2008,440300,22,19,3,0
6,2008,440300,29,24,5,4
7,2008,440300,39,37,2,3
8,2008,440300,32,27,5,11
9,2008,440300,32,28,4,2
10,2008,440300,24,23,1,0
11,2008,440300,22,20,2,7
12,2008,440300,24,22,2,1
1,2009,440300,14,13,1,6
2,2009,440300,14,12,2,2
3,2009,440300,15,13,2,2
4,2009,440300,25,22,3,2
5,2009,440300,33,32,1,4
6,2009,440300,20,18,2,2
7,2009,440300,31,28,3,6
8,2009,440300,43,42,1,2
9,2009,440300,26,24,2,2
10,2009,440300,34,32,2,1
11,2009,440300,20,17,3,3
12,2009,440300,22,20,2,1
1,2010,440300,20,19,1,3
2,2010,440300,19,19,0,0
3,2010,440300,36,30,6,1
4,2010,440300,26,22,4,5
5,2010,440300,23,19,4,2
6,2010,440300,17,15,2,4
7,2010,440300,13,13,0,4
8,2010,440300,29,27,2,4
9,2010,440300,17,17,0,3
10,2010,440300,20,19,1,3
11,2010,440300,26,26,0,4
12,2010,440300,19,17,2,0
1,2011,440300,21,17,4,3
2,2011,440300,5,4,1,2
1,1999,440202,9,9,0,0
2,1999,440202,11,6,5,3
3,1999,440202,17,14,3,0
4,1999,440202,16,9,7,0
5,1999,440202,27,25,2,2
6,1999,440202,19,18,1,0
7,1999,440202,24,20,4,0
8,1999,440202,11,10,1,0
9,1999,440202,20,19,1,0
10,1999,440202,21,19,2,0
11,1999,440202,23,21,2,3
12,1999,440202,20,17,3,0
1,2000,440202,16,12,4,2
2,2000,440202,14,11,3,0
3,2000,440202,13,11,2,2
4,2000,440202,20,19,1,1
5,2000,440202,27,23,4,3
6,2000,440202,33,32,1,7
7,2000,440202,29,25,4,3
8,2000,440202,20,18,2,3
9,2000,440202,25,23,2,1
10,2000,440202,25,23,2,1
11,2000,440202,17,12,5,2
12,2000,440202,21,19,2,3
1,2001,440202,25,21,4,1
2,2001,440202,16,15,1,3
3,2001,440202,21,19,2,2
4,2001,440202,21,16,5,3
5,2001,440202,23,20,3,2
6,2001,440202,26,23,3,0
7,2001,440202,20,19,1,0
8,2001,440202,19,17,2,0
9,2001,440202,19,17,2,2
10,2001,440202,21,17,4,1
11,2001,440202,31,29,2,0
12,2001,440202,18,16,2,5
1,2002,440202,21,19,2,0
2,2002,440202,16,16,0,2
3,2002,440202,18,16,2,3
4,2002,440202,18,16,2,4
5,2002,440202,23,19,4,2
6,2002,440202,35,27,8,8
7,2002,440202,33,28,5,2
8,2002,440202,34,33,1,2
9,2002,440202,31,29,2,5
10,2002,440202,36,36,0,6
11,2002,440202,42,39,3,3
12,2002,440202,43,40,3,4
1,2003,440202,65,60,5,1
2,2003,440202,35,35,0,1
3,2003,440202,57,53,4,6
4,2003,440202,44,42,2,3
5,2003,440202,49,46,3,2
6,2003,440202,44,41,3,1
7,2003,440202,59,56,3,1
8,2003,440202,67,62,5,3
9,2003,440202,49,43,6,0
10,2003,440202,55,50,5,3
11,2003,440202,55,51,4,6
12,2003,440202,64,62,2,2
1,2004,440202,54,51,3,3
2,2004,440202,26,23,3,3
3,2004,440202,40,36,4,4
4,2004,440202,43,40,3,5
5,2004,440202,56,50,6,6
6,2004,440202,47,41,6,2
7,2004,440202,59,52,7,2
8,2004,440202,64,62,2,2
9,2004,440202,48,46,2,2
10,2004,440202,64,61,3,6
11,2004,440202,48,45,3,4
12,2004,440202,56,54,2,8
1,2005,440202,41,39,2,2
2,2005,440202,44,38,6,3
3,2005,440202,49,47,2,1
4,2005,440202,59,56,3,5
5,2005,440202,49,46,3,5
6,2005,440202,41,37,4,1
7,2005,440202,54,49,5,4
8,2005,440202,42,41,1,4
9,2005,440202,46,43,3,2
10,2005,440202,45,40,5,3
11,2005,440202,57,55,2,5
12,2005,440202,59,56,3,5
1,2006,440202,50,45,5,0
2,2006,440202,31,29,2,2
3,2006,440202,49,46,3,3
4,2006,440202,47,43,4,2
5,2006,440202,55,52,3,0
6,2006,440202,48,43,5,4
7,2006,440202,51,46,5,0
8,2006,440202,39,36,3,5
9,2006,440202,42,41,1,3
10,2006,440202,47,44,3,3
11,2006,440202,46,44,2,9
12,2006,440202,45,40,5,4
1,2007,440202,35,34,1,9
2,2007,440202,31,31,0,10
3,2007,440202,39,39,0,4
4,2007,440202,32,29,3,14
5,2007,440202,59,51,8,8
6,2007,440202,48,45,3,16
7,2007,440202,45,42,3,16
8,2007,440202,29,29,0,1
9,2007,440202,38,36,2,9
10,2007,440202,40,38,2,5
11,2007,440202,55,53,2,4
12,2007,440202,45,41,4,3
1,2008,440202,37,32,5,5
2,2008,440202,37,35,2,5
3,2008,440202,39,37,2,2
4,2008,440202,29,27,2,2
5,2008,440202,55,54,1,5
6,2008,440202,45,39,6,1
7,2008,440202,40,39,1,6
8,2008,440202,59,52,7,6
9,2008,440202,53,50,3,2
10,2008,440202,52,49,3,5
11,2008,440202,38,36,2,7
12,2008,440202,33,33,0,3
1,2009,440202,32,31,1,9
2,2009,440202,17,16,1,5
3,2009,440202,47,42,5,3
4,2009,440202,42,41,1,5
5,2009,440202,48,45,3,5
6,2009,440202,30,27,3,4
7,2009,440202,36,33,3,5
8,2009,440202,46,45,1,4
9,2009,440202,38,34,4,4
10,2009,440202,49,47,2,3
11,2009,440202,40,37,3,2
12,2009,440202,30,28,2,6
1,2010,440202,35,34,1,6
2,2010,440202,20,17,3,2
3,2010,440202,28,25,3,4
4,2010,440202,33,31,2,2
5,2010,440202,32,28,4,2
6,2010,440202,32,29,3,5
7,2010,440202,30,26,4,3
8,2010,440202,32,30,2,4
9,2010,440202,36,32,4,7
10,2010,440202,40,38,2,8
11,2010,440202,36,35,1,2
12,2010,440202,32,31,1,2
1,2011,440202,30,26,4,4
2,2011,440202,20,17,3,3
1,1999,440102,21,16,5,0
2,1999,440102,22,17,5,11
3,1999,440102,26,20,6,2
4,1999,440102,27,20,7,2
5,1999,440102,20,15,5,9
6,1999,440102,31,21,10,11
7,1999,440102,25,17,8,4
8,1999,440102,29,25,4,10
9,1999,440102,27,20,7,9
10,1999,440102,28,21,7,6
11,1999,440102,19,16,3,3
12,1999,440102,17,13,4,1
1,2000,440102,11,9,2,3
2,2000,440102,16,13,3,2
3,2000,440102,19,18,1,2
4,2000,440102,32,30,2,1
5,2000,440102,27,22,5,4
6,2000,440102,32,28,4,2
7,2000,440102,29,22,7,3
8,2000,440102,32,29,3,2
9,2000,440102,27,22,5,3
10,2000,440102,23,22,1,3
11,2000,440102,28,22,6,1
12,2000,440102,23,18,5,2
1,2001,440102,34,25,9,6
2,2001,440102,20,13,7,7
3,2001,440102,14,14,0,7
4,2001,440102,20,16,4,6
5,2001,440102,23,17,6,6
6,2001,440102,26,20,6,2
7,2001,440102,44,39,5,4
8,2001,440102,30,26,4,4
9,2001,440102,22,19,3,2
10,2001,440102,36,32,4,3
11,2001,440102,30,26,4,4
12,2001,440102,40,33,7,9
1,2002,440102,39,36,3,5
2,2002,440102,22,20,2,1
3,2002,440102,12,10,2,1
4,2002,440102,22,16,6,4
5,2002,440102,29,20,9,4
6,2002,440102,29,20,9,3
7,2002,440102,20,16,4,1
8,2002,440102,24,21,3,3
9,2002,440102,24,13,11,2
10,2002,440102,27,23,4,4
11,2002,440102,20,16,4,14
12,2002,440102,22,16,6,2
1,2003,440102,21,17,4,6
2,2003,440102,24,21,3,2
3,2003,440102,35,28,7,7
4,2003,440102,19,13,6,5
5,2003,440102,43,38,5,0
6,2003,440102,34,25,9,1
7,2003,440102,31,26,5,0
8,2003,440102,41,38,3,2
9,2003,440102,39,36,3,17
10,2003,440102,42,36,6,7
11,2003,440102,30,25,5,8
12,2003,440102,30,29,1,3
1,2004,440102,33,30,3,14
2,2004,440102,20,18,2,22
3,2004,440102,37,29,8,3
4,2004,440102,40,29,11,4
5,2004,440102,30,28,2,2
6,2004,440102,34,28,6,9
7,2004,440102,25,23,2,1
8,2004,440102,30,24,6,7
9,2004,440102,24,20,4,5
10,2004,440102,29,22,7,6
11,2004,440102,24,20,4,6
12,2004,440102,25,21,4,8
1,2005,440102,24,20,4,3
2,2005,440102,19,16,3,7
3,2005,440102,29,22,7,5
4,2005,440102,28,26,2,11
5,2005,440102,24,21,3,6
6,2005,440102,24,22,2,8
7,2005,440102,26,24,2,4
8,2005,440102,40,37,3,1
9,2005,440102,20,15,5,2
10,2005,440102,33,23,10,5
11,2005,440102,30,25,5,2
12,2005,440102,26,23,3,9
1,2006,440102,30,26,4,4
2,2006,440102,25,23,2,5
3,2006,440102,25,23,2,9
4,2006,440102,28,20,8,4
5,2006,440102,28,23,5,2
6,2006,440102,33,25,8,0
7,2006,440102,32,25,7,1
8,2006,440102,37,30,7,8
9,2006,440102,25,20,5,10
10,2006,440102,36,33,3,5
11,2006,440102,30,24,6,1
12,2006,440102,19,18,1,6
1,2007,440102,27,23,4,17
2,2007,440102,19,17,2,7
3,2007,440102,31,21,10,11
4,2007,440102,22,19,3,6
5,2007,440102,39,29,10,14
6,2007,440102,32,25,7,17
7,2007,440102,26,21,5,28
8,2007,440102,35,24,11,5
9,2007,440102,31,25,6,11
10,2007,440102,32,25,7,9
11,2007,440102,33,26,7,4
12,2007,440102,34,23,11,8
1,2008,440102,32,24,8,5
2,2008,440102,18,12,6,0
3,2008,440102,35,27,8,5
4,2008,440102,22,18,4,0
5,2008,440102,32,22,10,4
6,2008,440102,27,18,9,8
7,2008,440102,32,27,5,1
8,2008,440102,39,34,5,4
9,2008,440102,35,30,5,10
10,2008,440102,43,41,2,6
11,2008,440102,31,27,4,6
12,2008,440102,27,22,5,2
1,2009,440102,33,26,7,9
2,2009,440102,22,18,4,3
3,2009,440102,37,30,7,5
4,2009,440102,27,19,8,6
5,2009,440102,26,21,5,8
6,2009,440102,28,25,3,2
7,2009,440102,31,23,8,4
8,2009,440102,32,27,5,1
9,2009,440102,29,26,3,3
10,2009,440102,21,19,2,4
11,2009,440102,19,16,3,7
12,2009,440102,23,19,4,3
1,2010,440102,22,16,6,5
2,2010,440102,16,14,2,1
3,2010,440102,21,17,4,4
4,2010,440102,32,18,14,1
5,2010,440102,31,25,6,5
6,2010,440102,22,20,2,4
7,2010,440102,25,23,2,6
8,2010,440102,23,20,3,5
9,2010,440102,32,29,3,7
10,2010,440102,28,22,6,4
11,2010,440102,24,21,3,3
12,2010,440102,25,19,6,3
1,2011,440102,20,17,3,4
2,2011,440102,13,12,1,4
1,1999,834300,49,43,6,4
2,1999,834300,27,24,3,0
3,1999,834300,48,41,7,5
4,1999,834300,39,36,3,4
5,1999,834300,52,43,9,4
6,1999,834300,42,33,9,1
7,1999,834300,55,49,6,7
8,1999,834300,55,50,5,4
9,1999,834300,52,48,4,4
10,1999,834300,54,46,8,3
11,1999,834300,51,46,5,3
12,1999,834300,67,62,5,9
1,2000,834300,53,47,6,1
2,2000,834300,29,23,6,5
3,2000,834300,50,45,5,4
4,2000,834300,64,56,8,4
5,2000,834300,47,42,5,3
6,2000,834300,59,47,12,5
7,2000,834300,68,55,13,13
8,2000,834300,68,62,6,3
9,2000,834300,64,53,11,6
10,2000,834300,52,42,10,6
11,2000,834300,42,39,3,1
12,2000,834300,59,52,7,5
1,2001,834300,45,41,4,3
2,2001,834300,33,25,8,3
3,2001,834300,43,37,6,4
4,2001,834300,37,36,1,4
5,2001,834300,50,43,7,1
6,2001,834300,51,39,12,8
7,2001,834300,73,65,8,5
8,2001,834300,63,57,6,2
9,2001,834300,51,46,5,2
10,2001,834300,65,55,10,5
11,2001,834300,48,43,5,2
12,2001,834300,50,47,3,2
1,2002,834300,65,62,3,5
2,2002,834300,49,46,3,6
3,2002,834300,38,36,2,6
4,2002,834300,41,37,4,6
5,2002,834300,54,47,7,3
6,2002,834300,44,33,11,4
7,2002,834300,67,61,6,0
8,2002,834300,74,63,11,5
9,2002,834300,49,46,3,2
10,2002,834300,48,38,10,5
11,2002,834300,45,41,4,5
12,2002,834300,58,53,5,3
1,2003,834300,43,40,3,3
2,2003,834300,38,36,2,5
3,2003,834300,53,49,4,4
4,2003,834300,41,37,4,3
5,2003,834300,37,35,2,2
6,2003,834300,50,41,9,3
7,2003,834300,53,50,3,3
8,2003,834300,62,58,4,1
9,2003,834300,50,45,5,0
10,2003,834300,47,45,2,7
11,2003,834300,40,38,2,2
12,2003,834300,38,37,1,4
1,2004,834300,57,49,8,4
2,2004,834300,50,42,8,4
3,2004,834300,49,47,2,9
4,2004,834300,48,39,9,9
5,2004,834300,46,42,4,3
6,2004,834300,41,38,3,5
7,2004,834300,52,43,9,1
8,2004,834300,66,60,6,5
9,2004,834300,47,44,3,5
10,2004,834300,48,45,3,6
11,2004,834300,56,47,9,1
12,2004,834300,47,43,4,1
1,2005,834300,49,41,8,3
2,2005,834300,38,32,6,12
3,2005,834300,53,50,3,8
4,2005,834300,45,42,3,4
5,2005,834300,59,53,6,9
6,2005,834300,51,45,6,3
7,2005,834300,65,60,5,6
8,2005,834300,55,44,11,5
9,2005,834300,35,34,1,9
10,2005,834300,51,47,4,7
11,2005,834300,41,38,3,7
12,2005,834300,45,38,7,3
1,2006,834300,39,37,2,3
2,2006,834300,35,34,1,3
3,2006,834300,51,39,12,2
4,2006,834300,40,37,3,4
5,2006,834300,59,54,5,11
6,2006,834300,57,50,7,11
7,2006,834300,59,54,5,10
8,2006,834300,64,57,7,11
9,2006,834300,48,41,7,9
10,2006,834300,45,40,5,2
11,2006,834300,44,37,7,6
12,2006,834300,54,43,11,11
1,2007,834300,32,30,2,4
2,2007,834300,30,24,6,9
3,2007,834300,45,39,6,2
4,2007,834300,52,48,4,13
5,2007,834300,39,37,2,10
6,2007,834300,40,37,3,7
7,2007,834300,47,42,5,15
8,2007,834300,69,57,12,16
9,2007,834300,44,36,8,6
10,2007,834300,38,35,3,3
11,2007,834300,55,47,8,2
12,2007,834300,65,59,6,3
1,2008,834300,44,37,7,12
2,2008,834300,34,28,6,4
3,2008,834300,57,51,6,9
4,2008,834300,33,30,3,5
5,2008,834300,55,44,11,5
6,2008,834300,55,47,8,7
7,2008,834300,51,43,8,5
8,2008,834300,43,39,4,5
9,2008,834300,51,44,7,3
10,2008,834300,58,50,8,7
11,2008,834300,52,48,4,9
12,2008,834300,49,46,3,6
1,2009,834300,32,27,5,7
2,2009,834300,39,36,3,11
3,2009,834300,42,37,5,7
4,2009,834300,39,36,3,8
5,2009,834300,37,30,7,3
6,2009,834300,51,43,8,6
7,2009,834300,41,37,4,13
8,2009,834300,51,43,8,5
9,2009,834300,55,48,7,1
10,2009,834300,44,39,5,5
11,2009,834300,43,39,4,1
12,2009,834300,41,37,4,4
1,2010,834300,32,31,1,6
2,2010,834300,28,23,5,5
3,2010,834300,51,44,7,3
4,2010,834300,47,43,4,0
5,2010,834300,56,48,8,3
6,2010,834300,42,39,3,2
7,2010,834300,51,47,4,2
8,2010,834300,47,43,4,1
9,2010,834300,53,47,6,3
10,2010,834300,33,31,2,2
11,2010,834300,36,31,5,3
12,2010,834300,33,30,3,7
1,2011,834300,45,41,4,2
2,2011,834300,16,15,1,1
1,1999,450300,41,40,1,3
2,1999,450300,36,32,4,6
3,1999,450300,43,36,7,12
4,1999,450300,49,46,3,7
5,1999,450300,39,37,2,5
6,1999,450300,46,41,5,2
7,1999,450300,60,54,6,8
8,1999,450300,37,36,1,10
9,1999,450300,45,39,6,6
10,1999,450300,41,33,8,3
11,1999,450300,38,35,3,3
12,1999,450300,41,38,3,11
1,2000,450300,40,38,2,3
2,2000,450300,39,36,3,7
3,2000,450300,47,39,8,3
4,2000,450300,54,48,6,4
5,2000,450300,47,41,6,2
6,2000,450300,37,33,4,9
7,2000,450300,45,37,8,5
8,2000,450300,49,45,4,6
9,2000,450300,61,54,7,7
10,2000,450300,50,48,2,2
11,2000,450300,49,39,10,8
12,2000,450300,39,35,4,4
1,2001,450300,33,32,1,13
2,2001,450300,39,33,6,5
3,2001,450300,28,21,7,3
4,2001,450300,42,33,9,3
5,2001,450300,35,32,3,8
6,2001,450300,42,34,8,0
7,2001,450300,34,31,3,2
8,2001,450300,53,45,8,3
9,2001,450300,38,34,4,4
10,2001,450300,53,46,7,3
11,2001,450300,25,24,1,5
12,2001,450300,44,38,6,1
1,2002,450300,44,41,3,7
2,2002,450300,31,29,2,11
3,2002,450300,40,33,7,11
4,2002,450300,33,27,6,6
5,2002,450300,37,36,1,5
6,2002,450300,34,27,7,2
7,2002,450300,49,40,9,2
8,2002,450300,43,41,2,3
9,2002,450300,52,46,6,3
10,2002,450300,63,58,5,3
11,2002,450300,49,48,1,3
12,2002,450300,38,31,7,4
1,2003,450300,32,26,6,4
2,2003,450300,30,28,2,8
3,2003,450300,49,44,5,5
4,2003,450300,52,48,4,2
5,2003,450300,41,35,6,5
6,2003,450300,40,35,5,3
7,2003,450300,48,46,2,13
8,2003,450300,40,32,8,3
9,2003,450300,44,42,2,5
10,2003,450300,59,54,5,12
11,2003,450300,69,61,8,7
12,2003,450300,38,33,5,10
1,2004,450300,34,31,3,16
2,2004,450300,48,39,9,9
3,2004,450300,53,48,5,11
4,2004,450300,38,36,2,6
5,2004,450300,48,45,3,6
6,2004,450300,34,28,6,3
7,2004,450300,56,52,4,7
8,2004,450300,39,34,5,11
9,2004,450300,56,51,5,4
10,2004,450300,51,46,5,5
11,2004,450300,45,39,6,6
12,2004,450300,37,35,2,3
1,2005,450300,38,34,4,5
2,2005,450300,44,39,5,17
3,2005,450300,45,39,6,9
4,2005,450300,32,29,3,8
5,2005,450300,37,31,6,9
6,2005,450300,46,40,6,4
7,2005,450300,61,55,6,5
8,2005,450300,32,29,3,2
9,2005,450300,32,31,1,6
10,2005,450300,53,46,7,5
11,2005,450300,35,32,3,9
12,2005,450300,36,29,7,11
1,2006,450300,33,32,1,1
2,2006,450300,36,31,5,6
3,2006,450300,37,32,5,9
4,2006,450300,37,31,6,4
5,2006,450300,41,40,1,7
6,2006,450300,36,32,4,6
7,2006,450300,39,38,1,4
8,2006,450300,27,25,2,6
9,2006,450300,38,36,2,7
10,2006,450300,52,49,3,5
11,2006,450300,39,35,4,6
12,2006,450300,43,40,3,5
1,2007,450300,35,31,4,7
2,2007,450300,23,21,2,14
3,2007,450300,44,37,7,3
4,2007,450300,32,28,4,4
5,2007,450300,56,48,8,5
6,2007,450300,39,35,4,5
7,2007,450300,52,48,4,5
8,2007,450300,42,38,4,9
9,2007,450300,41,38,3,14
10,2007,450300,36,30,6,11
11,2007,450300,51,45,6,4
12,2007,450300,39,32,7,5
1,2008,450300,28,25,3,5
2,2008,450300,29,26,3,8
3,2008,450300,48,45,3,3
4,2008,450300,57,49,8,5
5,2008,450300,63,57,6,2
6,2008,450300,46,41,5,3
7,2008,450300,52,48,4,8
8,2008,450300,41,35,6,11
9,2008,450300,48,43,5,4
10,2008,450300,52,49,3,1
11,2008,450300,34,32,2,5
12,2008,450300,46,42,4,5
1,2009,450300,38,31,7,5
2,2009,450300,32,30,2,5
3,2009,450300,36,33,3,0
4,2009,450300,34,27,7,7
5,2009,450300,47,44,3,10
6,2009,450300,41,40,1,6
7,2009,450300,44,39,5,10
8,2009,450300,37,33,4,4
9,2009,450300,45,42,3,6
10,2009,450300,45,40,5,11
11,2009,450300,37,35,2,6
12,2009,450300,46,44,2,10
1,2010,450300,37,34,3,6
2,2010,450300,33,27,6,6
3,2010,450300,32,23,9,8
4,2010,450300,39,32,7,2
5,2010,450300,32,25,7,8
6,2010,450300,35,34,1,7
7,2010,450300,28,23,5,4
8,2010,450300,44,38,6,1
9,2010,450300,28,28,0,9
10,2010,450300,44,42,2,5
11,2010,450300,41,36,5,2
12,2010,450300,24,23,1,3
1,2011,450300,34,31,3,5
2,2011,450300,22,19,3,2
1,1999,460400,17,11,6,1
2,1999,460400,14,11,3,2
3,1999,460400,21,19,2,4
4,1999,460400,17,12,5,4
5,1999,460400,12,10,2,0
6,1999,460400,21,16,5,3
7,1999,460400,18,15,3,6
8,1999,460400,26,21,5,1
9,1999,460400,19,13,6,1
10,1999,460400,16,12,4,2
11,1999,460400,14,14,0,3
12,1999,460400,18,14,4,1
1,2000,460400,12,9,3,3
2,2000,460400,8,6,2,5
3,2000,460400,15,13,2,3
4,2000,460400,10,8,2,6
5,2000,460400,21,17,4,3
6,2000,460400,15,13,2,4
7,2000,460400,12,10,2,4
8,2000,460400,18,15,3,2
9,2000,460400,12,10,2,2
10,2000,460400,25,22,3,2
11,2000,460400,15,11,4,5
12,2000,460400,14,11,3,4
1,2001,460400,15,11,4,5
2,2001,460400,16,13,3,1
3,2001,460400,20,17,3,4
4,2001,460400,14,13,1,1
5,2001,460400,26,22,4,5
6,2001,460400,21,15,6,5
7,2001,460400,17,13,4,6
8,2001,460400,15,11,4,4
9,2001,460400,25,22,3,1
10,2001,460400,25,20,5,1
11,2001,460400,18,15,3,1
12,2001,460400,13,12,1,0
1,2002,460400,21,13,8,4
2,2002,460400,6,4,2,1
3,2002,460400,10,6,4,2
4,2002,460400,15,10,5,1
5,2002,460400,16,12,4,2
6,2002,460400,26,21,5,3
7,2002,460400,33,26,7,5
8,2002,460400,17,11,6,1
9,2002,460400,33,24,9,3
10,2002,460400,28,22,6,2
11,2002,460400,20,17,3,3
12,2002,460400,24,19,5,4
1,2003,460400,15,15,0,9
2,2003,460400,19,17,2,1
3,2003,460400,25,24,1,2
4,2003,460400,28,24,4,1
5,2003,460400,26,25,1,2
6,2003,460400,24,17,7,2
7,2003,460400,41,39,2,0
8,2003,460400,23,22,1,1
9,2003,460400,20,18,2,2
10,2003,460400,23,18,5,3
11,2003,460400,11,11,0,0
12,2003,460400,19,19,0,1
1,2004,460400,15,12,3,4
2,2004,460400,25,20,5,7
3,2004,460400,28,23,5,4
4,2004,460400,24,23,1,12
5,2004,460400,25,19,6,10
6,2004,460400,22,18,4,2
7,2004,460400,32,30,2,0
8,2004,460400,30,29,1,6
9,2004,460400,29,28,1,10
10,2004,460400,16,14,2,2
11,2004,460400,12,10,2,3
12,2004,460400,31,26,5,7
1,2005,460400,22,19,3,7
2,2005,460400,14,12,2,7
3,2005,460400,21,14,7,3
4,2005,460400,18,15,3,2
5,2005,460400,14,7,7,3
6,2005,460400,22,19,3,2
7,2005,460400,33,26,7,5
8,2005,460400,30,30,0,2
9,2005,460400,16,14,2,1
10,2005,460400,15,13,2,7
11,2005,460400,30,27,3,1
12,2005,460400,13,13,0,5
1,2006,460400,22,20,2,7
2,2006,460400,14,12,2,1
3,2006,460400,17,11,6,5
4,2006,460400,25,21,4,2
5,2006,460400,17,16,1,6
6,2006,460400,14,13,1,2
7,2006,460400,24,18,6,5
8,2006,460400,22,19,3,7
9,2006,460400,20,17,3,6
10,2006,460400,15,11,4,4
11,2006,460400,14,9,5,1
12,2006,460400,22,20,2,12
1,2007,460400,17,13,4,2
2,2007,460400,10,9,1,7
3,2007,460400,18,15,3,4
4,2007,460400,19,16,3,3
5,2007,460400,32,24,8,13
6,2007,460400,29,19,10,2
7,2007,460400,27,19,8,2
8,2007,460400,20,15,5,3
9,2007,460400,21,17,4,4
10,2007,460400,20,18,2,2
11,2007,460400,24,23,1,1
12,2007,460400,19,13,6,6
1,2008,460400,19,16,3,0
2,2008,460400,10,8,2,13
3,2008,460400,20,16,4,5
4,2008,460400,23,20,3,2
5,2008,460400,16,15,1,6
6,2008,460400,26,17,9,11
7,2008,460400,20,15,5,11
8,2008,460400,22,16,6,2
9,2008,460400,20,18,2,5
10,2008,460400,20,16,4,2
11,2008,460400,19,17,2,3
12,2008,460400,9,8,1,5
1,2009,460400,15,13,2,2
2,2009,460400,22,19,3,6
3,2009,460400,24,18,6,10
4,2009,460400,19,16,3,4
5,2009,460400,18,17,1,5
6,2009,460400,22,17,5,6
7,2009,460400,31,29,2,5
8,2009,460400,29,27,2,17
9,2009,460400,16,14,2,6
10,2009,460400,11,10,1,10
11,2009,460400,19,17,2,5
12,2009,460400,14,10,4,3
1,2010,460400,17,13,4,7
2,2010,460400,16,14,2,16
3,2010,460400,21,18,3,10
4,2010,460400,16,13,3,5
5,2010,460400,23,21,2,6
6,2010,460400,18,16,2,2
7,2010,460400,22,21,1,6
8,2010,460400,21,18,3,3
9,2010,460400,21,16,5,9
10,2010,460400,23,21,2,5
11,2010,460400,14,14,0,3
12,2010,460400,13,12,1,1
1,2011,460400,16,14,2,0
2,2011,460400,6,6,0,1
1,1999,460301,17,13,4,11
2,1999,460301,23,17,6,2
3,1999,460301,11,5,6,4
4,1999,460301,13,7,6,3
5,1999,460301,16,12,4,10
6,1999,460301,24,16,8,8
7,1999,460301,29,23,6,5
8,1999,460301,14,11,3,4
9,1999,460301,26,20,6,3
10,1999,460301,19,12,7,4
11,1999,460301,27,21,6,5
12,1999,460301,15,12,3,8
1,2000,460301,15,12,3,4
2,2000,460301,9,6,3,5
3,2000,460301,17,13,4,4
4,2000,460301,16,9,7,4
5,2000,460301,14,8,6,8
6,2000,460301,17,10,7,6
7,2000,460301,22,16,6,7
8,2000,460301,29,23,6,10
9,2000,460301,19,16,3,6
10,2000,460301,27,23,4,3
11,2000,460301,23,18,5,4
12,2000,460301,13,11,2,6
1,2001,460301,17,15,2,13
2,2001,460301,11,7,4,8
3,2001,460301,11,10,1,13
4,2001,460301,8,6,2,11
5,2001,460301,15,10,5,7
6,2001,460301,16,13,3,7
7,2001,460301,21,16,5,9
8,2001,460301,25,17,8,8
9,2001,460301,23,15,8,9
10,2001,460301,16,9,7,10
11,2001,460301,20,14,6,4
12,2001,460301,21,14,7,7
1,2002,460301,19,14,5,9
2,2002,460301,15,13,2,14
3,2002,460301,25,19,6,15
4,2002,460301,16,11,5,9
5,2002,460301,27,24,3,6
6,2002,460301,16,11,5,9
7,2002,460301,24,17,7,9
8,2002,460301,26,19,7,5
9,2002,460301,18,13,5,8
10,2002,460301,21,18,3,10
11,2002,460301,21,19,2,3
12,2002,460301,14,12,2,8
1,2003,460301,19,16,3,5
2,2003,460301,14,11,3,3
3,2003,460301,16,14,2,6
4,2003,460301,20,16,4,5
5,2003,460301,19,14,5,6
6,2003,460301,18,17,1,3
7,2003,460301,24,21,3,8
8,2003,460301,30,22,8,12
9,2003,460301,28,23,5,5
10,2003,460301,23,16,7,13
11,2003,460301,19,16,3,9
12,2003,460301,28,22,6,12
1,2004,460301,19,15,4,19
2,2004,460301,15,13,2,7
3,2004,460301,19,14,5,23
4,2004,460301,16,14,2,14
5,2004,460301,18,16,2,11
6,2004,460301,15,12,3,9
7,2004,460301,26,19,7,14
8,2004,460301,20,18,2,14
9,2004,460301,15,12,3,29
10,2004,460301,21,18,3,14
11,2004,460301,23,19,4,15
12,2004,460301,18,15,3,9
1,2005,460301,13,11,2,10
2,2005,460301,13,10,3,6
3,2005,460301,13,11,2,5
4,2005,460301,17,13,4,23
5,2005,460301,16,13,3,6
6,2005,460301,26,22,4,8
7,2005,460301,18,14,4,8
8,2005,460301,23,22,1,8
9,2005,460301,20,16,4,3
10,2005,460301,17,15,2,6
11,2005,460301,18,11,7,8
12,2005,460301,14,13,1,6
1,2006,460301,17,15,2,24
2,2006,460301,11,10,1,6
3,2006,460301,11,9,2,9
4,2006,460301,19,13,6,3
5,2006,460301,20,18,2,4
6,2006,460301,12,10,2,6
7,2006,460301,26,19,7,8
8,2006,460301,29,23,6,8
9,2006,460301,14,10,4,19
10,2006,460301,24,18,6,23
11,2006,460301,20,19,1,7
12,2006,460301,13,11,2,7
1,2007,460301,20,17,3,9
2,2007,460301,19,16,3,5
3,2007,460301,19,16,3,4
4,2007,460301,35,32,3,11
5,2007,460301,29,24,5,13
6,2007,460301,20,15,5,14
7,2007,460301,15,10,5,6
8,2007,460301,21,13,8,12
9,2007,460301,21,17,4,4
10,2007,460301,19,15,4,14
11,2007,460301,26,18,8,10
12,2007,460301,9,9,0,5
1,2008,460301,12,9,3,6
2,2008,460301,20,15,5,5
3,2008,460301,21,17,4,2
4,2008,460301,23,19,4,6
5,2008,460301,21,16,5,9
6,2008,460301,23,18,5,5
7,2008,460301,28,21,7,15
8,2008,460301,19,17,2,15
9,2008,460301,14,12,2,6
10,2008,460301,20,16,4,5
11,2008,460301,12,10,2,9
12,2008,460301,8,6,2,5
1,2009,460301,12,9,3,5
2,2009,460301,12,9,3,16
3,2009,460301,11,7,4,6
4,2009,460301,14,8,6,6
5,2009,460301,24,18,6,10
6,2009,460301,23,16,7,7
7,2009,460301,16,12,4,6
8,2009,460301,18,12,6,10
9,2009,460301,14,13,1,7
10,2009,460301,30,25,5,13
11,2009,460301,21,18,3,14
12,2009,460301,17,13,4,12
1,2010,460301,12,10,2,5
2,2010,460301,13,9,4,9
3,2010,460301,13,7,6,10
4,2010,460301,8,4,4,4
5,2010,460301,13,12,1,4
6,2010,460301,27,22,5,5
7,2010,460301,19,12,7,5
8,2010,460301,11,5,6,7
9,2010,460301,19,14,5,7
10,2010,460301,13,12,1,0
11,2010,460301,26,19,7,5
12,2010,460301,16,13,3,5
1,2011,460301,20,15,5,5
2,2011,460301,4,3,1,3
1,1999,460500,51,45,6,3
2,1999,460500,40,38,2,11
3,1999,460500,54,45,9,8
4,1999,460500,46,44,2,6
5,1999,460500,55,47,8,6
6,1999,460500,56,45,11,4
7,1999,460500,61,56,5,3
8,1999,460500,66,57,9,16
9,1999,460500,60,50,10,9
10,1999,460500,63,52,11,9
11,1999,460500,62,54,8,2
12,1999,460500,42,40,2,7
1,2000,460500,44,36,8,10
2,2000,460500,47,40,7,18
3,2000,460500,42,34,8,12
4,2000,460500,40,33,7,5
5,2000,460500,50,39,11,12
6,2000,460500,51,40,11,5
7,2000,460500,55,48,7,11
8,2000,460500,63,54,9,4
9,2000,460500,62,49,13,4
10,2000,460500,59,55,4,3
11,2000,460500,43,35,8,9
12,2000,460500,29,25,4,4
1,2001,460500,37,34,3,7
2,2001,460500,38,32,6,6
3,2001,460500,40,36,4,7
4,2001,460500,46,33,13,9
5,2001,460500,53,41,12,2
6,2001,460500,47,41,6,2
7,2001,460500,54,46,8,6
8,2001,460500,58,48,10,4
9,2001,460500,57,53,4,6
10,2001,460500,66,57,9,7
11,2001,460500,51,44,7,4
12,2001,460500,38,35,3,7
1,2002,460500,49,39,10,15
2,2002,460500,36,30,6,6
3,2002,460500,49,43,6,10
4,2002,460500,45,34,11,6
5,2002,460500,45,43,2,5
6,2002,460500,45,42,3,3
7,2002,460500,69,57,12,7
8,2002,460500,61,55,6,6
9,2002,460500,56,44,12,3
10,2002,460500,62,53,9,8
11,2002,460500,56,50,6,5
12,2002,460500,50,43,7,4
1,2003,460500,44,39,5,10
2,2003,460500,46,36,10,14
3,2003,460500,51,46,5,8
4,2003,460500,52,47,5,5
5,2003,460500,64,60,4,8
6,2003,460500,55,48,7,8
7,2003,460500,63,55,8,7
8,2003,460500,75,66,9,6
9,2003,460500,43,37,6,4
10,2003,460500,48,40,8,12
11,2003,460500,51,43,8,12
12,2003,460500,51,44,7,8
1,2004,460500,44,39,5,18
2,2004,460500,30,27,3,11
3,2004,460500,42,35,7,9
4,2004,460500,38,33,5,15
5,2004,460500,49,42,7,5
6,2004,460500,51,44,7,7
7,2004,460500,52,46,6,13
8,2004,460500,40,38,2,9
9,2004,460500,47,42,5,5
10,2004,460500,49,40,9,5
11,2004,460500,39,35,4,12
12,2004,460500,32,28,4,17
1,2005,460500,31,24,7,7
2,2005,460500,33,33,0,4
3,2005,460500,32,30,2,9
4,2005,460500,42,37,5,11
5,2005,460500,39,34,5,24
6,2005,460500,46,35,11,6
7,2005,460500,62,56,6,8
8,2005,460500,38,37,1,12
9,2005,460500,52,48,4,11
10,2005,460500,56,48,8,10
11,2005,460500,38,34,4,18
12,2005,460500,45,41,4,10
1,2006,460500,47,41,6,9
2,2006,460500,30,29,1,7
3,2006,460500,43,35,8,17
4,2006,460500,43,33,10,6
5,2006,460500,60,49,11,17
6,2006,460500,55,52,3,19
7,2006,460500,49,44,5,12
8,2006,460500,45,41,4,12
9,2006,460500,56,54,2,10
10,2006,460500,69,60,9,6
11,2006,460500,56,52,4,26
12,2006,460500,56,53,3,9
1,2007,460500,41,36,5,9
2,2007,460500,50,44,6,16
3,2007,460500,47,39,8,11
4,2007,460500,76,66,10,9
5,2007,460500,74,64,10,16
6,2007,460500,51,48,3,8
7,2007,460500,37,28,9,11
8,2007,460500,54,48,6,6
9,2007,460500,54,46,8,16
10,2007,460500,41,36,5,7
11,2007,460500,47,41,6,7
12,2007,460500,39,32,7,6
1,2008,460500,39,31,8,4
2,2008,460500,31,28,3,12
3,2008,460500,53,52,1,13
4,2008,460500,50,42,8,5
5,2008,460500,59,48,11,3
6,2008,460500,53,46,7,9
7,2008,460500,60,54,6,17
8,2008,460500,65,54,11,6
9,2008,460500,51,44,7,9
10,2008,460500,54,47,7,9
11,2008,460500,43,39,4,7
12,2008,460500,37,34,3,7
1,2009,460500,45,42,3,10
2,2009,460500,37,30,7,10
3,2009,460500,41,36,5,10
4,2009,460500,38,35,3,9
5,2009,460500,43,39,4,12
6,2009,460500,54,45,9,6
7,2009,460500,46,38,8,11
8,2009,460500,51,37,14,11
9,2009,460500,43,39,4,6
10,2009,460500,37,34,3,11
11,2009,460500,37,32,5,8
12,2009,460500,45,39,6,10
1,2010,460500,57,54,3,16
2,2010,460500,27,23,4,7
3,2010,460500,35,30,5,8
4,2010,460500,33,28,5,10
5,2010,460500,35,31,4,8
6,2010,460500,33,30,3,12
7,2010,460500,50,40,10,7
8,2010,460500,63,56,7,14
9,2010,460500,41,35,6,11
10,2010,460500,45,40,5,10
11,2010,460500,32,29,3,14
12,2010,460500,30,26,4,10
1,2011,460500,42,38,4,9
2,2011,460500,22,22,0,7
1,1999,460200,9,6,3,2
2,1999,460200,24,20,4,5
3,1999,460200,10,7,3,5
4,1999,460200,16,10,6,2
5,1999,460200,23,21,2,3
6,1999,460200,22,18,4,2
7,1999,460200,13,10,3,1
8,1999,460200,16,11,5,2
9,1999,460200,13,8,5,2
10,1999,460200,8,6,2,2
11,1999,460200,13,8,5,3
12,1999,460200,11,9,2,2
1,2000,460200,10,8,2,3
2,2000,460200,9,6,3,7
3,2000,460200,8,6,2,2
4,2000,460200,17,9,8,4
5,2000,460200,16,9,7,6
6,2000,460200,15,10,5,8
7,2000,460200,7,5,2,8
8,2000,460200,11,9,2,3
9,2000,460200,9,9,0,1
10,2000,460200,11,8,3,11
11,2000,460200,6,4,2,1
12,2000,460200,8,7,1,3
1,2001,460200,13,9,4,5
2,2001,460200,7,5,2,5
3,2001,460200,9,6,3,12
4,2001,460200,14,7,7,3
5,2001,460200,12,9,3,5
6,2001,460200,9,6,3,8
7,2001,460200,11,7,4,11
8,2001,460200,13,10,3,5
9,2001,460200,13,12,1,3
10,2001,460200,11,8,3,7
11,2001,460200,9,7,2,3
12,2001,460200,10,10,0,3
1,2002,460200,6,5,1,0
2,2002,460200,6,6,0,0
3,2002,460200,16,12,4,5
4,2002,460200,12,11,1,5
5,2002,460200,7,3,4,3
6,2002,460200,15,10,5,6
7,2002,460200,11,7,4,5
8,2002,460200,9,6,3,1
9,2002,460200,12,6,6,1
10,2002,460200,9,6,3,3
11,2002,460200,13,11,2,3
12,2002,460200,6,3,3,1
1,2003,460200,9,7,2,5
2,2003,460200,8,8,0,9
3,2003,460200,10,9,1,1
4,2003,460200,9,8,1,6
5,2003,460200,9,9,0,5
6,2003,460200,8,8,0,4
7,2003,460200,20,20,0,2
8,2003,460200,11,10,1,4
9,2003,460200,8,7,1,3
10,2003,460200,13,10,3,2
11,2003,460200,16,14,2,3
12,2003,460200,11,11,0,2
1,2004,460200,13,12,1,3
2,2004,460200,12,10,2,4
3,2004,460200,13,10,3,4
4,2004,460200,13,12,1,9
5,2004,460200,15,10,5,2
6,2004,460200,8,6,2,2
7,2004,460200,6,4,2,10
8,2004,460200,12,8,4,6
9,2004,460200,17,16,1,5
10,2004,460200,10,10,0,4
11,2004,460200,17,15,2,0
12,2004,460200,8,7,1,4
1,2005,460200,10,10,0,8
2,2005,460200,5,4,1,6
3,2005,460200,8,7,1,2
4,2005,460200,10,7,3,5
5,2005,460200,9,7,2,4
6,2005,460200,14,8,6,6
7,2005,460200,7,5,2,3
8,2005,460200,13,10,3,3
9,2005,460200,9,7,2,2
10,2005,460200,13,9,4,1
11,2005,460200,13,11,2,0
12,2005,460200,11,10,1,4
1,2006,460200,10,7,3,9
2,2006,460200,8,7,1,3
3,2006,460200,6,4,2,5
4,2006,460200,7,6,1,2
5,2006,460200,14,14,0,5
6,2006,460200,8,8,0,2
7,2006,460200,17,14,3,4
8,2006,460200,18,14,4,8
9,2006,460200,12,9,3,4
10,2006,460200,8,7,1,6
11,2006,460200,13,9,4,4
12,2006,460200,10,10,0,4
1,2007,460200,11,11,0,7
2,2007,460200,13,10,3,11
3,2007,460200,9,7,2,7
4,2007,460200,11,7,4,2
5,2007,460200,14,11,3,9
6,2007,460200,11,9,2,13
7,2007,460200,13,10,3,5
8,2007,460200,21,19,2,3
9,2007,460200,9,6,3,3
10,2007,460200,15,13,2,5
11,2007,460200,10,8,2,4
12,2007,460200,14,12,2,3
1,2008,460200,8,7,1,2
2,2008,460200,11,9,2,6
3,2008,460200,10,10,0,4
4,2008,460200,11,10,1,1
5,2008,460200,15,13,2,2
6,2008,460200,9,6,3,5
7,2008,460200,11,9,2,10
8,2008,460200,12,10,2,4
9,2008,460200,12,10,2,2
10,2008,460200,13,10,3,1
11,2008,460200,8,8,0,4
12,2008,460200,7,5,2,1
1,2009,460200,10,9,1,5
2,2009,460200,7,6,1,7
3,2009,460200,9,7,2,5
4,2009,460200,12,7,5,4
5,2009,460200,9,5,4,3
6,2009,460200,10,7,3,3
7,2009,460200,16,10,6,3
8,2009,460200,13,9,4,5
9,2009,460200,10,7,3,7
10,2009,460200,13,11,2,2
11,2009,460200,20,17,3,5
12,2009,460200,10,7,3,4
1,2010,460200,5,5,0,1
2,2010,460200,6,3,3,7
3,2010,460200,8,4,4,6
4,2010,460200,10,3,7,4
5,2010,460200,11,8,3,4
6,2010,460200,7,5,2,3
7,2010,460200,10,7,3,4
8,2010,460200,6,5,1,1
9,2010,460200,9,7,2,1
10,2010,460200,11,8,3,4
11,2010,460200,7,6,1,2
12,2010,460200,6,4,2,2
1,2011,460200,12,10,2,0
2,2011,460200,2,2,0,1
1,1999,460100,32,22,10,4
2,1999,460100,31,26,5,4
3,1999,460100,34,25,9,8
4,1999,460100,27,20,7,8
5,1999,460100,42,31,11,9
6,1999,460100,28,22,6,8
7,1999,460100,43,31,12,10
8,1999,460100,57,44,13,12
9,1999,460100,36,28,8,9
10,1999,460100,40,34,6,3
11,1999,460100,34,23,11,6
12,1999,460100,29,23,6,4
1,2000,460100,29,25,4,6
2,2000,460100,32,26,6,5
3,2000,460100,37,29,8,12
4,2000,460100,21,16,5,6
5,2000,460100,34,24,10,13
6,2000,460100,35,22,13,11
7,2000,460100,29,21,8,10
8,2000,460100,53,32,21,17
9,2000,460100,41,30,11,4
10,2000,460100,32,27,5,10
11,2000,460100,29,19,10,8
12,2000,460100,17,9,8,4
1,2001,460100,24,21,3,20
2,2001,460100,23,17,6,11
3,2001,460100,32,23,9,16
4,2001,460100,29,23,6,9
5,2001,460100,35,27,8,10
6,2001,460100,38,24,14,18
7,2001,460100,33,20,13,9
8,2001,460100,32,25,7,5
9,2001,460100,20,15,5,7
10,2001,460100,30,24,6,13
11,2001,460100,28,18,10,7
12,2001,460100,17,14,3,8
1,2002,460100,17,13,4,9
2,2002,460100,20,16,4,5
3,2002,460100,38,31,7,9
4,2002,460100,30,18,12,11
5,2002,460100,32,25,7,19
6,2002,460100,30,17,13,4
7,2002,460100,32,27,5,13
8,2002,460100,40,32,8,6
9,2002,460100,26,21,5,8
10,2002,460100,32,23,9,11
11,2002,460100,26,22,4,6
12,2002,460100,33,26,7,12
1,2003,460100,21,16,5,16
2,2003,460100,19,16,3,14
3,2003,460100,21,18,3,7
4,2003,460100,29,22,7,9
5,2003,460100,38,29,9,8
6,2003,460100,34,29,5,5
7,2003,460100,39,29,10,5
8,2003,460100,36,30,6,10
9,2003,460100,47,33,14,7
10,2003,460100,38,33,5,12
11,2003,460100,29,24,5,11
12,2003,460100,22,17,5,10
1,2004,460100,26,19,7,8
2,2004,460100,23,17,6,13
3,2004,460100,25,23,2,14
4,2004,460100,27,18,9,16
5,2004,460100,37,33,4,12
6,2004,460100,39,29,10,10
7,2004,460100,36,29,7,23
8,2004,460100,38,38,0,22
9,2004,460100,36,32,4,23
10,2004,460100,42,37,5,15
11,2004,460100,38,32,6,27
12,2004,460100,24,19,5,21
1,2005,460100,19,15,4,18
2,2005,460100,23,19,4,11
3,2005,460100,29,28,1,15
4,2005,460100,30,19,11,18
5,2005,460100,31,20,11,17
6,2005,460100,28,22,6,14
7,2005,460100,39,30,9,10
8,2005,460100,45,36,9,15
9,2005,460100,27,24,3,28
10,2005,460100,35,33,2,26
11,2005,460100,32,28,4,18
12,2005,460100,24,21,3,24
1,2006,460100,22,22,0,22
2,2006,460100,27,23,4,26
3,2006,460100,33,31,2,16
4,2006,460100,32,28,4,10
5,2006,460100,45,37,8,29
6,2006,460100,50,38,12,16
7,2006,460100,99,86,13,14
8,2006,460100,50,40,10,24
9,2006,460100,48,43,5,25
10,2006,460100,57,49,8,13
11,2006,460100,39,27,12,10
12,2006,460100,36,31,5,20
1,2007,460100,36,31,5,9
2,2007,460100,24,20,4,13
3,2007,460100,27,23,4,9
4,2007,460100,37,28,9,11
5,2007,460100,28,19,9,38
6,2007,460100,36,28,8,22
7,2007,460100,40,30,10,11
8,2007,460100,60,53,7,18
9,2007,460100,34,29,5,10
10,2007,460100,46,33,13,16
11,2007,460100,29,21,8,10
12,2007,460100,25,21,4,5
1,2008,460100,21,15,6,2
2,2008,460100,20,17,3,4
3,2008,460100,35,30,5,13
4,2008,460100,20,12,8,10
5,2008,460100,36,26,10,11
6,2008,460100,56,42,14,21
7,2008,460100,61,52,9,22
8,2008,460100,44,35,9,20
9,2008,460100,41,36,5,25
10,2008,460100,39,32,7,14
11,2008,460100,39,30,9,13
12,2008,460100,39,35,4,15
1,2009,460100,26,20,6,10
2,2009,460100,30,20,10,23
3,2009,460100,24,16,8,14
4,2009,460100,24,15,9,14
5,2009,460100,42,28,14,17
6,2009,460100,29,22,7,16
7,2009,460100,39,29,10,12
8,2009,460100,42,35,7,30
9,2009,460100,24,19,5,12
10,2009,460100,19,15,4,21
11,2009,460100,21,17,4,23
12,2009,460100,21,20,1,17
1,2010,460100,39,29,10,13
2,2010,460100,20,18,2,12
3,2010,460100,15,13,2,15
4,2010,460100,27,18,9,3
5,2010,460100,27,20,7,6
6,2010,460100,31,15,16,14
7,2010,460100,29,20,9,9
8,2010,460100,43,34,9,16
9,2010,460100,29,25,4,13
10,2010,460100,33,24,9,11
11,2010,460100,39,32,7,9
12,2010,460100,25,21,4,9
1,2011,460100,14,14,0,4
2,2011,460100,16,13,3,2
1,1999,700401,13,12,1,1
2,1999,700401,18,15,3,2
3,1999,700401,31,26,5,2
4,1999,700401,28,26,2,1
5,1999,700401,26,24,2,3
6,1999,700401,31,29,2,2
7,1999,700401,24,23,1,3
8,1999,700401,15,14,1,0
9,1999,700401,21,18,3,0
10,1999,700401,14,9,5,0
11,1999,700401,12,11,1,1
12,1999,700401,14,11,3,0
1,2000,700401,14,13,1,2
2,2000,700401,14,13,1,1
3,2000,700401,12,10,2,2
4,2000,700401,7,5,2,3
5,2000,700401,7,7,0,1
6,2000,700401,22,20,2,1
7,2000,700401,20,20,0,0
8,2000,700401,19,16,3,0
9,2000,700401,27,23,4,0
10,2000,700401,10,10,0,0
11,2000,700401,15,15,0,2
12,2000,700401,11,11,0,1
1,2001,700401,12,11,1,0
2,2001,700401,5,5,0,0
3,2001,700401,16,16,0,1
4,2001,700401,29,28,1,0
5,2001,700401,18,17,1,0
6,2001,700401,16,13,3,0
7,2001,700401,21,16,5,0
8,2001,700401,19,18,1,0
9,2001,700401,22,21,1,0
10,2001,700401,17,16,1,0
11,2001,700401,26,22,4,0
12,2001,700401,21,20,1,0
1,2002,700401,16,14,2,0
2,2002,700401,8,7,1,0
3,2002,700401,14,11,3,0
4,2002,700401,27,24,3,1
5,2002,700401,15,15,0,0
6,2002,700401,19,17,2,0
7,2002,700401,31,31,0,2
8,2002,700401,20,19,1,1
9,2002,700401,21,20,1,0
10,2002,700401,20,15,5,0
11,2002,700401,26,25,1,0
12,2002,700401,20,18,2,1
1,2003,700401,17,14,3,1
2,2003,700401,16,15,1,4
3,2003,700401,14,12,2,1
4,2003,700401,8,6,2,0
5,2003,700401,17,16,1,0
6,2003,700401,9,6,3,1
7,2003,700401,11,9,2,0
8,2003,700401,15,13,2,2
9,2003,700401,27,23,4,0
10,2003,700401,24,22,2,2
11,2003,700401,12,11,1,1
12,2003,700401,12,10,2,0
1,2004,700401,11,11,0,0
2,2004,700401,16,13,3,2
3,2004,700401,16,16,0,0
4,2004,700401,11,10,1,0
5,2004,700401,16,14,2,0
6,2004,700401,16,14,2,1
7,2004,700401,13,10,3,2
8,2004,700401,24,23,1,2
9,2004,700401,15,13,2,4
10,2004,700401,22,20,2,0
11,2004,700401,24,22,2,1
12,2004,700401,16,16,0,3
1,2005,700401,22,19,3,0
2,2005,700401,12,12,0,1
3,2005,700401,22,21,1,1
4,2005,700401,17,15,2,1
5,2005,700401,27,25,2,2
6,2005,700401,12,11,1,1
7,2005,700401,17,15,2,1
8,2005,700401,21,17,4,0
9,2005,700401,18,18,0,4
10,2005,700401,26,22,4,3
11,2005,700401,25,22,3,6
12,2005,700401,20,18,2,2
1,2006,700401,16,13,3,5
2,2006,700401,12,11,1,2
3,2006,700401,19,16,3,2
4,2006,700401,19,16,3,3
5,2006,700401,25,20,5,5
6,2006,700401,15,13,2,3
7,2006,700401,12,11,1,7
8,2006,700401,27,23,4,0
9,2006,700401,22,21,1,1
10,2006,700401,28,26,2,3
11,2006,700401,24,22,2,3
12,2006,700401,25,23,2,3
1,2007,700401,17,16,1,2
2,2007,700401,19,18,1,4
3,2007,700401,23,22,1,1
4,2007,700401,22,20,2,3
5,2007,700401,24,21,3,6
6,2007,700401,19,17,2,0
7,2007,700401,24,24,0,6
8,2007,700401,24,24,0,2
9,2007,700401,15,15,0,1
10,2007,700401,16,13,3,4
11,2007,700401,20,18,2,2
12,2007,700401,9,8,1,2
1,2008,700401,16,14,2,0
2,2008,700401,13,11,2,1
3,2008,700401,31,28,3,0
4,2008,700401,25,23,2,0
5,2008,700401,24,22,2,2
6,2008,700401,31,27,4,3
7,2008,700401,23,22,1,1
8,2008,700401,24,21,3,2
9,2008,700401,18,17,1,1
10,2008,700401,30,27,3,0
11,2008,700401,12,11,1,4
12,2008,700401,31,27,4,2
1,2009,700401,25,22,3,3
2,2009,700401,17,10,7,1
3,2009,700401,14,12,2,2
4,2009,700401,18,17,1,1
5,2009,700401,24,21,3,2
6,2009,700401,25,23,2,4
7,2009,700401,18,13,5,5
8,2009,700401,15,12,3,4
9,2009,700401,18,18,0,0
10,2009,700401,35,33,2,2
11,2009,700401,26,24,2,1
12,2009,700401,22,21,1,2
1,2010,700401,31,28,3,2
2,2010,700401,22,17,5,5
3,2010,700401,15,14,1,5
4,2010,700401,29,24,5,4
5,2010,700401,27,23,4,1
6,2010,700401,21,18,3,1
7,2010,700401,12,10,2,8
8,2010,700401,19,16,3,5
9,2010,700401,13,12,1,4
10,2010,700401,22,21,1,2
11,2010,700401,15,12,3,6
12,2010,700401,15,14,1,3
1,2011,700401,18,15,3,1
2,2011,700401,11,11,0,2
1,1999,700301,8,8,0,1
2,1999,700301,7,6,1,0
3,1999,700301,7,7,0,0
4,1999,700301,12,10,2,0
5,1999,700301,12,12,0,2
6,1999,700301,10,10,0,2
7,1999,700301,20,18,2,3
8,1999,700301,8,8,0,1
9,1999,700301,6,5,1,2
10,1999,700301,4,3,1,2
11,1999,700301,6,6,0,0
12,1999,700301,5,4,1,0
1,2000,700301,3,2,1,1
2,2000,700301,4,4,0,2
3,2000,700301,15,12,3,4
4,2000,700301,14,13,1,2
5,2000,700301,13,12,1,0
6,2000,700301,9,9,0,0
7,2000,700301,7,5,2,0
8,2000,700301,12,11,1,1
9,2000,700301,5,5,0,6
10,2000,700301,9,8,1,1
11,2000,700301,10,8,2,0
12,2000,700301,4,4,0,1
1,2001,700301,10,10,0,2
2,2001,700301,7,6,1,0
3,2001,700301,8,7,1,0
4,2001,700301,12,9,3,0
5,2001,700301,5,5,0,1
6,2001,700301,4,4,0,0
7,2001,700301,7,5,2,0
8,2001,700301,8,7,1,0
9,2001,700301,9,9,0,3
10,2001,700301,9,6,3,1
11,2001,700301,16,10,6,2
12,2001,700301,7,5,2,0
1,2002,700301,8,7,1,2
2,2002,700301,6,6,0,1
3,2002,700301,6,5,1,0
4,2002,700301,6,5,1,0
5,2002,700301,15,15,0,0
6,2002,700301,8,7,1,1
7,2002,700301,7,7,0,0
8,2002,700301,15,13,2,0
9,2002,700301,7,6,1,0
10,2002,700301,12,12,0,0
11,2002,700301,7,6,1,0
12,2002,700301,11,11,0,2
1,2003,700301,6,5,1,0
2,2003,700301,7,7,0,0
3,2003,700301,6,4,2,1
4,2003,700301,6,5,1,0
5,2003,700301,5,5,0,0
6,2003,700301,7,7,0,0
7,2003,700301,8,6,2,0
8,2003,700301,15,15,0,1
9,2003,700301,9,8,1,1
10,2003,700301,10,10,0,0
11,2003,700301,9,9,0,0
12,2003,700301,7,7,0,0
1,2004,700301,6,4,2,2
2,2004,700301,6,6,0,0
3,2004,700301,8,7,1,4
4,2004,700301,7,5,2,2
5,2004,700301,14,12,2,0
6,2004,700301,7,7,0,0
7,2004,700301,15,13,2,0
8,2004,700301,14,13,1,0
9,2004,700301,7,5,2,0
10,2004,700301,6,4,2,0
11,2004,700301,14,12,2,0
12,2004,700301,4,4,0,0
1,2005,700301,6,4,2,4
2,2005,700301,6,5,1,0
3,2005,700301,17,14,3,1
4,2005,700301,9,7,2,0
5,2005,700301,10,3,7,0
6,2005,700301,6,4,2,1
7,2005,700301,18,17,1,1
8,2005,700301,10,8,2,2
9,2005,700301,12,9,3,1
10,2005,700301,7,7,0,1
11,2005,700301,7,6,1,0
12,2005,700301,10,9,1,0
1,2006,700301,12,9,3,0
2,2006,700301,4,4,0,0
3,2006,700301,4,3,1,0
4,2006,700301,8,7,1,0
5,2006,700301,12,11,1,1
6,2006,700301,6,3,3,1
7,2006,700301,8,6,2,3
8,2006,700301,6,4,2,0
9,2006,700301,8,8,0,0
10,2006,700301,8,7,1,0
11,2006,700301,8,7,1,1
12,2006,700301,6,5,1,3
1,2007,700301,5,5,0,0
2,2007,700301,6,4,2,3
3,2007,700301,4,3,1,0
4,2007,700301,11,9,2,2
5,2007,700301,9,9,0,1
6,2007,700301,11,11,0,0
7,2007,700301,11,10,1,2
8,2007,700301,12,11,1,8
9,2007,700301,11,9,2,3
10,2007,700301,7,5,2,1
11,2007,700301,7,7,0,1
12,2007,700301,9,8,1,6
1,2008,700301,7,5,2,0
2,2008,700301,4,3,1,2
3,2008,700301,11,10,1,1
4,2008,700301,9,9,0,3
5,2008,700301,11,10,1,4
6,2008,700301,8,6,2,4
7,2008,700301,6,5,1,0
8,2008,700301,5,5,0,2
9,2008,700301,9,9,0,2
10,2008,700301,8,8,0,0
11,2008,700301,8,7,1,1
12,2008,700301,10,9,1,3
1,2009,700301,4,4,0,1
2,2009,700301,4,4,0,0
3,2009,700301,6,4,2,1
4,2009,700301,12,9,3,1
5,2009,700301,10,8,2,0
6,2009,700301,7,5,2,0
7,2009,700301,8,5,3,1
8,2009,700301,10,9,1,0
9,2009,700301,5,4,1,1
10,2009,700301,10,8,2,2
11,2009,700301,11,8,3,2
12,2009,700301,4,4,0,0
1,2010,700301,18,17,1,1
2,2010,700301,5,4,1,1
3,2010,700301,7,6,1,3
4,2010,700301,3,3,0,0
5,2010,700301,10,10,0,3
6,2010,700301,9,7,2,0
7,2010,700301,18,17,1,2
8,2010,700301,4,4,0,4
9,2010,700301,8,8,0,2
10,2010,700301,8,8,0,2
11,2010,700301,8,8,0,3
12,2010,700301,6,6,0,1
1,2011,700301,8,5,3,0
2,2011,700301,7,5,2,1
1,1999,700501,15,11,4,2
2,1999,700501,23,22,1,0
3,1999,700501,11,11,0,2
4,1999,700501,26,25,1,2
5,1999,700501,23,22,1,2
6,1999,700501,18,14,4,0
7,1999,700501,32,29,3,1
8,1999,700501,35,33,2,0
9,1999,700501,15,15,0,1
10,1999,700501,21,20,1,1
11,1999,700501,16,14,2,1
12,1999,700501,20,16,4,2
1,2000,700501,19,18,1,1
2,2000,700501,9,8,1,1
3,2000,700501,12,11,1,2
4,2000,700501,13,12,1,0
5,2000,700501,15,15,0,1
6,2000,700501,22,21,1,0
7,2000,700501,30,26,4,2
8,2000,700501,19,18,1,2
9,2000,700501,27,22,5,5
10,2000,700501,28,27,1,1
11,2000,700501,13,11,2,0
12,2000,700501,27,26,1,0
1,2001,700501,19,18,1,0
2,2001,700501,11,10,1,1
3,2001,700501,15,14,1,1
4,2001,700501,16,16,0,1
5,2001,700501,23,20,3,1
6,2001,700501,24,23,1,0
7,2001,700501,17,17,0,1
8,2001,700501,19,17,2,3
9,2001,700501,16,15,1,1
10,2001,700501,23,22,1,0
11,2001,700501,20,20,0,1
12,2001,700501,15,14,1,1
1,2002,700501,17,14,3,1
2,2002,700501,10,9,1,0
3,2002,700501,16,14,2,1
4,2002,700501,15,11,4,0
5,2002,700501,14,13,1,0
6,2002,700501,17,16,1,2
7,2002,700501,18,17,1,1
8,2002,700501,27,25,2,1
9,2002,700501,18,17,1,0
10,2002,700501,16,14,2,0
11,2002,700501,15,13,2,0
12,2002,700501,19,18,1,0
1,2003,700501,13,12,1,0
2,2003,700501,6,5,1,0
3,2003,700501,17,12,5,0
4,2003,700501,16,12,4,0
5,2003,700501,12,9,3,1
6,2003,700501,34,33,1,1
7,2003,700501,31,29,2,0
8,2003,700501,18,16,2,1
9,2003,700501,16,16,0,0
10,2003,700501,22,21,1,0
11,2003,700501,19,18,1,1
12,2003,700501,21,18,3,0
1,2004,700501,18,17,1,1
2,2004,700501,15,11,4,3
3,2004,700501,20,19,1,0
4,2004,700501,21,21,0,1
5,2004,700501,19,18,1,2
6,2004,700501,26,25,1,0
7,2004,700501,22,19,3,1
8,2004,700501,27,24,3,1
9,2004,700501,25,25,0,0
10,2004,700501,20,18,2,1
11,2004,700501,12,12,0,0
12,2004,700501,11,9,2,2
1,2005,700501,17,16,1,0
2,2005,700501,10,10,0,2
3,2005,700501,18,17,1,0
4,2005,700501,30,27,3,4
5,2005,700501,31,27,4,1
6,2005,700501,17,16,1,5
7,2005,700501,21,16,5,2
8,2005,700501,21,21,0,1
9,2005,700501,20,17,3,3
10,2005,700501,21,19,2,0
11,2005,700501,31,25,6,1
12,2005,700501,21,20,1,0
1,2006,700501,25,24,1,4
2,2006,700501,20,16,4,0
3,2006,700501,14,12,2,1
4,2006,700501,15,13,2,1
5,2006,700501,16,12,4,0
6,2006,700501,27,21,6,6
7,2006,700501,25,20,5,3
8,2006,700501,25,23,2,1
9,2006,700501,22,18,4,0
10,2006,700501,28,23,5,1
11,2006,700501,19,17,2,1
12,2006,700501,38,35,3,1
1,2007,700501,16,15,1,0
2,2007,700501,20,18,2,3
3,2007,700501,25,23,2,2
4,2007,700501,26,24,2,1
5,2007,700501,23,21,2,4
6,2007,700501,27,25,2,3
7,2007,700501,30,24,6,2
8,2007,700501,21,20,1,1
9,2007,700501,15,13,2,0
10,2007,700501,31,27,4,1
11,2007,700501,32,32,0,2
12,2007,700501,30,29,1,0
1,2008,700501,23,23,0,2
2,2008,700501,16,15,1,0
3,2008,700501,28,25,3,1
4,2008,700501,33,28,5,1
5,2008,700501,16,16,0,0
6,2008,700501,34,30,4,1
7,2008,700501,20,19,1,1
8,2008,700501,29,28,1,0
9,2008,700501,18,17,1,2
10,2008,700501,24,21,3,0
11,2008,700501,15,13,2,0
12,2008,700501,17,15,2,0
1,2009,700501,21,20,1,0
2,2009,700501,10,8,2,0
3,2009,700501,19,19,0,2
4,2009,700501,19,18,1,3
5,2009,700501,18,16,2,0
6,2009,700501,26,23,3,0
7,2009,700501,24,22,2,1
8,2009,700501,16,14,2,0
9,2009,700501,18,17,1,1
10,2009,700501,26,24,2,3
11,2009,700501,18,16,2,1
12,2009,700501,19,18,1,0
1,2010,700501,11,10,1,0
2,2010,700501,8,6,2,4
3,2010,700501,25,22,3,3
4,2010,700501,17,13,4,0
5,2010,700501,20,18,2,1
6,2010,700501,21,20,1,1
7,2010,700501,17,16,1,5
8,2010,700501,18,18,0,5
9,2010,700501,18,18,0,5
10,2010,700501,28,26,2,0
11,2010,700501,23,22,1,3
12,2010,700501,13,12,1,3
1,2011,700501,17,16,1,1
2,2011,700501,9,8,1,0
1,1999,460302,22,14,8,3
2,1999,460302,24,20,4,5
3,1999,460302,29,23,6,10
4,1999,460302,33,27,6,7
5,1999,460302,35,23,12,7
6,1999,460302,32,27,5,1
7,1999,460302,26,20,6,8
8,1999,460302,30,27,3,6
9,1999,460302,32,23,9,3
10,1999,460302,29,24,5,5
11,1999,460302,25,21,4,6
12,1999,460302,26,19,7,2
1,2000,460302,21,20,1,5
2,2000,460302,16,12,4,6
3,2000,460302,20,13,7,7
4,2000,460302,20,14,6,7
5,2000,460302,24,13,11,4
6,2000,460302,17,10,7,10
7,2000,460302,31,23,8,9
8,2000,460302,38,22,16,5
9,2000,460302,31,22,9,9
10,2000,460302,29,22,7,9
11,2000,460302,25,18,7,9
12,2000,460302,26,21,5,5
1,2001,460302,30,24,6,7
2,2001,460302,16,12,4,9
3,2001,460302,31,23,8,8
4,2001,460302,35,22,13,12
5,2001,460302,29,20,9,9
6,2001,460302,35,26,9,6
7,2001,460302,32,22,10,11
8,2001,460302,32,25,7,11
9,2001,460302,32,30,2,8
10,2001,460302,28,22,6,13
11,2001,460302,36,27,9,9
12,2001,460302,36,25,11,10
1,2002,460302,32,26,6,5
2,2002,460302,21,17,4,9
3,2002,460302,23,19,4,11
4,2002,460302,25,16,9,13
5,2002,460302,26,18,8,11
6,2002,460302,28,24,4,11
7,2002,460302,27,19,8,6
8,2002,460302,19,10,9,10
9,2002,460302,32,26,6,10
10,2002,460302,33,28,5,13
11,2002,460302,35,31,4,4
12,2002,460302,25,19,6,10
1,2003,460302,34,26,8,10
2,2003,460302,22,21,1,8
3,2003,460302,26,19,7,6
4,2003,460302,23,16,7,12
5,2003,460302,42,32,10,8
6,2003,460302,28,22,6,7
7,2003,460302,47,39,8,11
8,2003,460302,37,30,7,6
9,2003,460302,39,35,4,13
10,2003,460302,36,30,6,11
11,2003,460302,27,18,9,7
12,2003,460302,35,28,7,7
1,2004,460302,34,26,8,17
2,2004,460302,28,22,6,5
3,2004,460302,33,23,10,22
4,2004,460302,27,21,6,15
5,2004,460302,24,18,6,8
6,2004,460302,28,20,8,9
7,2004,460302,37,29,8,10
8,2004,460302,34,26,8,13
9,2004,460302,41,37,4,15
10,2004,460302,24,22,2,6
11,2004,460302,29,23,6,5
12,2004,460302,21,18,3,7
1,2005,460302,19,17,2,6
2,2005,460302,13,9,4,10
3,2005,460302,33,25,8,8
4,2005,460302,24,19,5,11
5,2005,460302,24,19,5,4
6,2005,460302,22,16,6,9
7,2005,460302,29,19,10,5
8,2005,460302,31,20,11,9
9,2005,460302,30,25,5,9
10,2005,460302,19,16,3,8
11,2005,460302,21,15,6,9
12,2005,460302,24,19,5,6
1,2006,460302,22,17,5,11
2,2006,460302,17,12,5,10
3,2006,460302,23,16,7,15
4,2006,460302,24,22,2,7
5,2006,460302,27,21,6,6
6,2006,460302,29,22,7,15
7,2006,460302,42,33,9,18
8,2006,460302,35,28,7,12
9,2006,460302,30,25,5,10
10,2006,460302,41,34,7,17
11,2006,460302,23,19,4,9
12,2006,460302,30,25,5,13
1,2007,460302,22,22,0,7
2,2007,460302,31,27,4,8
3,2007,460302,37,29,8,19
4,2007,460302,31,25,6,11
5,2007,460302,40,28,12,8
6,2007,460302,44,35,9,10
7,2007,460302,44,37,7,10
8,2007,460302,32,22,10,12
9,2007,460302,29,23,6,11
10,2007,460302,28,25,3,18
11,2007,460302,38,34,4,11
12,2007,460302,32,25,7,8
1,2008,460302,30,21,9,13
2,2008,460302,23,21,2,10
3,2008,460302,27,21,6,7
4,2008,460302,53,45,8,2
5,2008,460302,37,28,9,12
6,2008,460302,29,23,6,20
7,2008,460302,42,36,6,14
8,2008,460302,39,36,3,12
9,2008,460302,21,18,3,18
10,2008,460302,30,24,6,11
11,2008,460302,17,11,6,8
12,2008,460302,24,22,2,7
1,2009,460302,21,14,7,11
2,2009,460302,13,10,3,11
3,2009,460302,26,20,6,19
4,2009,460302,30,24,6,8
5,2009,460302,35,22,13,20
6,2009,460302,37,29,8,15
7,2009,460302,41,32,9,16
8,2009,460302,40,33,7,24
9,2009,460302,26,18,8,12
10,2009,460302,39,36,3,7
11,2009,460302,31,29,2,23
12,2009,460302,33,28,5,20
1,2010,460302,20,18,2,6
2,2010,460302,27,19,8,11
3,2010,460302,22,13,9,8
4,2010,460302,24,17,7,13
5,2010,460302,28,19,9,3
6,2010,460302,25,14,11,9
7,2010,460302,32,26,6,7
8,2010,460302,33,23,10,2
9,2010,460302,20,14,6,7
10,2010,460302,25,22,3,12
11,2010,460302,24,21,3,7
12,2010,460302,27,24,3,3
1,2011,460302,12,12,0,3
2,2011,460302,12,12,0,2
1,1999,710700,31,26,5,6
2,1999,710700,22,17,5,4
3,1999,710700,31,25,6,9
4,1999,710700,39,31,8,6
5,1999,710700,48,37,11,5
6,1999,710700,40,36,4,16
7,1999,710700,55,44,11,5
8,1999,710700,38,32,6,10
9,1999,710700,22,18,4,6
10,1999,710700,32,28,4,10
11,1999,710700,38,29,9,10
12,1999,710700,19,16,3,7
1,2000,710700,35,30,5,8
2,2000,710700,27,24,3,2
3,2000,710700,35,30,5,8
4,2000,710700,37,30,7,10
5,2000,710700,36,25,11,6
6,2000,710700,26,17,9,3
7,2000,710700,22,19,3,12
8,2000,710700,36,28,8,4
9,2000,710700,38,30,8,3
10,2000,710700,30,27,3,8
11,2000,710700,32,29,3,4
12,2000,710700,21,16,5,3
1,2001,710700,40,33,7,3
2,2001,710700,18,16,2,8
3,2001,710700,24,21,3,7
4,2001,710700,23,18,5,8
5,2001,710700,25,18,7,11
6,2001,710700,29,25,4,5
7,2001,710700,20,18,2,8
8,2001,710700,30,25,5,8
9,2001,710700,38,31,7,3
10,2001,710700,34,30,4,2
11,2001,710700,31,20,11,8
12,2001,710700,34,31,3,2
1,2002,710700,34,30,4,6
2,2002,710700,32,28,4,7
3,2002,710700,31,26,5,3
4,2002,710700,38,32,6,6
5,2002,710700,43,36,7,5
6,2002,710700,39,31,8,3
7,2002,710700,43,30,13,6
8,2002,710700,32,26,6,6
9,2002,710700,44,38,6,15
10,2002,710700,50,43,7,10
11,2002,710700,39,34,5,12
12,2002,710700,42,35,7,11
1,2003,710700,27,27,0,2
2,2003,710700,31,25,6,11
3,2003,710700,38,36,2,4
4,2003,710700,26,26,0,4
5,2003,710700,27,20,7,9
6,2003,710700,29,23,6,2
7,2003,710700,44,37,7,4
8,2003,710700,43,34,9,5
9,2003,710700,28,25,3,10
10,2003,710700,45,35,10,3
11,2003,710700,25,20,5,3
12,2003,710700,29,24,5,8
1,2004,710700,21,18,3,8
2,2004,710700,35,31,4,12
3,2004,710700,28,24,4,8
4,2004,710700,27,26,1,4
5,2004,710700,31,27,4,5
6,2004,710700,41,34,7,5
7,2004,710700,29,23,6,10
8,2004,710700,34,29,5,4
9,2004,710700,23,20,3,5
10,2004,710700,36,32,4,17
11,2004,710700,27,23,4,16
12,2004,710700,34,32,2,14
1,2005,710700,21,19,2,4
2,2005,710700,17,15,2,6
3,2005,710700,26,22,4,7
4,2005,710700,24,20,4,3
5,2005,710700,23,20,3,7
6,2005,710700,23,20,3,4
7,2005,710700,45,35,10,9
8,2005,710700,31,28,3,5
9,2005,710700,30,25,5,7
10,2005,710700,32,29,3,6
11,2005,710700,28,26,2,4
12,2005,710700,25,24,1,6
1,2006,710700,24,24,0,11
2,2006,710700,16,13,3,0
3,2006,710700,37,29,8,3
4,2006,710700,24,21,3,3
5,2006,710700,26,22,4,6
6,2006,710700,36,30,6,3
7,2006,710700,33,25,8,6
8,2006,710700,23,19,4,5
9,2006,710700,40,34,6,13
10,2006,710700,29,26,3,8
11,2006,710700,30,25,5,9
12,2006,710700,31,25,6,7
1,2007,710700,18,12,6,11
2,2007,710700,20,18,2,12
3,2007,710700,31,23,8,19
4,2007,710700,23,18,5,8
5,2007,710700,34,26,8,12
6,2007,710700,34,29,5,17
7,2007,710700,38,31,7,4
8,2007,710700,32,25,7,35
9,2007,710700,36,30,6,9
10,2007,710700,47,42,5,13
11,2007,710700,34,30,4,13
12,2007,710700,26,18,8,17
1,2008,710700,38,35,3,12
2,2008,710700,36,32,4,27
3,2008,710700,24,21,3,16
4,2008,710700,45,35,10,23
5,2008,710700,39,34,5,12
6,2008,710700,39,35,4,13
7,2008,710700,46,42,4,16
8,2008,710700,34,29,5,19
9,2008,710700,27,22,5,10
10,2008,710700,35,28,7,10
11,2008,710700,26,21,5,25
12,2008,710700,18,17,1,5
1,2009,710700,28,20,8,21
2,2009,710700,18,14,4,27
3,2009,710700,23,19,4,16
4,2009,710700,19,17,2,12
5,2009,710700,42,37,5,24
6,2009,710700,42,35,7,17
7,2009,710700,42,38,4,15
8,2009,710700,32,24,8,7
9,2009,710700,26,25,1,9
10,2009,710700,31,24,7,16
11,2009,710700,29,24,5,11
12,2009,710700,18,17,1,18
1,2010,710700,41,35,6,17
2,2010,710700,18,17,1,17
3,2010,710700,24,22,2,21
4,2010,710700,28,27,1,17
5,2010,710700,29,23,6,14
6,2010,710700,27,19,8,17
7,2010,710700,25,21,4,27
8,2010,710700,33,29,4,16
9,2010,710700,40,32,8,10
10,2010,710700,27,22,5,17
11,2010,710700,28,26,2,12
12,2010,710700,22,17,5,4
1,2011,710700,24,24,0,11
2,2011,710700,10,9,1,8
1,1999,710800,48,39,9,5
2,1999,710800,43,38,5,11
3,1999,710800,56,40,16,9
4,1999,710800,53,40,13,12
5,1999,710800,55,48,7,10
6,1999,710800,65,54,11,12
7,1999,710800,97,78,19,6
8,1999,710800,61,54,7,12
9,1999,710800,64,52,12,10
10,1999,710800,57,49,8,13
11,1999,710800,54,44,10,13
12,1999,710800,41,35,6,12
1,2000,710800,55,48,7,10
2,2000,710800,47,36,11,12
3,2000,710800,59,54,5,24
4,2000,710800,55,43,12,19
5,2000,710800,62,54,8,18
6,2000,710800,43,34,9,15
7,2000,710800,45,39,6,14
8,2000,710800,58,51,7,13
9,2000,710800,54,42,12,13
10,2000,710800,53,41,12,13
11,2000,710800,47,43,4,17
12,2000,710800,45,38,7,13
1,2001,710800,55,46,9,9
2,2001,710800,52,42,10,17
3,2001,710800,58,47,11,13
4,2001,710800,55,47,8,11
5,2001,710800,50,44,6,22
6,2001,710800,58,50,8,8
7,2001,710800,56,43,13,17
8,2001,710800,50,44,6,15
9,2001,710800,56,45,11,9
10,2001,710800,70,60,10,13
11,2001,710800,63,57,6,15
12,2001,710800,47,41,6,8
1,2002,710800,34,25,9,12
2,2002,710800,40,33,7,8
3,2002,710800,59,49,10,28
4,2002,710800,51,39,12,6
5,2002,710800,56,40,16,11
6,2002,710800,48,37,11,10
7,2002,710800,77,64,13,11
8,2002,710800,70,58,12,5
9,2002,710800,46,37,9,5
10,2002,710800,66,56,10,11
11,2002,710800,62,56,6,21
12,2002,710800,41,36,5,11
1,2003,710800,52,46,6,9
2,2003,710800,44,37,7,21
3,2003,710800,53,47,6,14
4,2003,710800,54,44,10,8
5,2003,710800,51,42,9,7
6,2003,710800,53,44,9,14
7,2003,710800,68,59,9,5
8,2003,710800,59,46,13,6
9,2003,710800,65,54,11,15
10,2003,710800,82,69,13,18
11,2003,710800,58,52,6,15
12,2003,710800,72,64,8,10
1,2004,710800,52,44,8,5
2,2004,710800,71,61,10,19
3,2004,710800,58,46,12,18
4,2004,710800,66,49,17,14
5,2004,710800,53,43,10,12
6,2004,710800,81,73,8,13
7,2004,710800,84,79,5,14
8,2004,710800,57,53,4,9
9,2004,710800,72,65,7,16
10,2004,710800,67,58,9,21
11,2004,710800,62,51,11,16
12,2004,710800,47,41,6,10
1,2005,710800,47,41,6,7
2,2005,710800,48,36,12,25
3,2005,710800,68,59,9,12
4,2005,710800,76,62,14,20
5,2005,710800,58,50,8,14
6,2005,710800,75,60,15,12
7,2005,710800,69,59,10,6
8,2005,710800,79,62,17,11
9,2005,710800,80,66,14,26
10,2005,710800,73,61,12,14
11,2005,710800,61,51,10,10
12,2005,710800,51,44,7,15
1,2006,710800,59,53,6,14
2,2006,710800,60,48,12,9
3,2006,710800,48,43,5,18
4,2006,710800,46,35,11,12
5,2006,710800,65,52,13,11
6,2006,710800,55,49,6,8
7,2006,710800,42,34,8,12
8,2006,710800,56,47,9,10
9,2006,710800,58,47,11,21
10,2006,710800,54,40,14,16
11,2006,710800,61,54,7,11
12,2006,710800,44,38,6,18
1,2007,710800,56,51,5,20
2,2007,710800,41,35,6,10
3,2007,710800,71,63,8,20
4,2007,710800,64,50,14,28
5,2007,710800,61,50,11,38
6,2007,710800,57,46,11,18
7,2007,710800,82,61,21,17
8,2007,710800,69,57,12,40
9,2007,710800,68,57,11,14
10,2007,710800,60,45,15,23
11,2007,710800,42,37,5,25
12,2007,710800,44,36,8,9
1,2008,710800,59,49,10,21
2,2008,710800,48,42,6,24
3,2008,710800,57,47,10,35
4,2008,710800,56,45,11,14
5,2008,710800,70,54,16,20
6,2008,710800,59,48,11,23
7,2008,710800,58,48,10,22
8,2008,710800,63,59,4,29
9,2008,710800,88,76,12,23
10,2008,710800,78,64,14,34
11,2008,710800,44,41,3,38
12,2008,710800,42,40,2,13
1,2009,710800,46,40,6,26
2,2009,710800,46,41,5,26
3,2009,710800,68,58,10,15
4,2009,710800,63,52,11,18
5,2009,710800,59,43,16,21
6,2009,710800,58,49,9,22
7,2009,710800,49,37,12,18
8,2009,710800,54,48,6,14
9,2009,710800,48,36,12,29
10,2009,710800,51,42,9,17
11,2009,710800,41,35,6,29
12,2009,710800,35,31,4,39
1,2010,710800,49,45,4,24
2,2010,710800,28,25,3,19
3,2010,710800,38,28,10,37
4,2010,710800,40,30,10,32
5,2010,710800,49,36,13,16
6,2010,710800,47,41,6,27
7,2010,710800,38,31,7,21
8,2010,710800,42,33,9,24
9,2010,710800,57,49,8,29
10,2010,710800,47,41,6,26
11,2010,710800,45,39,6,18
12,2010,710800,40,34,6,10
1,2011,710800,33,25,8,15
2,2011,710800,24,24,0,13
1,1999,710500,50,40,10,4
2,1999,710500,41,39,2,6
3,1999,710500,30,27,3,3
4,1999,710500,46,37,9,10
5,1999,710500,47,35,12,9
6,1999,710500,57,48,9,12
7,1999,710500,78,68,10,6
8,1999,710500,46,39,7,6
9,1999,710500,42,39,3,5
10,1999,710500,49,39,10,6
11,1999,710500,36,29,7,3
12,1999,710500,43,40,3,10
1,2000,710500,54,49,5,19
2,2000,710500,35,31,4,6
3,2000,710500,36,30,6,15
4,2000,710500,45,38,7,10
5,2000,710500,39,32,7,4
6,2000,710500,47,36,11,6
7,2000,710500,35,30,5,7
8,2000,710500,42,37,5,8
9,2000,710500,56,53,3,6
10,2000,710500,37,31,6,3
11,2000,710500,34,30,4,6
12,2000,710500,24,21,3,4
1,2001,710500,34,27,7,5
2,2001,710500,27,23,4,3
3,2001,710500,36,32,4,5
4,2001,710500,34,27,7,10
5,2001,710500,43,36,7,16
6,2001,710500,38,33,5,7
7,2001,710500,62,49,13,7
8,2001,710500,51,44,7,3
9,2001,710500,38,33,5,7
10,2001,710500,44,38,6,11
11,2001,710500,38,34,4,9
12,2001,710500,38,33,5,6
1,2002,710500,32,28,4,2
2,2002,710500,30,21,9,9
3,2002,710500,32,28,4,6
4,2002,710500,23,18,5,10
5,2002,710500,28,25,3,11
6,2002,710500,32,26,6,7
7,2002,710500,48,37,11,10
8,2002,710500,49,40,9,3
9,2002,710500,45,44,1,12
10,2002,710500,47,40,7,7
11,2002,710500,37,33,4,9
12,2002,710500,45,35,10,13
1,2003,710500,40,29,11,5
2,2003,710500,31,24,7,4
3,2003,710500,31,26,5,0
4,2003,710500,39,35,4,11
5,2003,710500,38,32,6,8
6,2003,710500,33,28,5,3
7,2003,710500,53,46,7,24
8,2003,710500,43,42,1,5
9,2003,710500,53,46,7,5
10,2003,710500,46,42,4,5
11,2003,710500,36,32,4,4
12,2003,710500,30,26,4,8
1,2004,710500,42,37,5,2
2,2004,710500,38,35,3,28
3,2004,710500,30,30,0,6
4,2004,710500,31,28,3,9
5,2004,710500,36,28,8,11
6,2004,710500,53,43,10,12
7,2004,710500,39,27,12,6
8,2004,710500,41,35,6,7
9,2004,710500,34,31,3,10
10,2004,710500,34,26,8,10
11,2004,710500,27,23,4,14
12,2004,710500,26,24,2,6
1,2005,710500,38,30,8,8
2,2005,710500,33,28,5,9
3,2005,710500,34,31,3,9
4,2005,710500,32,31,1,6
5,2005,710500,52,41,11,2
6,2005,710500,37,32,5,10
7,2005,710500,38,28,10,5
8,2005,710500,31,25,6,5
9,2005,710500,37,31,6,5
10,2005,710500,45,38,7,4
11,2005,710500,48,45,3,6
12,2005,710500,27,26,1,5
1,2006,710500,44,36,8,7
2,2006,710500,31,30,1,2
3,2006,710500,29,24,5,14
4,2006,710500,33,27,6,5
5,2006,710500,39,32,7,12
6,2006,710500,45,41,4,8
7,2006,710500,55,47,8,10
8,2006,710500,64,55,9,7
9,2006,710500,44,38,6,13
10,2006,710500,65,58,7,8
11,2006,710500,46,37,9,5
12,2006,710500,63,59,4,14
1,2007,710500,32,28,4,14
2,2007,710500,37,29,8,18
3,2007,710500,39,34,5,25
4,2007,710500,30,25,5,20
5,2007,710500,52,43,9,12
6,2007,710500,35,29,6,8
7,2007,710500,55,49,6,7
8,2007,710500,43,38,5,36
9,2007,710500,41,36,5,16
10,2007,710500,55,48,7,14
11,2007,710500,39,33,6,13
12,2007,710500,43,39,4,14
1,2008,710500,32,28,4,7
2,2008,710500,36,32,4,30
3,2008,710500,40,32,8,18
4,2008,710500,29,21,8,21
5,2008,710500,42,38,4,16
6,2008,710500,40,36,4,13
7,2008,710500,53,42,11,18
8,2008,710500,59,54,5,24
9,2008,710500,41,37,4,10
10,2008,710500,42,34,8,10
11,2008,710500,39,36,3,14
12,2008,710500,23,21,2,9
1,2009,710500,24,21,3,17
2,2009,710500,33,26,7,12
3,2009,710500,42,35,7,11
4,2009,710500,42,37,5,7
5,2009,710500,46,39,7,12
6,2009,710500,46,39,7,12
7,2009,710500,45,37,8,10
8,2009,710500,45,44,1,8
9,2009,710500,48,42,6,8
10,2009,710500,48,41,7,14
11,2009,710500,31,25,6,11
12,2009,710500,45,40,5,4
1,2010,710500,19,15,4,10
2,2010,710500,25,23,2,12
3,2010,710500,38,29,9,16
4,2010,710500,33,28,5,15
5,2010,710500,27,24,3,10
6,2010,710500,40,33,7,9
7,2010,710500,34,24,10,13
8,2010,710500,34,34,0,16
9,2010,710500,47,44,3,11
10,2010,710500,36,29,7,16
11,2010,710500,38,33,5,10
12,2010,710500,22,21,1,7
1,2011,710500,32,27,5,10
2,2011,710500,22,22,0,7
1,1999,710600,18,11,7,7
2,1999,710600,14,10,4,5
3,1999,710600,13,8,5,6
4,1999,710600,13,9,4,1
5,1999,710600,14,11,3,4
6,1999,710600,13,9,4,0
7,1999,710600,27,15,12,5
8,1999,710600,21,18,3,5
9,1999,710600,22,17,5,8
10,1999,710600,24,20,4,2
11,1999,710600,19,17,2,2
12,1999,710600,9,7,2,2
1,2000,710600,14,8,6,1
2,2000,710600,9,7,2,4
3,2000,710600,6,5,1,5
4,2000,710600,7,7,0,0
5,2000,710600,15,11,4,6
6,2000,710600,13,7,6,2
7,2000,710600,13,10,3,2
8,2000,710600,13,9,4,3
9,2000,710600,16,11,5,0
10,2000,710600,6,4,2,3
11,2000,710600,12,8,4,2
12,2000,710600,12,6,6,3
1,2001,710600,14,10,4,2
2,2001,710600,14,13,1,0
3,2001,710600,18,15,3,1
4,2001,710600,12,8,4,4
5,2001,710600,18,12,6,3
6,2001,710600,13,10,3,5
7,2001,710600,9,6,3,4
8,2001,710600,11,9,2,6
9,2001,710600,14,12,2,0
10,2001,710600,16,13,3,4
11,2001,710600,13,10,3,3
12,2001,710600,5,3,2,5
1,2002,710600,6,6,0,2
2,2002,710600,7,3,4,2
3,2002,710600,10,7,3,4
4,2002,710600,10,7,3,3
5,2002,710600,20,17,3,2
6,2002,710600,24,17,7,1
7,2002,710600,14,11,3,3
8,2002,710600,13,10,3,5
9,2002,710600,20,15,5,3
10,2002,710600,15,12,3,5
11,2002,710600,15,13,2,3
12,2002,710600,12,12,0,3
1,2003,710600,20,18,2,2
2,2003,710600,14,13,1,1
3,2003,710600,11,11,0,2
4,2003,710600,12,9,3,3
5,2003,710600,10,9,1,1
6,2003,710600,12,8,4,1
7,2003,710600,11,6,5,1
8,2003,710600,21,17,4,5
9,2003,710600,12,8,4,6
10,2003,710600,10,9,1,0
11,2003,710600,14,7,7,3
12,2003,710600,15,12,3,1
1,2004,710600,10,7,3,3
2,2004,710600,11,10,1,2
3,2004,710600,17,14,3,4
4,2004,710600,14,12,2,4
5,2004,710600,17,14,3,2
6,2004,710600,20,15,5,8
7,2004,710600,9,8,1,2
8,2004,710600,14,11,3,5
9,2004,710600,13,12,1,5
10,2004,710600,10,9,1,1
11,2004,710600,21,20,1,2
12,2004,710600,19,16,3,0
1,2005,710600,14,10,4,0
2,2005,710600,15,11,4,0
3,2005,710600,8,6,2,4
4,2005,710600,13,9,4,6
5,2005,710600,11,9,2,6
6,2005,710600,11,7,4,5
7,2005,710600,19,14,5,1
8,2005,710600,9,6,3,4
9,2005,710600,8,7,1,3
10,2005,710600,18,17,1,3
11,2005,710600,12,11,1,4
12,2005,710600,12,8,4,2
1,2006,710600,18,14,4,2
2,2006,710600,9,7,2,0
3,2006,710600,12,11,1,5
4,2006,710600,12,5,7,2
5,2006,710600,16,13,3,0
6,2006,710600,13,11,2,2
7,2006,710600,16,10,6,1
8,2006,710600,10,6,4,1
9,2006,710600,14,10,4,8
10,2006,710600,8,3,5,7
11,2006,710600,11,9,2,2
12,2006,710600,7,6,1,5
1,2007,710600,14,14,0,5
2,2007,710600,6,5,1,2
3,2007,710600,14,10,4,10
4,2007,710600,16,13,3,12
5,2007,710600,8,7,1,3
6,2007,710600,12,12,0,9
7,2007,710600,19,15,4,10
8,2007,710600,13,10,3,17
9,2007,710600,13,13,0,3
10,2007,710600,13,8,5,6
11,2007,710600,18,13,5,6
12,2007,710600,20,15,5,7
1,2008,710600,9,8,1,4
2,2008,710600,8,8,0,20
3,2008,710600,16,12,4,7
4,2008,710600,9,8,1,7
5,2008,710600,24,18,6,8
6,2008,710600,16,14,2,5
7,2008,710600,17,12,5,2
8,2008,710600,10,8,2,12
9,2008,710600,14,13,1,5
10,2008,710600,13,11,2,4
11,2008,710600,16,13,3,6
12,2008,710600,10,6,4,6
1,2009,710600,10,6,4,6
2,2009,710600,13,12,1,8
3,2009,710600,12,6,6,4
4,2009,710600,11,8,3,3
5,2009,710600,13,10,3,3
6,2009,710600,16,14,2,6
7,2009,710600,14,12,2,3
8,2009,710600,12,10,2,5
9,2009,710600,20,19,1,8
10,2009,710600,8,6,2,3
11,2009,710600,13,11,2,0
12,2009,710600,14,13,1,4
1,2010,710600,10,8,2,6
2,2010,710600,6,6,0,3
3,2010,710600,11,5,6,11
4,2010,710600,13,8,5,6
5,2010,710600,13,10,3,1
6,2010,710600,10,8,2,6
7,2010,710600,14,11,3,0
8,2010,710600,13,10,3,7
9,2010,710600,14,12,2,1
10,2010,710600,17,14,3,8
11,2010,710600,10,10,0,5
12,2010,710600,10,8,2,1
1,2011,710600,10,9,1,3
2,2011,710600,8,8,0,0
1,1999,440201,27,24,3,1
2,1999,440201,28,25,3,5
3,1999,440201,25,22,3,1
4,1999,440201,34,26,8,3
5,1999,440201,30,26,4,2
6,1999,440201,36,30,6,4
7,1999,440201,31,25,6,4
8,1999,440201,29,25,4,5
9,1999,440201,34,28,6,3
10,1999,440201,33,29,4,2
11,1999,440201,28,27,1,2
12,1999,440201,40,32,8,12
1,2000,440201,35,31,4,5
2,2000,440201,27,25,2,8
3,2000,440201,46,41,5,3
4,2000,440201,32,26,6,4
5,2000,440201,31,26,5,1
6,2000,440201,31,27,4,0
7,2000,440201,34,30,4,2
8,2000,440201,31,30,1,4
9,2000,440201,33,31,2,2
10,2000,440201,37,31,6,9
11,2000,440201,40,34,6,3
12,2000,440201,27,24,3,3
1,2001,440201,27,22,5,3
2,2001,440201,28,25,3,2
3,2001,440201,24,23,1,2
4,2001,440201,32,30,2,4
5,2001,440201,34,31,3,7
6,2001,440201,31,28,3,4
7,2001,440201,35,31,4,7
8,2001,440201,38,35,3,12
9,2001,440201,48,40,8,6
10,2001,440201,41,32,9,9
11,2001,440201,36,32,4,15
12,2001,440201,25,22,3,2
1,2002,440201,37,32,5,4
2,2002,440201,16,13,3,6
3,2002,440201,27,21,6,3
4,2002,440201,30,27,3,5
5,2002,440201,38,28,10,2
6,2002,440201,37,28,9,4
7,2002,440201,51,43,8,9
8,2002,440201,34,29,5,10
9,2002,440201,31,25,6,3
10,2002,440201,35,32,3,3
11,2002,440201,45,43,2,1
12,2002,440201,47,41,6,11
1,2003,440201,30,24,6,16
2,2003,440201,31,28,3,6
3,2003,440201,30,27,3,10
4,2003,440201,32,23,9,6
5,2003,440201,35,31,4,4
6,2003,440201,43,39,4,1
7,2003,440201,53,43,10,16
8,2003,440201,46,42,4,20
9,2003,440201,47,45,2,5
10,2003,440201,52,43,9,14
11,2003,440201,36,32,4,9
12,2003,440201,36,28,8,5
1,2004,440201,32,25,7,12
2,2004,440201,35,31,4,4
3,2004,440201,46,40,6,4
4,2004,440201,46,43,3,11
5,2004,440201,44,44,0,10
6,2004,440201,47,44,3,14
7,2004,440201,46,36,10,10
8,2004,440201,49,42,7,6
9,2004,440201,44,37,7,3
10,2004,440201,44,38,6,5
11,2004,440201,32,31,1,9
12,2004,440201,31,28,3,15
1,2005,440201,42,37,5,6
2,2005,440201,28,24,4,5
3,2005,440201,29,26,3,4
4,2005,440201,40,34,6,12
5,2005,440201,37,29,8,16
6,2005,440201,55,42,13,13
7,2005,440201,39,33,6,8
8,2005,440201,40,34,6,13
9,2005,440201,27,21,6,8
10,2005,440201,41,34,7,17
11,2005,440201,37,31,6,10
12,2005,440201,43,41,2,17
1,2006,440201,46,40,6,16
2,2006,440201,28,26,2,4
3,2006,440201,47,41,6,8
4,2006,440201,34,31,3,8
5,2006,440201,41,35,6,15
6,2006,440201,39,32,7,28
7,2006,440201,49,44,5,7
8,2006,440201,57,55,2,15
9,2006,440201,32,29,3,27
10,2006,440201,34,29,5,28
11,2006,440201,37,33,4,14
12,2006,440201,38,35,3,25
1,2007,440201,25,22,3,21
2,2007,440201,21,17,4,25
3,2007,440201,38,34,4,12
4,2007,440201,39,34,5,24
5,2007,440201,49,41,8,14
6,2007,440201,56,47,9,30
7,2007,440201,35,28,7,32
8,2007,440201,45,38,7,9
9,2007,440201,30,27,3,27
10,2007,440201,36,30,6,21
11,2007,440201,48,45,3,10
12,2007,440201,36,30,6,17
1,2008,440201,40,38,2,24
2,2008,440201,28,22,6,12
3,2008,440201,30,25,5,8
4,2008,440201,39,31,8,9
5,2008,440201,26,24,2,21
6,2008,440201,55,43,12,14
7,2008,440201,53,42,11,17
8,2008,440201,39,34,5,20
9,2008,440201,43,40,3,17
10,2008,440201,56,50,6,12
11,2008,440201,38,31,7,13
12,2008,440201,37,33,4,6
1,2009,440201,34,28,6,15
2,2009,440201,29,21,8,14
3,2009,440201,40,36,4,15
4,2009,440201,29,25,4,21
5,2009,440201,39,33,6,13
6,2009,440201,38,35,3,8
7,2009,440201,38,33,5,11
8,2009,440201,40,35,5,11
9,2009,440201,35,30,5,13
10,2009,440201,35,30,5,8
11,2009,440201,36,29,7,17
12,2009,440201,41,34,7,17
1,2010,440201,26,23,3,13
2,2010,440201,9,9,0,4
3,2010,440201,34,27,7,5
4,2010,440201,34,32,2,14
5,2010,440201,25,19,6,17
6,2010,440201,34,29,5,9
7,2010,440201,26,22,4,3
8,2010,440201,37,27,10,10
9,2010,440201,34,27,7,18
10,2010,440201,25,24,1,18
11,2010,440201,22,20,2,14
12,2010,440201,28,21,7,10
1,2011,440201,26,23,3,7
2,2011,440201,15,11,4,6
1,1999,440101,36,28,8,6
2,1999,440101,33,28,5,7
3,1999,440101,21,17,4,12
4,1999,440101,27,20,7,14
5,1999,440101,24,18,6,6
6,1999,440101,21,14,7,7
7,1999,440101,30,24,6,4
8,1999,440101,29,21,8,8
9,1999,440101,20,18,2,4
10,1999,440101,21,20,1,25
11,1999,440101,21,13,8,9
12,1999,440101,27,23,4,9
1,2000,440101,23,20,3,16
2,2000,440101,24,22,2,11
3,2000,440101,24,19,5,8
4,2000,440101,30,24,6,4
5,2000,440101,24,21,3,3
6,2000,440101,34,27,7,5
7,2000,440101,38,33,5,5
8,2000,440101,23,20,3,6
9,2000,440101,40,36,4,3
10,2000,440101,24,20,4,11
11,2000,440101,25,20,5,4
12,2000,440101,21,20,1,8
1,2001,440101,24,18,6,13
2,2001,440101,18,14,4,8
3,2001,440101,33,30,3,6
4,2001,440101,33,28,5,5
5,2001,440101,38,31,7,7
6,2001,440101,28,22,6,9
7,2001,440101,35,26,9,6
8,2001,440101,24,22,2,7
9,2001,440101,34,25,9,9
10,2001,440101,48,37,11,4
11,2001,440101,42,34,8,21
12,2001,440101,31,22,9,15
1,2002,440101,31,27,4,4
2,2002,440101,40,34,6,11
3,2002,440101,33,24,9,13
4,2002,440101,31,23,8,12
5,2002,440101,30,24,6,10
6,2002,440101,37,23,14,7
7,2002,440101,31,17,14,10
8,2002,440101,30,26,4,3
9,2002,440101,27,20,7,3
10,2002,440101,25,20,5,7
11,2002,440101,22,20,2,8
12,2002,440101,32,26,6,5
1,2003,440101,19,10,9,4
2,2003,440101,25,23,2,3
3,2003,440101,31,26,5,3
4,2003,440101,23,17,6,10
5,2003,440101,24,20,4,6
6,2003,440101,23,20,3,4
7,2003,440101,27,18,9,6
8,2003,440101,42,38,4,8
9,2003,440101,25,21,4,6
10,2003,440101,24,20,4,11
11,2003,440101,24,17,7,7
12,2003,440101,20,18,2,6
1,2004,440101,29,21,8,10
2,2004,440101,21,16,5,8
3,2004,440101,28,24,4,8
4,2004,440101,28,24,4,13
5,2004,440101,36,32,4,7
6,2004,440101,40,34,6,14
7,2004,440101,23,15,8,13
8,2004,440101,23,20,3,8
9,2004,440101,31,26,5,2
10,2004,440101,29,24,5,20
11,2004,440101,26,20,6,11
12,2004,440101,20,16,4,16
1,2005,440101,17,12,5,13
2,2005,440101,21,15,6,10
3,2005,440101,27,19,8,16
4,2005,440101,31,23,8,13
5,2005,440101,23,15,8,17
6,2005,440101,21,14,7,5
7,2005,440101,36,28,8,4
8,2005,440101,25,17,8,9
9,2005,440101,12,8,4,7
10,2005,440101,32,26,6,8
11,2005,440101,16,12,4,10
12,2005,440101,22,19,3,14
1,2006,440101,35,29,6,7
2,2006,440101,21,19,2,5
3,2006,440101,23,20,3,9
4,2006,440101,33,25,8,2
5,2006,440101,21,16,5,9
6,2006,440101,30,24,6,7
7,2006,440101,32,27,5,10
8,2006,440101,28,22,6,11
9,2006,440101,33,25,8,11
10,2006,440101,29,20,9,10
11,2006,440101,36,30,6,5
12,2006,440101,25,23,2,12
1,2007,440101,20,16,4,18
2,2007,440101,16,11,5,13
3,2007,440101,36,30,6,16
4,2007,440101,31,26,5,12
5,2007,440101,31,25,6,6
6,2007,440101,30,21,9,11
7,2007,440101,30,24,6,23
8,2007,440101,50,37,13,12
9,2007,440101,28,23,5,19
10,2007,440101,24,19,5,13
11,2007,440101,33,27,6,7
12,2007,440101,24,19,5,13
1,2008,440101,23,22,1,12
2,2008,440101,26,19,7,9
3,2008,440101,29,22,7,8
4,2008,440101,19,15,4,4
5,2008,440101,41,31,10,12
6,2008,440101,22,19,3,14
7,2008,440101,35,25,10,7
8,2008,440101,33,27,6,7
9,2008,440101,36,32,4,12
10,2008,440101,26,24,2,9
11,2008,440101,30,23,7,22
12,2008,440101,18,16,2,3
1,2009,440101,31,22,9,6
2,2009,440101,14,10,4,5
3,2009,440101,23,18,5,7
4,2009,440101,25,19,6,9
5,2009,440101,33,28,5,4
6,2009,440101,32,26,6,10
7,2009,440101,18,13,5,11
8,2009,440101,27,23,4,8
9,2009,440101,22,18,4,6
10,2009,440101,29,23,6,6
11,2009,440101,27,19,8,8
12,2009,440101,17,10,7,9
1,2010,440101,16,11,5,8
2,2010,440101,20,13,7,16
3,2010,440101,26,17,9,17
4,2010,440101,20,15,5,11
5,2010,440101,25,20,5,11
6,2010,440101,23,19,4,10
7,2010,440101,24,21,3,5
8,2010,440101,25,18,7,2
9,2010,440101,22,18,4,10
10,2010,440101,27,23,4,8
11,2010,440101,23,17,6,9
12,2010,440101,18,16,2,8
1,2011,440101,24,19,5,13
2,2011,440101,8,5,3,9
1,1999,700200,18,15,3,1
2,1999,700200,17,17,0,4
3,1999,700200,22,20,2,0
4,1999,700200,20,18,2,5
5,1999,700200,13,13,0,5
6,1999,700200,18,17,1,4
7,1999,700200,30,29,1,2
8,1999,700200,21,19,2,3
9,1999,700200,18,15,3,1
10,1999,700200,25,21,4,3
11,1999,700200,25,23,2,3
12,1999,700200,14,13,1,0
1,2000,700200,18,16,2,2
2,2000,700200,9,9,0,7
3,2000,700200,11,7,4,6
4,2000,700200,18,15,3,4
5,2000,700200,10,7,3,7
6,2000,700200,13,12,1,1
7,2000,700200,14,11,3,4
8,2000,700200,26,23,3,2
9,2000,700200,14,13,1,3
10,2000,700200,18,15,3,7
11,2000,700200,27,26,1,2
12,2000,700200,18,16,2,8
1,2001,700200,16,14,2,2
2,2001,700200,9,7,2,1
3,2001,700200,20,17,3,6
4,2001,700200,16,14,2,0
5,2001,700200,16,15,1,7
6,2001,700200,13,8,5,0
7,2001,700200,14,11,3,1
8,2001,700200,15,10,5,1
9,2001,700200,15,13,2,3
10,2001,700200,20,17,3,3
11,2001,700200,16,12,4,2
12,2001,700200,23,18,5,1
1,2002,700200,16,14,2,3
2,2002,700200,19,15,4,5
3,2002,700200,23,20,3,3
4,2002,700200,24,22,2,2
5,2002,700200,18,12,6,0
6,2002,700200,14,8,6,0
7,2002,700200,33,31,2,3
8,2002,700200,23,20,3,0
9,2002,700200,28,25,3,3
10,2002,700200,26,19,7,1
11,2002,700200,9,7,2,3
12,2002,700200,29,25,4,2
1,2003,700200,14,14,0,1
2,2003,700200,23,22,1,5
3,2003,700200,19,17,2,7
4,2003,700200,16,14,2,1
5,2003,700200,20,18,2,2
6,2003,700200,29,26,3,3
7,2003,700200,25,23,2,2
8,2003,700200,16,15,1,3
9,2003,700200,21,16,5,2
10,2003,700200,17,11,6,3
11,2003,700200,18,16,2,5
12,2003,700200,14,13,1,3
1,2004,700200,17,14,3,7
2,2004,700200,20,18,2,3
3,2004,700200,21,18,3,3
4,2004,700200,13,10,3,5
5,2004,700200,12,10,2,3
6,2004,700200,24,21,3,0
7,2004,700200,13,11,2,3
8,2004,700200,14,12,2,2
9,2004,700200,12,9,3,4
10,2004,700200,33,24,9,4
11,2004,700200,16,11,5,0
12,2004,700200,21,19,2,2
1,2005,700200,23,21,2,4
2,2005,700200,23,18,5,3
3,2005,700200,19,18,1,4
4,2005,700200,18,13,5,5
5,2005,700200,25,22,3,3
6,2005,700200,18,16,2,1
7,2005,700200,26,23,3,3
8,2005,700200,20,16,4,0
9,2005,700200,20,14,6,4
10,2005,700200,32,26,6,1
11,2005,700200,31,26,5,4
12,2005,700200,14,11,3,5
1,2006,700200,21,17,4,2
2,2006,700200,13,12,1,1
3,2006,700200,23,18,5,2
4,2006,700200,29,28,1,2
5,2006,700200,26,22,4,1
6,2006,700200,23,21,2,1
7,2006,700200,25,20,5,7
8,2006,700200,26,24,2,3
9,2006,700200,29,28,1,0
10,2006,700200,48,43,5,6
11,2006,700200,29,26,3,4
12,2006,700200,17,16,1,3
1,2007,700200,31,28,3,7
2,2007,700200,15,13,2,4
3,2007,700200,10,8,2,4
4,2007,700200,24,23,1,0
5,2007,700200,37,24,13,2
6,2007,700200,24,22,2,4
7,2007,700200,24,21,3,7
8,2007,700200,9,8,1,2
9,2007,700200,23,19,4,4
10,2007,700200,20,15,5,1
11,2007,700200,20,19,1,3
12,2007,700200,8,7,1,3
1,2008,700200,17,15,2,4
2,2008,700200,14,11,3,2
3,2008,700200,23,21,2,5
4,2008,700200,25,24,1,4
5,2008,700200,16,15,1,1
6,2008,700200,18,13,5,2
7,2008,700200,6,4,2,2
8,2008,700200,25,18,7,1
9,2008,700200,13,9,4,2
10,2008,700200,26,23,3,0
11,2008,700200,17,15,2,6
12,2008,700200,25,20,5,1
1,2009,700200,17,12,5,0
2,2009,700200,21,20,1,4
3,2009,700200,15,11,4,3
4,2009,700200,18,13,5,1
5,2009,700200,20,18,2,7
6,2009,700200,12,8,4,1
7,2009,700200,16,12,4,2
8,2009,700200,16,16,0,1
9,2009,700200,34,25,9,4
10,2009,700200,21,18,3,1
11,2009,700200,16,11,5,13
12,2009,700200,19,17,2,1
1,2010,700200,24,22,2,4
2,2010,700200,10,8,2,3
3,2010,700200,25,22,3,10
4,2010,700200,22,19,3,3
5,2010,700200,24,17,7,5
6,2010,700200,17,14,3,2
7,2010,700200,16,12,4,4
8,2010,700200,20,16,4,6
9,2010,700200,15,9,6,4
10,2010,700200,21,17,4,0
11,2010,700200,20,16,4,1
12,2010,700200,11,11,0,3
1,2011,700200,21,21,0,2
2,2011,700200,15,15,0,3
1,1999,700100,35,31,4,11
2,1999,700100,25,22,3,3
3,1999,700100,26,23,3,5
4,1999,700100,35,31,4,4
5,1999,700100,28,26,2,6
6,1999,700100,44,41,3,3
7,1999,700100,60,51,9,6
8,1999,700100,22,17,5,3
9,1999,700100,33,30,3,2
10,1999,700100,31,25,6,2
11,1999,700100,26,22,4,3
12,1999,700100,23,22,1,2
1,2000,700100,26,24,2,2
2,2000,700100,26,23,3,5
3,2000,700100,33,28,5,2
4,2000,700100,28,24,4,6
5,2000,700100,26,22,4,1
6,2000,700100,42,34,8,2
7,2000,700100,32,31,1,7
8,2000,700100,31,24,7,5
9,2000,700100,32,27,5,0
10,2000,700100,35,27,8,4
11,2000,700100,27,26,1,1
12,2000,700100,27,27,0,1
1,2001,700100,29,26,3,3
2,2001,700100,18,17,1,1
3,2001,700100,25,23,2,2
4,2001,700100,30,28,2,3
5,2001,700100,30,26,4,1
6,2001,700100,34,29,5,5
7,2001,700100,29,29,0,3
8,2001,700100,28,27,1,2
9,2001,700100,32,31,1,5
10,2001,700100,38,35,3,2
11,2001,700100,40,33,7,1
12,2001,700100,26,24,2,1
1,2002,700100,35,32,3,1
2,2002,700100,19,19,0,3
3,2002,700100,23,22,1,4
4,2002,700100,32,28,4,5
5,2002,700100,28,24,4,1
6,2002,700100,34,32,2,1
7,2002,700100,43,41,2,4
8,2002,700100,37,31,6,3
9,2002,700100,29,26,3,4
10,2002,700100,37,34,3,6
11,2002,700100,27,23,4,8
12,2002,700100,32,30,2,12
1,2003,700100,17,15,2,4
2,2003,700100,18,16,2,3
3,2003,700100,27,26,1,2
4,2003,700100,30,25,5,0
5,2003,700100,27,25,2,5
6,2003,700100,30,25,5,5
7,2003,700100,30,29,1,5
8,2003,700100,26,21,5,14
9,2003,700100,21,19,2,1
10,2003,700100,39,39,0,9
11,2003,700100,37,32,5,2
12,2003,700100,22,20,2,4
1,2004,700100,39,35,4,2
2,2004,700100,28,25,3,4
3,2004,700100,34,33,1,2
4,2004,700100,36,31,5,5
5,2004,700100,44,40,4,10
6,2004,700100,44,40,4,9
7,2004,700100,41,34,7,2
8,2004,700100,42,39,3,9
9,2004,700100,34,31,3,1
10,2004,700100,37,34,3,3
11,2004,700100,24,23,1,1
12,2004,700100,27,22,5,5
1,2005,700100,25,21,4,2
2,2005,700100,38,37,1,3
3,2005,700100,35,29,6,7
4,2005,700100,29,26,3,11
5,2005,700100,24,20,4,2
6,2005,700100,37,33,4,3
7,2005,700100,30,28,2,8
8,2005,700100,25,23,2,5
9,2005,700100,31,29,2,4
10,2005,700100,37,35,2,4
11,2005,700100,39,35,4,8
12,2005,700100,22,20,2,2
1,2006,700100,32,27,5,4
2,2006,700100,32,30,2,8
3,2006,700100,37,31,6,2
4,2006,700100,22,18,4,9
5,2006,700100,40,33,7,6
6,2006,700100,36,29,7,5
7,2006,700100,38,34,4,14
8,2006,700100,38,36,2,6
9,2006,700100,42,42,0,16
10,2006,700100,51,48,3,9
11,2006,700100,36,32,4,13
12,2006,700100,38,35,3,4
1,2007,700100,22,20,2,2
2,2007,700100,27,23,4,8
3,2007,700100,34,30,4,4
4,2007,700100,41,37,4,5
5,2007,700100,33,29,4,3
6,2007,700100,37,32,5,8
7,2007,700100,33,29,4,2
8,2007,700100,46,44,2,5
9,2007,700100,43,36,7,4
10,2007,700100,47,44,3,8
11,2007,700100,38,35,3,6
12,2007,700100,38,34,4,2
1,2008,700100,35,30,5,2
2,2008,700100,31,27,4,6
3,2008,700100,44,40,4,2
4,2008,700100,35,31,4,4
5,2008,700100,49,46,3,3
6,2008,700100,49,46,3,6
7,2008,700100,39,35,4,2
8,2008,700100,37,33,4,6
9,2008,700100,36,33,3,7
10,2008,700100,45,40,5,4
11,2008,700100,38,34,4,6
12,2008,700100,29,26,3,3
1,2009,700100,29,24,5,5
2,2009,700100,20,16,4,4
3,2009,700100,30,27,3,2
4,2009,700100,29,27,2,6
5,2009,700100,35,31,4,9
6,2009,700100,24,23,1,11
7,2009,700100,30,28,2,3
8,2009,700100,48,43,5,13
9,2009,700100,32,24,8,8
10,2009,700100,26,23,3,4
11,2009,700100,32,31,1,3
12,2009,700100,25,23,2,4
1,2010,700100,28,28,0,7
2,2010,700100,17,13,4,8
3,2010,700100,21,17,4,12
4,2010,700100,33,29,4,5
5,2010,700100,36,30,6,7
6,2010,700100,32,32,0,3
7,2010,700100,27,22,5,17
8,2010,700100,28,27,1,7
9,2010,700100,28,23,5,4
10,2010,700100,29,27,2,9
11,2010,700100,31,22,9,9
12,2010,700100,13,12,1,3
1,2011,700100,23,20,3,8
2,2011,700100,10,10,0,9
1,1999,710400,48,44,4,20
2,1999,710400,39,34,5,13
3,1999,710400,44,38,6,24
4,1999,710400,43,32,11,16
5,1999,710400,63,45,18,16
6,1999,710400,58,38,20,22
7,1999,710400,60,48,12,16
8,1999,710400,59,52,7,11
9,1999,710400,46,44,2,11
10,1999,710400,56,49,7,22
11,1999,710400,35,32,3,15
12,1999,710400,56,46,10,14
1,2000,710400,41,35,6,19
2,2000,710400,48,39,9,24
3,2000,710400,51,42,9,21
4,2000,710400,55,48,7,32
5,2000,710400,53,48,5,30
6,2000,710400,55,41,14,19
7,2000,710400,57,50,7,16
8,2000,710400,55,44,11,28
9,2000,710400,65,58,7,19
10,2000,710400,58,48,10,23
11,2000,710400,41,36,5,26
12,2000,710400,29,27,2,18
1,2001,710400,44,41,3,19
2,2001,710400,30,26,4,8
3,2001,710400,37,29,8,19
4,2001,710400,38,31,7,10
5,2001,710400,42,35,7,23
6,2001,710400,37,34,3,14
7,2001,710400,51,40,11,14
8,2001,710400,48,36,12,7
9,2001,710400,48,40,8,10
10,2001,710400,57,41,16,13
11,2001,710400,46,41,5,20
12,2001,710400,50,44,6,17
1,2002,710400,44,35,9,16
2,2002,710400,44,38,6,11
3,2002,710400,41,37,4,9
4,2002,710400,49,36,13,7
5,2002,710400,50,44,6,10
6,2002,710400,44,36,8,12
7,2002,710400,49,42,7,7
8,2002,710400,43,27,16,7
9,2002,710400,43,37,6,10
10,2002,710400,34,32,2,52
11,2002,710400,46,42,4,42
12,2002,710400,40,32,8,31
1,2003,710400,32,28,4,16
2,2003,710400,31,24,7,4
3,2003,710400,37,34,3,6
4,2003,710400,35,28,7,30
5,2003,710400,44,39,5,10
6,2003,710400,42,35,7,17
7,2003,710400,47,38,9,25
8,2003,710400,37,27,10,7
9,2003,710400,44,37,7,6
10,2003,710400,37,30,7,15
11,2003,710400,53,44,9,12
12,2003,710400,45,38,7,16
1,2004,710400,44,35,9,9
2,2004,710400,33,24,9,12
3,2004,710400,42,36,6,16
4,2004,710400,49,38,11,25
5,2004,710400,47,33,14,34
6,2004,710400,60,47,13,13
7,2004,710400,48,42,6,7
8,2004,710400,50,41,9,15
9,2004,710400,41,27,14,21
10,2004,710400,55,49,6,32
11,2004,710400,37,26,11,10
12,2004,710400,38,32,6,16
1,2005,710400,41,40,1,15
2,2005,710400,31,27,4,9
3,2005,710400,41,32,9,22
4,2005,710400,48,39,9,14
5,2005,710400,48,36,12,12
6,2005,710400,42,30,12,14
7,2005,710400,56,50,6,9
8,2005,710400,44,35,9,11
9,2005,710400,41,34,7,5
10,2005,710400,49,41,8,7
11,2005,710400,53,48,5,10
12,2005,710400,34,29,5,11
1,2006,710400,40,34,6,7
2,2006,710400,20,17,3,7
3,2006,710400,41,35,6,8
4,2006,710400,34,28,6,12
5,2006,710400,30,22,8,7
6,2006,710400,58,49,9,7
7,2006,710400,40,32,8,5
8,2006,710400,49,37,12,9
9,2006,710400,33,24,9,7
10,2006,710400,28,19,9,12
11,2006,710400,36,34,2,8
12,2006,710400,53,44,9,13
1,2007,710400,46,43,3,18
2,2007,710400,48,38,10,8
3,2007,710400,54,46,8,20
4,2007,710400,54,41,13,11
5,2007,710400,45,36,9,11
6,2007,710400,49,41,8,18
7,2007,710400,39,26,13,14
8,2007,710400,40,30,10,26
9,2007,710400,31,20,11,16
10,2007,710400,41,34,7,9
11,2007,710400,36,27,9,12
12,2007,710400,29,25,4,12
1,2008,710400,39,30,9,23
2,2008,710400,31,25,6,30
3,2008,710400,32,28,4,23
4,2008,710400,35,24,11,20
5,2008,710400,41,34,7,15
6,2008,710400,47,37,10,8
7,2008,710400,38,32,6,12
8,2008,710400,55,43,12,22
9,2008,710400,37,28,9,24
10,2008,710400,36,30,6,19
11,2008,710400,31,24,7,17
12,2008,710400,33,31,2,9
1,2009,710400,26,22,4,24
2,2009,710400,30,26,4,14
3,2009,710400,30,25,5,19
4,2009,710400,42,29,13,14
5,2009,710400,47,41,6,20
6,2009,710400,48,39,9,14
7,2009,710400,32,21,11,21
8,2009,710400,42,32,10,15
9,2009,710400,47,35,12,12
10,2009,710400,39,34,5,13
11,2009,710400,33,24,9,10
12,2009,710400,24,23,1,17
1,2010,710400,26,22,4,8
2,2010,710400,24,20,4,13
3,2010,710400,33,24,9,17
4,2010,710400,41,39,2,17
5,2010,710400,47,38,9,10
6,2010,710400,46,42,4,12
7,2010,710400,41,35,6,16
8,2010,710400,41,36,5,28
9,2010,710400,34,31,3,12
10,2010,710400,31,27,4,4
11,2010,710400,45,42,3,11
12,2010,710400,33,28,5,7
1,2011,710400,29,26,3,12
2,2011,710400,22,20,2,7
1,1999,710300,8,4,4,2
2,1999,710300,12,12,0,4
3,1999,710300,12,10,2,3
4,1999,710300,8,6,2,4
5,1999,710300,21,17,4,5
6,1999,710300,22,17,5,5
7,1999,710300,17,14,3,5
8,1999,710300,14,13,1,10
9,1999,710300,19,15,4,4
10,1999,710300,18,14,4,1
11,1999,710300,14,12,2,1
12,1999,710300,11,10,1,0
1,2000,710300,19,14,5,4
2,2000,710300,11,10,1,3
3,2000,710300,16,11,5,18
4,2000,710300,13,9,4,4
5,2000,710300,25,21,4,5
6,2000,710300,16,16,0,2
7,2000,710300,17,12,5,2
8,2000,710300,17,13,4,10
9,2000,710300,24,19,5,6
10,2000,710300,19,16,3,11
11,2000,710300,9,8,1,5
12,2000,710300,16,13,3,3
1,2001,710300,11,9,2,1
2,2001,710300,16,16,0,9
3,2001,710300,25,18,7,6
4,2001,710300,17,13,4,1
5,2001,710300,15,10,5,9
6,2001,710300,18,14,4,2
7,2001,710300,16,11,5,4
8,2001,710300,17,14,3,5
9,2001,710300,22,20,2,3
10,2001,710300,43,36,7,4
11,2001,710300,18,16,2,11
12,2001,710300,16,14,2,11
1,2002,710300,23,18,5,7
2,2002,710300,13,12,1,5
3,2002,710300,14,11,3,4
4,2002,710300,24,23,1,6
5,2002,710300,17,14,3,7
6,2002,710300,15,14,1,4
7,2002,710300,10,10,0,9
8,2002,710300,17,14,3,4
9,2002,710300,22,19,3,3
10,2002,710300,27,25,2,7
11,2002,710300,8,7,1,4
12,2002,710300,12,10,2,6
1,2003,710300,15,12,3,5
2,2003,710300,13,12,1,6
3,2003,710300,12,11,1,2
4,2003,710300,12,10,2,4
5,2003,710300,17,14,3,4
6,2003,710300,15,12,3,24
7,2003,710300,31,29,2,2
8,2003,710300,20,17,3,2
9,2003,710300,18,16,2,20
10,2003,710300,18,17,1,8
11,2003,710300,19,14,5,1
12,2003,710300,11,7,4,3
1,2004,710300,15,13,2,3
2,2004,710300,15,12,3,3
3,2004,710300,10,7,3,10
4,2004,710300,19,15,4,5
5,2004,710300,17,15,2,14
6,2004,710300,20,17,3,11
7,2004,710300,10,7,3,2
8,2004,710300,15,11,4,9
9,2004,710300,16,12,4,5
10,2004,710300,14,11,3,16
11,2004,710300,14,12,2,6
12,2004,710300,17,13,4,6
1,2005,710300,15,15,0,5
2,2005,710300,15,12,3,3
3,2005,710300,20,14,6,4
4,2005,710300,15,13,2,3
5,2005,710300,14,13,1,3
6,2005,710300,28,22,6,8
7,2005,710300,19,14,5,10
8,2005,710300,38,34,4,8
9,2005,710300,20,17,3,10
10,2005,710300,22,20,2,6
11,2005,710300,26,25,1,4
12,2005,710300,15,13,2,15
1,2006,710300,23,19,4,11
2,2006,710300,16,11,5,1
3,2006,710300,19,15,4,12
4,2006,710300,16,13,3,4
5,2006,710300,16,13,3,6
6,2006,710300,15,11,4,6
7,2006,710300,20,17,3,7
8,2006,710300,19,16,3,5
9,2006,710300,17,15,2,9
10,2006,710300,25,21,4,14
11,2006,710300,18,17,1,4
12,2006,710300,22,17,5,11
1,2007,710300,30,22,8,18
2,2007,710300,10,7,3,11
3,2007,710300,25,18,7,28
4,2007,710300,16,12,4,11
5,2007,710300,18,17,1,8
6,2007,710300,19,17,2,14
7,2007,710300,18,14,4,8
8,2007,710300,25,23,2,20
9,2007,710300,12,10,2,11
10,2007,710300,30,22,8,8
11,2007,710300,17,16,1,6
12,2007,710300,15,14,1,10
1,2008,710300,9,9,0,10
2,2008,710300,15,12,3,13
3,2008,710300,18,17,1,21
4,2008,710300,13,10,3,6
5,2008,710300,15,11,4,8
6,2008,710300,16,14,2,14
7,2008,710300,19,15,4,11
8,2008,710300,30,26,4,16
9,2008,710300,9,7,2,10
10,2008,710300,20,16,4,10
11,2008,710300,10,8,2,7
12,2008,710300,17,15,2,10
1,2009,710300,5,3,2,10
2,2009,710300,8,6,2,9
3,2009,710300,21,15,6,18
4,2009,710300,20,15,5,6
5,2009,710300,20,17,3,10
6,2009,710300,18,17,1,5
7,2009,710300,31,25,6,7
8,2009,710300,19,17,2,10
9,2009,710300,18,14,4,5
10,2009,710300,17,16,1,2
11,2009,710300,14,12,2,7
12,2009,710300,13,11,2,6
1,2010,710300,20,17,3,1
2,2010,710300,15,14,1,10
3,2010,710300,20,12,8,13
4,2010,710300,21,16,5,8
5,2010,710300,15,11,4,2
6,2010,710300,17,11,6,16
7,2010,710300,23,19,4,9
8,2010,710300,18,14,4,8
9,2010,710300,28,26,2,7
10,2010,710300,26,23,3,1
11,2010,710300,19,18,1,7
12,2010,710300,12,10,2,2
1,2011,710300,14,9,5,5
2,2011,710300,17,14,3,6
1,1999,691200,36,30,6,7
2,1999,691200,40,34,6,5
3,1999,691200,49,42,7,13
4,1999,691200,54,46,8,2
5,1999,691200,69,57,12,5
6,1999,691200,59,49,10,6
7,1999,691200,62,53,9,7
8,1999,691200,77,64,13,14
9,1999,691200,75,66,9,11
10,1999,691200,53,47,6,20
11,1999,691200,48,46,2,35
12,1999,691200,48,40,8,13
1,2000,691200,38,34,4,14
2,2000,691200,42,35,7,16
3,2000,691200,66,52,14,19
4,2000,691200,50,42,8,12
5,2000,691200,53,43,10,15
6,2000,691200,48,41,7,9
7,2000,691200,67,58,9,10
8,2000,691200,56,50,6,11
9,2000,691200,61,56,5,11
10,2000,691200,42,36,6,12
11,2000,691200,47,36,11,13
12,2000,691200,49,47,2,10
1,2001,691200,47,43,4,19
2,2001,691200,33,27,6,14
3,2001,691200,43,40,3,16
4,2001,691200,44,37,7,9
5,2001,691200,54,47,7,22
6,2001,691200,56,46,10,8
7,2001,691200,43,36,7,9
8,2001,691200,58,52,6,17
9,2001,691200,44,38,6,9
10,2001,691200,62,57,5,4
11,2001,691200,72,64,8,13
12,2001,691200,67,55,12,19
1,2002,691200,51,40,11,18
2,2002,691200,25,20,5,17
3,2002,691200,52,40,12,11
4,2002,691200,48,42,6,6
5,2002,691200,60,54,6,8
6,2002,691200,41,34,7,7
7,2002,691200,51,41,10,13
8,2002,691200,57,50,7,13
9,2002,691200,52,44,8,8
10,2002,691200,43,36,7,33
11,2002,691200,34,26,8,13
12,2002,691200,30,24,6,15
1,2003,691200,39,35,4,29
2,2003,691200,41,37,4,5
3,2003,691200,50,47,3,9
4,2003,691200,33,30,3,11
5,2003,691200,42,32,10,15
6,2003,691200,50,43,7,40
7,2003,691200,44,36,8,13
8,2003,691200,45,39,6,5
9,2003,691200,45,37,8,13
10,2003,691200,48,40,8,18
11,2003,691200,42,37,5,23
12,2003,691200,29,21,8,8
1,2004,691200,24,19,5,7
2,2004,691200,27,20,7,14
3,2004,691200,43,39,4,10
4,2004,691200,39,28,11,9
5,2004,691200,44,37,7,12
6,2004,691200,42,35,7,8
7,2004,691200,54,47,7,6
8,2004,691200,47,37,10,12
9,2004,691200,32,31,1,9
10,2004,691200,48,40,8,9
11,2004,691200,37,30,7,4
12,2004,691200,32,29,3,7
1,2005,691200,28,25,3,1
2,2005,691200,35,32,3,8
3,2005,691200,27,22,5,4
4,2005,691200,36,31,5,9
5,2005,691200,33,29,4,12
6,2005,691200,54,45,9,5
7,2005,691200,31,29,2,5
8,2005,691200,44,37,7,5
9,2005,691200,43,35,8,11
10,2005,691200,39,36,3,17
11,2005,691200,34,30,4,5
12,2005,691200,32,30,2,4
1,2006,691200,47,38,9,10
2,2006,691200,26,25,1,11
3,2006,691200,35,30,5,1
4,2006,691200,29,25,4,6
5,2006,691200,41,34,7,7
6,2006,691200,26,23,3,5
7,2006,691200,38,31,7,3
8,2006,691200,34,28,6,8
9,2006,691200,24,19,5,6
10,2006,691200,32,27,5,7
11,2006,691200,34,31,3,6
12,2006,691200,38,33,5,7
1,2007,691200,46,40,6,6
2,2007,691200,29,25,4,7
3,2007,691200,28,25,3,10
4,2007,691200,34,30,4,24
5,2007,691200,41,35,6,15
6,2007,691200,34,27,7,27
7,2007,691200,29,24,5,10
8,2007,691200,26,20,6,13
9,2007,691200,37,27,10,11
10,2007,691200,29,23,6,22
11,2007,691200,26,20,6,12
12,2007,691200,16,15,1,11
1,2008,691200,30,22,8,12
2,2008,691200,20,15,5,13
3,2008,691200,29,21,8,17
4,2008,691200,40,30,10,12
5,2008,691200,28,21,7,15
6,2008,691200,26,19,7,8
7,2008,691200,34,22,12,15
8,2008,691200,40,31,9,14
9,2008,691200,31,25,6,17
10,2008,691200,46,38,8,15
11,2008,691200,17,14,3,16
12,2008,691200,20,20,0,12
1,2009,691200,24,18,6,9
2,2009,691200,21,16,5,20
3,2009,691200,34,26,8,19
4,2009,691200,25,21,4,8
5,2009,691200,27,24,3,13
6,2009,691200,30,24,6,10
7,2009,691200,35,29,6,12
8,2009,691200,27,25,2,11
9,2009,691200,15,13,2,12
10,2009,691200,39,36,3,10
11,2009,691200,28,23,5,13
12,2009,691200,33,25,8,12
1,2010,691200,39,36,3,10
2,2010,691200,17,11,6,13
3,2010,691200,25,20,5,16
4,2010,691200,34,25,9,22
5,2010,691200,30,25,5,10
6,2010,691200,35,32,3,13
7,2010,691200,29,21,8,13
8,2010,691200,32,29,3,15
9,2010,691200,31,25,6,8
10,2010,691200,22,19,3,12
11,2010,691200,20,20,0,7
12,2010,691200,15,12,3,15
1,2011,691200,27,22,5,5
2,2011,691200,13,11,2,5
1,1999,691400,36,33,3,6
2,1999,691400,16,15,1,9
3,1999,691400,22,17,5,8
4,1999,691400,27,21,6,4
5,1999,691400,23,14,9,7
6,1999,691400,28,25,3,10
7,1999,691400,25,20,5,4
8,1999,691400,22,20,2,5
9,1999,691400,27,22,5,4
10,1999,691400,36,28,8,3
11,1999,691400,36,32,4,5
12,1999,691400,21,20,1,2
1,2000,691400,26,20,6,7
2,2000,691400,27,20,7,5
3,2000,691400,30,21,9,10
4,2000,691400,25,22,3,6
5,2000,691400,25,23,2,3
6,2000,691400,31,23,8,4
7,2000,691400,49,42,7,7
8,2000,691400,31,24,7,5
9,2000,691400,35,28,7,6
10,2000,691400,39,36,3,9
11,2000,691400,40,34,6,6
12,2000,691400,34,30,4,9
1,2001,691400,31,26,5,7
2,2001,691400,24,22,2,10
3,2001,691400,33,28,5,8
4,2001,691400,32,23,9,6
5,2001,691400,28,25,3,9
6,2001,691400,28,20,8,5
7,2001,691400,36,26,10,8
8,2001,691400,53,42,11,2
9,2001,691400,29,28,1,4
10,2001,691400,42,34,8,3
11,2001,691400,26,19,7,8
12,2001,691400,38,35,3,10
1,2002,691400,32,29,3,3
2,2002,691400,15,11,4,5
3,2002,691400,27,23,4,7
4,2002,691400,42,35,7,10
5,2002,691400,48,38,10,12
6,2002,691400,51,42,9,6
7,2002,691400,43,36,7,6
8,2002,691400,47,41,6,6
9,2002,691400,41,32,9,4
10,2002,691400,43,32,11,2
11,2002,691400,37,32,5,4
12,2002,691400,22,21,1,6
1,2003,691400,26,23,3,4
2,2003,691400,27,25,2,6
3,2003,691400,42,34,8,14
4,2003,691400,39,29,10,9
5,2003,691400,27,22,5,4
6,2003,691400,49,40,9,4
7,2003,691400,44,40,4,12
8,2003,691400,37,34,3,5
9,2003,691400,58,52,6,5
10,2003,691400,38,30,8,6
11,2003,691400,35,28,7,10
12,2003,691400,36,33,3,16
1,2004,691400,30,27,3,11
2,2004,691400,43,37,6,17
3,2004,691400,53,47,6,17
4,2004,691400,57,52,5,20
5,2004,691400,46,39,7,18
6,2004,691400,55,44,11,17
7,2004,691400,56,49,7,30
8,2004,691400,59,53,6,25
9,2004,691400,32,30,2,22
10,2004,691400,35,28,7,18
11,2004,691400,42,35,7,11
12,2004,691400,31,26,5,17
1,2005,691400,25,24,1,16
2,2005,691400,25,17,8,9
3,2005,691400,32,30,2,9
4,2005,691400,40,28,12,13
5,2005,691400,33,26,7,18
6,2005,691400,46,40,6,19
7,2005,691400,54,44,10,24
8,2005,691400,29,23,6,13
9,2005,691400,32,27,5,11
10,2005,691400,41,30,11,17
11,2005,691400,36,31,5,10
12,2005,691400,25,22,3,31
1,2006,691400,29,25,4,14
2,2006,691400,29,27,2,13
3,2006,691400,38,36,2,7
4,2006,691400,45,38,7,12
5,2006,691400,52,48,4,12
6,2006,691400,36,29,7,31
7,2006,691400,48,40,8,22
8,2006,691400,39,32,7,25
9,2006,691400,41,35,6,18
10,2006,691400,31,25,6,25
11,2006,691400,30,27,3,21
12,2006,691400,30,25,5,35
1,2007,691400,20,18,2,49
2,2007,691400,18,14,4,37
3,2007,691400,40,32,8,32
4,2007,691400,33,27,6,44
5,2007,691400,32,23,9,13
6,2007,691400,43,34,9,40
7,2007,691400,45,38,7,51
8,2007,691400,30,26,4,8
9,2007,691400,38,28,10,37
10,2007,691400,43,35,8,33
11,2007,691400,45,41,4,24
12,2007,691400,27,25,2,25
1,2008,691400,34,29,5,34
2,2008,691400,21,15,6,20
3,2008,691400,50,44,6,9
4,2008,691400,54,43,11,15
5,2008,691400,47,41,6,24
6,2008,691400,48,38,10,25
7,2008,691400,51,42,9,23
8,2008,691400,53,41,12,27
9,2008,691400,51,40,11,14
10,2008,691400,50,37,13,12
11,2008,691400,37,30,7,26
12,2008,691400,31,26,5,19
1,2009,691400,36,33,3,22
2,2009,691400,26,23,3,21
3,2009,691400,31,24,7,23
4,2009,691400,39,30,9,26
5,2009,691400,38,31,7,16
6,2009,691400,33,27,6,10
7,2009,691400,41,35,6,18
8,2009,691400,52,40,12,13
9,2009,691400,46,39,7,18
10,2009,691400,30,24,6,14
11,2009,691400,28,22,6,14
12,2009,691400,39,34,5,16
1,2010,691400,37,30,7,19
2,2010,691400,29,20,9,18
3,2010,691400,39,33,6,13
4,2010,691400,25,19,6,22
5,2010,691400,33,26,7,11
6,2010,691400,34,30,4,15
7,2010,691400,26,24,2,16
8,2010,691400,33,23,10,14
9,2010,691400,39,34,5,11
10,2010,691400,48,43,5,22
11,2010,691400,28,23,5,11
12,2010,691400,32,31,1,10
1,2011,691400,28,26,2,18
2,2011,691400,26,24,2,8
1,1999,691500,24,21,3,4
2,1999,691500,11,11,0,5
3,1999,691500,27,19,8,7
4,1999,691500,17,13,4,3
5,1999,691500,22,13,9,1
6,1999,691500,17,13,4,10
7,1999,691500,25,21,4,7
8,1999,691500,28,19,9,9
9,1999,691500,25,20,5,5
10,1999,691500,16,13,3,5
11,1999,691500,10,8,2,4
12,1999,691500,15,10,5,3
1,2000,691500,27,21,6,5
2,2000,691500,20,18,2,7
3,2000,691500,29,19,10,4
4,2000,691500,18,16,2,30
5,2000,691500,29,26,3,7
6,2000,691500,20,18,2,6
7,2000,691500,30,24,6,3
8,2000,691500,40,28,12,17
9,2000,691500,34,29,5,9
10,2000,691500,18,17,1,5
11,2000,691500,25,20,5,7
12,2000,691500,30,25,5,5
1,2001,691500,24,19,5,12
2,2001,691500,18,15,3,5
3,2001,691500,29,25,4,1
4,2001,691500,23,20,3,7
5,2001,691500,28,26,2,9
6,2001,691500,20,14,6,13
7,2001,691500,36,28,8,1
8,2001,691500,26,21,5,4
9,2001,691500,29,26,3,7
10,2001,691500,27,21,6,9
11,2001,691500,24,18,6,14
12,2001,691500,23,20,3,12
1,2002,691500,25,21,4,5
2,2002,691500,16,14,2,6
3,2002,691500,22,13,9,17
4,2002,691500,24,19,5,4
5,2002,691500,40,35,5,7
6,2002,691500,16,12,4,5
7,2002,691500,35,28,7,9
8,2002,691500,26,20,6,8
9,2002,691500,33,26,7,9
10,2002,691500,32,26,6,14
11,2002,691500,26,23,3,9
12,2002,691500,19,16,3,13
1,2003,691500,20,17,3,26
2,2003,691500,22,17,5,10
3,2003,691500,31,24,7,19
4,2003,691500,22,18,4,9
5,2003,691500,17,16,1,20
6,2003,691500,18,15,3,4
7,2003,691500,31,25,6,12
8,2003,691500,30,26,4,7
9,2003,691500,16,14,2,10
10,2003,691500,32,15,17,28
11,2003,691500,15,14,1,4
12,2003,691500,21,18,3,12
1,2004,691500,19,15,4,11
2,2004,691500,23,20,3,12
3,2004,691500,26,21,5,19
4,2004,691500,31,24,7,3
5,2004,691500,27,22,5,11
6,2004,691500,26,18,8,16
7,2004,691500,32,29,3,13
8,2004,691500,32,24,8,7
9,2004,691500,21,17,4,23
10,2004,691500,16,14,2,45
11,2004,691500,21,18,3,17
12,2004,691500,12,10,2,25
1,2005,691500,22,14,8,9
2,2005,691500,15,12,3,14
3,2005,691500,26,20,6,9
4,2005,691500,18,15,3,9
5,2005,691500,27,20,7,19
6,2005,691500,26,21,5,6
7,2005,691500,35,27,8,7
8,2005,691500,32,21,11,9
9,2005,691500,20,15,5,5
10,2005,691500,29,23,6,16
11,2005,691500,34,29,5,14
12,2005,691500,27,22,5,21
1,2006,691500,25,20,5,17
2,2006,691500,16,10,6,17
3,2006,691500,20,16,4,7
4,2006,691500,43,34,9,6
5,2006,691500,36,32,4,25
6,2006,691500,21,13,8,17
7,2006,691500,35,31,4,18
8,2006,691500,22,18,4,17
9,2006,691500,28,23,5,28
10,2006,691500,38,36,2,18
11,2006,691500,28,23,5,14
12,2006,691500,20,11,9,29
1,2007,691500,19,14,5,31
2,2007,691500,15,12,3,32
3,2007,691500,14,12,2,20
4,2007,691500,43,30,13,40
5,2007,691500,34,22,12,23
6,2007,691500,34,24,10,31
7,2007,691500,29,22,7,43
8,2007,691500,30,25,5,2
9,2007,691500,25,18,7,24
10,2007,691500,37,31,6,34
11,2007,691500,37,25,12,8
12,2007,691500,26,18,8,19
1,2008,691500,16,15,1,22
2,2008,691500,21,19,2,9
3,2008,691500,34,24,10,8
4,2008,691500,37,29,8,16
5,2008,691500,34,26,8,16
6,2008,691500,25,20,5,14
7,2008,691500,34,27,7,23
8,2008,691500,47,36,11,23
9,2008,691500,33,29,4,18
10,2008,691500,50,46,4,19
11,2008,691500,26,23,3,17
12,2008,691500,23,18,5,7
1,2009,691500,19,18,1,12
2,2009,691500,25,19,6,8
3,2009,691500,23,17,6,18
4,2009,691500,25,19,6,19
5,2009,691500,29,18,11,5
6,2009,691500,30,26,4,9
7,2009,691500,29,20,9,6
8,2009,691500,32,24,8,9
9,2009,691500,18,14,4,13
10,2009,691500,40,33,7,8
11,2009,691500,27,25,2,19
12,2009,691500,21,16,5,9
1,2010,691500,26,20,6,14
2,2010,691500,16,16,0,13
3,2010,691500,25,20,5,10
4,2010,691500,27,21,6,28
5,2010,691500,31,27,4,7
6,2010,691500,31,26,5,12
7,2010,691500,28,22,6,9
8,2010,691500,14,11,3,7
9,2010,691500,27,23,4,16
10,2010,691500,13,9,4,17
11,2010,691500,22,18,4,9
12,2010,691500,17,11,6,13
1,2011,691500,20,18,2,8
2,2011,691500,12,9,3,11
1,1999,431200,15,14,1,0
2,1999,431200,13,10,3,3
3,1999,431200,18,12,6,1
4,1999,431200,11,9,2,4
5,1999,431200,14,12,2,0
6,1999,431200,17,13,4,0
7,1999,431200,23,17,6,3
8,1999,431200,35,30,5,4
9,1999,431200,9,8,1,1
10,1999,431200,18,12,6,3
11,1999,431200,20,19,1,4
12,1999,431200,18,17,1,1
1,2000,431200,8,7,1,1
2,2000,431200,14,9,5,1
3,2000,431200,19,15,4,4
4,2000,431200,16,16,0,1
5,2000,431200,18,16,2,0
6,2000,431200,11,11,0,3
7,2000,431200,13,12,1,3
8,2000,431200,22,18,4,2
9,2000,431200,20,18,2,3
10,2000,431200,20,16,4,1
11,2000,431200,9,8,1,4
12,2000,431200,13,13,0,1
1,2001,431200,14,12,2,4
2,2001,431200,9,7,2,1
3,2001,431200,10,9,1,0
4,2001,431200,18,16,2,0
5,2001,431200,21,18,3,5
6,2001,431200,16,16,0,2
7,2001,431200,19,18,1,1
8,2001,431200,14,11,3,4
9,2001,431200,13,13,0,1
10,2001,431200,25,22,3,2
11,2001,431200,22,18,4,1
12,2001,431200,25,23,2,1
1,2002,431200,11,9,2,3
2,2002,431200,13,13,0,3
3,2002,431200,14,14,0,3
4,2002,431200,11,10,1,8
5,2002,431200,19,15,4,6
6,2002,431200,21,18,3,3
7,2002,431200,32,30,2,2
8,2002,431200,27,22,5,4
9,2002,431200,22,18,4,2
10,2002,431200,33,25,8,1
11,2002,431200,18,16,2,4
12,2002,431200,18,14,4,5
1,2003,431200,11,10,1,4
2,2003,431200,14,11,3,2
3,2003,431200,17,14,3,4
4,2003,431200,22,19,3,4
5,2003,431200,29,24,5,1
6,2003,431200,24,18,6,1
7,2003,431200,30,28,2,8
8,2003,431200,18,15,3,0
9,2003,431200,27,23,4,5
10,2003,431200,27,21,6,2
11,2003,431200,13,12,1,5
12,2003,431200,23,20,3,0
1,2004,431200,14,12,2,1
2,2004,431200,16,13,3,5
3,2004,431200,13,10,3,1
4,2004,431200,16,15,1,2
5,2004,431200,14,12,2,4
6,2004,431200,21,17,4,6
7,2004,431200,22,18,4,6
8,2004,431200,15,13,2,2
9,2004,431200,18,17,1,4
10,2004,431200,17,15,2,2
11,2004,431200,10,8,2,1
12,2004,431200,9,9,0,10
1,2005,431200,12,10,2,2
2,2005,431200,11,9,2,2
3,2005,431200,12,10,2,2
4,2005,431200,14,13,1,4
5,2005,431200,20,18,2,5
6,2005,431200,18,17,1,2
7,2005,431200,12,11,1,2
8,2005,431200,14,12,2,2
9,2005,431200,16,16,0,4
10,2005,431200,17,16,1,3
11,2005,431200,13,11,2,3
12,2005,431200,18,17,1,4
1,2006,431200,14,11,3,5
2,2006,431200,10,9,1,1
3,2006,431200,13,9,4,5
4,2006,431200,16,13,3,1
5,2006,431200,16,13,3,3
6,2006,431200,14,11,3,5
7,2006,431200,23,17,6,4
8,2006,431200,11,7,4,1
9,2006,431200,14,13,1,4
10,2006,431200,18,16,2,4
11,2006,431200,8,7,1,3
12,2006,431200,19,16,3,1
1,2007,431200,13,11,2,5
2,2007,431200,9,9,0,1
3,2007,431200,13,10,3,2
4,2007,431200,12,10,2,2
5,2007,431200,27,23,4,2
6,2007,431200,14,10,4,1
7,2007,431200,11,10,1,1
8,2007,431200,7,6,1,8
9,2007,431200,13,12,1,1
10,2007,431200,33,30,3,2
11,2007,431200,17,14,3,6
12,2007,431200,26,22,4,0
1,2008,431200,16,13,3,2
2,2008,431200,17,14,3,2
3,2008,431200,22,20,2,1
4,2008,431200,31,30,1,1
5,2008,431200,17,14,3,1
6,2008,431200,22,20,2,7
7,2008,431200,27,26,1,11
8,2008,431200,15,15,0,9
9,2008,431200,15,13,2,7
10,2008,431200,23,21,2,4
11,2008,431200,18,16,2,8
12,2008,431200,17,17,0,2
1,2009,431200,12,12,0,14
2,2009,431200,7,5,2,4
3,2009,431200,15,13,2,3
4,2009,431200,10,7,3,3
5,2009,431200,11,10,1,6
6,2009,431200,21,19,2,2
7,2009,431200,19,17,2,14
8,2009,431200,19,17,2,6
9,2009,431200,16,14,2,6
10,2009,431200,21,19,2,10
11,2009,431200,16,13,3,5
12,2009,431200,12,10,2,8
1,2010,431200,21,17,4,5
2,2010,431200,9,8,1,4
3,2010,431200,17,13,4,4
4,2010,431200,22,17,5,3
5,2010,431200,18,15,3,9
6,2010,431200,15,14,1,8
7,2010,431200,8,8,0,3
8,2010,431200,28,27,1,4
9,2010,431200,21,19,2,1
10,2010,431200,9,6,3,5
11,2010,431200,20,17,3,3
12,2010,431200,16,15,1,6
1,2011,431200,15,13,2,7
2,2011,431200,6,6,0,3
1,1999,431301,34,27,7,6
2,1999,431301,38,28,10,12
3,1999,431301,42,33,9,18
4,1999,431301,35,27,8,13
5,1999,431301,41,30,11,8
6,1999,431301,51,44,7,12
7,1999,431301,48,38,10,11
8,1999,431301,48,39,9,31
9,1999,431301,42,34,8,13
10,1999,431301,39,30,9,4
11,1999,431301,44,37,7,18
12,1999,431301,29,19,10,15
1,2000,431301,40,36,4,16
2,2000,431301,39,29,10,14
3,2000,431301,45,39,6,26
4,2000,431301,43,32,11,8
5,2000,431301,55,45,10,15
6,2000,431301,48,28,20,17
7,2000,431301,48,42,6,30
8,2000,431301,53,45,8,13
9,2000,431301,51,34,17,12
10,2000,431301,66,50,16,17
11,2000,431301,37,29,8,14
12,2000,431301,29,23,6,11
1,2001,431301,44,38,6,12
2,2001,431301,31,29,2,17
3,2001,431301,43,33,10,17
4,2001,431301,37,31,6,9
5,2001,431301,47,37,10,18
6,2001,431301,49,37,12,14
7,2001,431301,46,32,14,38
8,2001,431301,50,39,11,14
9,2001,431301,40,32,8,16
10,2001,431301,48,35,13,15
11,2001,431301,37,28,9,17
12,2001,431301,33,27,6,23
1,2002,431301,50,41,9,13
2,2002,431301,30,24,6,23
3,2002,431301,34,31,3,27
4,2002,431301,39,31,8,16
5,2002,431301,47,42,5,31
6,2002,431301,52,41,11,19
7,2002,431301,65,48,17,20
8,2002,431301,46,39,7,15
9,2002,431301,52,41,11,19
10,2002,431301,47,35,12,14
11,2002,431301,37,29,8,17
12,2002,431301,52,48,4,20
1,2003,431301,49,44,5,20
2,2003,431301,39,38,1,16
3,2003,431301,40,34,6,17
4,2003,431301,40,36,4,18
5,2003,431301,50,40,10,17
6,2003,431301,43,32,11,29
7,2003,431301,66,52,14,21
8,2003,431301,62,52,10,24
9,2003,431301,46,39,7,15
10,2003,431301,43,35,8,28
11,2003,431301,50,42,8,29
12,2003,431301,46,39,7,29
1,2004,431301,44,38,6,19
2,2004,431301,56,46,10,10
3,2004,431301,50,46,4,22
4,2004,431301,55,52,3,29
5,2004,431301,54,48,6,20
6,2004,431301,51,40,11,14
7,2004,431301,59,46,13,55
8,2004,431301,44,32,12,33
9,2004,431301,32,28,4,21
10,2004,431301,27,21,6,27
11,2004,431301,38,31,7,37
12,2004,431301,30,23,7,13
1,2005,431301,39,31,8,34
2,2005,431301,31,29,2,27
3,2005,431301,34,26,8,25
4,2005,431301,39,32,7,22
5,2005,431301,39,34,5,19
6,2005,431301,42,31,11,31
7,2005,431301,40,29,11,20
8,2005,431301,37,32,5,19
9,2005,431301,31,26,5,21
10,2005,431301,44,40,4,21
11,2005,431301,33,29,4,61
12,2005,431301,48,43,5,24
1,2006,431301,31,25,6,40
2,2006,431301,32,28,4,38
3,2006,431301,36,29,7,34
4,2006,431301,40,34,6,32
5,2006,431301,35,31,4,44
6,2006,431301,40,35,5,38
7,2006,431301,51,36,15,38
8,2006,431301,55,51,4,47
9,2006,431301,40,36,4,23
10,2006,431301,32,28,4,19
11,2006,431301,36,31,5,17
12,2006,431301,39,35,4,22
1,2007,431301,37,35,2,19
2,2007,431301,22,18,4,30
3,2007,431301,29,19,10,29
4,2007,431301,35,30,5,18
5,2007,431301,39,28,11,23
6,2007,431301,35,32,3,17
7,2007,431301,47,38,9,13
8,2007,431301,71,58,13,24
9,2007,431301,49,40,9,23
10,2007,431301,49,44,5,34
11,2007,431301,50,35,15,32
12,2007,431301,38,29,9,15
1,2008,431301,38,31,7,21
2,2008,431301,43,38,5,19
3,2008,431301,45,37,8,18
4,2008,431301,25,14,11,18
5,2008,431301,42,26,16,33
6,2008,431301,49,35,14,40
7,2008,431301,41,30,11,52
8,2008,431301,38,30,8,16
9,2008,431301,33,26,7,14
10,2008,431301,34,23,11,22
11,2008,431301,39,28,11,21
12,2008,431301,29,23,6,26
1,2009,431301,28,19,9,19
2,2009,431301,27,20,7,25
3,2009,431301,18,12,6,28
4,2009,431301,29,22,7,14
5,2009,431301,30,24,6,22
6,2009,431301,35,26,9,23
7,2009,431301,39,34,5,20
8,2009,431301,45,36,9,47
9,2009,431301,40,35,5,34
10,2009,431301,47,37,10,21
11,2009,431301,32,29,3,25
12,2009,431301,27,19,8,30
1,2010,431301,27,19,8,12
2,2010,431301,27,22,5,24
3,2010,431301,26,21,5,32
4,2010,431301,45,40,5,7
5,2010,431301,26,22,4,12
6,2010,431301,35,27,8,11
7,2010,431301,38,29,9,14
8,2010,431301,69,56,13,12
9,2010,431301,38,34,4,20
10,2010,431301,47,37,10,19
11,2010,431301,43,37,6,18
12,2010,431301,41,32,9,13
1,2011,431301,45,36,9,28
2,2011,431301,16,13,3,6
1,1999,431400,34,30,4,7
2,1999,431400,30,24,6,13
3,1999,431400,44,33,11,12
4,1999,431400,38,31,7,11
5,1999,431400,42,33,9,6
6,1999,431400,53,45,8,15
7,1999,431400,73,64,9,10
8,1999,431400,60,50,10,20
9,1999,431400,47,37,10,10
10,1999,431400,56,39,17,13
11,1999,431400,43,33,10,17
12,1999,431400,46,40,6,15
1,2000,431400,24,21,3,15
2,2000,431400,26,18,8,13
3,2000,431400,22,17,5,16
4,2000,431400,35,24,11,7
5,2000,431400,55,43,12,13
6,2000,431400,60,49,11,3
7,2000,431400,55,42,13,6
8,2000,431400,50,39,11,11
9,2000,431400,52,47,5,14
10,2000,431400,54,44,10,12
11,2000,431400,32,23,9,7
12,2000,431400,42,32,10,3
1,2001,431400,40,33,7,2
2,2001,431400,35,29,6,5
3,2001,431400,48,44,4,9
4,2001,431400,54,49,5,7
5,2001,431400,47,42,5,11
6,2001,431400,37,32,5,14
7,2001,431400,50,40,10,6
8,2001,431400,43,37,6,9
9,2001,431400,39,37,2,6
10,2001,431400,33,27,6,4
11,2001,431400,34,23,11,4
12,2001,431400,39,31,8,2
1,2002,431400,37,34,3,4
2,2002,431400,22,17,5,10
3,2002,431400,40,26,14,10
4,2002,431400,40,35,5,3
5,2002,431400,39,29,10,4
6,2002,431400,41,32,9,10
7,2002,431400,44,32,12,6
8,2002,431400,39,32,7,14
9,2002,431400,42,37,5,3
10,2002,431400,53,45,8,2
11,2002,431400,34,30,4,3
12,2002,431400,44,40,4,5
1,2003,431400,37,32,5,4
2,2003,431400,25,21,4,8
3,2003,431400,41,34,7,5
4,2003,431400,41,36,5,7
5,2003,431400,40,33,7,11
6,2003,431400,39,32,7,15
7,2003,431400,56,43,13,3
8,2003,431400,41,30,11,5
9,2003,431400,42,37,5,3
10,2003,431400,29,28,1,10
11,2003,431400,30,27,3,2
12,2003,431400,38,30,8,3
1,2004,431400,39,31,8,16
2,2004,431400,42,35,7,2
3,2004,431400,27,22,5,10
4,2004,431400,39,35,4,9
5,2004,431400,58,50,8,6
6,2004,431400,28,21,7,8
7,2004,431400,46,36,10,17
8,2004,431400,39,36,3,5
9,2004,431400,34,27,7,6
10,2004,431400,18,12,6,7
11,2004,431400,26,22,4,12
12,2004,431400,22,16,6,9
1,2005,431400,33,28,5,11
2,2005,431400,27,18,9,6
3,2005,431400,29,23,6,8
4,2005,431400,32,26,6,6
5,2005,431400,33,31,2,3
6,2005,431400,36,31,5,14
7,2005,431400,45,40,5,6
8,2005,431400,51,42,9,9
9,2005,431400,29,24,5,9
10,2005,431400,44,38,6,6
11,2005,431400,39,32,7,8
12,2005,431400,39,37,2,10
1,2006,431400,29,29,0,7
2,2006,431400,33,31,2,10
3,2006,431400,46,40,6,6
4,2006,431400,58,52,6,7
5,2006,431400,66,60,6,11
6,2006,431400,51,44,7,9
7,2006,431400,67,55,12,17
8,2006,431400,73,62,11,29
9,2006,431400,55,49,6,13
10,2006,431400,39,36,3,4
11,2006,431400,23,16,7,20
12,2006,431400,40,33,7,10
1,2007,431400,28,21,7,12
2,2007,431400,22,19,3,7
3,2007,431400,33,29,4,5
4,2007,431400,37,31,6,5
5,2007,431400,30,24,6,11
6,2007,431400,47,40,7,14
7,2007,431400,38,34,4,8
8,2007,431400,38,32,6,8
9,2007,431400,25,21,4,5
10,2007,431400,35,29,6,14
11,2007,431400,42,33,9,10
12,2007,431400,34,29,5,5
1,2008,431400,39,35,4,7
2,2008,431400,30,23,7,11
3,2008,431400,35,28,7,3
4,2008,431400,36,24,12,1
5,2008,431400,36,25,11,5
6,2008,431400,44,30,14,18
7,2008,431400,57,45,12,19
8,2008,431400,51,46,5,13
9,2008,431400,31,26,5,4
10,2008,431400,39,31,8,11
11,2008,431400,31,28,3,10
12,2008,431400,19,16,3,17
1,2009,431400,23,19,4,6
2,2009,431400,24,22,2,7
3,2009,431400,31,25,6,17
4,2009,431400,35,28,7,3
5,2009,431400,38,30,8,8
6,2009,431400,27,25,2,4
7,2009,431400,38,29,9,13
8,2009,431400,30,28,2,15
9,2009,431400,26,19,7,12
10,2009,431400,44,39,5,9
11,2009,431400,25,21,4,12
12,2009,431400,30,24,6,7
1,2010,431400,32,25,7,7
2,2010,431400,24,20,4,4
3,2010,431400,31,26,5,5
4,2010,431400,25,22,3,3
5,2010,431400,37,28,9,8
6,2010,431400,22,14,8,3
7,2010,431400,38,30,8,5
8,2010,431400,40,33,7,3
9,2010,431400,40,31,9,8
10,2010,431400,34,29,5,8
11,2010,431400,40,38,2,10
12,2010,431400,27,17,10,12
1,2011,431400,43,37,6,7
2,2011,431400,20,20,0,4
1,1999,710100,9,7,2,2
2,1999,710100,10,6,4,1
3,1999,710100,9,6,3,1
4,1999,710100,4,2,2,1
5,1999,710100,18,10,8,0
6,1999,710100,10,8,2,1
7,1999,710100,15,11,4,0
8,1999,710100,14,9,5,1
9,1999,710100,8,6,2,2
10,1999,710100,13,10,3,0
11,1999,710100,10,9,1,1
12,1999,710100,7,5,2,3
1,2000,710100,9,5,4,0
2,2000,710100,10,5,5,0
3,2000,710100,13,9,4,2
4,2000,710100,8,8,0,4
5,2000,710100,11,6,5,1
6,2000,710100,15,11,4,4
7,2000,710100,9,7,2,2
8,2000,710100,9,7,2,4
9,2000,710100,16,15,1,1
10,2000,710100,10,7,3,3
11,2000,710100,14,11,3,4
12,2000,710100,11,9,2,2
1,2001,710100,7,6,1,4
2,2001,710100,7,6,1,2
3,2001,710100,10,9,1,3
4,2001,710100,10,6,4,1
5,2001,710100,13,8,5,1
6,2001,710100,7,4,3,2
7,2001,710100,10,6,4,2
8,2001,710100,10,7,3,3
9,2001,710100,13,11,2,2
10,2001,710100,6,5,1,4
11,2001,710100,5,4,1,2
12,2001,710100,7,6,1,3
1,2002,710100,8,8,0,2
2,2002,710100,7,7,0,16
3,2002,710100,10,8,2,8
4,2002,710100,7,5,2,3
5,2002,710100,12,9,3,8
6,2002,710100,6,2,4,4
7,2002,710100,11,10,1,5
8,2002,710100,13,7,6,2
9,2002,710100,9,5,4,3
10,2002,710100,11,8,3,5
11,2002,710100,10,8,2,2
12,2002,710100,4,3,1,2
1,2003,710100,11,8,3,0
2,2003,710100,3,2,1,8
3,2003,710100,6,4,2,2
4,2003,710100,7,5,2,3
5,2003,710100,9,9,0,2
6,2003,710100,10,8,2,8
7,2003,710100,14,8,6,0
8,2003,710100,10,8,2,2
9,2003,710100,4,3,1,1
10,2003,710100,10,9,1,4
11,2003,710100,5,4,1,1
12,2003,710100,8,6,2,3
1,2004,710100,14,10,4,1
2,2004,710100,10,5,5,6
3,2004,710100,10,7,3,0
4,2004,710100,6,5,1,4
5,2004,710100,13,6,7,2
6,2004,710100,15,11,4,8
7,2004,710100,10,8,2,5
8,2004,710100,12,10,2,6
9,2004,710100,11,8,3,6
10,2004,710100,12,9,3,12
11,2004,710100,8,8,0,5
12,2004,710100,9,8,1,1
1,2005,710100,10,7,3,3
2,2005,710100,3,3,0,6
3,2005,710100,6,4,2,4
4,2005,710100,8,5,3,8
5,2005,710100,10,6,4,4
6,2005,710100,10,8,2,7
7,2005,710100,18,13,5,3
8,2005,710100,17,9,8,7
9,2005,710100,12,7,5,5
10,2005,710100,9,8,1,4
11,2005,710100,6,4,2,1
12,2005,710100,4,4,0,4
1,2006,710100,6,5,1,5
2,2006,710100,5,5,0,6
3,2006,710100,5,4,1,6
4,2006,710100,17,14,3,9
5,2006,710100,11,9,2,12
6,2006,710100,9,5,4,7
7,2006,710100,10,8,2,8
8,2006,710100,8,5,3,8
9,2006,710100,5,4,1,10
10,2006,710100,10,9,1,15
11,2006,710100,6,5,1,0
12,2006,710100,6,6,0,3
1,2007,710100,4,2,2,2
2,2007,710100,4,1,3,4
3,2007,710100,2,2,0,8
4,2007,710100,6,5,1,4
5,2007,710100,19,17,2,0
6,2007,710100,15,10,5,9
7,2007,710100,17,12,5,9
8,2007,710100,7,6,1,12
9,2007,710100,16,13,3,8
10,2007,710100,14,13,1,4
11,2007,710100,12,10,2,10
12,2007,710100,16,9,7,6
1,2008,710100,11,10,1,7
2,2008,710100,9,7,2,9
3,2008,710100,15,14,1,7
4,2008,710100,9,9,0,3
5,2008,710100,20,15,5,7
6,2008,710100,13,11,2,3
7,2008,710100,15,13,2,8
8,2008,710100,16,10,6,7
9,2008,710100,15,9,6,5
10,2008,710100,19,18,1,4
11,2008,710100,6,4,2,3
12,2008,710100,11,11,0,1
1,2009,710100,5,4,1,2
2,2009,710100,11,11,0,5
3,2009,710100,8,5,3,3
4,2009,710100,7,7,0,3
5,2009,710100,16,14,2,1
6,2009,710100,13,12,1,3
7,2009,710100,11,5,6,4
8,2009,710100,5,5,0,2
9,2009,710100,10,8,2,3
10,2009,710100,5,4,1,4
11,2009,710100,10,10,0,5
12,2009,710100,14,13,1,2
1,2010,710100,11,7,4,1
2,2010,710100,3,3,0,4
3,2010,710100,7,7,0,6
4,2010,710100,5,5,0,4
5,2010,710100,14,11,3,3
6,2010,710100,8,8,0,4
7,2010,710100,7,5,2,4
8,2010,710100,18,17,1,4
9,2010,710100,10,9,1,2
10,2010,710100,12,9,3,1
11,2010,710100,3,3,0,2
12,2010,710100,4,4,0,2
1,2011,710100,2,2,0,2
2,2011,710100,4,3,1,6
1,1999,691300,18,17,1,0
2,1999,691300,12,9,3,0
3,1999,691300,27,24,3,1
4,1999,691300,19,18,1,1
5,1999,691300,21,20,1,2
6,1999,691300,22,20,2,1
7,1999,691300,25,21,4,1
8,1999,691300,22,15,7,0
9,1999,691300,33,29,4,1
10,1999,691300,27,22,5,2
11,1999,691300,20,19,1,2
12,1999,691300,25,20,5,4
1,2000,691300,16,15,1,0
2,2000,691300,13,11,2,2
3,2000,691300,17,14,3,2
4,2000,691300,26,19,7,2
5,2000,691300,17,16,1,5
6,2000,691300,25,20,5,0
7,2000,691300,21,20,1,0
8,2000,691300,27,24,3,5
9,2000,691300,23,22,1,2
10,2000,691300,26,25,1,3
11,2000,691300,19,18,1,1
12,2000,691300,13,11,2,1
1,2001,691300,24,22,2,0
2,2001,691300,17,17,0,4
3,2001,691300,20,19,1,1
4,2001,691300,16,14,2,1
5,2001,691300,14,13,1,0
6,2001,691300,18,17,1,1
7,2001,691300,24,21,3,0
8,2001,691300,21,20,1,1
9,2001,691300,31,26,5,1
10,2001,691300,20,17,3,0
11,2001,691300,17,16,1,2
12,2001,691300,14,11,3,1
1,2002,691300,24,21,3,0
2,2002,691300,14,12,2,2
3,2002,691300,16,14,2,1
4,2002,691300,17,12,5,3
5,2002,691300,21,19,2,1
6,2002,691300,21,17,4,0
7,2002,691300,36,32,4,0
8,2002,691300,32,27,5,2
9,2002,691300,25,23,2,6
10,2002,691300,16,14,2,2
11,2002,691300,20,17,3,1
12,2002,691300,19,18,1,1
1,2003,691300,14,14,0,4
2,2003,691300,22,18,4,2
3,2003,691300,18,15,3,2
4,2003,691300,24,23,1,0
5,2003,691300,24,22,2,1
6,2003,691300,18,14,4,3
7,2003,691300,27,23,4,1
8,2003,691300,23,21,2,1
9,2003,691300,19,16,3,1
10,2003,691300,22,21,1,4
11,2003,691300,19,15,4,4
12,2003,691300,7,7,0,4
1,2004,691300,17,14,3,5
2,2004,691300,15,15,0,2
3,2004,691300,21,20,1,1
4,2004,691300,21,18,3,5
5,2004,691300,15,14,1,1
6,2004,691300,27,24,3,2
7,2004,691300,26,24,2,7
8,2004,691300,24,24,0,3
9,2004,691300,16,13,3,3
10,2004,691300,21,20,1,3
11,2004,691300,30,26,4,3
12,2004,691300,11,11,0,1
1,2005,691300,19,18,1,0
2,2005,691300,12,12,0,4
3,2005,691300,20,16,4,1
4,2005,691300,18,13,5,3
5,2005,691300,5,5,0,12
6,2005,691300,19,13,6,2
7,2005,691300,16,13,3,2
8,2005,691300,20,16,4,1
9,2005,691300,15,15,0,2
10,2005,691300,29,26,3,2
11,2005,691300,26,24,2,4
12,2005,691300,15,13,2,3
1,2006,691300,21,17,4,1
2,2006,691300,14,12,2,0
3,2006,691300,16,15,1,4
4,2006,691300,19,18,1,4
5,2006,691300,26,24,2,3
6,2006,691300,14,12,2,3
7,2006,691300,24,23,1,5
8,2006,691300,19,15,4,3
9,2006,691300,18,16,2,4
10,2006,691300,29,26,3,2
11,2006,691300,11,11,0,6
12,2006,691300,22,21,1,5
1,2007,691300,29,22,7,8
2,2007,691300,13,11,2,9
3,2007,691300,13,12,1,2
4,2007,691300,21,17,4,11
5,2007,691300,20,17,3,5
6,2007,691300,32,26,6,14
7,2007,691300,16,15,1,13
8,2007,691300,16,13,3,5
9,2007,691300,16,14,2,6
10,2007,691300,17,14,3,5
11,2007,691300,22,18,4,6
12,2007,691300,23,19,4,8
1,2008,691300,15,14,1,9
2,2008,691300,13,11,2,6
3,2008,691300,14,10,4,4
4,2008,691300,15,13,2,3
5,2008,691300,23,22,1,7
6,2008,691300,10,9,1,4
7,2008,691300,17,15,2,4
8,2008,691300,24,22,2,12
9,2008,691300,18,16,2,6
10,2008,691300,11,10,1,9
11,2008,691300,24,20,4,10
12,2008,691300,5,4,1,2
1,2009,691300,18,18,0,5
2,2009,691300,14,12,2,3
3,2009,691300,9,5,4,6
4,2009,691300,25,24,1,4
5,2009,691300,18,12,6,1
6,2009,691300,21,19,2,5
7,2009,691300,16,14,2,3
8,2009,691300,24,23,1,3
9,2009,691300,24,20,4,5
10,2009,691300,19,17,2,3
11,2009,691300,24,21,3,5
12,2009,691300,11,11,0,4
1,2010,691300,11,7,4,1
2,2010,691300,6,5,1,8
3,2010,691300,13,13,0,1
4,2010,691300,18,13,5,1
5,2010,691300,26,24,2,5
6,2010,691300,12,9,3,2
7,2010,691300,16,14,2,3
8,2010,691300,20,17,3,4
9,2010,691300,18,17,1,8
10,2010,691300,25,21,4,2
11,2010,691300,14,14,0,5
12,2010,691300,12,11,1,1
1,2011,691300,12,10,2,6
2,2011,691300,6,6,0,6
1,1999,834200,30,30,0,3
2,1999,834200,24,19,5,2
3,1999,834200,27,18,9,5
4,1999,834200,32,30,2,1
5,1999,834200,30,19,11,4
6,1999,834200,23,19,4,5
7,1999,834200,43,38,5,8
8,1999,834200,47,36,11,5
9,1999,834200,47,40,7,7
10,1999,834200,45,39,6,8
11,1999,834200,31,26,5,4
12,1999,834200,25,22,3,4
1,2000,834200,27,22,5,5
2,2000,834200,21,20,1,12
3,2000,834200,22,16,6,4
4,2000,834200,18,14,4,4
5,2000,834200,23,22,1,6
6,2000,834200,22,19,3,11
7,2000,834200,23,19,4,4
8,2000,834200,44,37,7,9
9,2000,834200,29,25,4,7
10,2000,834200,33,30,3,5
11,2000,834200,21,17,4,17
12,2000,834200,33,25,8,4
1,2001,834200,35,30,5,11
2,2001,834200,28,19,9,9
3,2001,834200,37,31,6,9
4,2001,834200,27,22,5,10
5,2001,834200,48,43,5,17
6,2001,834200,47,36,11,6
7,2001,834200,33,24,9,6
8,2001,834200,44,38,6,6
9,2001,834200,32,24,8,15
10,2001,834200,28,23,5,6
11,2001,834200,36,33,3,10
12,2001,834200,33,25,8,8
1,2002,834200,30,23,7,8
2,2002,834200,33,29,4,6
3,2002,834200,30,24,6,14
4,2002,834200,34,29,5,15
5,2002,834200,38,30,8,20
6,2002,834200,19,14,5,9
7,2002,834200,36,30,6,9
8,2002,834200,29,21,8,15
9,2002,834200,33,27,6,6
10,2002,834200,49,42,7,8
11,2002,834200,40,37,3,15
12,2002,834200,41,31,10,10
1,2003,834200,35,26,9,19
2,2003,834200,35,32,3,10
3,2003,834200,38,33,5,12
4,2003,834200,42,31,11,8
5,2003,834200,43,32,11,9
6,2003,834200,47,39,8,8
7,2003,834200,35,33,2,15
8,2003,834200,41,36,5,11
9,2003,834200,41,30,11,16
10,2003,834200,30,21,9,19
11,2003,834200,36,29,7,11
12,2003,834200,31,30,1,6
1,2004,834200,41,33,8,19
2,2004,834200,37,30,7,11
3,2004,834200,40,32,8,7
4,2004,834200,38,34,4,8
5,2004,834200,40,31,9,11
6,2004,834200,38,32,6,11
7,2004,834200,57,48,9,12
8,2004,834200,31,25,6,5
9,2004,834200,44,38,6,11
10,2004,834200,51,46,5,4
11,2004,834200,36,31,5,13
12,2004,834200,32,27,5,6
1,2005,834200,24,17,7,9
2,2005,834200,31,28,3,17
3,2005,834200,33,31,2,10
4,2005,834200,39,32,7,24
5,2005,834200,38,32,6,16
6,2005,834200,46,40,6,6
7,2005,834200,49,42,7,14
8,2005,834200,29,26,3,7
9,2005,834200,34,31,3,15
10,2005,834200,44,36,8,15
11,2005,834200,28,23,5,6
12,2005,834200,31,28,3,6
1,2006,834200,40,37,3,17
2,2006,834200,27,22,5,11
3,2006,834200,59,55,4,15
4,2006,834200,39,35,4,2
5,2006,834200,31,28,3,20
6,2006,834200,51,46,5,18
7,2006,834200,55,48,7,23
8,2006,834200,36,33,3,11
9,2006,834200,43,37,6,12
10,2006,834200,43,38,5,12
11,2006,834200,47,37,10,9
12,2006,834200,33,30,3,11
1,2007,834200,26,25,1,5
2,2007,834200,26,23,3,17
3,2007,834200,38,31,7,17
4,2007,834200,32,27,5,5
5,2007,834200,43,36,7,6
6,2007,834200,30,25,5,8
7,2007,834200,35,26,9,13
8,2007,834200,28,21,7,10
9,2007,834200,42,36,6,15
10,2007,834200,40,34,6,14
11,2007,834200,31,26,5,27
12,2007,834200,29,24,5,18
1,2008,834200,33,30,3,10
2,2008,834200,36,35,1,17
3,2008,834200,44,38,6,17
4,2008,834200,31,28,3,7
5,2008,834200,39,36,3,9
6,2008,834200,36,31,5,7
7,2008,834200,47,39,8,9
8,2008,834200,36,29,7,11
9,2008,834200,40,35,5,15
10,2008,834200,56,50,6,12
11,2008,834200,38,32,6,9
12,2008,834200,23,17,6,8
1,2009,834200,21,18,3,10
2,2009,834200,26,21,5,8
3,2009,834200,34,29,5,19
4,2009,834200,18,15,3,9
5,2009,834200,24,21,3,16
6,2009,834200,40,31,9,10
7,2009,834200,25,21,4,10
8,2009,834200,33,26,7,12
9,2009,834200,23,18,5,13
10,2009,834200,19,19,0,15
11,2009,834200,33,29,4,7
12,2009,834200,21,19,2,11
1,2010,834200,21,18,3,18
2,2010,834200,19,16,3,14
3,2010,834200,20,17,3,14
4,2010,834200,25,23,2,9
5,2010,834200,38,33,5,16
6,2010,834200,26,21,5,16
7,2010,834200,41,35,6,16
8,2010,834200,54,49,5,12
9,2010,834200,35,29,6,10
10,2010,834200,46,40,6,7
11,2010,834200,29,23,6,6
12,2010,834200,33,31,2,9
1,2011,834200,23,23,0,12
2,2011,834200,11,10,1,7
1,1999,650500,20,20,0,0
2,1999,650500,19,18,1,1
3,1999,650500,41,40,1,0
4,1999,650500,45,43,2,0
5,1999,650500,25,23,2,0
6,1999,650500,38,37,1,0
7,1999,650500,23,23,0,1
8,1999,650500,34,34,0,0
9,1999,650500,25,24,1,0
10,1999,650500,31,30,1,1
11,1999,650500,28,28,0,0
12,1999,650500,32,31,1,0
1,2000,650500,17,17,0,0
2,2000,650500,30,30,0,0
3,2000,650500,33,32,1,1
4,2000,650500,23,23,0,0
5,2000,650500,40,38,2,0
6,2000,650500,29,28,1,0
7,2000,650500,35,34,1,0
8,2000,650500,38,36,2,0
9,2000,650500,39,37,2,3
10,2000,650500,29,28,1,0
11,2000,650500,44,43,1,0
12,2000,650500,36,36,0,1
1,2001,650500,24,24,0,4
2,2001,650500,24,24,0,1
3,2001,650500,32,31,1,1
4,2001,650500,23,22,1,1
5,2001,650500,28,28,0,0
6,2001,650500,22,21,1,1
7,2001,650500,25,23,2,0
8,2001,650500,33,30,3,1
9,2001,650500,41,40,1,0
10,2001,650500,46,46,0,2
11,2001,650500,32,31,1,1
12,2001,650500,49,48,1,0
1,2002,650500,32,32,0,0
2,2002,650500,17,17,0,0
3,2002,650500,29,29,0,0
4,2002,650500,36,35,1,0
5,2002,650500,28,27,1,1
6,2002,650500,29,29,0,0
7,2002,650500,22,22,0,1
8,2002,650500,30,30,0,0
9,2002,650500,23,23,0,0
10,2002,650500,46,42,4,0
11,2002,650500,40,39,1,0
12,2002,650500,29,29,0,1
1,2003,650500,42,42,0,0
2,2003,650500,22,20,2,0
3,2003,650500,29,29,0,0
4,2003,650500,24,24,0,0
5,2003,650500,30,29,1,0
6,2003,650500,25,24,1,0
7,2003,650500,24,21,3,1
8,2003,650500,23,21,2,1
9,2003,650500,19,19,0,0
10,2003,650500,36,35,1,1
11,2003,650500,19,19,0,0
12,2003,650500,24,23,1,0
1,2004,650500,23,23,0,0
2,2004,650500,16,16,0,1
3,2004,650500,15,15,0,0
4,2004,650500,25,23,2,0
5,2004,650500,17,13,4,0
6,2004,650500,13,13,0,2
7,2004,650500,20,20,0,0
8,2004,650500,15,15,0,0
9,2004,650500,11,10,1,1
10,2004,650500,23,22,1,2
11,2004,650500,18,18,0,1
12,2004,650500,9,9,0,0
1,2005,650500,16,16,0,0
2,2005,650500,14,14,0,1
3,2005,650500,23,22,1,0
4,2005,650500,18,17,1,1
5,2005,650500,13,13,0,0
6,2005,650500,16,14,2,0
7,2005,650500,18,16,2,1
8,2005,650500,13,11,2,0
9,2005,650500,12,11,1,2
10,2005,650500,19,18,1,1
11,2005,650500,16,16,0,1
12,2005,650500,16,14,2,2
1,2006,650500,19,18,1,0
2,2006,650500,15,15,0,0
3,2006,650500,20,19,1,0
4,2006,650500,19,19,0,0
5,2006,650500,22,22,0,0
6,2006,650500,22,21,1,1
7,2006,650500,27,26,1,0
8,2006,650500,19,19,0,0
9,2006,650500,18,18,0,0
10,2006,650500,24,23,1,0
11,2006,650500,25,24,1,0
12,2006,650500,21,20,1,0
1,2007,650500,20,20,0,1
2,2007,650500,15,13,2,0
3,2007,650500,24,22,2,0
4,2007,650500,18,18,0,1
5,2007,650500,13,12,1,0
6,2007,650500,17,17,0,0
7,2007,650500,15,14,1,0
8,2007,650500,13,13,0,0
9,2007,650500,19,18,1,0
10,2007,650500,10,9,1,1
11,2007,650500,14,14,0,0
12,2007,650500,17,17,0,2
1,2008,650500,32,30,2,4
2,2008,650500,14,14,0,0
3,2008,650500,9,8,1,2
4,2008,650500,19,19,0,2
5,2008,650500,11,9,2,1
6,2008,650500,16,15,1,0
7,2008,650500,15,15,0,0
8,2008,650500,15,15,0,0
9,2008,650500,26,26,0,1
10,2008,650500,21,21,0,0
11,2008,650500,15,15,0,0
12,2008,650500,18,17,1,1
1,2009,650500,17,15,2,4
2,2009,650500,6,6,0,2
3,2009,650500,9,8,1,2
4,2009,650500,11,11,0,1
5,2009,650500,7,6,1,0
6,2009,650500,18,16,2,2
7,2009,650500,13,11,2,0
8,2009,650500,18,14,4,0
9,2009,650500,14,13,1,1
10,2009,650500,16,16,0,1
11,2009,650500,14,14,0,1
12,2009,650500,10,10,0,0
1,2010,650500,21,19,2,1
2,2010,650500,13,13,0,1
3,2010,650500,20,20,0,3
4,2010,650500,17,17,0,0
5,2010,650500,14,14,0,1
6,2010,650500,13,12,1,1
7,2010,650500,8,8,0,0
8,2010,650500,12,8,4,0
9,2010,650500,10,9,1,3
10,2010,650500,11,9,2,1
11,2010,650500,13,11,2,1
12,2010,650500,20,20,0,1
1,2011,650500,8,7,1,0
2,2011,650500,11,11,0,0
1,1999,710200,27,19,8,10
2,1999,710200,32,25,7,1
3,1999,710200,25,19,6,9
4,1999,710200,31,21,10,6
5,1999,710200,32,23,9,4
6,1999,710200,50,38,12,8
7,1999,710200,40,34,6,5
8,1999,710200,38,33,5,16
9,1999,710200,47,36,11,12
10,1999,710200,29,21,8,7
11,1999,710200,32,26,6,11
12,1999,710200,23,18,5,4
1,2000,710200,29,22,7,12
2,2000,710200,25,23,2,6
3,2000,710200,23,19,4,6
4,2000,710200,26,20,6,5
5,2000,710200,28,22,6,3
6,2000,710200,31,20,11,6
7,2000,710200,38,33,5,1
8,2000,710200,41,31,10,1
9,2000,710200,32,21,11,2
10,2000,710200,28,19,9,8
11,2000,710200,32,28,4,6
12,2000,710200,32,26,6,7
1,2001,710200,25,17,8,7
2,2001,710200,21,17,4,5
3,2001,710200,18,14,4,3
4,2001,710200,26,19,7,4
5,2001,710200,27,23,4,4
6,2001,710200,33,26,7,6
7,2001,710200,43,34,9,7
8,2001,710200,30,22,8,2
9,2001,710200,31,26,5,1
10,2001,710200,31,22,9,7
11,2001,710200,36,22,14,11
12,2001,710200,23,20,3,14
1,2002,710200,26,22,4,8
2,2002,710200,28,22,6,5
3,2002,710200,20,14,6,12
4,2002,710200,32,25,7,8
5,2002,710200,44,37,7,7
6,2002,710200,32,23,9,0
7,2002,710200,31,20,11,7
8,2002,710200,38,33,5,7
9,2002,710200,36,25,11,10
10,2002,710200,38,32,6,8
11,2002,710200,34,30,4,10
12,2002,710200,25,21,4,8
1,2003,710200,22,20,2,6
2,2003,710200,23,17,6,12
3,2003,710200,39,29,10,6
4,2003,710200,28,19,9,2
5,2003,710200,33,27,6,3
6,2003,710200,35,30,5,7
7,2003,710200,41,34,7,4
8,2003,710200,41,34,7,5
9,2003,710200,26,20,6,5
10,2003,710200,31,25,6,22
11,2003,710200,42,39,3,9
12,2003,710200,25,21,4,7
1,2004,710200,47,40,7,7
2,2004,710200,35,30,5,16
3,2004,710200,28,23,5,18
4,2004,710200,21,14,7,19
5,2004,710200,34,26,8,14
6,2004,710200,34,28,6,7
7,2004,710200,47,40,7,3
8,2004,710200,36,28,8,6
9,2004,710200,45,32,13,4
10,2004,710200,34,28,6,4
11,2004,710200,27,20,7,5
12,2004,710200,26,21,5,4
1,2005,710200,32,24,8,3
2,2005,710200,24,18,6,5
3,2005,710200,32,26,6,4
4,2005,710200,34,25,9,14
5,2005,710200,43,35,8,7
6,2005,710200,43,33,10,7
7,2005,710200,39,23,16,9
8,2005,710200,46,41,5,4
9,2005,710200,47,37,10,8
10,2005,710200,34,27,7,10
11,2005,710200,33,30,3,6
12,2005,710200,30,26,4,3
1,2006,710200,34,23,11,6
2,2006,710200,24,20,4,4
3,2006,710200,29,25,4,5
4,2006,710200,26,19,7,2
5,2006,710200,37,26,11,3
6,2006,710200,31,22,9,8
7,2006,710200,34,23,11,7
8,2006,710200,25,19,6,2
9,2006,710200,24,20,4,2
10,2006,710200,23,20,3,10
11,2006,710200,25,20,5,4
12,2006,710200,27,21,6,2
1,2007,710200,27,20,7,11
2,2007,710200,21,17,4,13
3,2007,710200,37,31,6,12
4,2007,710200,26,19,7,15
5,2007,710200,48,35,13,10
6,2007,710200,39,28,11,10
7,2007,710200,54,48,6,11
8,2007,710200,41,33,8,23
9,2007,710200,24,22,2,10
10,2007,710200,48,37,11,10
11,2007,710200,31,22,9,8
12,2007,710200,20,12,8,9
1,2008,710200,28,24,4,3
2,2008,710200,27,20,7,7
3,2008,710200,47,39,8,8
4,2008,710200,48,42,6,9
5,2008,710200,39,28,11,13
6,2008,710200,46,39,7,8
7,2008,710200,31,22,9,9
8,2008,710200,33,25,8,9
9,2008,710200,42,33,9,13
10,2008,710200,28,23,5,8
11,2008,710200,33,30,3,11
12,2008,710200,24,20,4,4
1,2009,710200,17,14,3,9
2,2009,710200,28,22,6,5
3,2009,710200,31,25,6,3
4,2009,710200,36,30,6,5
5,2009,710200,45,37,8,7
6,2009,710200,24,21,3,12
7,2009,710200,34,26,8,6
8,2009,710200,45,34,11,8
9,2009,710200,26,19,7,9
10,2009,710200,26,21,5,12
11,2009,710200,30,23,7,13
12,2009,710200,34,28,6,9
1,2010,710200,31,25,6,9
2,2010,710200,22,18,4,9
3,2010,710200,29,25,4,5
4,2010,710200,33,25,8,19
5,2010,710200,30,23,7,7
6,2010,710200,19,16,3,9
7,2010,710200,29,24,5,10
8,2010,710200,35,28,7,8
9,2010,710200,31,23,8,16
10,2010,710200,27,24,3,6
11,2010,710200,22,18,4,6
12,2010,710200,25,22,3,1
1,2011,710200,29,26,3,4
2,2011,710200,14,13,1,2
1,1999,431302,56,44,12,9
2,1999,431302,40,32,8,15
3,1999,431302,55,45,10,20
4,1999,431302,35,27,8,20
5,1999,431302,39,29,10,12
6,1999,431302,58,43,15,12
7,1999,431302,49,37,12,16
8,1999,431302,50,36,14,31
9,1999,431302,59,49,10,8
10,1999,431302,53,36,17,14
11,1999,431302,57,52,5,18
12,1999,431302,49,41,8,8
1,2000,431302,49,33,16,28
2,2000,431302,33,28,5,20
3,2000,431302,55,41,14,18
4,2000,431302,33,24,9,21
5,2000,431302,35,29,6,21
6,2000,431302,47,30,17,17
7,2000,431302,44,33,11,29
8,2000,431302,60,50,10,21
9,2000,431302,44,37,7,15
10,2000,431302,57,46,11,11
11,2000,431302,42,30,12,28
12,2000,431302,34,26,8,31
1,2001,431302,42,33,9,27
2,2001,431302,44,38,6,25
3,2001,431302,54,43,11,25
4,2001,431302,56,46,10,21
5,2001,431302,59,52,7,13
6,2001,431302,53,35,18,20
7,2001,431302,54,39,15,23
8,2001,431302,56,37,19,9
9,2001,431302,44,35,9,15
10,2001,431302,61,47,14,31
11,2001,431302,57,44,13,25
12,2001,431302,41,33,8,21
1,2002,431302,50,40,10,25
2,2002,431302,35,28,7,32
3,2002,431302,49,37,12,19
4,2002,431302,55,47,8,20
5,2002,431302,48,38,10,48
6,2002,431302,79,61,18,22
7,2002,431302,66,50,16,27
8,2002,431302,72,55,17,18
9,2002,431302,76,62,14,15
10,2002,431302,54,39,15,20
11,2002,431302,48,43,5,17
12,2002,431302,52,46,6,16
1,2003,431302,55,43,12,20
2,2003,431302,58,50,8,21
3,2003,431302,69,64,5,14
4,2003,431302,59,44,15,24
5,2003,431302,51,39,12,13
6,2003,431302,52,40,12,21
7,2003,431302,71,57,14,19
8,2003,431302,79,65,14,18
9,2003,431302,52,42,10,16
10,2003,431302,54,40,14,28
11,2003,431302,49,44,5,19
12,2003,431302,45,32,13,14
1,2004,431302,47,38,9,32
2,2004,431302,42,33,9,18
3,2004,431302,48,38,10,14
4,2004,431302,43,31,12,26
5,2004,431302,60,44,16,24
6,2004,431302,49,39,10,13
7,2004,431302,51,43,8,35
8,2004,431302,44,40,4,28
9,2004,431302,47,36,11,15
10,2004,431302,41,35,6,34
11,2004,431302,34,29,5,28
12,2004,431302,28,20,8,27
1,2005,431302,34,28,6,29
2,2005,431302,40,31,9,9
3,2005,431302,41,34,7,57
4,2005,431302,55,46,9,19
5,2005,431302,48,42,6,11
6,2005,431302,54,39,15,27
7,2005,431302,64,50,14,17
8,2005,431302,53,42,11,29
9,2005,431302,57,48,9,20
10,2005,431302,68,56,12,32
11,2005,431302,45,37,8,24
12,2005,431302,38,32,6,22
1,2006,431302,44,38,6,29
2,2006,431302,38,34,4,26
3,2006,431302,40,31,9,39
4,2006,431302,38,29,9,23
5,2006,431302,47,35,12,73
6,2006,431302,49,42,7,41
7,2006,431302,54,41,13,33
8,2006,431302,66,56,10,41
9,2006,431302,61,47,14,36
10,2006,431302,58,49,9,33
11,2006,431302,45,42,3,44
12,2006,431302,37,32,5,34
1,2007,431302,36,33,3,29
2,2007,431302,28,26,2,22
3,2007,431302,42,30,12,29
4,2007,431302,44,39,5,27
5,2007,431302,53,43,10,18
6,2007,431302,52,40,12,15
7,2007,431302,65,50,15,13
8,2007,431302,65,54,11,36
9,2007,431302,52,36,16,27
10,2007,431302,77,59,18,24
11,2007,431302,49,44,5,8
12,2007,431302,53,44,9,27
1,2008,431302,50,44,6,24
2,2008,431302,38,32,6,34
3,2008,431302,58,46,12,17
4,2008,431302,47,38,9,16
5,2008,431302,51,42,9,22
6,2008,431302,39,25,14,28
7,2008,431302,61,46,15,38
8,2008,431302,50,42,8,27
9,2008,431302,37,25,12,23
10,2008,431302,52,45,7,19
11,2008,431302,39,33,6,32
12,2008,431302,46,42,4,23
1,2009,431302,43,32,11,28
2,2009,431302,31,25,6,36
3,2009,431302,37,26,11,32
4,2009,431302,51,40,11,18
5,2009,431302,53,39,14,25
6,2009,431302,51,37,14,23
7,2009,431302,39,31,8,21
8,2009,431302,70,60,10,29
9,2009,431302,49,35,14,30
10,2009,431302,50,40,10,39
11,2009,431302,59,50,9,24
12,2009,431302,35,28,7,28
1,2010,431302,38,37,1,32
2,2010,431302,39,28,11,17
3,2010,431302,22,17,5,24
4,2010,431302,41,30,11,10
5,2010,431302,54,47,7,11
6,2010,431302,41,23,18,16
7,2010,431302,42,35,7,16
8,2010,431302,55,44,11,13
9,2010,431302,55,48,7,19
10,2010,431302,65,52,13,26
11,2010,431302,59,47,12,27
12,2010,431302,44,31,13,17
1,2011,431302,64,55,9,26
2,2011,431302,32,26,6,8
1,1999,681300,16,12,4,11
2,1999,681300,25,23,2,8
3,1999,681300,22,13,9,11
4,1999,681300,26,19,7,7
5,1999,681300,31,25,6,6
6,1999,681300,40,29,11,13
7,1999,681300,38,21,17,5
8,1999,681300,40,25,15,6
9,1999,681300,48,30,18,8
10,1999,681300,41,35,6,14
11,1999,681300,25,20,5,8
12,1999,681300,30,22,8,11
1,2000,681300,21,17,4,8
2,2000,681300,27,15,12,3
3,2000,681300,29,20,9,3
4,2000,681300,23,17,6,3
5,2000,681300,33,22,11,9
6,2000,681300,26,16,10,6
7,2000,681300,34,19,15,12
8,2000,681300,40,24,16,8
9,2000,681300,33,21,12,6
10,2000,681300,29,25,4,6
11,2000,681300,33,25,8,6
12,2000,681300,17,11,6,0
1,2001,681300,14,9,5,2
2,2001,681300,23,19,4,3
3,2001,681300,25,17,8,6
4,2001,681300,22,16,6,4
5,2001,681300,32,21,11,2
6,2001,681300,28,21,7,9
7,2001,681300,33,20,13,4
8,2001,681300,48,33,15,8
9,2001,681300,30,22,8,6
10,2001,681300,38,25,13,10
11,2001,681300,28,18,10,10
12,2001,681300,30,24,6,6
1,2002,681300,29,24,5,11
2,2002,681300,20,14,6,10
3,2002,681300,28,16,12,10
4,2002,681300,23,15,8,12
5,2002,681300,27,19,8,6
6,2002,681300,27,17,10,6
7,2002,681300,29,20,9,16
8,2002,681300,30,24,6,8
9,2002,681300,24,18,6,9
10,2002,681300,27,19,8,4
11,2002,681300,20,14,6,9
12,2002,681300,24,19,5,7
1,2003,681300,26,22,4,8
2,2003,681300,10,8,2,12
3,2003,681300,28,18,10,9
4,2003,681300,20,13,7,4
5,2003,681300,27,19,8,10
6,2003,681300,29,21,8,4
7,2003,681300,28,18,10,11
8,2003,681300,32,21,11,7
9,2003,681300,37,27,10,4
10,2003,681300,31,24,7,11
11,2003,681300,19,17,2,12
12,2003,681300,27,20,7,9
1,2004,681300,19,14,5,18
2,2004,681300,19,15,4,14
3,2004,681300,27,19,8,5
4,2004,681300,19,15,4,7
5,2004,681300,17,12,5,9
6,2004,681300,25,18,7,13
7,2004,681300,20,15,5,8
8,2004,681300,27,19,8,10
9,2004,681300,17,13,4,7
10,2004,681300,15,15,0,6
11,2004,681300,18,15,3,14
12,2004,681300,26,21,5,6
1,2005,681300,20,15,5,4
2,2005,681300,14,11,3,9
3,2005,681300,22,17,5,1
4,2005,681300,26,22,4,2
5,2005,681300,32,22,10,6
6,2005,681300,34,30,4,7
7,2005,681300,33,26,7,8
8,2005,681300,28,22,6,5
9,2005,681300,27,23,4,10
10,2005,681300,23,19,4,6
11,2005,681300,26,23,3,5
12,2005,681300,19,17,2,7
1,2006,681300,25,18,7,8
2,2006,681300,14,13,1,2
3,2006,681300,19,14,5,12
4,2006,681300,33,22,11,8
5,2006,681300,32,22,10,14
6,2006,681300,25,22,3,7
7,2006,681300,24,16,8,12
8,2006,681300,37,26,11,24
9,2006,681300,24,21,3,19
10,2006,681300,25,17,8,14
11,2006,681300,16,15,1,2
12,2006,681300,24,21,3,4
1,2007,681300,22,17,5,3
2,2007,681300,21,15,6,7
3,2007,681300,25,17,8,13
4,2007,681300,21,14,7,6
5,2007,681300,18,15,3,9
6,2007,681300,42,26,16,16
7,2007,681300,29,24,5,13
8,2007,681300,30,21,9,17
9,2007,681300,30,20,10,16
10,2007,681300,17,14,3,11
11,2007,681300,31,21,10,9
12,2007,681300,22,19,3,7
1,2008,681300,24,18,6,20
2,2008,681300,13,11,2,9
3,2008,681300,32,23,9,9
4,2008,681300,31,23,8,10
5,2008,681300,34,20,14,14
6,2008,681300,33,26,7,8
7,2008,681300,34,28,6,13
8,2008,681300,28,19,9,7
9,2008,681300,25,21,4,4
10,2008,681300,27,22,5,6
11,2008,681300,17,13,4,14
12,2008,681300,12,12,0,3
1,2009,681300,25,20,5,3
2,2009,681300,16,14,2,3
3,2009,681300,21,18,3,5
4,2009,681300,24,22,2,3
5,2009,681300,28,22,6,10
6,2009,681300,28,27,1,12
7,2009,681300,24,22,2,9
8,2009,681300,32,26,6,7
9,2009,681300,27,24,3,6
10,2009,681300,20,17,3,6
11,2009,681300,26,23,3,7
12,2009,681300,33,30,3,9
1,2010,681300,29,24,5,4
2,2010,681300,13,12,1,4
3,2010,681300,24,21,3,9
4,2010,681300,21,16,5,8
5,2010,681300,28,25,3,7
6,2010,681300,30,22,8,7
7,2010,681300,32,28,4,2
8,2010,681300,39,35,4,7
9,2010,681300,31,26,5,5
10,2010,681300,20,13,7,2
11,2010,681300,27,23,4,4
12,2010,681300,17,17,0,5
1,2011,681300,28,20,8,3
2,2011,681300,14,11,3,12
1,1999,661100,23,21,2,2
2,1999,661100,10,9,1,2
3,1999,661100,7,6,1,3
4,1999,661100,10,9,1,1
5,1999,661100,16,16,0,0
6,1999,661100,29,27,2,1
7,1999,661100,28,27,1,1
8,1999,661100,19,19,0,0
9,1999,661100,10,7,3,0
10,1999,661100,13,10,3,0
11,1999,661100,11,10,1,0
12,1999,661100,10,9,1,0
1,2000,661100,13,13,0,2
2,2000,661100,4,4,0,1
3,2000,661100,15,13,2,0
4,2000,661100,18,18,0,1
5,2000,661100,19,19,0,1
6,2000,661100,18,15,3,1
7,2000,661100,36,36,0,2
8,2000,661100,15,14,1,1
9,2000,661100,11,9,2,0
10,2000,661100,18,16,2,2
11,2000,661100,15,12,3,1
12,2000,661100,11,7,4,0
1,2001,661100,13,10,3,0
2,2001,661100,8,6,2,0
3,2001,661100,9,8,1,0
4,2001,661100,17,15,2,2
5,2001,661100,15,14,1,1
6,2001,661100,17,14,3,0
7,2001,661100,16,11,5,0
8,2001,661100,18,17,1,1
9,2001,661100,13,11,2,0
10,2001,661100,19,16,3,0
11,2001,661100,21,20,1,0
12,2001,661100,12,12,0,0
1,2002,661100,7,7,0,1
2,2002,661100,3,2,1,0
3,2002,661100,15,12,3,0
4,2002,661100,12,11,1,0
5,2002,661100,23,19,4,0
6,2002,661100,19,15,4,0
7,2002,661100,20,18,2,0
8,2002,661100,29,26,3,0
9,2002,661100,21,19,2,0
10,2002,661100,11,11,0,0
11,2002,661100,12,12,0,0
12,2002,661100,13,13,0,1
1,2003,661100,12,12,0,0
2,2003,661100,6,4,2,1
3,2003,661100,26,26,0,0
4,2003,661100,22,19,3,5
5,2003,661100,10,9,1,3
6,2003,661100,19,13,6,0
7,2003,661100,18,17,1,1
8,2003,661100,16,15,1,0
9,2003,661100,20,18,2,0
10,2003,661100,12,12,0,0
11,2003,661100,13,13,0,0
12,2003,661100,10,10,0,0
1,2004,661100,8,8,0,1
2,2004,661100,8,8,0,1
3,2004,661100,11,10,1,3
4,2004,661100,8,8,0,0
5,2004,661100,10,8,2,1
6,2004,661100,22,16,6,0
7,2004,661100,15,14,1,0
8,2004,661100,15,12,3,1
9,2004,661100,11,9,2,0
10,2004,661100,8,8,0,0
11,2004,661100,13,12,1,3
12,2004,661100,8,8,0,1
1,2005,661100,10,8,2,0
2,2005,661100,10,10,0,3
3,2005,661100,15,12,3,1
4,2005,661100,16,15,1,1
5,2005,661100,14,11,3,0
6,2005,661100,18,17,1,0
7,2005,661100,11,11,0,0
8,2005,661100,13,12,1,2
9,2005,661100,13,12,1,2
10,2005,661100,13,9,4,3
11,2005,661100,15,15,0,1
12,2005,661100,22,20,2,1
1,2006,661100,13,12,1,1
2,2006,661100,13,13,0,4
3,2006,661100,11,11,0,1
4,2006,661100,6,5,1,0
5,2006,661100,16,12,4,0
6,2006,661100,12,12,0,0
7,2006,661100,21,18,3,2
8,2006,661100,23,20,3,2
9,2006,661100,18,15,3,0
10,2006,661100,17,17,0,2
11,2006,661100,15,14,1,0
12,2006,661100,21,18,3,0
1,2007,661100,16,15,1,5
2,2007,661100,9,8,1,3
3,2007,661100,11,10,1,0
4,2007,661100,11,9,2,2
5,2007,661100,15,13,2,2
6,2007,661100,16,15,1,1
7,2007,661100,22,21,1,1
8,2007,661100,17,15,2,3
9,2007,661100,14,11,3,0
10,2007,661100,16,14,2,1
11,2007,661100,18,17,1,1
12,2007,661100,9,9,0,5
1,2008,661100,9,8,1,0
2,2008,661100,10,9,1,6
3,2008,661100,13,13,0,4
4,2008,661100,17,16,1,0
5,2008,661100,18,17,1,2
6,2008,661100,18,14,4,1
7,2008,661100,21,16,5,4
8,2008,661100,20,17,3,1
9,2008,661100,21,17,4,3
10,2008,661100,14,12,2,2
11,2008,661100,20,14,6,3
12,2008,661100,21,20,1,1
1,2009,661100,6,5,1,5
2,2009,661100,7,7,0,6
3,2009,661100,5,5,0,1
4,2009,661100,21,17,4,1
5,2009,661100,19,18,1,4
6,2009,661100,13,12,1,0
7,2009,661100,24,24,0,1
8,2009,661100,24,23,1,1
9,2009,661100,23,21,2,0
10,2009,661100,18,15,3,2
11,2009,661100,19,18,1,1
12,2009,661100,15,15,0,0
1,2010,661100,14,13,1,0
2,2010,661100,5,5,0,11
3,2010,661100,13,13,0,4
4,2010,661100,28,23,5,2
5,2010,661100,17,15,2,1
6,2010,661100,12,9,3,2
7,2010,661100,16,13,3,1
8,2010,661100,27,27,0,3
9,2010,661100,14,13,1,1
10,2010,661100,15,15,0,1
11,2010,661100,21,21,0,4
12,2010,661100,18,17,1,1
1,2011,661100,11,10,1,2
2,2011,661100,9,9,0,2
1,1999,672000,25,22,3,15
2,1999,672000,36,28,8,12
3,1999,672000,42,28,14,8
4,1999,672000,47,38,9,11
5,1999,672000,50,34,16,3
6,1999,672000,47,38,9,3
7,1999,672000,51,31,20,2
8,1999,672000,61,46,15,6
9,1999,672000,41,31,10,7
10,1999,672000,46,32,14,7
11,1999,672000,35,27,8,4
12,1999,672000,23,19,4,3
1,2000,672000,41,31,10,5
2,2000,672000,28,22,6,8
3,2000,672000,47,37,10,8
4,2000,672000,45,35,10,12
5,2000,672000,49,43,6,9
6,2000,672000,44,35,9,5
7,2000,672000,57,46,11,9
8,2000,672000,65,49,16,3
9,2000,672000,42,32,10,5
10,2000,672000,36,27,9,11
11,2000,672000,31,23,8,6
12,2000,672000,24,20,4,13
1,2001,672000,20,17,3,7
2,2001,672000,19,14,5,8
3,2001,672000,33,25,8,10
4,2001,672000,41,30,11,7
5,2001,672000,41,36,5,9
6,2001,672000,37,32,5,13
7,2001,672000,49,37,12,4
8,2001,672000,41,33,8,14
9,2001,672000,38,31,7,8
10,2001,672000,46,38,8,3
11,2001,672000,42,28,14,8
12,2001,672000,39,34,5,10
1,2002,672000,38,27,11,4
2,2002,672000,27,19,8,5
3,2002,672000,32,20,12,14
4,2002,672000,33,23,10,7
5,2002,672000,36,29,7,4
6,2002,672000,37,18,19,7
7,2002,672000,34,21,13,7
8,2002,672000,40,30,10,6
9,2002,672000,38,26,12,3
10,2002,672000,31,26,5,3
11,2002,672000,44,33,11,4
12,2002,672000,26,23,3,9
1,2003,672000,33,28,5,5
2,2003,672000,26,19,7,9
3,2003,672000,36,26,10,4
4,2003,672000,34,24,10,6
5,2003,672000,35,25,10,10
6,2003,672000,39,30,9,5
7,2003,672000,49,39,10,6
8,2003,672000,40,34,6,4
9,2003,672000,42,36,6,13
10,2003,672000,49,40,9,4
11,2003,672000,31,26,5,14
12,2003,672000,28,24,4,6
1,2004,672000,28,24,4,7
2,2004,672000,27,23,4,6
3,2004,672000,56,43,13,11
4,2004,672000,39,31,8,10
5,2004,672000,41,30,11,7
6,2004,672000,33,27,6,2
7,2004,672000,35,27,8,5
8,2004,672000,38,28,10,18
9,2004,672000,35,26,9,6
10,2004,672000,34,27,7,9
11,2004,672000,32,26,6,7
12,2004,672000,20,16,4,10
1,2005,672000,27,20,7,8
2,2005,672000,24,17,7,13
3,2005,672000,32,28,4,9
4,2005,672000,44,39,5,6
5,2005,672000,36,28,8,13
6,2005,672000,56,48,8,6
7,2005,672000,49,37,12,15
8,2005,672000,51,45,6,11
9,2005,672000,51,38,13,14
10,2005,672000,43,36,7,12
11,2005,672000,44,34,10,11
12,2005,672000,37,34,3,4
1,2006,672000,28,23,5,16
2,2006,672000,26,22,4,13
3,2006,672000,38,29,9,17
4,2006,672000,44,33,11,4
5,2006,672000,48,41,7,5
6,2006,672000,39,28,11,11
7,2006,672000,40,26,14,8
8,2006,672000,43,29,14,9
9,2006,672000,37,27,10,2
10,2006,672000,33,24,9,14
11,2006,672000,32,28,4,15
12,2006,672000,45,39,6,13
1,2007,672000,27,26,1,6
2,2007,672000,26,22,4,14
3,2007,672000,28,18,10,6
4,2007,672000,30,23,7,10
5,2007,672000,40,31,9,6
6,2007,672000,58,48,10,20
7,2007,672000,52,32,20,13
8,2007,672000,46,38,8,8
9,2007,672000,23,13,10,5
10,2007,672000,20,14,6,9
11,2007,672000,29,28,1,7
12,2007,672000,31,27,4,10
1,2008,672000,28,20,8,3
2,2008,672000,26,23,3,9
3,2008,672000,23,19,4,3
4,2008,672000,47,43,4,8
5,2008,672000,40,35,5,8
6,2008,672000,21,16,5,6
7,2008,672000,58,48,10,12
8,2008,672000,51,33,18,11
9,2008,672000,42,29,13,15
10,2008,672000,40,30,10,8
11,2008,672000,33,29,4,13
12,2008,672000,32,26,6,16
1,2009,672000,21,16,5,12
2,2009,672000,22,17,5,6
3,2009,672000,28,20,8,4
4,2009,672000,24,16,8,3
5,2009,672000,38,31,7,12
6,2009,672000,23,18,5,3
7,2009,672000,40,28,12,13
8,2009,672000,39,28,11,10
9,2009,672000,37,30,7,6
10,2009,672000,40,36,4,8
11,2009,672000,45,32,13,2
12,2009,672000,22,20,2,6
1,2010,672000,26,23,3,2
2,2010,672000,22,19,3,12
3,2010,672000,35,30,5,4
4,2010,672000,21,16,5,6
5,2010,672000,26,19,7,9
6,2010,672000,21,16,5,3
7,2010,672000,42,37,5,8
8,2010,672000,32,26,6,2
9,2010,672000,31,28,3,8
10,2010,672000,42,38,4,9
11,2010,672000,38,33,5,11
12,2010,672000,22,19,3,4
1,2011,672000,13,9,4,7
2,2011,672000,18,15,3,3
1,1999,661000,16,13,3,7
2,1999,661000,21,18,3,6
3,1999,661000,28,24,4,3
4,1999,661000,24,23,1,6
5,1999,661000,25,19,6,3
6,1999,661000,38,32,6,6
7,1999,661000,26,24,2,6
8,1999,661000,27,25,2,4
9,1999,661000,26,21,5,4
10,1999,661000,22,22,0,3
11,1999,661000,17,12,5,1
12,1999,661000,21,17,4,10
1,2000,661000,18,18,0,4
2,2000,661000,19,19,0,3
3,2000,661000,28,23,5,2
4,2000,661000,30,28,2,1
5,2000,661000,34,27,7,5
6,2000,661000,27,22,5,5
7,2000,661000,32,23,9,3
8,2000,661000,20,18,2,6
9,2000,661000,28,23,5,4
10,2000,661000,31,28,3,4
11,2000,661000,17,13,4,3
12,2000,661000,17,17,0,5
1,2001,661000,25,24,1,0
2,2001,661000,30,26,4,6
3,2001,661000,19,16,3,2
4,2001,661000,37,36,1,2
5,2001,661000,11,10,1,2
6,2001,661000,17,16,1,4
7,2001,661000,28,24,4,5
8,2001,661000,36,32,4,2
9,2001,661000,26,20,6,9
10,2001,661000,25,21,4,4
11,2001,661000,26,23,3,7
12,2001,661000,21,21,0,1
1,2002,661000,14,12,2,2
2,2002,661000,12,11,1,2
3,2002,661000,17,14,3,0
4,2002,661000,28,22,6,2
5,2002,661000,26,22,4,2
6,2002,661000,13,8,5,7
7,2002,661000,25,19,6,6
8,2002,661000,22,20,2,6
9,2002,661000,16,15,1,8
10,2002,661000,23,21,2,1
11,2002,661000,27,24,3,6
12,2002,661000,17,14,3,14
1,2003,661000,16,16,0,2
2,2003,661000,13,11,2,8
3,2003,661000,13,12,1,2
4,2003,661000,26,23,3,3
5,2003,661000,19,15,4,10
6,2003,661000,22,18,4,6
7,2003,661000,21,17,4,3
8,2003,661000,22,19,3,4
9,2003,661000,30,24,6,6
10,2003,661000,24,19,5,2
11,2003,661000,25,19,6,2
12,2003,661000,18,15,3,2
1,2004,661000,17,15,2,1
2,2004,661000,26,25,1,4
3,2004,661000,30,22,8,6
4,2004,661000,25,22,3,6
5,2004,661000,22,19,3,4
6,2004,661000,24,21,3,1
7,2004,661000,18,15,3,7
8,2004,661000,24,19,5,3
9,2004,661000,13,11,2,6
10,2004,661000,16,15,1,3
11,2004,661000,14,11,3,5
12,2004,661000,14,14,0,3
1,2005,661000,17,15,2,1
2,2005,661000,23,19,4,9
3,2005,661000,16,10,6,5
4,2005,661000,26,18,8,5
5,2005,661000,19,17,2,1
6,2005,661000,17,15,2,5
7,2005,661000,37,30,7,8
8,2005,661000,35,25,10,7
9,2005,661000,28,24,4,9
10,2005,661000,30,19,11,5
11,2005,661000,28,24,4,5
12,2005,661000,36,34,2,5
1,2006,661000,24,20,4,2
2,2006,661000,19,16,3,5
3,2006,661000,20,17,3,3
4,2006,661000,27,26,1,3
5,2006,661000,13,9,4,5
6,2006,661000,32,27,5,8
7,2006,661000,23,20,3,11
8,2006,661000,40,35,5,7
9,2006,661000,31,25,6,7
10,2006,661000,37,28,9,8
11,2006,661000,35,31,4,10
12,2006,661000,24,23,1,6
1,2007,661000,33,28,5,6
2,2007,661000,17,16,1,11
3,2007,661000,27,22,5,7
4,2007,661000,27,23,4,4
5,2007,661000,29,20,9,3
6,2007,661000,33,29,4,3
7,2007,661000,37,31,6,1
8,2007,661000,32,26,6,5
9,2007,661000,40,24,16,0
10,2007,661000,28,23,5,5
11,2007,661000,28,24,4,11
12,2007,661000,27,23,4,1
1,2008,661000,27,25,2,4
2,2008,661000,13,11,2,2
3,2008,661000,26,20,6,1
4,2008,661000,19,18,1,5
5,2008,661000,28,25,3,6
6,2008,661000,26,22,4,4
7,2008,661000,23,16,7,4
8,2008,661000,28,25,3,4
9,2008,661000,29,27,2,7
10,2008,661000,30,25,5,8
11,2008,661000,18,15,3,9
12,2008,661000,21,18,3,6
1,2009,661000,17,14,3,3
2,2009,661000,17,15,2,2
3,2009,661000,25,19,6,5
4,2009,661000,17,16,1,2
5,2009,661000,29,26,3,9
6,2009,661000,27,24,3,1
7,2009,661000,23,20,3,7
8,2009,661000,30,24,6,10
9,2009,661000,21,17,4,6
10,2009,661000,30,26,4,10
11,2009,661000,19,15,4,12
12,2009,661000,16,14,2,7
1,2010,661000,30,28,2,8
2,2010,661000,11,7,4,9
3,2010,661000,27,26,1,7
4,2010,661000,21,13,8,18
5,2010,661000,22,20,2,9
6,2010,661000,23,21,2,8
7,2010,661000,23,21,2,11
8,2010,661000,31,25,6,11
9,2010,661000,23,21,2,9
10,2010,661000,19,18,1,10
11,2010,661000,22,20,2,11
12,2010,661000,14,13,1,12
1,2011,661000,14,13,1,4
2,2011,661000,6,6,0,2
1,1999,681400,38,28,10,8
2,1999,681400,34,27,7,7
3,1999,681400,36,22,14,9
4,1999,681400,52,40,12,7
5,1999,681400,60,38,22,3
6,1999,681400,54,38,16,8
7,1999,681400,72,51,21,5
8,1999,681400,55,43,12,7
9,1999,681400,54,37,17,4
10,1999,681400,49,31,18,7
11,1999,681400,32,27,5,1
12,1999,681400,45,37,8,0
1,2000,681400,28,22,6,11
2,2000,681400,30,20,10,7
3,2000,681400,34,24,10,13
4,2000,681400,43,29,14,6
5,2000,681400,36,24,12,7
6,2000,681400,47,35,12,11
7,2000,681400,50,37,13,4
8,2000,681400,50,40,10,8
9,2000,681400,55,40,15,13
10,2000,681400,56,42,14,9
11,2000,681400,38,28,10,7
12,2000,681400,27,21,6,13
1,2001,681400,36,29,7,9
2,2001,681400,38,30,8,13
3,2001,681400,41,29,12,20
4,2001,681400,37,29,8,6
5,2001,681400,45,32,13,8
6,2001,681400,48,31,17,7
7,2001,681400,52,40,12,7
8,2001,681400,48,39,9,7
9,2001,681400,45,34,11,8
10,2001,681400,42,32,10,4
11,2001,681400,41,38,3,8
12,2001,681400,31,23,8,12
1,2002,681400,29,20,9,6
2,2002,681400,26,22,4,6
3,2002,681400,38,28,10,11
4,2002,681400,28,23,5,7
5,2002,681400,39,25,14,14
6,2002,681400,35,22,13,5
7,2002,681400,43,34,9,6
8,2002,681400,42,34,8,10
9,2002,681400,43,31,12,12
10,2002,681400,43,35,8,12
11,2002,681400,35,30,5,10
12,2002,681400,36,28,8,10
1,2003,681400,27,20,7,2
2,2003,681400,19,12,7,2
3,2003,681400,36,30,6,10
4,2003,681400,25,22,3,3
5,2003,681400,35,30,5,3
6,2003,681400,28,20,8,5
7,2003,681400,41,30,11,6
8,2003,681400,37,34,3,13
9,2003,681400,46,33,13,5
10,2003,681400,29,18,11,5
11,2003,681400,32,24,8,8
12,2003,681400,33,26,7,6
1,2004,681400,24,16,8,9
2,2004,681400,25,19,6,5
3,2004,681400,34,25,9,21
4,2004,681400,34,25,9,25
5,2004,681400,41,33,8,19
6,2004,681400,38,28,10,7
7,2004,681400,34,24,10,10
8,2004,681400,51,44,7,41
9,2004,681400,47,40,7,7
10,2004,681400,44,38,6,23
11,2004,681400,45,34,11,26
12,2004,681400,39,33,6,5
1,2005,681400,25,19,6,14
2,2005,681400,22,19,3,10
3,2005,681400,28,22,6,13
4,2005,681400,43,35,8,6
5,2005,681400,24,16,8,11
6,2005,681400,40,30,10,17
7,2005,681400,36,24,12,14
8,2005,681400,38,29,9,14
9,2005,681400,37,26,11,22
10,2005,681400,41,32,9,7
11,2005,681400,38,32,6,10
12,2005,681400,23,20,3,7
1,2006,681400,40,34,6,9
2,2006,681400,19,17,2,9
3,2006,681400,19,12,7,26
4,2006,681400,26,20,6,16
5,2006,681400,29,21,8,5
6,2006,681400,42,33,9,4
7,2006,681400,55,43,12,22
8,2006,681400,47,40,7,14
9,2006,681400,31,24,7,20
10,2006,681400,36,27,9,5
11,2006,681400,36,30,6,16
12,2006,681400,30,24,6,13
1,2007,681400,28,25,3,14
2,2007,681400,16,11,5,14
3,2007,681400,46,37,9,14
4,2007,681400,28,20,8,10
5,2007,681400,41,25,16,9
6,2007,681400,45,31,14,21
7,2007,681400,40,23,17,17
8,2007,681400,49,34,15,22
9,2007,681400,50,37,13,16
10,2007,681400,39,27,12,11
11,2007,681400,34,30,4,10
12,2007,681400,30,26,4,9
1,2008,681400,41,38,3,10
2,2008,681400,24,22,2,9
3,2008,681400,35,29,6,11
4,2008,681400,62,54,8,3
5,2008,681400,59,48,11,9
6,2008,681400,42,34,8,11
7,2008,681400,59,43,16,15
8,2008,681400,39,29,10,13
9,2008,681400,46,34,12,7
10,2008,681400,40,31,9,10
11,2008,681400,40,29,11,12
12,2008,681400,19,16,3,7
1,2009,681400,30,27,3,6
2,2009,681400,30,24,6,4
3,2009,681400,31,26,5,7
4,2009,681400,29,21,8,15
5,2009,681400,41,31,10,16
6,2009,681400,41,31,10,10
7,2009,681400,30,26,4,16
8,2009,681400,47,38,9,9
9,2009,681400,39,33,6,8
10,2009,681400,44,36,8,15
11,2009,681400,34,32,2,15
12,2009,681400,29,23,6,11
1,2010,681400,29,21,8,7
2,2010,681400,29,25,4,14
3,2010,681400,27,19,8,32
4,2010,681400,38,31,7,8
5,2010,681400,41,33,8,12
6,2010,681400,45,38,7,11
7,2010,681400,30,26,4,8
8,2010,681400,45,38,7,12
9,2010,681400,49,44,5,11
10,2010,681400,40,36,4,8
11,2010,681400,38,26,12,8
12,2010,681400,27,24,3,12
1,2011,681400,24,19,5,12
2,2011,681400,19,16,3,11
1,1999,691100,41,34,7,21
2,1999,691100,37,31,6,29
3,1999,691100,37,27,10,16
4,1999,691100,51,41,10,16
5,1999,691100,60,47,13,7
6,1999,691100,54,44,10,24
7,1999,691100,44,27,17,15
8,1999,691100,52,40,12,8
9,1999,691100,29,20,9,16
10,1999,691100,44,37,7,15
11,1999,691100,46,35,11,8
12,1999,691100,28,24,4,6
1,2000,691100,33,26,7,19
2,2000,691100,40,25,15,8
3,2000,691100,32,24,8,23
4,2000,691100,35,23,12,9
5,2000,691100,50,38,12,12
6,2000,691100,39,31,8,13
7,2000,691100,55,41,14,7
8,2000,691100,59,47,12,7
9,2000,691100,60,45,15,3
10,2000,691100,43,35,8,12
11,2000,691100,34,28,6,7
12,2000,691100,29,21,8,6
1,2001,691100,38,28,10,18
2,2001,691100,43,32,11,6
3,2001,691100,42,33,9,18
4,2001,691100,49,39,10,9
5,2001,691100,48,38,10,3
6,2001,691100,41,29,12,8
7,2001,691100,41,27,14,6
8,2001,691100,52,42,10,10
9,2001,691100,44,31,13,11
10,2001,691100,46,42,4,10
11,2001,691100,28,23,5,7
12,2001,691100,39,34,5,6
1,2002,691100,50,39,11,2
2,2002,691100,33,27,6,9
3,2002,691100,49,42,7,10
4,2002,691100,42,26,16,9
5,2002,691100,56,43,13,8
6,2002,691100,39,28,11,4
7,2002,691100,74,56,18,6
8,2002,691100,47,36,11,3
9,2002,691100,39,23,16,5
10,2002,691100,33,26,7,6
11,2002,691100,37,29,8,3
12,2002,691100,39,33,6,5
1,2003,691100,34,31,3,9
2,2003,691100,25,20,5,4
3,2003,691100,38,30,8,5
4,2003,691100,28,21,7,8
5,2003,691100,50,40,10,9
6,2003,691100,38,28,10,8
7,2003,691100,46,38,8,0
8,2003,691100,44,34,10,8
9,2003,691100,39,31,8,5
10,2003,691100,38,25,13,9
11,2003,691100,46,34,12,6
12,2003,691100,37,33,4,6
1,2004,691100,37,31,6,9
2,2004,691100,30,25,5,19
3,2004,691100,45,41,4,10
4,2004,691100,33,27,6,8
5,2004,691100,37,26,11,11
6,2004,691100,45,37,8,8
7,2004,691100,38,33,5,6
8,2004,691100,52,40,12,4
9,2004,691100,48,38,10,5
10,2004,691100,42,36,6,12
11,2004,691100,30,22,8,14
12,2004,691100,47,42,5,5
1,2005,691100,29,24,5,8
2,2005,691100,17,13,4,8
3,2005,691100,34,27,7,27
4,2005,691100,37,29,8,9
5,2005,691100,39,29,10,14
6,2005,691100,40,32,8,13
7,2005,691100,39,32,7,9
8,2005,691100,59,50,9,17
9,2005,691100,48,40,8,11
10,2005,691100,38,28,10,23
11,2005,691100,47,39,8,16
12,2005,691100,34,29,5,13
1,2006,691100,36,31,5,9
2,2006,691100,26,21,5,9
3,2006,691100,33,27,6,18
4,2006,691100,46,37,9,7
5,2006,691100,45,36,9,12
6,2006,691100,38,28,10,9
7,2006,691100,48,41,7,12
8,2006,691100,45,38,7,15
9,2006,691100,34,29,5,7
10,2006,691100,39,31,8,5
11,2006,691100,43,36,7,8
12,2006,691100,51,44,7,4
1,2007,691100,44,37,7,18
2,2007,691100,28,24,4,20
3,2007,691100,37,27,10,16
4,2007,691100,27,19,8,18
5,2007,691100,37,31,6,13
6,2007,691100,43,35,8,8
7,2007,691100,56,48,8,6
8,2007,691100,39,35,4,7
9,2007,691100,35,32,3,7
10,2007,691100,58,51,7,11
11,2007,691100,23,20,3,19
12,2007,691100,45,40,5,18
1,2008,691100,49,42,7,15
2,2008,691100,26,23,3,12
3,2008,691100,53,46,7,8
4,2008,691100,53,47,6,12
5,2008,691100,36,32,4,6
6,2008,691100,27,19,8,5
7,2008,691100,36,33,3,7
8,2008,691100,55,43,12,5
9,2008,691100,42,34,8,14
10,2008,691100,45,34,11,13
11,2008,691100,33,29,4,17
12,2008,691100,38,31,7,7
1,2009,691100,25,22,3,14
2,2009,691100,21,15,6,19
3,2009,691100,33,27,6,11
4,2009,691100,34,23,11,17
5,2009,691100,50,42,8,7
6,2009,691100,33,26,7,13
7,2009,691100,27,20,7,4
8,2009,691100,39,29,10,12
9,2009,691100,30,26,4,11
10,2009,691100,39,34,5,7
11,2009,691100,37,29,8,3
12,2009,691100,36,30,6,11
1,2010,691100,31,22,9,10
2,2010,691100,24,22,2,12
3,2010,691100,28,23,5,14
4,2010,691100,29,26,3,8
5,2010,691100,39,33,6,7
6,2010,691100,26,21,5,5
7,2010,691100,27,22,5,9
8,2010,691100,38,29,9,12
9,2010,691100,47,41,6,14
10,2010,691100,42,36,6,9
11,2010,691100,31,26,5,11
12,2010,691100,33,29,4,5
1,2011,691100,32,28,4,20
2,2011,691100,11,9,2,9
1,1999,691000,26,26,0,2
2,1999,691000,24,21,3,3
3,1999,691000,42,35,7,0
4,1999,691000,35,32,3,3
5,1999,691000,41,36,5,2
6,1999,691000,29,24,5,1
7,1999,691000,29,26,3,1
8,1999,691000,37,32,5,2
9,1999,691000,31,28,3,3
10,1999,691000,31,29,2,1
11,1999,691000,31,30,1,2
12,1999,691000,23,20,3,1
1,2000,691000,33,29,4,0
2,2000,691000,31,26,5,4
3,2000,691000,30,29,1,2
4,2000,691000,23,22,1,3
5,2000,691000,30,26,4,3
6,2000,691000,26,22,4,1
7,2000,691000,42,39,3,3
8,2000,691000,37,36,1,0
9,2000,691000,42,40,2,1
10,2000,691000,50,47,3,2
11,2000,691000,37,35,2,1
12,2000,691000,24,24,0,3
1,2001,691000,32,31,1,1
2,2001,691000,29,26,3,3
3,2001,691000,29,26,3,1
4,2001,691000,19,18,1,1
5,2001,691000,31,28,3,2
6,2001,691000,29,23,6,2
7,2001,691000,35,33,2,1
8,2001,691000,26,23,3,2
9,2001,691000,42,37,5,3
10,2001,691000,36,31,5,1
11,2001,691000,31,28,3,3
12,2001,691000,38,38,0,0
1,2002,691000,38,36,2,12
2,2002,691000,20,18,2,7
3,2002,691000,28,21,7,7
4,2002,691000,28,20,8,2
5,2002,691000,17,15,2,2
6,2002,691000,32,28,4,2
7,2002,691000,28,27,1,1
8,2002,691000,31,28,3,10
9,2002,691000,23,21,2,6
10,2002,691000,33,32,1,4
11,2002,691000,27,24,3,4
12,2002,691000,18,17,1,4
1,2003,691000,18,17,1,4
2,2003,691000,14,11,3,4
3,2003,691000,30,28,2,4
4,2003,691000,20,18,2,7
5,2003,691000,27,26,1,3
6,2003,691000,21,19,2,8
7,2003,691000,29,27,2,3
8,2003,691000,34,30,4,2
9,2003,691000,34,32,2,4
10,2003,691000,36,34,2,1
11,2003,691000,30,29,1,5
12,2003,691000,18,13,5,1
1,2004,691000,24,22,2,5
2,2004,691000,18,18,0,6
3,2004,691000,15,13,2,2
4,2004,691000,26,25,1,4
5,2004,691000,29,26,3,3
6,2004,691000,39,33,6,6
7,2004,691000,52,48,4,8
8,2004,691000,42,39,3,8
9,2004,691000,22,20,2,6
10,2004,691000,38,36,2,2
11,2004,691000,26,24,2,2
12,2004,691000,26,25,1,5
1,2005,691000,30,26,4,4
2,2005,691000,23,20,3,6
3,2005,691000,33,28,5,2
4,2005,691000,22,21,1,0
5,2005,691000,29,26,3,7
6,2005,691000,24,21,3,4
7,2005,691000,25,24,1,6
8,2005,691000,27,26,1,4
9,2005,691000,26,24,2,6
10,2005,691000,44,42,2,8
11,2005,691000,36,35,1,10
12,2005,691000,25,20,5,8
1,2006,691000,46,40,6,12
2,2006,691000,18,16,2,9
3,2006,691000,21,18,3,4
4,2006,691000,22,21,1,4
5,2006,691000,32,26,6,8
6,2006,691000,21,16,5,1
7,2006,691000,38,38,0,3
8,2006,691000,25,20,5,3
9,2006,691000,39,30,9,2
10,2006,691000,31,26,5,3
11,2006,691000,24,23,1,4
12,2006,691000,26,25,1,3
1,2007,691000,33,32,1,2
2,2007,691000,9,9,0,3
3,2007,691000,21,17,4,3
4,2007,691000,23,20,3,6
5,2007,691000,20,17,3,12
6,2007,691000,32,29,3,10
7,2007,691000,25,20,5,8
8,2007,691000,37,34,3,6
9,2007,691000,14,13,1,6
10,2007,691000,30,26,4,2
11,2007,691000,24,19,5,2
12,2007,691000,18,16,2,8
1,2008,691000,21,19,2,5
2,2008,691000,16,13,3,2
3,2008,691000,22,18,4,7
4,2008,691000,27,23,4,3
5,2008,691000,37,36,1,6
6,2008,691000,23,20,3,9
7,2008,691000,40,36,4,5
8,2008,691000,31,24,7,9
9,2008,691000,29,28,1,5
10,2008,691000,19,17,2,6
11,2008,691000,28,25,3,5
12,2008,691000,14,14,0,6
1,2009,691000,12,10,2,6
2,2009,691000,17,14,3,4
3,2009,691000,18,17,1,2
4,2009,691000,31,28,3,9
5,2009,691000,28,18,10,10
6,2009,691000,25,23,2,3
7,2009,691000,32,31,1,2
8,2009,691000,25,22,3,8
9,2009,691000,31,26,5,11
10,2009,691000,25,24,1,9
11,2009,691000,27,25,2,8
12,2009,691000,21,19,2,9
1,2010,691000,29,26,3,7
2,2010,691000,8,7,1,12
3,2010,691000,26,23,3,10
4,2010,691000,24,21,3,2
5,2010,691000,21,18,3,5
6,2010,691000,23,21,2,2
7,2010,691000,26,25,1,4
8,2010,691000,29,26,3,2
9,2010,691000,30,28,2,5
10,2010,691000,24,22,2,9
11,2010,691000,19,14,5,8
12,2010,691000,15,14,1,4
1,2011,691000,15,11,4,6
2,2011,691000,11,11,0,9
1,1999,690900,37,23,14,5
2,1999,690900,29,23,6,2
3,1999,690900,25,22,3,6
4,1999,690900,25,19,6,5
5,1999,690900,26,24,2,5
6,1999,690900,31,27,4,6
7,1999,690900,28,20,8,8
8,1999,690900,34,26,8,4
9,1999,690900,35,28,7,13
10,1999,690900,28,24,4,2
11,1999,690900,43,40,3,7
12,1999,690900,36,33,3,9
1,2000,690900,36,30,6,7
2,2000,690900,46,41,5,6
3,2000,690900,29,19,10,12
4,2000,690900,23,18,5,6
5,2000,690900,27,22,5,6
6,2000,690900,39,32,7,3
7,2000,690900,43,31,12,3
8,2000,690900,34,32,2,6
9,2000,690900,28,23,5,7
10,2000,690900,26,22,4,6
11,2000,690900,20,18,2,10
12,2000,690900,22,18,4,7
1,2001,690900,35,25,10,5
2,2001,690900,24,20,4,3
3,2001,690900,22,19,3,7
4,2001,690900,29,20,9,7
5,2001,690900,28,23,5,4
6,2001,690900,43,32,11,8
7,2001,690900,44,41,3,4
8,2001,690900,34,28,6,5
9,2001,690900,37,31,6,2
10,2001,690900,40,35,5,6
11,2001,690900,32,27,5,8
12,2001,690900,25,23,2,9
1,2002,690900,32,29,3,5
2,2002,690900,20,17,3,3
3,2002,690900,42,33,9,6
4,2002,690900,42,38,4,6
5,2002,690900,37,27,10,2
6,2002,690900,44,34,10,7
7,2002,690900,40,32,8,3
8,2002,690900,42,31,11,7
9,2002,690900,43,32,11,4
10,2002,690900,36,30,6,1
11,2002,690900,31,24,7,4
12,2002,690900,22,19,3,0
1,2003,690900,27,23,4,4
2,2003,690900,25,19,6,6
3,2003,690900,32,26,6,15
4,2003,690900,38,33,5,5
5,2003,690900,31,27,4,6
6,2003,690900,32,27,5,10
7,2003,690900,47,43,4,5
8,2003,690900,47,41,6,10
9,2003,690900,34,25,9,9
10,2003,690900,36,28,8,8
11,2003,690900,35,29,6,4
12,2003,690900,33,28,5,7
1,2004,690900,31,22,9,17
2,2004,690900,30,25,5,4
3,2004,690900,40,33,7,15
4,2004,690900,37,28,9,7
5,2004,690900,32,27,5,10
6,2004,690900,37,27,10,10
7,2004,690900,44,32,12,12
8,2004,690900,41,35,6,9
9,2004,690900,34,30,4,9
10,2004,690900,39,36,3,11
11,2004,690900,27,25,2,10
12,2004,690900,26,19,7,12
1,2005,690900,22,15,7,7
2,2005,690900,24,20,4,3
3,2005,690900,33,24,9,10
4,2005,690900,34,26,8,7
5,2005,690900,37,28,9,6
6,2005,690900,35,33,2,8
7,2005,690900,27,19,8,7
8,2005,690900,38,24,14,10
9,2005,690900,36,25,11,9
10,2005,690900,30,23,7,20
11,2005,690900,39,34,5,13
12,2005,690900,30,28,2,21
1,2006,690900,37,31,6,3
2,2006,690900,24,20,4,19
3,2006,690900,27,24,3,13
4,2006,690900,35,27,8,19
5,2006,690900,30,24,6,7
6,2006,690900,29,21,8,14
7,2006,690900,50,44,6,2
8,2006,690900,43,38,5,13
9,2006,690900,35,33,2,4
10,2006,690900,47,42,5,4
11,2006,690900,29,25,4,10
12,2006,690900,31,28,3,17
1,2007,690900,49,44,5,9
2,2007,690900,20,14,6,11
3,2007,690900,36,27,9,13
4,2007,690900,38,31,7,21
5,2007,690900,40,30,10,9
6,2007,690900,43,38,5,12
7,2007,690900,44,37,7,25
8,2007,690900,42,31,11,8
9,2007,690900,40,30,10,20
10,2007,690900,43,37,6,11
11,2007,690900,36,31,5,10
12,2007,690900,34,27,7,6
1,2008,690900,27,24,3,7
2,2008,690900,26,20,6,6
3,2008,690900,22,19,3,5
4,2008,690900,33,26,7,6
5,2008,690900,32,21,11,9
6,2008,690900,35,25,10,8
7,2008,690900,51,41,10,13
8,2008,690900,42,33,9,6
9,2008,690900,35,25,10,13
10,2008,690900,45,42,3,9
11,2008,690900,30,23,7,14
12,2008,690900,34,22,12,9
1,2009,690900,26,21,5,7
2,2009,690900,16,12,4,5
3,2009,690900,28,21,7,12
4,2009,690900,30,27,3,17
5,2009,690900,34,29,5,9
6,2009,690900,42,33,9,4
7,2009,690900,33,25,8,9
8,2009,690900,53,41,12,6
9,2009,690900,32,22,10,13
10,2009,690900,30,24,6,6
11,2009,690900,29,24,5,5
12,2009,690900,30,25,5,11
1,2010,690900,36,32,4,13
2,2010,690900,19,13,6,5
3,2010,690900,31,22,9,7
4,2010,690900,42,32,10,9
5,2010,690900,32,24,8,6
6,2010,690900,43,33,10,11
7,2010,690900,43,30,13,15
8,2010,690900,36,32,4,9
9,2010,690900,31,23,8,8
10,2010,690900,30,23,7,10
11,2010,690900,20,18,2,3
12,2010,690900,23,19,4,8
1,2011,690900,17,16,1,6
2,2011,690900,10,9,1,7
1,1999,841800,31,23,8,8
2,1999,841800,27,21,6,12
3,1999,841800,25,19,6,10
4,1999,841800,23,16,7,6
5,1999,841800,38,26,12,5
6,1999,841800,38,23,15,18
7,1999,841800,47,42,5,12
8,1999,841800,29,24,5,19
9,1999,841800,44,28,16,10
10,1999,841800,24,15,9,7
11,1999,841800,31,18,13,26
12,1999,841800,25,19,6,24
1,2000,841800,31,24,7,34
2,2000,841800,34,24,10,16
3,2000,841800,21,16,5,14
4,2000,841800,40,34,6,10
5,2000,841800,36,23,13,12
6,2000,841800,29,21,8,20
7,2000,841800,34,25,9,11
8,2000,841800,29,16,13,9
9,2000,841800,37,28,9,11
10,2000,841800,36,29,7,8
11,2000,841800,17,13,4,12
12,2000,841800,21,18,3,14
1,2001,841800,32,25,7,5
2,2001,841800,24,18,6,8
3,2001,841800,23,17,6,8
4,2001,841800,26,16,10,6
5,2001,841800,39,27,12,3
6,2001,841800,51,35,16,7
7,2001,841800,35,25,10,6
8,2001,841800,32,24,8,4
9,2001,841800,34,24,10,6
10,2001,841800,39,27,12,12
11,2001,841800,34,19,15,12
12,2001,841800,20,19,1,21
1,2002,841800,32,18,14,24
2,2002,841800,30,18,12,11
3,2002,841800,27,17,10,17
4,2002,841800,38,18,20,10
5,2002,841800,40,25,15,4
6,2002,841800,34,16,18,9
7,2002,841800,33,19,14,7
8,2002,841800,34,22,12,16
9,2002,841800,19,9,10,9
10,2002,841800,26,17,9,10
11,2002,841800,29,20,9,9
12,2002,841800,19,15,4,10
1,2003,841800,38,29,9,14
2,2003,841800,21,17,4,23
3,2003,841800,38,32,6,8
4,2003,841800,38,27,11,16
5,2003,841800,35,29,6,3
6,2003,841800,28,18,10,8
7,2003,841800,55,43,12,4
8,2003,841800,25,18,7,2
9,2003,841800,27,17,10,6
10,2003,841800,24,20,4,13
11,2003,841800,16,13,3,28
12,2003,841800,23,19,4,8
1,2004,841800,27,23,4,10
2,2004,841800,22,17,5,18
3,2004,841800,19,15,4,16
4,2004,841800,25,16,9,4
5,2004,841800,44,28,16,14
6,2004,841800,38,24,14,19
7,2004,841800,28,22,6,14
8,2004,841800,21,16,5,19
9,2004,841800,29,17,12,39
10,2004,841800,31,23,8,44
11,2004,841800,22,15,7,15
12,2004,841800,21,15,6,29
1,2005,841800,31,24,7,6
2,2005,841800,20,15,5,12
3,2005,841800,32,22,10,7
4,2005,841800,21,16,5,23
5,2005,841800,31,22,9,18
6,2005,841800,37,29,8,11
7,2005,841800,28,20,8,14
8,2005,841800,34,29,5,18
9,2005,841800,29,22,7,22
10,2005,841800,29,20,9,13
11,2005,841800,23,18,5,8
12,2005,841800,14,11,3,2
1,2006,841800,29,26,3,10
2,2006,841800,18,17,1,20
3,2006,841800,22,15,7,9
4,2006,841800,19,13,6,4
5,2006,841800,49,43,6,16
6,2006,841800,27,18,9,9
7,2006,841800,27,18,9,18
8,2006,841800,21,18,3,17
9,2006,841800,22,12,10,9
10,2006,841800,22,17,5,11
11,2006,841800,17,13,4,5
12,2006,841800,28,24,4,12
1,2007,841800,18,14,4,6
2,2007,841800,22,15,7,14
3,2007,841800,27,17,10,14
4,2007,841800,22,13,9,19
5,2007,841800,24,11,13,10
6,2007,841800,25,16,9,11
7,2007,841800,33,28,5,29
8,2007,841800,36,25,11,10
9,2007,841800,22,13,9,19
10,2007,841800,22,16,6,7
11,2007,841800,21,19,2,9
12,2007,841800,19,19,0,3
1,2008,841800,18,15,3,8
2,2008,841800,14,12,2,5
3,2008,841800,28,24,4,6
4,2008,841800,31,24,7,8
5,2008,841800,27,22,5,3
6,2008,841800,23,13,10,5
7,2008,841800,27,21,6,2
8,2008,841800,24,19,5,11
9,2008,841800,33,20,13,4
10,2008,841800,30,19,11,11
11,2008,841800,21,16,5,2
12,2008,841800,20,19,1,10
1,2009,841800,15,13,2,19
2,2009,841800,10,8,2,7
3,2009,841800,13,11,2,4
4,2009,841800,22,18,4,8
5,2009,841800,24,19,5,3
6,2009,841800,22,13,9,7
7,2009,841800,19,12,7,4
8,2009,841800,29,21,8,3
9,2009,841800,29,24,5,6
10,2009,841800,17,12,5,9
11,2009,841800,18,15,3,3
12,2009,841800,24,21,3,1
1,2010,841800,18,15,3,13
2,2010,841800,19,13,6,5
3,2010,841800,21,15,6,5
4,2010,841800,19,15,4,13
5,2010,841800,28,24,4,8
6,2010,841800,18,13,5,4
7,2010,841800,23,17,6,7
8,2010,841800,20,15,5,11
9,2010,841800,28,20,8,4
10,2010,841800,17,14,3,6
11,2010,841800,17,13,4,2
12,2010,841800,18,17,1,5
1,2011,841800,11,9,2,14
2,2011,841800,8,6,2,3
1,1999,430400,25,18,7,4
2,1999,430400,21,14,7,10
3,1999,430400,27,18,9,2
4,1999,430400,26,21,5,17
5,1999,430400,26,23,3,2
6,1999,430400,24,19,5,9
7,1999,430400,28,20,8,8
8,1999,430400,27,21,6,9
9,1999,430400,22,17,5,11
10,1999,430400,16,16,0,9
11,1999,430400,20,17,3,8
12,1999,430400,17,14,3,1
1,2000,430400,31,25,6,6
2,2000,430400,26,18,8,11
3,2000,430400,25,14,11,13
4,2000,430400,27,21,6,12
5,2000,430400,20,14,6,11
6,2000,430400,29,15,14,2
7,2000,430400,28,22,6,3
8,2000,430400,22,15,7,5
9,2000,430400,29,24,5,9
10,2000,430400,24,15,9,2
11,2000,430400,25,19,6,4
12,2000,430400,18,14,4,5
1,2001,430400,18,15,3,10
2,2001,430400,22,16,6,6
3,2001,430400,25,17,8,5
4,2001,430400,20,7,13,2
5,2001,430400,22,17,5,7
6,2001,430400,31,19,12,5
7,2001,430400,26,16,10,6
8,2001,430400,19,14,5,2
9,2001,430400,24,18,6,14
10,2001,430400,24,20,4,4
11,2001,430400,17,13,4,4
12,2001,430400,21,16,5,7
1,2002,430400,17,16,1,7
2,2002,430400,29,23,6,18
3,2002,430400,21,17,4,6
4,2002,430400,22,18,4,5
5,2002,430400,30,20,10,7
6,2002,430400,23,17,6,4
7,2002,430400,33,19,14,6
8,2002,430400,22,18,4,12
9,2002,430400,19,13,6,8
10,2002,430400,24,16,8,5
11,2002,430400,19,17,2,5
12,2002,430400,26,20,6,9
1,2003,430400,24,22,2,8
2,2003,430400,24,20,4,10
3,2003,430400,20,15,5,8
4,2003,430400,31,28,3,10
5,2003,430400,16,11,5,10
6,2003,430400,19,13,6,7
7,2003,430400,15,11,4,5
8,2003,430400,30,22,8,9
9,2003,430400,18,13,5,7
10,2003,430400,30,19,11,7
11,2003,430400,21,13,8,6
12,2003,430400,23,20,3,5
1,2004,430400,23,19,4,12
2,2004,430400,21,17,4,5
3,2004,430400,25,22,3,6
4,2004,430400,31,26,5,11
5,2004,430400,39,32,7,9
6,2004,430400,26,23,3,11
7,2004,430400,22,16,6,13
8,2004,430400,31,23,8,19
9,2004,430400,26,21,5,19
10,2004,430400,17,13,4,16
11,2004,430400,26,22,4,3
12,2004,430400,19,15,4,11
1,2005,430400,15,12,3,6
2,2005,430400,17,14,3,6
3,2005,430400,23,20,3,11
4,2005,430400,25,19,6,11
5,2005,430400,31,27,4,11
6,2005,430400,38,34,4,8
7,2005,430400,34,31,3,22
8,2005,430400,33,28,5,7
9,2005,430400,30,25,5,7
10,2005,430400,30,26,4,9
11,2005,430400,18,17,1,7
12,2005,430400,20,18,2,4
1,2006,430400,15,11,4,6
2,2006,430400,16,9,7,6
3,2006,430400,26,21,5,15
4,2006,430400,30,26,4,9
5,2006,430400,36,34,2,13
6,2006,430400,27,26,1,13
7,2006,430400,36,29,7,9
8,2006,430400,38,35,3,14
9,2006,430400,19,13,6,17
10,2006,430400,21,17,4,12
11,2006,430400,17,15,2,8
12,2006,430400,19,15,4,16
1,2007,430400,18,12,6,9
2,2007,430400,21,14,7,5
3,2007,430400,26,22,4,7
4,2007,430400,27,22,5,6
5,2007,430400,28,26,2,6
6,2007,430400,20,17,3,9
7,2007,430400,25,19,6,27
8,2007,430400,32,21,11,10
9,2007,430400,19,15,4,14
10,2007,430400,30,24,6,14
11,2007,430400,21,19,2,8
12,2007,430400,21,19,2,3
1,2008,430400,32,28,4,2
2,2008,430400,33,27,6,9
3,2008,430400,29,25,4,5
4,2008,430400,44,39,5,4
5,2008,430400,33,32,1,7
6,2008,430400,36,27,9,3
7,2008,430400,38,34,4,5
8,2008,430400,32,29,3,4
9,2008,430400,40,35,5,6
10,2008,430400,44,37,7,12
11,2008,430400,35,31,4,5
12,2008,430400,19,18,1,2
1,2009,430400,27,22,5,3
2,2009,430400,16,11,5,10
3,2009,430400,19,15,4,4
4,2009,430400,21,20,1,1
5,2009,430400,25,17,8,4
6,2009,430400,32,27,5,3
7,2009,430400,21,16,5,6
8,2009,430400,27,20,7,3
9,2009,430400,20,14,6,6
10,2009,430400,27,22,5,11
11,2009,430400,20,19,1,10
12,2009,430400,34,27,7,4
1,2010,430400,16,14,2,9
2,2010,430400,15,13,2,7
3,2010,430400,16,15,1,5
4,2010,430400,20,16,4,4
5,2010,430400,24,21,3,5
6,2010,430400,45,41,4,6
7,2010,430400,54,40,14,9
8,2010,430400,36,32,4,6
9,2010,430400,25,22,3,3
10,2010,430400,21,18,3,1
11,2010,430400,16,11,5,4
12,2010,430400,20,18,2,1
1,2011,430400,18,14,4,7
2,2011,430400,10,6,4,7
1,1999,430900,60,58,2,3
2,1999,430900,48,40,8,2
3,1999,430900,58,55,3,3
4,1999,430900,52,49,3,7
5,1999,430900,65,58,7,10
6,1999,430900,62,52,10,7
7,1999,430900,53,51,2,4
8,1999,430900,75,69,6,4
9,1999,430900,52,47,5,3
10,1999,430900,43,39,4,7
11,1999,430900,55,47,8,1
12,1999,430900,65,57,8,0
1,2000,430900,41,38,3,3
2,2000,430900,28,23,5,3
3,2000,430900,56,53,3,9
4,2000,430900,39,36,3,9
5,2000,430900,50,46,4,4
6,2000,430900,41,38,3,6
7,2000,430900,57,50,7,9
8,2000,430900,51,46,5,1
9,2000,430900,35,32,3,6
10,2000,430900,62,55,7,6
11,2000,430900,63,62,1,2
12,2000,430900,55,49,6,3
1,2001,430900,59,54,5,4
2,2001,430900,45,42,3,5
3,2001,430900,39,34,5,0
4,2001,430900,42,39,3,4
5,2001,430900,51,46,5,2
6,2001,430900,34,28,6,6
7,2001,430900,36,32,4,2
8,2001,430900,38,36,2,1
9,2001,430900,45,44,1,2
10,2001,430900,38,36,2,5
11,2001,430900,35,33,2,0
12,2001,430900,42,41,1,4
1,2002,430900,45,45,0,3
2,2002,430900,29,27,2,2
3,2002,430900,44,40,4,6
4,2002,430900,36,33,3,4
5,2002,430900,41,38,3,1
6,2002,430900,34,28,6,0
7,2002,430900,44,37,7,2
8,2002,430900,36,33,3,6
9,2002,430900,39,32,7,2
10,2002,430900,48,39,9,2
11,2002,430900,34,33,1,5
12,2002,430900,57,55,2,2
1,2003,430900,46,43,3,3
2,2003,430900,30,29,1,4
3,2003,430900,45,40,5,4
4,2003,430900,32,30,2,7
5,2003,430900,46,42,4,0
6,2003,430900,57,54,3,2
7,2003,430900,43,39,4,1
8,2003,430900,45,39,6,7
9,2003,430900,41,34,7,1
10,2003,430900,35,27,8,3
11,2003,430900,38,35,3,3
12,2003,430900,35,30,5,0
1,2004,430900,37,31,6,4
2,2004,430900,29,27,2,4
3,2004,430900,38,33,5,3
4,2004,430900,43,36,7,3
5,2004,430900,43,35,8,2
6,2004,430900,40,37,3,4
7,2004,430900,30,26,4,5
8,2004,430900,33,33,0,4
9,2004,430900,35,29,6,4
10,2004,430900,32,30,2,12
11,2004,430900,29,28,1,0
12,2004,430900,39,35,4,3
1,2005,430900,28,22,6,1
2,2005,430900,31,26,5,7
3,2005,430900,33,28,5,8
4,2005,430900,46,38,8,2
5,2005,430900,37,35,2,9
6,2005,430900,36,35,1,5
7,2005,430900,42,40,2,2
8,2005,430900,49,44,5,4
9,2005,430900,35,30,5,5
10,2005,430900,35,35,0,2
11,2005,430900,30,28,2,2
12,2005,430900,28,26,2,5
1,2006,430900,32,29,3,3
2,2006,430900,28,27,1,3
3,2006,430900,34,33,1,9
4,2006,430900,35,33,2,3
5,2006,430900,32,30,2,10
6,2006,430900,38,35,3,16
7,2006,430900,37,33,4,10
8,2006,430900,38,33,5,15
9,2006,430900,22,21,1,8
10,2006,430900,37,32,5,6
11,2006,430900,37,32,5,4
12,2006,430900,33,30,3,2
1,2007,430900,25,23,2,6
2,2007,430900,26,23,3,13
3,2007,430900,26,24,2,7
4,2007,430900,29,25,4,13
5,2007,430900,40,37,3,11
6,2007,430900,32,30,2,7
7,2007,430900,29,24,5,3
8,2007,430900,35,31,4,2
9,2007,430900,42,35,7,2
10,2007,430900,36,32,4,5
11,2007,430900,45,45,0,3
12,2007,430900,42,36,6,4
1,2008,430900,49,42,7,4
2,2008,430900,38,35,3,3
3,2008,430900,39,36,3,3
4,2008,430900,36,31,5,2
5,2008,430900,39,30,9,3
6,2008,430900,25,24,1,3
7,2008,430900,43,36,7,2
8,2008,430900,33,28,5,6
9,2008,430900,38,35,3,2
10,2008,430900,41,37,4,12
11,2008,430900,27,24,3,1
12,2008,430900,19,18,1,7
1,2009,430900,25,23,2,7
2,2009,430900,27,24,3,4
3,2009,430900,24,21,3,7
4,2009,430900,28,23,5,8
5,2009,430900,37,34,3,2
6,2009,430900,32,28,4,3
7,2009,430900,35,32,3,5
8,2009,430900,33,25,8,3
9,2009,430900,32,27,5,3
10,2009,430900,25,21,4,6
11,2009,430900,38,36,2,3
12,2009,430900,27,24,3,1
1,2010,430900,31,28,3,0
2,2010,430900,16,16,0,5
3,2010,430900,29,25,4,4
4,2010,430900,36,31,5,5
5,2010,430900,41,33,8,5
6,2010,430900,33,31,2,4
7,2010,430900,24,24,0,2
8,2010,430900,38,37,1,4
9,2010,430900,25,23,2,3
10,2010,430900,33,29,4,1
11,2010,430900,34,31,3,0
12,2010,430900,31,31,0,1
1,2011,430900,29,24,5,3
2,2011,430900,16,14,2,3
1,1999,430800,16,14,2,6
2,1999,430800,11,9,2,5
3,1999,430800,17,15,2,7
4,1999,430800,14,11,3,6
5,1999,430800,12,9,3,5
6,1999,430800,13,12,1,5
7,1999,430800,12,11,1,1
8,1999,430800,16,15,1,2
9,1999,430800,15,9,6,2
10,1999,430800,17,14,3,3
11,1999,430800,23,23,0,3
12,1999,430800,16,12,4,1
1,2000,430800,14,12,2,5
2,2000,430800,17,16,1,2
3,2000,430800,9,9,0,3
4,2000,430800,14,9,5,3
5,2000,430800,12,10,2,3
6,2000,430800,16,14,2,4
7,2000,430800,11,10,1,3
8,2000,430800,15,14,1,2
9,2000,430800,15,14,1,2
10,2000,430800,10,9,1,2
11,2000,430800,19,15,4,2
12,2000,430800,15,13,2,0
1,2001,430800,11,10,1,2
2,2001,430800,8,6,2,1
3,2001,430800,11,9,2,1
4,2001,430800,6,5,1,3
5,2001,430800,20,19,1,5
6,2001,430800,14,13,1,3
7,2001,430800,20,17,3,4
8,2001,430800,10,8,2,7
9,2001,430800,19,15,4,6
10,2001,430800,17,12,5,4
11,2001,430800,19,16,3,1
12,2001,430800,5,4,1,0
1,2002,430800,10,8,2,2
2,2002,430800,12,11,1,2
3,2002,430800,14,13,1,3
4,2002,430800,11,11,0,0
5,2002,430800,10,7,3,4
6,2002,430800,13,11,2,3
7,2002,430800,18,14,4,2
8,2002,430800,16,13,3,5
9,2002,430800,14,11,3,3
10,2002,430800,15,13,2,7
11,2002,430800,16,14,2,6
12,2002,430800,20,16,4,0
1,2003,430800,11,9,2,0
2,2003,430800,7,7,0,1
3,2003,430800,14,12,2,1
4,2003,430800,23,20,3,2
5,2003,430800,14,11,3,4
6,2003,430800,11,10,1,2
7,2003,430800,22,16,6,3
8,2003,430800,20,16,4,5
9,2003,430800,14,13,1,1
10,2003,430800,12,8,4,0
11,2003,430800,22,19,3,3
12,2003,430800,15,12,3,3
1,2004,430800,8,7,1,5
2,2004,430800,6,6,0,0
3,2004,430800,21,18,3,1
4,2004,430800,20,19,1,1
5,2004,430800,15,11,4,5
6,2004,430800,25,22,3,4
7,2004,430800,21,15,6,2
8,2004,430800,8,8,0,3
9,2004,430800,14,12,2,0
10,2004,430800,7,7,0,3
11,2004,430800,12,12,0,2
12,2004,430800,7,6,1,0
1,2005,430800,8,7,1,15
2,2005,430800,11,11,0,13
3,2005,430800,18,16,2,3
4,2005,430800,10,6,4,4
5,2005,430800,13,11,2,1
6,2005,430800,15,11,4,1
7,2005,430800,14,12,2,0
8,2005,430800,8,7,1,2
9,2005,430800,13,13,0,0
10,2005,430800,20,17,3,3
11,2005,430800,14,10,4,4
12,2005,430800,10,9,1,4
1,2006,430800,5,4,1,2
2,2006,430800,3,2,1,0
3,2006,430800,12,11,1,5
4,2006,430800,16,12,4,1
5,2006,430800,10,8,2,1
6,2006,430800,13,11,2,7
7,2006,430800,16,11,5,1
8,2006,430800,16,16,0,2
9,2006,430800,12,11,1,0
10,2006,430800,19,16,3,3
11,2006,430800,15,13,2,2
12,2006,430800,15,14,1,4
1,2007,430800,15,13,2,1
2,2007,430800,7,7,0,0
3,2007,430800,5,3,2,7
4,2007,430800,9,8,1,1
5,2007,430800,15,9,6,8
6,2007,430800,13,12,1,5
7,2007,430800,11,10,1,7
8,2007,430800,10,10,0,4
9,2007,430800,7,7,0,3
10,2007,430800,17,15,2,8
11,2007,430800,12,11,1,5
12,2007,430800,14,12,2,2
1,2008,430800,19,17,2,3
2,2008,430800,7,7,0,2
3,2008,430800,11,9,2,6
4,2008,430800,16,15,1,3
5,2008,430800,14,13,1,3
6,2008,430800,15,14,1,1
7,2008,430800,17,16,1,5
8,2008,430800,17,15,2,2
9,2008,430800,20,18,2,1
10,2008,430800,7,7,0,7
11,2008,430800,13,12,1,5
12,2008,430800,10,10,0,0
1,2009,430800,11,10,1,2
2,2009,430800,8,7,1,4
3,2009,430800,10,8,2,9
4,2009,430800,10,10,0,7
5,2009,430800,12,10,2,3
6,2009,430800,11,7,4,5
7,2009,430800,14,11,3,5
8,2009,430800,17,15,2,1
9,2009,430800,9,7,2,6
10,2009,430800,6,6,0,7
11,2009,430800,12,11,1,9
12,2009,430800,11,7,4,2
1,2010,430800,8,7,1,8
2,2010,430800,11,10,1,4
3,2010,430800,14,11,3,6
4,2010,430800,7,7,0,7
5,2010,430800,9,8,1,5
6,2010,430800,8,8,0,7
7,2010,430800,12,8,4,3
8,2010,430800,16,14,2,1
9,2010,430800,11,10,1,2
10,2010,430800,7,6,1,1
11,2010,430800,13,10,3,2
12,2010,430800,8,7,1,2
1,2011,430800,10,9,1,2
2,2011,430800,2,2,0,0
1,1999,671900,7,6,1,5
2,1999,671900,7,4,3,4
3,1999,671900,8,4,4,0
4,1999,671900,6,4,2,1
5,1999,671900,10,7,3,1
6,1999,671900,13,11,2,3
7,1999,671900,13,9,4,0
8,1999,671900,15,13,2,3
9,1999,671900,7,5,2,0
10,1999,671900,10,9,1,0
11,1999,671900,6,6,0,1
12,1999,671900,5,2,3,3
1,2000,671900,5,5,0,4
2,2000,671900,2,1,1,2
3,2000,671900,5,4,1,2
4,2000,671900,14,10,4,3
5,2000,671900,9,6,3,2
6,2000,671900,10,9,1,1
7,2000,671900,8,5,3,1
8,2000,671900,9,8,1,0
9,2000,671900,8,7,1,1
10,2000,671900,20,17,3,1
11,2000,671900,11,10,1,5
12,2000,671900,6,5,1,1
1,2001,671900,12,11,1,5
2,2001,671900,3,3,0,0
3,2001,671900,5,5,0,0
4,2001,671900,4,3,1,1
5,2001,671900,9,6,3,1
6,2001,671900,5,5,0,4
7,2001,671900,7,5,2,4
8,2001,671900,11,11,0,7
9,2001,671900,16,12,4,0
10,2001,671900,12,12,0,3
11,2001,671900,12,9,3,2
12,2001,671900,5,5,0,1
1,2002,671900,9,6,3,0
2,2002,671900,3,1,2,1
3,2002,671900,10,7,3,2
4,2002,671900,9,7,2,4
5,2002,671900,9,6,3,6
6,2002,671900,17,10,7,1
7,2002,671900,6,5,1,0
8,2002,671900,6,4,2,7
9,2002,671900,11,9,2,5
10,2002,671900,13,9,4,2
11,2002,671900,8,8,0,0
12,2002,671900,5,4,1,1
1,2003,671900,13,11,2,4
2,2003,671900,8,6,2,1
3,2003,671900,12,12,0,2
4,2003,671900,11,9,2,4
5,2003,671900,1,1,0,9
6,2003,671900,10,8,2,3
7,2003,671900,11,10,1,2
8,2003,671900,11,9,2,1
9,2003,671900,8,7,1,0
10,2003,671900,8,7,1,2
11,2003,671900,7,6,1,0
12,2003,671900,10,8,2,1
1,2004,671900,5,5,0,1
2,2004,671900,10,10,0,5
3,2004,671900,12,11,1,3
4,2004,671900,14,11,3,3
5,2004,671900,11,8,3,4
6,2004,671900,5,3,2,4
7,2004,671900,11,8,3,1
8,2004,671900,9,8,1,1
9,2004,671900,5,4,1,5
10,2004,671900,5,4,1,0
11,2004,671900,7,6,1,2
12,2004,671900,10,9,1,0
1,2005,671900,5,4,1,4
2,2005,671900,7,7,0,2
3,2005,671900,5,5,0,1
4,2005,671900,5,4,1,0
5,2005,671900,6,5,1,4
6,2005,671900,7,6,1,2
7,2005,671900,11,7,4,2
8,2005,671900,8,7,1,0
9,2005,671900,7,6,1,0
10,2005,671900,13,13,0,1
11,2005,671900,6,6,0,1
12,2005,671900,7,7,0,2
1,2006,671900,7,5,2,2
2,2006,671900,4,4,0,1
3,2006,671900,12,10,2,4
4,2006,671900,9,8,1,2
5,2006,671900,2,2,0,2
6,2006,671900,3,2,1,1
7,2006,671900,12,9,3,4
8,2006,671900,10,9,1,4
9,2006,671900,4,4,0,2
10,2006,671900,14,11,3,0
11,2006,671900,6,6,0,3
12,2006,671900,5,3,2,3
1,2007,671900,5,5,0,1
2,2007,671900,1,0,1,1
3,2007,671900,13,11,2,0
4,2007,671900,14,10,4,4
5,2007,671900,5,4,1,0
6,2007,671900,6,5,1,7
7,2007,671900,8,6,2,6
8,2007,671900,4,3,1,1
9,2007,671900,13,11,2,1
10,2007,671900,6,6,0,0
11,2007,671900,8,7,1,2
12,2007,671900,7,6,1,0
1,2008,671900,7,6,1,2
2,2008,671900,10,7,3,1
3,2008,671900,5,4,1,1
4,2008,671900,9,8,1,1
5,2008,671900,7,6,1,1
6,2008,671900,6,6,0,2
7,2008,671900,15,11,4,3
8,2008,671900,17,14,3,2
9,2008,671900,6,6,0,2
10,2008,671900,16,14,2,2
11,2008,671900,14,14,0,1
12,2008,671900,11,10,1,4
1,2009,671900,5,5,0,1
2,2009,671900,1,1,0,2
3,2009,671900,5,4,1,1
4,2009,671900,6,6,0,1
5,2009,671900,20,19,1,3
6,2009,671900,7,6,1,2
7,2009,671900,14,10,4,2
8,2009,671900,12,11,1,4
9,2009,671900,18,18,0,1
10,2009,671900,9,9,0,1
11,2009,671900,15,15,0,2
12,2009,671900,8,8,0,1
1,2010,671900,9,7,2,1
2,2010,671900,5,5,0,3
3,2010,671900,14,11,3,3
4,2010,671900,10,9,1,2
5,2010,671900,6,4,2,2
6,2010,671900,7,7,0,6
7,2010,671900,11,10,1,1
8,2010,671900,12,11,1,1
9,2010,671900,13,8,5,1
10,2010,671900,13,12,1,2
11,2010,671900,19,15,4,1
12,2010,671900,11,10,1,3
1,2011,671900,3,1,2,2
2,2011,671900,4,4,0,2
1,1999,671800,9,6,3,7
2,1999,671800,9,7,2,4
3,1999,671800,18,13,5,9
4,1999,671800,10,7,3,8
5,1999,671800,18,13,5,2
6,1999,671800,13,9,4,1
7,1999,671800,22,18,4,0
8,1999,671800,15,11,4,1
9,1999,671800,9,7,2,2
10,1999,671800,9,4,5,2
11,1999,671800,6,6,0,3
12,1999,671800,7,7,0,2
1,2000,671800,7,5,2,1
2,2000,671800,12,8,4,1
3,2000,671800,14,11,3,6
4,2000,671800,15,10,5,1
5,2000,671800,10,6,4,2
6,2000,671800,8,7,1,0
7,2000,671800,20,16,4,1
8,2000,671800,14,9,5,2
9,2000,671800,16,11,5,2
10,2000,671800,10,9,1,0
11,2000,671800,10,7,3,2
12,2000,671800,9,8,1,4
1,2001,671800,19,17,2,0
2,2001,671800,10,9,1,2
3,2001,671800,12,8,4,6
4,2001,671800,11,10,1,2
5,2001,671800,8,7,1,3
6,2001,671800,11,9,2,0
7,2001,671800,13,9,4,0
8,2001,671800,13,12,1,0
9,2001,671800,13,10,3,0
10,2001,671800,19,17,2,3
11,2001,671800,15,9,6,2
12,2001,671800,10,10,0,2
1,2002,671800,22,17,5,0
2,2002,671800,7,4,3,0
3,2002,671800,16,13,3,3
4,2002,671800,14,11,3,0
5,2002,671800,12,10,2,0
6,2002,671800,10,9,1,2
7,2002,671800,11,10,1,0
8,2002,671800,8,6,2,0
9,2002,671800,14,9,5,1
10,2002,671800,9,8,1,1
11,2002,671800,15,9,6,6
12,2002,671800,16,13,3,3
1,2003,671800,11,10,1,3
2,2003,671800,10,10,0,3
3,2003,671800,17,12,5,1
4,2003,671800,10,10,0,2
5,2003,671800,9,7,2,3
6,2003,671800,10,9,1,1
7,2003,671800,10,8,2,0
8,2003,671800,16,12,4,1
9,2003,671800,12,11,1,0
10,2003,671800,12,10,2,1
11,2003,671800,11,10,1,2
12,2003,671800,8,8,0,2
1,2004,671800,7,5,2,1
2,2004,671800,10,10,0,2
3,2004,671800,8,7,1,6
4,2004,671800,13,7,6,0
5,2004,671800,13,9,4,3
6,2004,671800,12,10,2,0
7,2004,671800,14,10,4,4
8,2004,671800,14,13,1,4
9,2004,671800,10,8,2,4
10,2004,671800,12,8,4,2
11,2004,671800,9,7,2,0
12,2004,671800,9,8,1,0
1,2005,671800,7,6,1,3
2,2005,671800,10,9,1,4
3,2005,671800,11,7,4,2
4,2005,671800,14,11,3,2
5,2005,671800,16,10,6,4
6,2005,671800,7,5,2,3
7,2005,671800,15,11,4,0
8,2005,671800,13,12,1,3
9,2005,671800,11,7,4,2
10,2005,671800,14,11,3,1
11,2005,671800,13,11,2,1
12,2005,671800,9,9,0,1
1,2006,671800,12,11,1,10
2,2006,671800,9,8,1,0
3,2006,671800,9,9,0,9
4,2006,671800,10,8,2,3
5,2006,671800,26,20,6,2
6,2006,671800,14,12,2,1
7,2006,671800,12,12,0,0
8,2006,671800,11,9,2,3
9,2006,671800,7,4,3,0
10,2006,671800,6,3,3,3
11,2006,671800,11,11,0,6
12,2006,671800,8,5,3,1
1,2007,671800,10,8,2,0
2,2007,671800,4,3,1,0
3,2007,671800,7,6,1,1
4,2007,671800,13,11,2,3
5,2007,671800,11,10,1,3
6,2007,671800,17,15,2,6
7,2007,671800,7,5,2,1
8,2007,671800,9,7,2,4
9,2007,671800,10,7,3,2
10,2007,671800,14,13,1,2
11,2007,671800,6,6,0,1
12,2007,671800,8,7,1,1
1,2008,671800,14,13,1,5
2,2008,671800,7,6,1,2
3,2008,671800,11,10,1,3
4,2008,671800,14,11,3,2
5,2008,671800,9,6,3,6
6,2008,671800,12,12,0,2
7,2008,671800,12,10,2,2
8,2008,671800,18,14,4,3
9,2008,671800,7,6,1,10
10,2008,671800,11,11,0,7
11,2008,671800,7,6,1,0
12,2008,671800,9,8,1,6
1,2009,671800,9,8,1,7
2,2009,671800,12,11,1,2
3,2009,671800,11,9,2,2
4,2009,671800,8,7,1,1
5,2009,671800,6,4,2,6
6,2009,671800,18,17,1,0
7,2009,671800,18,14,4,3
8,2009,671800,12,11,1,1
9,2009,671800,11,10,1,0
10,2009,671800,15,13,2,4
11,2009,671800,11,11,0,2
12,2009,671800,6,6,0,1
1,2010,671800,9,7,2,1
2,2010,671800,6,5,1,5
3,2010,671800,10,8,2,3
4,2010,671800,5,4,1,3
5,2010,671800,6,6,0,3
6,2010,671800,8,7,1,2
7,2010,671800,16,12,4,2
8,2010,671800,9,7,2,1
9,2010,671800,14,11,3,2
10,2010,671800,14,13,1,1
11,2010,671800,7,6,1,3
12,2010,671800,7,6,1,4
1,2011,671800,7,4,3,3
2,2011,671800,4,4,0,1
1,1999,650400,10,8,2,0
2,1999,650400,9,9,0,0
3,1999,650400,12,11,1,1
4,1999,650400,8,7,1,0
5,1999,650400,7,5,2,0
6,1999,650400,8,7,1,2
7,1999,650400,10,10,0,2
8,1999,650400,10,8,2,1
9,1999,650400,9,8,1,3
10,1999,650400,14,13,1,1
11,1999,650400,10,9,1,0
12,1999,650400,7,7,0,0
1,2000,650400,12,9,3,0
2,2000,650400,7,7,0,0
3,2000,650400,12,11,1,0
4,2000,650400,12,10,2,0
5,2000,650400,12,9,3,0
6,2000,650400,17,11,6,0
7,2000,650400,18,16,2,0
8,2000,650400,16,14,2,1
9,2000,650400,9,9,0,2
10,2000,650400,19,19,0,1
11,2000,650400,6,6,0,3
12,2000,650400,7,7,0,1
1,2001,650400,8,8,0,0
2,2001,650400,6,4,2,0
3,2001,650400,7,5,2,1
4,2001,650400,5,2,3,0
5,2001,650400,6,5,1,0
6,2001,650400,9,7,2,0
7,2001,650400,11,9,2,0
8,2001,650400,13,12,1,1
9,2001,650400,16,15,1,0
10,2001,650400,19,17,2,1
11,2001,650400,32,30,2,0
12,2001,650400,17,16,1,0
1,2002,650400,12,10,2,1
2,2002,650400,14,12,2,0
3,2002,650400,13,13,0,2
4,2002,650400,10,9,1,1
5,2002,650400,15,12,3,0
6,2002,650400,9,8,1,0
7,2002,650400,11,8,3,0
8,2002,650400,13,10,3,0
9,2002,650400,14,13,1,0
10,2002,650400,14,11,3,1
11,2002,650400,5,4,1,2
12,2002,650400,12,12,0,0
1,2003,650400,5,5,0,1
2,2003,650400,8,8,0,0
3,2003,650400,17,13,4,0
4,2003,650400,10,10,0,0
5,2003,650400,16,16,0,0
6,2003,650400,14,11,3,0
7,2003,650400,14,13,1,1
8,2003,650400,15,13,2,1
9,2003,650400,16,14,2,1
10,2003,650400,20,18,2,2
11,2003,650400,7,7,0,0
12,2003,650400,9,8,1,0
1,2004,650400,14,13,1,2
2,2004,650400,9,8,1,1
3,2004,650400,9,8,1,3
4,2004,650400,9,9,0,1
5,2004,650400,17,15,2,1
6,2004,650400,14,12,2,0
7,2004,650400,13,12,1,5
8,2004,650400,14,12,2,0
9,2004,650400,13,12,1,0
10,2004,650400,19,19,0,2
11,2004,650400,13,13,0,0
12,2004,650400,16,16,0,1
1,2005,650400,10,10,0,0
2,2005,650400,8,8,0,0
3,2005,650400,13,12,1,0
4,2005,650400,17,15,2,3
5,2005,650400,16,14,2,1
6,2005,650400,15,13,2,0
7,2005,650400,18,17,1,0
8,2005,650400,4,3,1,1
9,2005,650400,3,3,0,0
10,2005,650400,14,11,3,0
11,2005,650400,6,3,3,0
12,2005,650400,11,10,1,1
1,2006,650400,13,10,3,1
2,2006,650400,9,8,1,0
3,2006,650400,14,12,2,0
4,2006,650400,18,16,2,0
5,2006,650400,19,17,2,0
6,2006,650400,17,12,5,0
7,2006,650400,15,14,1,0
8,2006,650400,16,13,3,0
9,2006,650400,11,9,2,0
10,2006,650400,19,16,3,1
11,2006,650400,12,12,0,2
12,2006,650400,15,12,3,2
1,2007,650400,10,7,3,1
2,2007,650400,9,8,1,1
3,2007,650400,11,9,2,3
4,2007,650400,11,10,1,3
5,2007,650400,17,16,1,3
6,2007,650400,6,6,0,1
7,2007,650400,16,14,2,1
8,2007,650400,14,13,1,1
9,2007,650400,12,9,3,5
10,2007,650400,9,9,0,1
11,2007,650400,16,15,1,1
12,2007,650400,12,10,2,3
1,2008,650400,13,13,0,1
2,2008,650400,4,4,0,2
3,2008,650400,11,10,1,0
4,2008,650400,9,6,3,0
5,2008,650400,6,4,2,0
6,2008,650400,12,10,2,1
7,2008,650400,6,6,0,0
8,2008,650400,9,8,1,3
9,2008,650400,12,10,2,1
10,2008,650400,27,23,4,1
11,2008,650400,13,12,1,0
12,2008,650400,20,19,1,0
1,2009,650400,5,5,0,1
2,2009,650400,13,12,1,2
3,2009,650400,8,6,2,0
4,2009,650400,16,15,1,1
5,2009,650400,12,10,2,1
6,2009,650400,13,13,0,0
7,2009,650400,10,10,0,1
8,2009,650400,12,9,3,3
9,2009,650400,18,18,0,0
10,2009,650400,15,13,2,1
11,2009,650400,21,21,0,2
12,2009,650400,18,17,1,1
1,2010,650400,9,7,2,0
2,2010,650400,10,9,1,1
3,2010,650400,13,12,1,0
4,2010,650400,15,15,0,2
5,2010,650400,17,17,0,2
6,2010,650400,15,14,1,2
7,2010,650400,16,14,2,0
8,2010,650400,16,14,2,1
9,2010,650400,10,9,1,0
10,2010,650400,14,12,2,0
11,2010,650400,11,9,2,2
12,2010,650400,15,15,0,1
1,2011,650400,28,27,1,2
2,2011,650400,5,5,0,1
1,1999,430500,55,46,9,3
2,1999,430500,19,17,2,6
3,1999,430500,35,28,7,6
4,1999,430500,36,32,4,18
5,1999,430500,33,23,10,23
6,1999,430500,30,27,3,12
7,1999,430500,36,29,7,12
8,1999,430500,29,25,4,18
9,1999,430500,40,34,6,3
10,1999,430500,37,31,6,15
11,1999,430500,38,35,3,4
12,1999,430500,40,37,3,6
1,2000,430500,31,25,6,1
2,2000,430500,22,16,6,8
3,2000,430500,34,28,6,4
4,2000,430500,36,27,9,7
5,2000,430500,36,29,7,9
6,2000,430500,35,21,14,13
7,2000,430500,36,32,4,10
8,2000,430500,31,25,6,7
9,2000,430500,25,22,3,8
10,2000,430500,30,26,4,15
11,2000,430500,37,28,9,3
12,2000,430500,43,38,5,6
1,2001,430500,26,21,5,13
2,2001,430500,23,19,4,4
3,2001,430500,24,16,8,7
4,2001,430500,32,25,7,10
5,2001,430500,29,25,4,5
6,2001,430500,43,39,4,5
7,2001,430500,50,37,13,9
8,2001,430500,37,31,6,7
9,2001,430500,47,35,12,11
10,2001,430500,34,30,4,13
11,2001,430500,33,25,8,13
12,2001,430500,30,28,2,9
1,2002,430500,21,16,5,11
2,2002,430500,25,21,4,10
3,2002,430500,25,20,5,9
4,2002,430500,30,27,3,6
5,2002,430500,24,17,7,8
6,2002,430500,39,29,10,13
7,2002,430500,35,28,7,5
8,2002,430500,39,29,10,16
9,2002,430500,23,19,4,10
10,2002,430500,22,17,5,10
11,2002,430500,35,30,5,0
12,2002,430500,36,29,7,3
1,2003,430500,27,21,6,6
2,2003,430500,19,19,0,7
3,2003,430500,29,27,2,6
4,2003,430500,30,25,5,7
5,2003,430500,36,28,8,3
6,2003,430500,33,24,9,7
7,2003,430500,41,35,6,6
8,2003,430500,35,26,9,7
9,2003,430500,29,24,5,13
10,2003,430500,35,30,5,15
11,2003,430500,21,18,3,16
12,2003,430500,29,24,5,7
1,2004,430500,21,16,5,1
2,2004,430500,30,24,6,6
3,2004,430500,46,42,4,7
4,2004,430500,35,34,1,7
5,2004,430500,45,34,11,7
6,2004,430500,41,27,14,12
7,2004,430500,34,29,5,9
8,2004,430500,34,28,6,8
9,2004,430500,26,24,2,10
10,2004,430500,35,34,1,7
11,2004,430500,31,24,7,11
12,2004,430500,34,29,5,11
1,2005,430500,21,20,1,6
2,2005,430500,21,19,2,6
3,2005,430500,33,26,7,5
4,2005,430500,28,23,5,13
5,2005,430500,44,37,7,7
6,2005,430500,34,29,5,6
7,2005,430500,33,30,3,16
8,2005,430500,33,29,4,14
9,2005,430500,37,26,11,15
10,2005,430500,32,27,5,12
11,2005,430500,33,27,6,3
12,2005,430500,26,23,3,8
1,2006,430500,27,22,5,8
2,2006,430500,20,18,2,7
3,2006,430500,30,25,5,16
4,2006,430500,28,24,4,7
5,2006,430500,25,20,5,18
6,2006,430500,48,38,10,16
7,2006,430500,44,32,12,10
8,2006,430500,35,30,5,8
9,2006,430500,30,27,3,12
10,2006,430500,20,19,1,11
11,2006,430500,33,29,4,5
12,2006,430500,23,15,8,2
1,2007,430500,30,23,7,3
2,2007,430500,20,14,6,4
3,2007,430500,27,24,3,8
4,2007,430500,26,19,7,7
5,2007,430500,26,24,2,11
6,2007,430500,39,35,4,5
7,2007,430500,40,34,6,10
8,2007,430500,32,26,6,5
9,2007,430500,40,33,7,4
10,2007,430500,40,32,8,3
11,2007,430500,34,32,2,7
12,2007,430500,30,27,3,6
1,2008,430500,27,21,6,2
2,2008,430500,28,22,6,0
3,2008,430500,25,20,5,7
4,2008,430500,30,25,5,8
5,2008,430500,21,19,2,4
6,2008,430500,28,24,4,5
7,2008,430500,26,21,5,4
8,2008,430500,31,21,10,6
9,2008,430500,32,29,3,7
10,2008,430500,49,46,3,7
11,2008,430500,28,25,3,1
12,2008,430500,27,26,1,5
1,2009,430500,21,19,2,8
2,2009,430500,18,12,6,5
3,2009,430500,30,20,10,2
4,2009,430500,38,35,3,8
5,2009,430500,33,26,7,6
6,2009,430500,23,15,8,3
7,2009,430500,32,28,4,7
8,2009,430500,27,22,5,2
9,2009,430500,26,21,5,7
10,2009,430500,26,20,6,2
11,2009,430500,26,23,3,2
12,2009,430500,21,18,3,1
1,2010,430500,31,27,4,5
2,2010,430500,21,19,2,12
3,2010,430500,23,16,7,7
4,2010,430500,33,29,4,3
5,2010,430500,26,20,6,3
6,2010,430500,34,26,8,3
7,2010,430500,27,23,4,7
8,2010,430500,24,21,3,16
9,2010,430500,38,36,2,5
10,2010,430500,33,24,9,5
11,2010,430500,31,27,4,12
12,2010,430500,32,28,4,8
1,2011,430500,27,23,4,6
2,2011,430500,15,14,1,1
1,1999,430600,8,7,1,0
2,1999,430600,12,11,1,0
3,1999,430600,8,7,1,2
4,1999,430600,10,8,2,3
5,1999,430600,7,5,2,0
6,1999,430600,8,8,0,0
7,1999,430600,14,12,2,0
8,1999,430600,12,10,2,1
9,1999,430600,7,6,1,1
10,1999,430600,14,13,1,3
11,1999,430600,13,13,0,0
12,1999,430600,14,12,2,0
1,2000,430600,7,7,0,0
2,2000,430600,5,5,0,1
3,2000,430600,11,10,1,2
4,2000,430600,9,8,1,0
5,2000,430600,7,6,1,1
6,2000,430600,11,7,4,0
7,2000,430600,4,4,0,0
8,2000,430600,8,8,0,0
9,2000,430600,13,10,3,0
10,2000,430600,7,7,0,1
11,2000,430600,9,7,2,0
12,2000,430600,8,7,1,0
1,2001,430600,6,5,1,0
2,2001,430600,6,4,2,0
3,2001,430600,16,13,3,0
4,2001,430600,10,7,3,2
5,2001,430600,15,13,2,0
6,2001,430600,6,5,1,1
7,2001,430600,13,13,0,0
8,2001,430600,9,9,0,0
9,2001,430600,11,9,2,0
10,2001,430600,6,6,0,0
11,2001,430600,9,8,1,0
12,2001,430600,9,9,0,2
1,2002,430600,11,8,3,1
2,2002,430600,5,4,1,3
3,2002,430600,11,10,1,0
4,2002,430600,9,8,1,0
5,2002,430600,13,9,4,0
6,2002,430600,15,13,2,0
7,2002,430600,12,9,3,0
8,2002,430600,8,7,1,1
9,2002,430600,10,8,2,1
10,2002,430600,5,5,0,0
11,2002,430600,14,11,3,1
12,2002,430600,11,9,2,0
1,2003,430600,9,7,2,0
2,2003,430600,9,8,1,0
3,2003,430600,18,17,1,1
4,2003,430600,9,9,0,0
5,2003,430600,14,8,6,0
6,2003,430600,8,6,2,1
7,2003,430600,9,7,2,1
8,2003,430600,6,6,0,2
9,2003,430600,14,13,1,0
10,2003,430600,11,9,2,1
11,2003,430600,15,12,3,1
12,2003,430600,11,10,1,0
1,2004,430600,12,11,1,0
2,2004,430600,5,5,0,0
3,2004,430600,3,3,0,0
4,2004,430600,8,6,2,2
5,2004,430600,20,17,3,0
6,2004,430600,14,11,3,2
7,2004,430600,8,7,1,0
8,2004,430600,11,11,0,0
9,2004,430600,4,4,0,0
10,2004,430600,7,7,0,0
11,2004,430600,12,9,3,3
12,2004,430600,8,6,2,1
1,2005,430600,8,5,3,0
2,2005,430600,6,5,1,0
3,2005,430600,12,11,1,1
4,2005,430600,5,5,0,0
5,2005,430600,5,4,1,0
6,2005,430600,11,11,0,0
7,2005,430600,18,17,1,0
8,2005,430600,15,14,1,3
9,2005,430600,12,9,3,1
10,2005,430600,12,8,4,0
11,2005,430600,11,10,1,0
12,2005,430600,16,14,2,1
1,2006,430600,12,11,1,1
2,2006,430600,13,8,5,0
3,2006,430600,16,14,2,1
4,2006,430600,10,10,0,2
5,2006,430600,10,8,2,0
6,2006,430600,11,10,1,1
7,2006,430600,14,10,4,4
8,2006,430600,12,12,0,4
9,2006,430600,13,12,1,0
10,2006,430600,13,12,1,0
11,2006,430600,7,5,2,2
12,2006,430600,5,3,2,0
1,2007,430600,5,3,2,0
2,2007,430600,11,10,1,1
3,2007,430600,5,5,0,2
4,2007,430600,12,9,3,1
5,2007,430600,4,4,0,5
6,2007,430600,11,5,6,0
7,2007,430600,17,17,0,1
8,2007,430600,8,6,2,1
9,2007,430600,12,11,1,0
10,2007,430600,16,15,1,0
11,2007,430600,17,16,1,0
12,2007,430600,10,10,0,0
1,2008,430600,14,13,1,1
2,2008,430600,8,8,0,0
3,2008,430600,7,6,1,1
4,2008,430600,14,12,2,0
5,2008,430600,17,16,1,2
6,2008,430600,16,15,1,0
7,2008,430600,11,11,0,1
8,2008,430600,14,13,1,1
9,2008,430600,12,12,0,0
10,2008,430600,14,12,2,2
11,2008,430600,13,11,2,3
12,2008,430600,6,5,1,1
1,2009,430600,5,4,1,2
2,2009,430600,2,2,0,1
3,2009,430600,10,9,1,1
4,2009,430600,7,7,0,0
5,2009,430600,14,11,3,3
6,2009,430600,15,14,1,0
7,2009,430600,14,14,0,0
8,2009,430600,10,10,0,4
9,2009,430600,11,9,2,1
10,2009,430600,7,6,1,1
11,2009,430600,7,6,1,0
12,2009,430600,6,5,1,1
1,2010,430600,3,1,2,1
2,2010,430600,7,6,1,3
3,2010,430600,7,6,1,2
4,2010,430600,8,6,2,1
5,2010,430600,11,10,1,1
6,2010,430600,9,8,1,3
7,2010,430600,8,7,1,1
8,2010,430600,11,10,1,1
9,2010,430600,11,9,2,1
10,2010,430600,9,7,2,0
11,2010,430600,9,9,0,0
12,2010,430600,13,13,0,0
1,2011,430600,11,11,0,0
2,2011,430600,4,3,1,1
1,1999,430700,29,23,6,1
2,1999,430700,19,17,2,1
3,1999,430700,19,12,7,4
4,1999,430700,14,9,5,2
5,1999,430700,17,14,3,5
6,1999,430700,27,23,4,3
7,1999,430700,25,21,4,1
8,1999,430700,18,15,3,4
9,1999,430700,15,13,2,4
10,1999,430700,23,19,4,3
11,1999,430700,23,19,4,2
12,1999,430700,24,23,1,4
1,2000,430700,18,15,3,4
2,2000,430700,15,13,2,5
3,2000,430700,20,16,4,3
4,2000,430700,22,17,5,6
5,2000,430700,23,21,2,6
6,2000,430700,30,26,4,3
7,2000,430700,24,18,6,5
8,2000,430700,30,25,5,2
9,2000,430700,27,23,4,2
10,2000,430700,29,23,6,2
11,2000,430700,27,24,3,3
12,2000,430700,15,14,1,4
1,2001,430700,28,16,12,2
2,2001,430700,23,17,6,3
3,2001,430700,21,19,2,1
4,2001,430700,26,23,3,1
5,2001,430700,25,20,5,0
6,2001,430700,28,23,5,1
7,2001,430700,31,25,6,4
8,2001,430700,25,20,5,5
9,2001,430700,23,20,3,2
10,2001,430700,26,18,8,3
11,2001,430700,19,14,5,3
12,2001,430700,14,10,4,3
1,2002,430700,23,14,9,8
2,2002,430700,18,15,3,8
3,2002,430700,26,23,3,7
4,2002,430700,30,29,1,2
5,2002,430700,16,13,3,6
6,2002,430700,26,22,4,3
7,2002,430700,28,25,3,7
8,2002,430700,18,10,8,2
9,2002,430700,27,23,4,1
10,2002,430700,21,17,4,2
11,2002,430700,29,24,5,0
12,2002,430700,19,16,3,1
1,2003,430700,22,20,2,5
2,2003,430700,18,13,5,3
3,2003,430700,27,25,2,1
4,2003,430700,18,15,3,7
5,2003,430700,25,23,2,4
6,2003,430700,23,19,4,5
7,2003,430700,37,30,7,3
8,2003,430700,23,16,7,9
9,2003,430700,25,24,1,4
10,2003,430700,26,22,4,5
11,2003,430700,24,19,5,5
12,2003,430700,21,17,4,5
1,2004,430700,23,17,6,3
2,2004,430700,18,15,3,3
3,2004,430700,27,24,3,8
4,2004,430700,24,21,3,4
5,2004,430700,40,37,3,4
6,2004,430700,23,19,4,4
7,2004,430700,25,21,4,8
8,2004,430700,28,20,8,4
9,2004,430700,25,22,3,4
10,2004,430700,27,17,10,4
11,2004,430700,17,14,3,4
12,2004,430700,13,10,3,1
1,2005,430700,17,17,0,0
2,2005,430700,13,12,1,6
3,2005,430700,19,17,2,3
4,2005,430700,21,16,5,3
5,2005,430700,28,22,6,11
6,2005,430700,26,22,4,7
7,2005,430700,26,20,6,7
8,2005,430700,27,22,5,1
9,2005,430700,25,21,4,4
10,2005,430700,20,20,0,3
11,2005,430700,24,18,6,4
12,2005,430700,23,21,2,1
1,2006,430700,16,14,2,4
2,2006,430700,18,17,1,2
3,2006,430700,16,16,0,0
4,2006,430700,19,18,1,2
5,2006,430700,18,15,3,8
6,2006,430700,27,23,4,7
7,2006,430700,31,24,7,5
8,2006,430700,30,29,1,6
9,2006,430700,19,13,6,5
10,2006,430700,20,18,2,8
11,2006,430700,18,17,1,25
12,2006,430700,10,8,2,4
1,2007,430700,11,9,2,3
2,2007,430700,14,11,3,1
3,2007,430700,19,16,3,2
4,2007,430700,18,16,2,4
5,2007,430700,15,10,5,5
6,2007,430700,14,10,4,7
7,2007,430700,25,17,8,2
8,2007,430700,14,12,2,2
9,2007,430700,15,12,3,1
10,2007,430700,28,23,5,4
11,2007,430700,20,18,2,8
12,2007,430700,17,14,3,3
1,2008,430700,20,16,4,5
2,2008,430700,16,15,1,4
3,2008,430700,26,22,4,0
4,2008,430700,14,11,3,1
5,2008,430700,23,21,2,5
6,2008,430700,26,23,3,2
7,2008,430700,19,14,5,3
8,2008,430700,16,10,6,4
9,2008,430700,24,16,8,5
10,2008,430700,18,13,5,6
11,2008,430700,8,6,2,4
12,2008,430700,19,15,4,1
1,2009,430700,24,22,2,4
2,2009,430700,23,20,3,3
3,2009,430700,17,14,3,4
4,2009,430700,18,15,3,1
5,2009,430700,24,19,5,4
6,2009,430700,21,18,3,6
7,2009,430700,18,17,1,8
8,2009,430700,8,6,2,5
9,2009,430700,24,21,3,2
10,2009,430700,14,12,2,5
11,2009,430700,15,14,1,10
12,2009,430700,13,11,2,2
1,2010,430700,11,9,2,3
2,2010,430700,17,16,1,4
3,2010,430700,25,20,5,5
4,2010,430700,19,15,4,2
5,2010,430700,12,9,3,1
6,2010,430700,9,9,0,3
7,2010,430700,18,11,7,2
8,2010,430700,24,21,3,3
9,2010,430700,16,15,1,7
10,2010,430700,18,15,3,3
11,2010,430700,17,12,5,7
12,2010,430700,27,25,2,0
1,2011,430700,21,19,2,5
2,2011,430700,9,8,1,4
1,1999,660900,57,49,8,24
2,1999,660900,32,25,7,21
3,1999,660900,45,42,3,20
4,1999,660900,68,59,9,13
5,1999,660900,54,46,8,13
6,1999,660900,69,60,9,19
7,1999,660900,62,54,8,13
8,1999,660900,70,62,8,15
9,1999,660900,61,58,3,10
10,1999,660900,46,39,7,26
11,1999,660900,42,33,9,24
12,1999,660900,40,34,6,9
1,2000,660900,53,45,8,11
2,2000,660900,30,26,4,20
3,2000,660900,43,38,5,19
4,2000,660900,40,34,6,18
5,2000,660900,69,61,8,14
6,2000,660900,61,49,12,18
7,2000,660900,65,56,9,16
8,2000,660900,63,52,11,21
9,2000,660900,75,63,12,30
10,2000,660900,59,46,13,12
11,2000,660900,60,47,13,12
12,2000,660900,43,37,6,21
1,2001,660900,60,53,7,18
2,2001,660900,55,51,4,18
3,2001,660900,52,44,8,25
4,2001,660900,50,38,12,17
5,2001,660900,43,35,8,6
6,2001,660900,68,53,15,18
7,2001,660900,67,53,14,25
8,2001,660900,62,53,9,17
9,2001,660900,65,58,7,11
10,2001,660900,83,75,8,19
11,2001,660900,66,55,11,23
12,2001,660900,54,47,7,11
1,2002,660900,49,40,9,9
2,2002,660900,43,29,14,12
3,2002,660900,51,41,10,11
4,2002,660900,58,47,11,11
5,2002,660900,55,48,7,12
6,2002,660900,51,36,15,10
7,2002,660900,63,58,5,7
8,2002,660900,70,55,15,11
9,2002,660900,74,63,11,28
10,2002,660900,53,48,5,18
11,2002,660900,29,22,7,12
12,2002,660900,32,26,6,17
1,2003,660900,37,30,7,16
2,2003,660900,45,40,5,23
3,2003,660900,46,42,4,20
4,2003,660900,44,38,6,22
5,2003,660900,58,50,8,26
6,2003,660900,60,53,7,32
7,2003,660900,77,70,7,15
8,2003,660900,77,66,11,11
9,2003,660900,57,52,5,12
10,2003,660900,62,52,10,8
11,2003,660900,63,52,11,8
12,2003,660900,86,79,7,17
1,2004,660900,71,66,5,7
2,2004,660900,45,35,10,25
3,2004,660900,52,45,7,23
4,2004,660900,44,33,11,14
5,2004,660900,61,46,15,30
6,2004,660900,50,38,12,23
7,2004,660900,62,51,11,22
8,2004,660900,54,46,8,16
9,2004,660900,62,51,11,30
10,2004,660900,48,42,6,24
11,2004,660900,50,40,10,28
12,2004,660900,49,47,2,15
1,2005,660900,47,43,4,5
2,2005,660900,36,33,3,18
3,2005,660900,60,47,13,16
4,2005,660900,48,37,11,15
5,2005,660900,71,56,15,17
6,2005,660900,71,58,13,13
7,2005,660900,84,69,15,12
8,2005,660900,53,42,11,26
9,2005,660900,72,60,12,22
10,2005,660900,92,69,23,18
11,2005,660900,75,61,14,20
12,2005,660900,67,55,12,22
1,2006,660900,73,65,8,18
2,2006,660900,40,36,4,24
3,2006,660900,48,36,12,15
4,2006,660900,51,36,15,27
5,2006,660900,81,65,16,28
6,2006,660900,62,55,7,22
7,2006,660900,85,67,18,54
8,2006,660900,81,71,10,30
9,2006,660900,64,57,7,28
10,2006,660900,70,53,17,25
11,2006,660900,57,51,6,10
12,2006,660900,58,51,7,16
1,2007,660900,70,59,11,34
2,2007,660900,51,46,5,30
3,2007,660900,56,47,9,18
4,2007,660900,68,55,13,29
5,2007,660900,76,60,16,23
6,2007,660900,77,63,14,14
7,2007,660900,75,67,8,10
8,2007,660900,68,57,11,17
9,2007,660900,63,47,16,23
10,2007,660900,75,59,16,24
11,2007,660900,57,50,7,11
12,2007,660900,43,39,4,10
1,2008,660900,49,38,11,18
2,2008,660900,62,55,7,15
3,2008,660900,78,69,9,8
4,2008,660900,71,57,14,16
5,2008,660900,74,59,15,18
6,2008,660900,68,57,11,9
7,2008,660900,78,67,11,13
8,2008,660900,84,77,7,13
9,2008,660900,54,44,10,17
10,2008,660900,64,51,13,10
11,2008,660900,60,51,9,12
12,2008,660900,55,50,5,21
1,2009,660900,63,54,9,12
2,2009,660900,37,33,4,18
3,2009,660900,59,50,9,28
4,2009,660900,60,47,13,19
5,2009,660900,79,64,15,21
6,2009,660900,61,51,10,11
7,2009,660900,67,61,6,25
8,2009,660900,76,59,17,31
9,2009,660900,66,56,10,37
10,2009,660900,58,49,9,24
11,2009,660900,69,60,9,13
12,2009,660900,56,48,8,15
1,2010,660900,50,43,7,24
2,2010,660900,42,37,5,20
3,2010,660900,55,47,8,19
4,2010,660900,64,56,8,61
5,2010,660900,50,39,11,15
6,2010,660900,71,57,14,23
7,2010,660900,58,49,9,36
8,2010,660900,74,60,14,32
9,2010,660900,63,49,14,23
10,2010,660900,58,53,5,36
11,2010,660900,54,45,9,25
12,2010,660900,25,22,3,21
1,2011,660900,58,52,6,29
2,2011,660900,24,20,4,26
1,1999,671500,26,18,8,17
2,1999,671500,36,28,8,21
3,1999,671500,43,31,12,9
4,1999,671500,39,31,8,15
5,1999,671500,36,25,11,7
6,1999,671500,45,32,13,8
7,1999,671500,46,36,10,8
8,1999,671500,56,41,15,9
9,1999,671500,53,40,13,14
10,1999,671500,63,47,16,3
11,1999,671500,45,33,12,10
12,1999,671500,40,29,11,16
1,2000,671500,38,27,11,23
2,2000,671500,33,25,8,47
3,2000,671500,41,25,16,11
4,2000,671500,40,31,9,19
5,2000,671500,42,29,13,17
6,2000,671500,34,23,11,15
7,2000,671500,56,42,14,13
8,2000,671500,72,51,21,14
9,2000,671500,42,28,14,16
10,2000,671500,47,36,11,19
11,2000,671500,32,25,7,21
12,2000,671500,31,20,11,14
1,2001,671500,27,22,5,19
2,2001,671500,24,19,5,14
3,2001,671500,29,17,12,14
4,2001,671500,36,25,11,2
5,2001,671500,32,18,14,5
6,2001,671500,35,25,10,8
7,2001,671500,36,26,10,11
8,2001,671500,52,43,9,12
9,2001,671500,51,34,17,8
10,2001,671500,61,51,10,17
11,2001,671500,55,46,9,7
12,2001,671500,50,40,10,10
1,2002,671500,40,30,10,20
2,2002,671500,36,29,7,15
3,2002,671500,30,26,4,18
4,2002,671500,30,24,6,11
5,2002,671500,38,28,10,13
6,2002,671500,27,16,11,8
7,2002,671500,37,25,12,8
8,2002,671500,42,30,12,13
9,2002,671500,41,36,5,11
10,2002,671500,42,31,11,6
11,2002,671500,24,17,7,10
12,2002,671500,31,23,8,15
1,2003,671500,30,24,6,7
2,2003,671500,30,23,7,6
3,2003,671500,36,28,8,8
4,2003,671500,33,30,3,15
5,2003,671500,33,25,8,9
6,2003,671500,33,29,4,13
7,2003,671500,54,44,10,5
8,2003,671500,41,32,9,5
9,2003,671500,56,45,11,9
10,2003,671500,57,51,6,15
11,2003,671500,40,31,9,15
12,2003,671500,31,26,5,19
1,2004,671500,28,24,4,9
2,2004,671500,32,22,10,18
3,2004,671500,41,31,10,23
4,2004,671500,46,26,20,19
5,2004,671500,40,31,9,14
6,2004,671500,45,29,16,19
7,2004,671500,38,27,11,23
8,2004,671500,41,26,15,34
9,2004,671500,34,21,13,17
10,2004,671500,34,27,7,47
11,2004,671500,28,21,7,23
12,2004,671500,31,27,4,15
1,2005,671500,33,27,6,13
2,2005,671500,23,19,4,39
3,2005,671500,27,23,4,21
4,2005,671500,43,36,7,11
5,2005,671500,42,29,13,16
6,2005,671500,55,41,14,13
7,2005,671500,60,46,14,9
8,2005,671500,38,28,10,41
9,2005,671500,44,37,7,12
10,2005,671500,42,31,11,13
11,2005,671500,37,30,7,10
12,2005,671500,25,23,2,22
1,2006,671500,45,37,8,12
2,2006,671500,25,21,4,19
3,2006,671500,31,27,4,45
4,2006,671500,34,24,10,13
5,2006,671500,48,38,10,14
6,2006,671500,47,36,11,12
7,2006,671500,48,39,9,18
8,2006,671500,48,38,10,17
9,2006,671500,38,27,11,16
10,2006,671500,55,44,11,7
11,2006,671500,50,44,6,24
12,2006,671500,48,45,3,13
1,2007,671500,39,32,7,18
2,2007,671500,27,23,4,10
3,2007,671500,29,24,5,19
4,2007,671500,27,23,4,36
5,2007,671500,35,28,7,14
6,2007,671500,43,35,8,21
7,2007,671500,49,38,11,23
8,2007,671500,45,41,4,13
9,2007,671500,50,44,6,9
10,2007,671500,55,48,7,4
11,2007,671500,32,28,4,10
12,2007,671500,57,52,5,1
1,2008,671500,34,30,4,18
2,2008,671500,35,33,2,13
3,2008,671500,27,21,6,19
4,2008,671500,40,30,10,20
5,2008,671500,42,30,12,18
6,2008,671500,49,40,9,32
7,2008,671500,48,42,6,35
8,2008,671500,53,37,16,35
9,2008,671500,48,39,9,14
10,2008,671500,43,32,11,27
11,2008,671500,48,41,7,29
12,2008,671500,43,38,5,24
1,2009,671500,40,35,5,10
2,2009,671500,19,17,2,15
3,2009,671500,37,33,4,12
4,2009,671500,50,45,5,19
5,2009,671500,44,35,9,9
6,2009,671500,44,40,4,18
7,2009,671500,46,41,5,11
8,2009,671500,52,43,9,16
9,2009,671500,64,54,10,17
10,2009,671500,51,42,9,19
11,2009,671500,37,35,2,17
12,2009,671500,30,25,5,4
1,2010,671500,33,26,7,13
2,2010,671500,34,27,7,16
3,2010,671500,33,31,2,10
4,2010,671500,41,35,6,10
5,2010,671500,37,28,9,17
6,2010,671500,37,25,12,10
7,2010,671500,49,39,10,9
8,2010,671500,54,46,8,9
9,2010,671500,36,31,5,16
10,2010,671500,46,42,4,17
11,2010,671500,49,40,9,9
12,2010,671500,32,28,4,16
1,2011,671500,27,22,5,11
2,2011,671500,22,19,3,13
1,1999,834900,23,16,7,15
2,1999,834900,26,21,5,21
3,1999,834900,26,18,8,13
4,1999,834900,25,19,6,7
5,1999,834900,29,22,7,8
6,1999,834900,36,24,12,4
7,1999,834900,47,35,12,10
8,1999,834900,37,27,10,13
9,1999,834900,32,22,10,7
10,1999,834900,30,23,7,5
11,1999,834900,37,28,9,12
12,1999,834900,22,20,2,9
1,2000,834900,26,20,6,13
2,2000,834900,19,13,6,12
3,2000,834900,36,27,9,9
4,2000,834900,25,21,4,13
5,2000,834900,24,19,5,15
6,2000,834900,30,21,9,9
7,2000,834900,16,10,6,10
8,2000,834900,27,17,10,11
9,2000,834900,31,23,8,4
10,2000,834900,27,20,7,6
11,2000,834900,18,14,4,8
12,2000,834900,21,15,6,5
1,2001,834900,24,16,8,5
2,2001,834900,19,15,4,9
3,2001,834900,21,15,6,21
4,2001,834900,17,11,6,16
5,2001,834900,26,23,3,4
6,2001,834900,40,27,13,11
7,2001,834900,36,23,13,7
8,2001,834900,28,21,7,7
9,2001,834900,23,18,5,5
10,2001,834900,40,30,10,6
11,2001,834900,28,17,11,14
12,2001,834900,23,18,5,9
1,2002,834900,23,16,7,10
2,2002,834900,13,9,4,8
3,2002,834900,24,18,6,8
4,2002,834900,26,18,8,5
5,2002,834900,25,21,4,4
6,2002,834900,29,18,11,8
7,2002,834900,29,17,12,5
8,2002,834900,33,21,12,8
9,2002,834900,27,22,5,7
10,2002,834900,38,31,7,3
11,2002,834900,22,20,2,6
12,2002,834900,30,22,8,14
1,2003,834900,25,17,8,16
2,2003,834900,19,14,5,14
3,2003,834900,17,11,6,9
4,2003,834900,21,14,7,7
5,2003,834900,26,21,5,17
6,2003,834900,34,24,10,6
7,2003,834900,43,39,4,8
8,2003,834900,48,36,12,5
9,2003,834900,46,36,10,6
10,2003,834900,19,13,6,3
11,2003,834900,25,20,5,15
12,2003,834900,37,29,8,6
1,2004,834900,22,17,5,11
2,2004,834900,26,16,10,15
3,2004,834900,30,24,6,16
4,2004,834900,28,14,14,32
5,2004,834900,40,27,13,8
6,2004,834900,31,23,8,6
7,2004,834900,30,23,7,8
8,2004,834900,40,31,9,16
9,2004,834900,39,33,6,15
10,2004,834900,33,26,7,20
11,2004,834900,23,20,3,13
12,2004,834900,26,24,2,13
1,2005,834900,26,20,6,16
2,2005,834900,11,9,2,9
3,2005,834900,24,21,3,14
4,2005,834900,35,23,12,18
5,2005,834900,22,15,7,43
6,2005,834900,29,16,13,12
7,2005,834900,33,21,12,19
8,2005,834900,36,26,10,15
9,2005,834900,27,22,5,15
10,2005,834900,35,31,4,11
11,2005,834900,38,27,11,11
12,2005,834900,28,25,3,7
1,2006,834900,36,31,5,32
2,2006,834900,14,9,5,11
3,2006,834900,26,16,10,28
4,2006,834900,18,11,7,14
5,2006,834900,31,21,10,10
6,2006,834900,42,35,7,15
7,2006,834900,32,27,5,12
8,2006,834900,22,19,3,9
9,2006,834900,28,22,6,12
10,2006,834900,25,20,5,7
11,2006,834900,26,24,2,4
12,2006,834900,20,16,4,3
1,2007,834900,20,15,5,6
2,2007,834900,18,16,2,5
3,2007,834900,31,23,8,15
4,2007,834900,30,25,5,10
5,2007,834900,39,26,13,9
6,2007,834900,37,24,13,5
7,2007,834900,28,19,9,20
8,2007,834900,42,32,10,18
9,2007,834900,30,24,6,15
10,2007,834900,28,21,7,4
11,2007,834900,31,24,7,8
12,2007,834900,17,12,5,4
1,2008,834900,23,21,2,4
2,2008,834900,18,17,1,4
3,2008,834900,33,27,6,9
4,2008,834900,30,25,5,10
5,2008,834900,19,11,8,5
6,2008,834900,27,23,4,6
7,2008,834900,43,34,9,12
8,2008,834900,38,31,7,13
9,2008,834900,34,28,6,10
10,2008,834900,26,17,9,10
11,2008,834900,19,17,2,9
12,2008,834900,19,17,2,13
1,2009,834900,23,22,1,6
2,2009,834900,20,19,1,5
3,2009,834900,15,11,4,4
4,2009,834900,21,15,6,10
5,2009,834900,19,15,4,8
6,2009,834900,19,13,6,14
7,2009,834900,38,30,8,14
8,2009,834900,27,23,4,11
9,2009,834900,38,31,7,9
10,2009,834900,33,31,2,11
11,2009,834900,20,14,6,6
12,2009,834900,19,17,2,8
1,2010,834900,22,19,3,15
2,2010,834900,12,12,0,12
3,2010,834900,23,22,1,12
4,2010,834900,28,23,5,5
5,2010,834900,28,23,5,5
6,2010,834900,23,19,4,7
7,2010,834900,23,19,4,8
8,2010,834900,30,27,3,4
9,2010,834900,32,25,7,7
10,2010,834900,29,27,2,2
11,2010,834900,24,21,3,12
12,2010,834900,23,21,2,3
1,2011,834900,9,8,1,10
2,2011,834900,13,9,4,1
1,1999,681100,67,49,18,41
2,1999,681100,47,30,17,25
3,1999,681100,62,47,15,32
4,1999,681100,57,41,16,19
5,1999,681100,50,30,20,12
6,1999,681100,59,40,19,20
7,1999,681100,90,67,23,19
8,1999,681100,79,54,25,13
9,1999,681100,65,52,13,16
10,1999,681100,60,37,23,13
11,1999,681100,65,46,19,20
12,1999,681100,58,45,13,10
1,2000,681100,44,27,17,15
2,2000,681100,54,42,12,16
3,2000,681100,53,35,18,21
4,2000,681100,62,42,20,14
5,2000,681100,73,49,24,12
6,2000,681100,66,50,16,14
7,2000,681100,51,35,16,22
8,2000,681100,55,38,17,18
9,2000,681100,63,46,17,18
10,2000,681100,66,51,15,26
11,2000,681100,62,49,13,15
12,2000,681100,72,51,21,11
1,2001,681100,42,34,8,30
2,2001,681100,55,42,13,18
3,2001,681100,60,43,17,15
4,2001,681100,70,46,24,10
5,2001,681100,53,35,18,9
6,2001,681100,53,37,16,15
7,2001,681100,85,65,20,17
8,2001,681100,54,39,15,15
9,2001,681100,53,43,10,14
10,2001,681100,64,49,15,5
11,2001,681100,64,50,14,12
12,2001,681100,34,19,15,14
1,2002,681100,49,41,8,20
2,2002,681100,32,27,5,15
3,2002,681100,53,41,12,19
4,2002,681100,49,33,16,15
5,2002,681100,65,53,12,9
6,2002,681100,66,43,23,11
7,2002,681100,78,50,28,14
8,2002,681100,64,51,13,17
9,2002,681100,64,46,18,16
10,2002,681100,52,39,13,11
11,2002,681100,59,42,17,18
12,2002,681100,46,36,10,27
1,2003,681100,34,25,9,27
2,2003,681100,38,29,9,27
3,2003,681100,41,31,10,22
4,2003,681100,44,29,15,19
5,2003,681100,40,32,8,9
6,2003,681100,52,32,20,5
7,2003,681100,59,46,13,11
8,2003,681100,55,42,13,9
9,2003,681100,52,38,14,12
10,2003,681100,55,48,7,5
11,2003,681100,41,32,9,12
12,2003,681100,55,46,9,35
1,2004,681100,45,35,10,25
2,2004,681100,31,22,9,27
3,2004,681100,41,33,8,36
4,2004,681100,48,36,12,23
5,2004,681100,43,29,14,19
6,2004,681100,49,33,16,14
7,2004,681100,52,35,17,33
8,2004,681100,65,46,19,30
9,2004,681100,57,43,14,14
10,2004,681100,42,26,16,27
11,2004,681100,46,38,8,38
12,2004,681100,53,43,10,22
1,2005,681100,34,25,9,10
2,2005,681100,49,37,12,19
3,2005,681100,40,27,13,20
4,2005,681100,54,37,17,17
5,2005,681100,52,43,9,14
6,2005,681100,52,36,16,17
7,2005,681100,54,43,11,12
8,2005,681100,65,44,21,16
9,2005,681100,43,31,12,21
10,2005,681100,47,38,9,9
11,2005,681100,61,50,11,4
12,2005,681100,52,41,11,11
1,2006,681100,54,46,8,22
2,2006,681100,41,32,9,13
3,2006,681100,48,39,9,31
4,2006,681100,40,31,9,26
5,2006,681100,56,44,12,16
6,2006,681100,67,52,15,13
7,2006,681100,54,38,16,22
8,2006,681100,53,43,10,27
9,2006,681100,45,34,11,8
10,2006,681100,56,46,10,16
11,2006,681100,46,41,5,7
12,2006,681100,44,34,10,25
1,2007,681100,46,37,9,20
2,2007,681100,44,37,7,14
3,2007,681100,48,39,9,30
4,2007,681100,43,35,8,20
5,2007,681100,52,45,7,13
6,2007,681100,53,44,9,20
7,2007,681100,57,42,15,23
8,2007,681100,49,43,6,28
9,2007,681100,55,39,16,33
10,2007,681100,63,48,15,12
11,2007,681100,54,40,14,27
12,2007,681100,51,44,7,20
1,2008,681100,46,40,6,24
2,2008,681100,37,31,6,20
3,2008,681100,57,47,10,29
4,2008,681100,46,32,14,16
5,2008,681100,75,58,17,22
6,2008,681100,62,53,9,16
7,2008,681100,69,60,9,14
8,2008,681100,73,56,17,29
9,2008,681100,55,46,9,16
10,2008,681100,50,38,12,25
11,2008,681100,43,32,11,19
12,2008,681100,29,28,1,19
1,2009,681100,43,35,8,20
2,2009,681100,25,22,3,9
3,2009,681100,43,34,9,16
4,2009,681100,48,39,9,13
5,2009,681100,49,34,15,8
6,2009,681100,64,58,6,12
7,2009,681100,42,37,5,15
8,2009,681100,52,47,5,11
9,2009,681100,52,40,12,11
10,2009,681100,65,55,10,10
11,2009,681100,58,50,8,11
12,2009,681100,44,38,6,8
1,2010,681100,48,44,4,17
2,2010,681100,38,26,12,21
3,2010,681100,55,52,3,13
4,2010,681100,47,42,5,11
5,2010,681100,55,50,5,17
6,2010,681100,46,37,9,18
7,2010,681100,53,46,7,13
8,2010,681100,71,59,12,19
9,2010,681100,57,50,7,13
10,2010,681100,52,46,6,8
11,2010,681100,45,40,5,12
12,2010,681100,36,30,6,14
1,2011,681100,32,24,8,12
2,2011,681100,17,15,2,7
1,1999,681200,38,26,12,19
2,1999,681200,26,17,9,24
3,1999,681200,40,31,9,27
4,1999,681200,55,33,22,37
5,1999,681200,46,28,18,64
6,1999,681200,53,35,18,27
7,1999,681200,53,36,17,14
8,1999,681200,57,42,15,21
9,1999,681200,48,33,15,12
10,1999,681200,45,35,10,14
11,1999,681200,36,26,10,29
12,1999,681200,35,26,9,15
1,2000,681200,27,21,6,22
2,2000,681200,29,22,7,22
3,2000,681200,37,26,11,33
4,2000,681200,32,23,9,16
5,2000,681200,32,21,11,8
6,2000,681200,39,25,14,13
7,2000,681200,45,25,20,11
8,2000,681200,36,26,10,15
9,2000,681200,39,30,9,8
10,2000,681200,34,23,11,23
11,2000,681200,32,22,10,16
12,2000,681200,21,13,8,16
1,2001,681200,32,29,3,15
2,2001,681200,30,27,3,25
3,2001,681200,29,21,8,12
4,2001,681200,24,18,6,18
5,2001,681200,36,23,13,16
6,2001,681200,27,17,10,18
7,2001,681200,37,20,17,19
8,2001,681200,34,23,11,11
9,2001,681200,22,18,4,6
10,2001,681200,30,19,11,11
11,2001,681200,31,21,10,13
12,2001,681200,31,26,5,19
1,2002,681200,34,22,12,22
2,2002,681200,21,15,6,10
3,2002,681200,22,14,8,21
4,2002,681200,21,14,7,20
5,2002,681200,26,19,7,18
6,2002,681200,15,5,10,8
7,2002,681200,33,25,8,12
8,2002,681200,31,23,8,16
9,2002,681200,30,23,7,11
10,2002,681200,23,17,6,9
11,2002,681200,17,12,5,3
12,2002,681200,24,18,6,9
1,2003,681200,26,17,9,3
2,2003,681200,20,15,5,16
3,2003,681200,19,14,5,16
4,2003,681200,20,14,6,10
5,2003,681200,21,14,7,20
6,2003,681200,18,13,5,21
7,2003,681200,36,25,11,23
8,2003,681200,31,22,9,24
9,2003,681200,33,28,5,81
10,2003,681200,35,28,7,109
11,2003,681200,20,18,2,54
12,2003,681200,22,17,5,25
1,2004,681200,22,15,7,25
2,2004,681200,24,19,5,18
3,2004,681200,14,11,3,12
4,2004,681200,27,20,7,10
5,2004,681200,25,20,5,57
6,2004,681200,15,11,4,5
7,2004,681200,22,17,5,10
8,2004,681200,19,12,7,11
9,2004,681200,25,16,9,6
10,2004,681200,16,11,5,15
11,2004,681200,22,16,6,15
12,2004,681200,18,14,4,6
1,2005,681200,14,13,1,5
2,2005,681200,22,17,5,10
3,2005,681200,17,14,3,9
4,2005,681200,19,12,7,9
5,2005,681200,27,20,7,10
6,2005,681200,24,16,8,10
7,2005,681200,20,12,8,41
8,2005,681200,22,19,3,12
9,2005,681200,25,20,5,15
10,2005,681200,27,21,6,22
11,2005,681200,29,21,8,27
12,2005,681200,21,15,6,11
1,2006,681200,25,19,6,20
2,2006,681200,22,16,6,11
3,2006,681200,23,17,6,12
4,2006,681200,25,20,5,12
5,2006,681200,23,14,9,7
6,2006,681200,28,20,8,6
7,2006,681200,26,21,5,17
8,2006,681200,22,21,1,35
9,2006,681200,36,33,3,9
10,2006,681200,23,20,3,9
11,2006,681200,27,21,6,12
12,2006,681200,17,15,2,5
1,2007,681200,14,10,4,7
2,2007,681200,19,16,3,9
3,2007,681200,22,15,7,10
4,2007,681200,12,9,3,11
5,2007,681200,34,30,4,14
6,2007,681200,21,12,9,13
7,2007,681200,26,20,6,10
8,2007,681200,21,20,1,18
9,2007,681200,23,19,4,15
10,2007,681200,21,15,6,7
11,2007,681200,20,15,5,15
12,2007,681200,24,17,7,13
1,2008,681200,18,14,4,18
2,2008,681200,15,12,3,7
3,2008,681200,24,17,7,11
4,2008,681200,31,21,10,12
5,2008,681200,30,22,8,4
6,2008,681200,14,9,5,12
7,2008,681200,41,31,10,5
8,2008,681200,26,21,5,11
9,2008,681200,21,19,2,13
10,2008,681200,31,24,7,4
11,2008,681200,21,18,3,8
12,2008,681200,13,10,3,5
1,2009,681200,18,14,4,2
2,2009,681200,13,11,2,6
3,2009,681200,15,14,1,1
4,2009,681200,19,12,7,4
5,2009,681200,21,18,3,1
6,2009,681200,24,20,4,10
7,2009,681200,30,24,6,7
8,2009,681200,23,21,2,8
9,2009,681200,25,21,4,9
10,2009,681200,26,20,6,9
11,2009,681200,30,28,2,5
12,2009,681200,26,24,2,5
1,2010,681200,16,15,1,19
2,2010,681200,22,19,3,11
3,2010,681200,21,18,3,10
4,2010,681200,20,14,6,6
5,2010,681200,34,26,8,3
6,2010,681200,27,18,9,8
7,2010,681200,18,13,5,6
8,2010,681200,24,19,5,2
9,2010,681200,22,18,4,3
10,2010,681200,17,13,4,3
11,2010,681200,24,20,4,5
12,2010,681200,33,32,1,7
1,2011,681200,19,17,2,7
2,2011,681200,9,9,0,3
1,1999,430300,42,34,8,0
2,1999,430300,43,38,5,7
3,1999,430300,35,27,8,8
4,1999,430300,44,39,5,5
5,1999,430300,35,26,9,8
6,1999,430300,59,43,16,3
7,1999,430300,55,41,14,7
8,1999,430300,42,34,8,11
9,1999,430300,41,35,6,5
10,1999,430300,42,34,8,6
11,1999,430300,37,29,8,6
12,1999,430300,21,19,2,7
1,2000,430300,36,31,5,16
2,2000,430300,27,17,10,13
3,2000,430300,38,29,9,5
4,2000,430300,23,15,8,12
5,2000,430300,47,34,13,6
6,2000,430300,42,32,10,6
7,2000,430300,37,29,8,6
8,2000,430300,44,36,8,9
9,2000,430300,30,21,9,12
10,2000,430300,32,22,10,3
11,2000,430300,28,24,4,8
12,2000,430300,27,20,7,13
1,2001,430300,27,22,5,10
2,2001,430300,26,16,10,10
3,2001,430300,37,24,13,6
4,2001,430300,30,21,9,5
5,2001,430300,39,28,11,4
6,2001,430300,36,26,10,6
7,2001,430300,60,53,7,5
8,2001,430300,42,37,5,8
9,2001,430300,38,33,5,6
10,2001,430300,47,39,8,4
11,2001,430300,33,29,4,5
12,2001,430300,34,28,6,4
1,2002,430300,33,27,6,12
2,2002,430300,40,29,11,7
3,2002,430300,28,22,6,9
4,2002,430300,42,35,7,4
5,2002,430300,34,29,5,7
6,2002,430300,49,41,8,13
7,2002,430300,38,33,5,11
8,2002,430300,43,36,7,12
9,2002,430300,32,22,10,2
10,2002,430300,33,19,14,6
11,2002,430300,23,21,2,6
12,2002,430300,28,22,6,9
1,2003,430300,21,16,5,4
2,2003,430300,17,12,5,11
3,2003,430300,24,16,8,5
4,2003,430300,29,22,7,6
5,2003,430300,31,16,15,8
6,2003,430300,33,25,8,8
7,2003,430300,39,28,11,13
8,2003,430300,35,32,3,9
9,2003,430300,27,19,8,14
10,2003,430300,33,23,10,13
11,2003,430300,20,17,3,10
12,2003,430300,20,14,6,6
1,2004,430300,28,17,11,12
2,2004,430300,28,23,5,3
3,2004,430300,25,17,8,2
4,2004,430300,20,14,6,9
5,2004,430300,28,21,7,13
6,2004,430300,33,25,8,19
7,2004,430300,48,40,8,16
8,2004,430300,34,28,6,14
9,2004,430300,27,24,3,14
10,2004,430300,32,28,4,21
11,2004,430300,20,18,2,7
12,2004,430300,26,24,2,2
1,2005,430300,33,29,4,10
2,2005,430300,27,22,5,12
3,2005,430300,25,18,7,20
4,2005,430300,21,20,1,6
5,2005,430300,15,11,4,5
6,2005,430300,27,17,10,10
7,2005,430300,35,26,9,18
8,2005,430300,40,29,11,9
9,2005,430300,33,25,8,19
10,2005,430300,25,24,1,6
11,2005,430300,29,23,6,4
12,2005,430300,27,26,1,3
1,2006,430300,24,22,2,4
2,2006,430300,19,12,7,9
3,2006,430300,16,10,6,5
4,2006,430300,28,23,5,5
5,2006,430300,23,19,4,10
6,2006,430300,34,23,11,10
7,2006,430300,52,39,13,14
8,2006,430300,46,40,6,39
9,2006,430300,30,25,5,16
10,2006,430300,26,21,5,23
11,2006,430300,26,25,1,10
12,2006,430300,31,30,1,13
1,2007,430300,30,26,4,13
2,2007,430300,18,17,1,5
3,2007,430300,27,22,5,10
4,2007,430300,31,26,5,13
5,2007,430300,38,34,4,7
6,2007,430300,39,29,10,5
7,2007,430300,31,23,8,10
8,2007,430300,28,25,3,15
9,2007,430300,28,24,4,8
10,2007,430300,26,17,9,9
11,2007,430300,33,31,2,7
12,2007,430300,48,40,8,3
1,2008,430300,35,30,5,2
2,2008,430300,21,17,4,2
3,2008,430300,28,26,2,5
4,2008,430300,37,31,6,6
5,2008,430300,30,27,3,10
6,2008,430300,38,32,6,9
7,2008,430300,42,30,12,14
8,2008,430300,45,41,4,15
9,2008,430300,37,34,3,13
10,2008,430300,34,31,3,16
11,2008,430300,23,21,2,14
12,2008,430300,38,32,6,10
1,2009,430300,35,31,4,14
2,2009,430300,21,16,5,5
3,2009,430300,30,26,4,9
4,2009,430300,28,24,4,9
5,2009,430300,35,30,5,9
6,2009,430300,35,28,7,7
7,2009,430300,34,28,6,15
8,2009,430300,42,40,2,16
9,2009,430300,38,34,4,14
10,2009,430300,30,26,4,9
11,2009,430300,48,42,6,12
12,2009,430300,27,25,2,9
1,2010,430300,23,21,2,16
2,2010,430300,14,9,5,8
3,2010,430300,30,21,9,11
4,2010,430300,16,14,2,6
5,2010,430300,24,22,2,6
6,2010,430300,35,33,2,11
7,2010,430300,37,30,7,7
8,2010,430300,41,38,3,14
9,2010,430300,29,24,5,8
10,2010,430300,35,32,3,9
11,2010,430300,29,25,4,5
12,2010,430300,30,29,1,8
1,2011,430300,23,20,3,9
2,2011,430300,10,10,0,12
1,1999,430200,22,19,3,5
2,1999,430200,18,16,2,10
3,1999,430200,24,21,3,4
4,1999,430200,28,19,9,5
5,1999,430200,36,27,9,7
6,1999,430200,26,20,6,3
7,1999,430200,25,22,3,4
8,1999,430200,20,18,2,2
9,1999,430200,26,15,11,1
10,1999,430200,20,16,4,6
11,1999,430200,32,29,3,4
12,1999,430200,28,22,6,4
1,2000,430200,25,15,10,3
2,2000,430200,24,22,2,9
3,2000,430200,30,27,3,5
4,2000,430200,30,27,3,5
5,2000,430200,39,28,11,4
6,2000,430200,43,33,10,7
7,2000,430200,41,34,7,7
8,2000,430200,43,37,6,7
9,2000,430200,38,32,6,0
10,2000,430200,32,24,8,8
11,2000,430200,30,26,4,5
12,2000,430200,33,29,4,0
1,2001,430200,36,29,7,3
2,2001,430200,38,28,10,3
3,2001,430200,43,41,2,6
4,2001,430200,26,22,4,10
5,2001,430200,36,31,5,6
6,2001,430200,36,29,7,5
7,2001,430200,56,52,4,4
8,2001,430200,59,50,9,6
9,2001,430200,36,31,5,6
10,2001,430200,38,33,5,2
11,2001,430200,32,29,3,6
12,2001,430200,39,34,5,2
1,2002,430200,36,31,5,8
2,2002,430200,19,17,2,7
3,2002,430200,23,18,5,8
4,2002,430200,29,24,5,1
5,2002,430200,39,32,7,4
6,2002,430200,44,39,5,1
7,2002,430200,37,31,6,3
8,2002,430200,38,34,4,4
9,2002,430200,50,41,9,3
10,2002,430200,41,35,6,2
11,2002,430200,25,24,1,3
12,2002,430200,41,34,7,5
1,2003,430200,45,42,3,8
2,2003,430200,33,29,4,5
3,2003,430200,40,37,3,8
4,2003,430200,28,27,1,10
5,2003,430200,43,37,6,9
6,2003,430200,34,30,4,5
7,2003,430200,51,48,3,2
8,2003,430200,50,45,5,3
9,2003,430200,35,32,3,4
10,2003,430200,44,36,8,2
11,2003,430200,37,32,5,2
12,2003,430200,44,43,1,2
1,2004,430200,39,37,2,3
2,2004,430200,38,33,5,4
3,2004,430200,46,39,7,3
4,2004,430200,40,32,8,5
5,2004,430200,41,37,4,5
6,2004,430200,34,32,2,4
7,2004,430200,63,54,9,6
8,2004,430200,35,31,4,6
9,2004,430200,36,31,5,3
10,2004,430200,39,37,2,10
11,2004,430200,39,38,1,7
12,2004,430200,29,24,5,7
1,2005,430200,30,27,3,11
2,2005,430200,41,34,7,24
3,2005,430200,38,36,2,9
4,2005,430200,30,22,8,7
5,2005,430200,42,38,4,4
6,2005,430200,60,53,7,7
7,2005,430200,55,50,5,8
8,2005,430200,54,45,9,8
9,2005,430200,40,36,4,12
10,2005,430200,40,31,9,4
11,2005,430200,33,30,3,4
12,2005,430200,38,36,2,3
1,2006,430200,54,50,4,14
2,2006,430200,29,24,5,10
3,2006,430200,46,41,5,5
4,2006,430200,46,41,5,7
5,2006,430200,32,30,2,11
6,2006,430200,39,33,6,27
7,2006,430200,37,35,2,36
8,2006,430200,43,40,3,4
9,2006,430200,28,23,5,8
10,2006,430200,38,33,5,8
11,2006,430200,28,26,2,4
12,2006,430200,30,25,5,8
1,2007,430200,37,34,3,10
2,2007,430200,31,28,3,9
3,2007,430200,36,27,9,4
4,2007,430200,34,29,5,11
5,2007,430200,37,32,5,22
6,2007,430200,41,32,9,8
7,2007,430200,50,47,3,4
8,2007,430200,37,33,4,9
9,2007,430200,37,30,7,8
10,2007,430200,54,45,9,8
11,2007,430200,56,47,9,10
12,2007,430200,39,31,8,3
1,2008,430200,47,45,2,5
2,2008,430200,35,32,3,7
3,2008,430200,52,47,5,11
4,2008,430200,37,35,2,10
5,2008,430200,35,30,5,5
6,2008,430200,44,42,2,9
7,2008,430200,46,38,8,5
8,2008,430200,41,32,9,12
9,2008,430200,47,45,2,4
10,2008,430200,42,38,4,12
11,2008,430200,37,34,3,5
12,2008,430200,23,18,5,13
1,2009,430200,30,26,4,11
2,2009,430200,22,17,5,9
3,2009,430200,35,32,3,10
4,2009,430200,25,20,5,4
5,2009,430200,32,28,4,10
6,2009,430200,34,30,4,2
7,2009,430200,44,38,6,12
8,2009,430200,39,34,5,13
9,2009,430200,43,35,8,10
10,2009,430200,40,38,2,6
11,2009,430200,36,30,6,15
12,2009,430200,34,28,6,22
1,2010,430200,21,19,2,12
2,2010,430200,17,15,2,20
3,2010,430200,43,36,7,8
4,2010,430200,34,25,9,15
5,2010,430200,35,25,10,12
6,2010,430200,37,33,4,14
7,2010,430200,59,58,1,12
8,2010,430200,35,29,6,11
9,2010,430200,36,32,4,8
10,2010,430200,43,39,4,14
11,2010,430200,36,31,5,8
12,2010,430200,37,35,2,7
1,2011,430200,40,35,5,11
2,2011,430200,32,30,2,12
1,1999,430101,65,60,5,5
2,1999,430101,46,41,5,9
3,1999,430101,42,35,7,6
4,1999,430101,56,45,11,13
5,1999,430101,69,63,6,16
6,1999,430101,43,37,6,3
7,1999,430101,45,38,7,6
8,1999,430101,32,27,5,15
9,1999,430101,32,30,2,5
10,1999,430101,49,40,9,13
11,1999,430101,65,56,9,8
12,1999,430101,46,45,1,17
1,2000,430101,53,48,5,9
2,2000,430101,41,34,7,19
3,2000,430101,39,34,5,7
4,2000,430101,38,35,3,7
5,2000,430101,60,53,7,7
6,2000,430101,51,43,8,10
7,2000,430101,53,40,13,13
8,2000,430101,37,33,4,8
9,2000,430101,50,44,6,8
10,2000,430101,53,46,7,10
11,2000,430101,55,47,8,11
12,2000,430101,42,40,2,7
1,2001,430101,44,39,5,12
2,2001,430101,50,46,4,10
3,2001,430101,64,57,7,10
4,2001,430101,53,44,9,4
5,2001,430101,56,51,5,7
6,2001,430101,53,51,2,7
7,2001,430101,83,77,6,10
8,2001,430101,57,54,3,8
9,2001,430101,68,64,4,9
10,2001,430101,62,54,8,12
11,2001,430101,63,53,10,8
12,2001,430101,50,46,4,2
1,2002,430101,60,49,11,2
2,2002,430101,58,53,5,6
3,2002,430101,52,47,5,9
4,2002,430101,52,49,3,4
5,2002,430101,50,46,4,5
6,2002,430101,54,51,3,4
7,2002,430101,36,30,6,5
8,2002,430101,46,40,6,5
9,2002,430101,44,41,3,3
10,2002,430101,50,46,4,2
11,2002,430101,34,33,1,2
12,2002,430101,31,31,0,11
1,2003,430101,35,27,8,9
2,2003,430101,24,22,2,3
3,2003,430101,23,19,4,2
4,2003,430101,25,24,1,11
5,2003,430101,37,32,5,7
6,2003,430101,46,35,11,9
7,2003,430101,47,40,7,6
8,2003,430101,37,32,5,8
9,2003,430101,35,34,1,11
10,2003,430101,42,35,7,6
11,2003,430101,34,31,3,6
12,2003,430101,33,26,7,5
1,2004,430101,41,40,1,5
2,2004,430101,38,35,3,2
3,2004,430101,39,33,6,4
4,2004,430101,31,27,4,4
5,2004,430101,49,45,4,10
6,2004,430101,37,32,5,7
7,2004,430101,35,33,2,5
8,2004,430101,50,46,4,7
9,2004,430101,35,30,5,7
10,2004,430101,31,29,2,6
11,2004,430101,27,26,1,10
12,2004,430101,29,25,4,2
1,2005,430101,33,28,5,4
2,2005,430101,23,21,2,12
3,2005,430101,47,42,5,6
4,2005,430101,46,38,8,5
5,2005,430101,41,33,8,6
6,2005,430101,41,35,6,7
7,2005,430101,45,42,3,10
8,2005,430101,44,39,5,12
9,2005,430101,23,22,1,3
10,2005,430101,33,30,3,10
11,2005,430101,41,37,4,2
12,2005,430101,31,30,1,6
1,2006,430101,26,24,2,10
2,2006,430101,28,26,2,6
3,2006,430101,41,34,7,14
4,2006,430101,30,27,3,13
5,2006,430101,35,32,3,12
6,2006,430101,40,35,5,17
7,2006,430101,32,28,4,22
8,2006,430101,40,37,3,2
9,2006,430101,25,23,2,7
10,2006,430101,37,36,1,2
11,2006,430101,43,43,0,1
12,2006,430101,33,31,2,5
1,2007,430101,48,45,3,4
2,2007,430101,24,20,4,6
3,2007,430101,37,34,3,7
4,2007,430101,37,35,2,11
5,2007,430101,46,37,9,14
6,2007,430101,45,37,8,10
7,2007,430101,45,35,10,6
8,2007,430101,37,33,4,11
9,2007,430101,24,22,2,5
10,2007,430101,29,25,4,6
11,2007,430101,43,38,5,11
12,2007,430101,45,34,11,4
1,2008,430101,43,40,3,9
2,2008,430101,45,37,8,6
3,2008,430101,36,28,8,8
4,2008,430101,44,41,3,8
5,2008,430101,44,41,3,7
6,2008,430101,35,32,3,8
7,2008,430101,45,42,3,10
8,2008,430101,32,28,4,14
9,2008,430101,45,40,5,7
10,2008,430101,43,41,2,16
11,2008,430101,29,26,3,7
12,2008,430101,40,34,6,4
1,2009,430101,41,36,5,11
2,2009,430101,22,21,1,5
3,2009,430101,42,39,3,8
4,2009,430101,41,35,6,8
5,2009,430101,28,22,6,10
6,2009,430101,38,34,4,12
7,2009,430101,49,44,5,16
8,2009,430101,51,45,6,7
9,2009,430101,31,27,4,10
10,2009,430101,35,32,3,5
11,2009,430101,32,32,0,12
12,2009,430101,43,37,6,8
1,2010,430101,48,44,4,10
2,2010,430101,19,16,3,9
3,2010,430101,36,29,7,8
4,2010,430101,27,22,5,6
5,2010,430101,36,26,10,4
6,2010,430101,24,18,6,4
7,2010,430101,33,26,7,9
8,2010,430101,34,30,4,14
9,2010,430101,34,33,1,9
10,2010,430101,32,31,1,6
11,2010,430101,20,18,2,8
12,2010,430101,32,30,2,2
1,2011,430101,25,23,2,4
2,2011,430101,20,18,2,6
1,1999,430102,14,13,1,4
2,1999,430102,17,15,2,1
3,1999,430102,18,15,3,0
4,1999,430102,38,34,4,3
5,1999,430102,24,21,3,1
6,1999,430102,26,21,5,2
7,1999,430102,27,25,2,2
8,1999,430102,34,31,3,3
9,1999,430102,22,19,3,0
10,1999,430102,26,22,4,1
11,1999,430102,20,19,1,1
12,1999,430102,24,23,1,1
1,2000,430102,19,15,4,0
2,2000,430102,21,16,5,3
3,2000,430102,20,20,0,0
4,2000,430102,26,22,4,3
5,2000,430102,30,26,4,3
6,2000,430102,42,38,4,3
7,2000,430102,21,18,3,0
8,2000,430102,25,22,3,1
9,2000,430102,22,20,2,0
10,2000,430102,23,21,2,0
11,2000,430102,20,17,3,0
12,2000,430102,22,21,1,2
1,2001,430102,16,13,3,0
2,2001,430102,19,16,3,2
3,2001,430102,19,18,1,2
4,2001,430102,24,20,4,0
5,2001,430102,27,23,4,1
6,2001,430102,28,28,0,4
7,2001,430102,41,39,2,6
8,2001,430102,27,26,1,5
9,2001,430102,27,24,3,0
10,2001,430102,31,29,2,0
11,2001,430102,28,24,4,1
12,2001,430102,23,22,1,3
1,2002,430102,12,11,1,1
2,2002,430102,10,10,0,2
3,2002,430102,12,10,2,1
4,2002,430102,17,14,3,2
5,2002,430102,22,16,6,6
6,2002,430102,31,28,3,0
7,2002,430102,32,30,2,1
8,2002,430102,22,20,2,0
9,2002,430102,17,15,2,2
10,2002,430102,35,29,6,0
11,2002,430102,24,24,0,0
12,2002,430102,12,11,1,1
1,2003,430102,31,25,6,1
2,2003,430102,14,11,3,1
3,2003,430102,17,16,1,0
4,2003,430102,25,24,1,5
5,2003,430102,26,23,3,2
6,2003,430102,24,20,4,0
7,2003,430102,28,24,4,0
8,2003,430102,23,22,1,1
9,2003,430102,20,17,3,1
10,2003,430102,18,16,2,1
11,2003,430102,20,20,0,7
12,2003,430102,10,10,0,0
1,2004,430102,7,5,2,0
2,2004,430102,14,13,1,0
3,2004,430102,20,16,4,2
4,2004,430102,14,13,1,1
5,2004,430102,22,21,1,0
6,2004,430102,13,9,4,3
7,2004,430102,20,15,5,3
8,2004,430102,18,15,3,1
9,2004,430102,18,14,4,1
10,2004,430102,19,19,0,1
11,2004,430102,16,15,1,0
12,2004,430102,10,7,3,2
1,2005,430102,7,5,2,1
2,2005,430102,14,13,1,2
3,2005,430102,7,6,1,1
4,2005,430102,22,21,1,4
5,2005,430102,19,15,4,2
6,2005,430102,26,24,2,0
7,2005,430102,16,15,1,1
8,2005,430102,29,25,4,0
9,2005,430102,18,18,0,1
10,2005,430102,18,14,4,1
11,2005,430102,22,21,1,3
12,2005,430102,8,8,0,0
1,2006,430102,19,17,2,3
2,2006,430102,16,15,1,0
3,2006,430102,25,21,4,0
4,2006,430102,17,14,3,1
5,2006,430102,22,19,3,3
6,2006,430102,17,15,2,0
7,2006,430102,30,23,7,1
8,2006,430102,18,17,1,1
9,2006,430102,19,14,5,0
10,2006,430102,17,17,0,1
11,2006,430102,14,11,3,2
12,2006,430102,21,19,2,2
1,2007,430102,15,13,2,2
2,2007,430102,17,16,1,0
3,2007,430102,14,12,2,0
4,2007,430102,16,14,2,2
5,2007,430102,13,13,0,1
6,2007,430102,21,15,6,1
7,2007,430102,21,19,2,0
8,2007,430102,18,16,2,2
9,2007,430102,18,17,1,1
10,2007,430102,22,20,2,0
11,2007,430102,23,21,2,1
12,2007,430102,22,19,3,2
1,2008,430102,22,19,3,0
2,2008,430102,9,9,0,3
3,2008,430102,16,14,2,2
4,2008,430102,14,12,2,1
5,2008,430102,20,18,2,0
6,2008,430102,17,17,0,1
7,2008,430102,18,16,2,0
8,2008,430102,17,16,1,10
9,2008,430102,20,18,2,1
10,2008,430102,15,15,0,4
11,2008,430102,11,10,1,0
12,2008,430102,13,13,0,1
1,2009,430102,19,12,7,2
2,2009,430102,8,7,1,0
3,2009,430102,9,9,0,3
4,2009,430102,10,9,1,0
5,2009,430102,15,10,5,2
6,2009,430102,16,15,1,2
7,2009,430102,25,21,4,0
8,2009,430102,15,15,0,11
9,2009,430102,25,23,2,3
10,2009,430102,11,9,2,7
11,2009,430102,16,12,4,3
12,2009,430102,10,9,1,1
1,2010,430102,8,8,0,2
2,2010,430102,14,14,0,0
3,2010,430102,9,8,1,0
4,2010,430102,13,11,2,0
5,2010,430102,21,19,2,2
6,2010,430102,16,15,1,2
7,2010,430102,20,17,3,4
8,2010,430102,25,24,1,0
9,2010,430102,12,11,1,2
10,2010,430102,15,12,3,1
11,2010,430102,17,15,2,0
12,2010,430102,9,9,0,1
1,2011,430102,9,9,0,4
2,2011,430102,7,6,1,2
1,1999,690500,8,7,1,0
2,1999,690500,13,12,1,1
3,1999,690500,5,3,2,0
4,1999,690500,7,6,1,1
5,1999,690500,11,9,2,4
6,1999,690500,7,6,1,0
7,1999,690500,10,6,4,0
8,1999,690500,10,7,3,0
9,1999,690500,8,7,1,1
10,1999,690500,8,7,1,1
11,1999,690500,8,6,2,1
12,1999,690500,2,2,0,2
1,2000,690500,7,7,0,1
2,2000,690500,4,4,0,0
3,2000,690500,12,10,2,0
4,2000,690500,4,3,1,0
5,2000,690500,6,3,3,1
6,2000,690500,6,5,1,0
7,2000,690500,8,7,1,0
8,2000,690500,17,16,1,2
9,2000,690500,9,7,2,0
10,2000,690500,10,9,1,0
11,2000,690500,8,8,0,1
12,2000,690500,2,2,0,0
1,2001,690500,5,4,1,2
2,2001,690500,1,1,0,2
3,2001,690500,8,7,1,1
4,2001,690500,10,7,3,2
5,2001,690500,10,7,3,1
6,2001,690500,10,9,1,1
7,2001,690500,6,6,0,1
8,2001,690500,11,9,2,1
9,2001,690500,9,6,3,1
10,2001,690500,11,9,2,1
11,2001,690500,9,6,3,4
12,2001,690500,8,6,2,3
1,2002,690500,10,9,1,0
2,2002,690500,4,4,0,2
3,2002,690500,9,8,1,0
4,2002,690500,10,9,1,0
5,2002,690500,7,3,4,1
6,2002,690500,4,2,2,2
7,2002,690500,5,5,0,2
8,2002,690500,9,9,0,0
9,2002,690500,4,2,2,1
10,2002,690500,13,11,2,0
11,2002,690500,7,6,1,2
12,2002,690500,3,2,1,0
1,2003,690500,5,4,1,3
2,2003,690500,8,5,3,1
3,2003,690500,10,6,4,4
4,2003,690500,3,2,1,3
5,2003,690500,9,4,5,4
6,2003,690500,4,4,0,2
7,2003,690500,5,3,2,1
8,2003,690500,7,6,1,1
9,2003,690500,10,10,0,1
10,2003,690500,9,8,1,2
11,2003,690500,6,4,2,3
12,2003,690500,9,7,2,1
1,2004,690500,5,4,1,3
2,2004,690500,7,6,1,0
3,2004,690500,3,3,0,5
4,2004,690500,7,5,2,5
5,2004,690500,5,4,1,1
6,2004,690500,8,4,4,6
7,2004,690500,8,6,2,4
8,2004,690500,3,3,0,2
9,2004,690500,5,5,0,1
10,2004,690500,9,7,2,0
11,2004,690500,4,3,1,0
12,2004,690500,5,5,0,0
1,2005,690500,7,7,0,1
2,2005,690500,1,1,0,3
3,2005,690500,7,7,0,3
4,2005,690500,5,5,0,4
5,2005,690500,11,8,3,5
6,2005,690500,4,4,0,1
7,2005,690500,3,2,1,2
8,2005,690500,5,3,2,4
9,2005,690500,6,6,0,2
10,2005,690500,11,8,3,2
11,2005,690500,10,10,0,5
12,2005,690500,7,7,0,2
1,2006,690500,2,2,0,3
2,2006,690500,4,3,1,0
3,2006,690500,7,5,2,4
4,2006,690500,8,5,3,5
5,2006,690500,6,4,2,2
6,2006,690500,6,2,4,2
7,2006,690500,6,6,0,1
8,2006,690500,10,9,1,0
9,2006,690500,8,7,1,1
10,2006,690500,3,3,0,4
11,2006,690500,5,3,2,0
12,2006,690500,6,5,1,2
1,2007,690500,3,2,1,1
2,2007,690500,5,5,0,0
3,2007,690500,7,5,2,0
4,2007,690500,8,7,1,8
5,2007,690500,13,10,3,1
6,2007,690500,13,11,2,3
7,2007,690500,6,4,2,6
8,2007,690500,9,6,3,4
9,2007,690500,13,12,1,4
10,2007,690500,5,5,0,2
11,2007,690500,3,1,2,3
12,2007,690500,2,2,0,3
1,2008,690500,3,3,0,2
2,2008,690500,3,2,1,1
3,2008,690500,3,3,0,8
4,2008,690500,1,1,0,6
5,2008,690500,3,3,0,4
6,2008,690500,2,2,0,4
7,2008,690500,7,5,2,8
8,2008,690500,9,9,0,3
9,2008,690500,11,9,2,3
10,2008,690500,14,12,2,3
11,2008,690500,6,4,2,3
12,2008,690500,3,2,1,1
1,2009,690500,7,6,1,1
2,2009,690500,6,4,2,2
3,2009,690500,6,2,4,6
4,2009,690500,5,4,1,5
5,2009,690500,8,8,0,7
6,2009,690500,6,4,2,5
7,2009,690500,8,4,4,4
8,2009,690500,6,1,5,4
9,2009,690500,11,9,2,3
10,2009,690500,10,9,1,7
11,2009,690500,5,4,1,2
12,2009,690500,9,7,2,2
1,2010,690500,1,0,1,3
2,2010,690500,2,1,1,1
3,2010,690500,5,5,0,7
4,2010,690500,4,2,2,0
5,2010,690500,8,6,2,4
6,2010,690500,4,3,1,4
7,2010,690500,5,5,0,3
8,2010,690500,4,3,1,0
9,2010,690500,10,8,2,1
10,2010,690500,5,3,2,3
11,2010,690500,4,4,0,1
12,2010,690500,4,3,1,2
1,2011,690500,7,6,1,9
2,2011,690500,1,1,0,0
1,1999,671600,15,13,2,11
2,1999,671600,8,6,2,14
3,1999,671600,20,15,5,12
4,1999,671600,22,16,6,10
5,1999,671600,27,21,6,8
6,1999,671600,23,20,3,6
7,1999,671600,26,18,8,2
8,1999,671600,21,17,4,6
9,1999,671600,24,16,8,10
10,1999,671600,19,12,7,6
11,1999,671600,22,16,6,16
12,1999,671600,21,16,5,13
1,2000,671600,18,6,12,25
2,2000,671600,16,10,6,18
3,2000,671600,28,22,6,27
4,2000,671600,26,18,8,10
5,2000,671600,37,22,15,9
6,2000,671600,25,19,6,53
7,2000,671600,17,9,8,11
8,2000,671600,20,14,6,19
9,2000,671600,19,14,5,9
10,2000,671600,21,12,9,5
11,2000,671600,16,7,9,12
12,2000,671600,14,11,3,11
1,2001,671600,20,14,6,8
2,2001,671600,16,12,4,8
3,2001,671600,15,10,5,13
4,2001,671600,22,11,11,5
5,2001,671600,23,16,7,7
6,2001,671600,12,10,2,10
7,2001,671600,20,9,11,5
8,2001,671600,19,12,7,9
9,2001,671600,19,13,6,8
10,2001,671600,20,13,7,4
11,2001,671600,32,27,5,1
12,2001,671600,20,13,7,4
1,2002,671600,17,9,8,8
2,2002,671600,10,10,0,12
3,2002,671600,18,14,4,6
4,2002,671600,23,14,9,11
5,2002,671600,11,7,4,8
6,2002,671600,26,15,11,10
7,2002,671600,17,11,6,11
8,2002,671600,25,21,4,13
9,2002,671600,16,11,5,12
10,2002,671600,23,19,4,27
11,2002,671600,17,13,4,23
12,2002,671600,16,13,3,20
1,2003,671600,27,19,8,18
2,2003,671600,18,13,5,28
3,2003,671600,15,14,1,22
4,2003,671600,13,10,3,17
5,2003,671600,24,19,5,12
6,2003,671600,29,24,5,9
7,2003,671600,29,23,6,13
8,2003,671600,32,22,10,10
9,2003,671600,17,12,5,5
10,2003,671600,25,19,6,3
11,2003,671600,14,10,4,11
12,2003,671600,15,13,2,10
1,2004,671600,17,16,1,8
2,2004,671600,13,5,8,5
3,2004,671600,27,22,5,14
4,2004,671600,27,19,8,12
5,2004,671600,32,23,9,7
6,2004,671600,22,16,6,12
7,2004,671600,18,13,5,12
8,2004,671600,23,17,6,15
9,2004,671600,36,25,11,13
10,2004,671600,32,24,8,14
11,2004,671600,23,14,9,21
12,2004,671600,17,15,2,10
1,2005,671600,25,22,3,14
2,2005,671600,22,19,3,5
3,2005,671600,19,15,4,22
4,2005,671600,28,21,7,5
5,2005,671600,32,25,7,6
6,2005,671600,17,7,10,7
7,2005,671600,35,24,11,14
8,2005,671600,27,22,5,11
9,2005,671600,32,29,3,7
10,2005,671600,22,18,4,6
11,2005,671600,20,17,3,8
12,2005,671600,16,14,2,12
1,2006,671600,19,18,1,11
2,2006,671600,15,14,1,4
3,2006,671600,22,19,3,21
4,2006,671600,17,11,6,11
5,2006,671600,24,21,3,7
6,2006,671600,28,21,7,6
7,2006,671600,24,17,7,12
8,2006,671600,29,23,6,10
9,2006,671600,20,14,6,10
10,2006,671600,34,27,7,9
11,2006,671600,28,22,6,10
12,2006,671600,24,17,7,7
1,2007,671600,27,23,4,4
2,2007,671600,11,9,2,19
3,2007,671600,14,11,3,12
4,2007,671600,14,10,4,17
5,2007,671600,31,26,5,14
6,2007,671600,31,19,12,13
7,2007,671600,28,22,6,15
8,2007,671600,24,20,4,6
9,2007,671600,25,21,4,5
10,2007,671600,27,21,6,10
11,2007,671600,21,19,2,4
12,2007,671600,27,22,5,2
1,2008,671600,17,14,3,11
2,2008,671600,22,18,4,4
3,2008,671600,18,15,3,12
4,2008,671600,11,8,3,7
5,2008,671600,23,20,3,12
6,2008,671600,29,24,5,12
7,2008,671600,27,20,7,16
8,2008,671600,24,20,4,14
9,2008,671600,35,25,10,10
10,2008,671600,24,21,3,19
11,2008,671600,15,13,2,10
12,2008,671600,15,12,3,10
1,2009,671600,11,8,3,13
2,2009,671600,11,9,2,5
3,2009,671600,21,16,5,18
4,2009,671600,20,16,4,15
5,2009,671600,21,16,5,8
6,2009,671600,28,25,3,6
7,2009,671600,31,28,3,8
8,2009,671600,29,25,4,10
9,2009,671600,21,16,5,10
10,2009,671600,29,26,3,10
11,2009,671600,21,16,5,15
12,2009,671600,28,22,6,8
1,2010,671600,29,25,4,7
2,2010,671600,21,14,7,17
3,2010,671600,28,24,4,9
4,2010,671600,24,18,6,6
5,2010,671600,31,26,5,12
6,2010,671600,23,17,6,9
7,2010,671600,29,18,11,9
8,2010,671600,37,29,8,14
9,2010,671600,39,38,1,7
10,2010,671600,31,30,1,3
11,2010,671600,37,34,3,9
12,2010,671600,31,29,2,9
1,2011,671600,14,11,3,10
2,2011,671600,8,8,0,4
1,1999,690300,39,34,5,5
2,1999,690300,35,33,2,6
3,1999,690300,28,21,7,6
4,1999,690300,38,34,4,13
5,1999,690300,22,19,3,2
6,1999,690300,40,35,5,4
7,1999,690300,39,34,5,2
8,1999,690300,48,42,6,5
9,1999,690300,34,28,6,9
10,1999,690300,35,31,4,6
11,1999,690300,18,14,4,4
12,1999,690300,35,32,3,8
1,2000,690300,24,17,7,6
2,2000,690300,19,16,3,10
3,2000,690300,29,21,8,4
4,2000,690300,20,16,4,5
5,2000,690300,26,19,7,10
6,2000,690300,30,28,2,5
7,2000,690300,38,30,8,5
8,2000,690300,37,32,5,4
9,2000,690300,32,27,5,1
10,2000,690300,41,36,5,9
11,2000,690300,24,21,3,4
12,2000,690300,21,21,0,5
1,2001,690300,36,24,12,3
2,2001,690300,33,27,6,3
3,2001,690300,25,20,5,5
4,2001,690300,28,25,3,8
5,2001,690300,36,24,12,2
6,2001,690300,46,42,4,3
7,2001,690300,33,28,5,12
8,2001,690300,30,26,4,6
9,2001,690300,34,31,3,6
10,2001,690300,31,27,4,0
11,2001,690300,29,26,3,9
12,2001,690300,23,23,0,11
1,2002,690300,40,33,7,5
2,2002,690300,37,30,7,4
3,2002,690300,32,25,7,6
4,2002,690300,31,22,9,13
5,2002,690300,31,24,7,14
6,2002,690300,31,29,2,3
7,2002,690300,42,38,4,4
8,2002,690300,40,32,8,7
9,2002,690300,43,37,6,12
10,2002,690300,40,35,5,3
11,2002,690300,34,30,4,1
12,2002,690300,28,25,3,12
1,2003,690300,30,25,5,9
2,2003,690300,20,14,6,1
3,2003,690300,22,22,0,10
4,2003,690300,26,22,4,7
5,2003,690300,22,17,5,2
6,2003,690300,44,36,8,1
7,2003,690300,42,37,5,4
8,2003,690300,34,33,1,3
9,2003,690300,42,40,2,4
10,2003,690300,47,42,5,3
11,2003,690300,26,22,4,2
12,2003,690300,27,24,3,4
1,2004,690300,19,17,2,18
2,2004,690300,32,29,3,14
3,2004,690300,37,36,1,8
4,2004,690300,31,25,6,10
5,2004,690300,29,22,7,9
6,2004,690300,36,27,9,13
7,2004,690300,41,31,10,7
8,2004,690300,29,22,7,2
9,2004,690300,45,38,7,6
10,2004,690300,28,26,2,9
11,2004,690300,36,33,3,6
12,2004,690300,22,18,4,4
1,2005,690300,19,18,1,3
2,2005,690300,18,17,1,7
3,2005,690300,27,25,2,6
4,2005,690300,16,13,3,11
5,2005,690300,22,20,2,6
6,2005,690300,40,37,3,9
7,2005,690300,44,38,6,3
8,2005,690300,36,34,2,6
9,2005,690300,38,35,3,3
10,2005,690300,40,35,5,10
11,2005,690300,33,27,6,14
12,2005,690300,29,27,2,4
1,2006,690300,26,24,2,4
2,2006,690300,21,19,2,13
3,2006,690300,28,23,5,10
4,2006,690300,26,19,7,10
5,2006,690300,29,25,4,2
6,2006,690300,27,25,2,5
7,2006,690300,29,25,4,8
8,2006,690300,29,24,5,4
9,2006,690300,25,20,5,9
10,2006,690300,32,28,4,6
11,2006,690300,20,19,1,12
12,2006,690300,20,17,3,11
1,2007,690300,23,19,4,8
2,2007,690300,16,13,3,3
3,2007,690300,27,25,2,10
4,2007,690300,24,16,8,9
5,2007,690300,28,24,4,15
6,2007,690300,28,25,3,9
7,2007,690300,34,31,3,8
8,2007,690300,36,32,4,12
9,2007,690300,27,20,7,3
10,2007,690300,23,21,2,12
11,2007,690300,20,16,4,12
12,2007,690300,22,21,1,4
1,2008,690300,19,13,6,5
2,2008,690300,20,18,2,6
3,2008,690300,22,20,2,9
4,2008,690300,30,30,0,4
5,2008,690300,30,27,3,20
6,2008,690300,24,19,5,7
7,2008,690300,44,38,6,6
8,2008,690300,33,25,8,4
9,2008,690300,27,26,1,3
10,2008,690300,28,23,5,7
11,2008,690300,27,20,7,5
12,2008,690300,33,30,3,4
1,2009,690300,29,22,7,5
2,2009,690300,20,17,3,3
3,2009,690300,19,16,3,3
4,2009,690300,18,15,3,8
5,2009,690300,32,27,5,8
6,2009,690300,28,20,8,6
7,2009,690300,25,21,4,4
8,2009,690300,39,35,4,6
9,2009,690300,42,36,6,2
10,2009,690300,34,29,5,2
11,2009,690300,27,22,5,2
12,2009,690300,27,20,7,1
1,2010,690300,25,23,2,4
2,2010,690300,19,15,4,5
3,2010,690300,19,18,1,14
4,2010,690300,39,37,2,8
5,2010,690300,25,23,2,4
6,2010,690300,35,28,7,3
7,2010,690300,30,25,5,1
8,2010,690300,34,29,5,4
9,2010,690300,53,49,4,3
10,2010,690300,37,34,3,7
11,2010,690300,33,29,4,2
12,2010,690300,23,20,3,3
1,2011,690300,25,23,2,13
2,2011,690300,10,8,2,6
1,1999,421200,11,9,2,0
2,1999,421200,7,4,3,0
3,1999,421200,6,5,1,1
4,1999,421200,13,8,5,4
5,1999,421200,6,6,0,0
6,1999,421200,6,5,1,1
7,1999,421200,15,8,7,3
8,1999,421200,9,6,3,1
9,1999,421200,7,5,2,1
10,1999,421200,8,6,2,1
11,1999,421200,11,8,3,1
12,1999,421200,16,14,2,4
1,2000,421200,9,8,1,3
2,2000,421200,7,4,3,4
3,2000,421200,14,12,2,1
4,2000,421200,9,9,0,4
5,2000,421200,11,10,1,5
6,2000,421200,12,11,1,2
7,2000,421200,21,18,3,1
8,2000,421200,22,19,3,0
9,2000,421200,18,18,0,3
10,2000,421200,14,9,5,2
11,2000,421200,14,12,2,3
12,2000,421200,9,8,1,0
1,2001,421200,11,6,5,8
2,2001,421200,1,1,0,4
3,2001,421200,10,7,3,2
4,2001,421200,10,9,1,3
5,2001,421200,12,12,0,1
6,2001,421200,17,16,1,1
7,2001,421200,24,22,2,6
8,2001,421200,11,5,6,2
9,2001,421200,10,5,5,2
10,2001,421200,20,17,3,2
11,2001,421200,16,10,6,3
12,2001,421200,12,9,3,0
1,2002,421200,12,8,4,4
2,2002,421200,9,9,0,4
3,2002,421200,14,9,5,3
4,2002,421200,15,13,2,2
5,2002,421200,9,6,3,1
6,2002,421200,14,9,5,3
7,2002,421200,18,14,4,1
8,2002,421200,19,18,1,4
9,2002,421200,16,12,4,2
10,2002,421200,10,6,4,3
11,2002,421200,15,12,3,4
12,2002,421200,10,7,3,3
1,2003,421200,10,8,2,2
2,2003,421200,8,6,2,3
3,2003,421200,13,12,1,4
4,2003,421200,19,14,5,5
5,2003,421200,15,12,3,2
6,2003,421200,20,13,7,3
7,2003,421200,15,14,1,5
8,2003,421200,12,9,3,3
9,2003,421200,11,9,2,1
10,2003,421200,14,12,2,10
11,2003,421200,11,10,1,8
12,2003,421200,12,11,1,5
1,2004,421200,9,6,3,12
2,2004,421200,12,12,0,5
3,2004,421200,6,4,2,3
4,2004,421200,9,8,1,4
5,2004,421200,23,16,7,4
6,2004,421200,25,23,2,19
7,2004,421200,12,9,3,8
8,2004,421200,11,7,4,10
9,2004,421200,15,12,3,6
10,2004,421200,14,13,1,6
11,2004,421200,9,4,5,9
12,2004,421200,16,15,1,7
1,2005,421200,8,7,1,12
2,2005,421200,12,11,1,14
3,2005,421200,6,5,1,6
4,2005,421200,17,16,1,7
5,2005,421200,17,12,5,2
6,2005,421200,15,9,6,9
7,2005,421200,27,21,6,7
8,2005,421200,24,22,2,6
9,2005,421200,6,4,2,2
10,2005,421200,10,10,0,8
11,2005,421200,16,12,4,4
12,2005,421200,19,17,2,5
1,2006,421200,15,11,4,4
2,2006,421200,9,7,2,13
3,2006,421200,13,7,6,5
4,2006,421200,21,16,5,3
5,2006,421200,25,20,5,8
6,2006,421200,13,12,1,18
7,2006,421200,16,14,2,11
8,2006,421200,17,16,1,4
9,2006,421200,12,10,2,7
10,2006,421200,22,18,4,12
11,2006,421200,9,7,2,11
12,2006,421200,10,9,1,10
1,2007,421200,18,13,5,7
2,2007,421200,9,7,2,8
3,2007,421200,14,11,3,8
4,2007,421200,16,12,4,13
5,2007,421200,18,14,4,9
6,2007,421200,21,17,4,11
7,2007,421200,22,18,4,10
8,2007,421200,17,14,3,7
9,2007,421200,15,14,1,14
10,2007,421200,25,22,3,9
11,2007,421200,23,21,2,13
12,2007,421200,14,8,6,5
1,2008,421200,12,10,2,9
2,2008,421200,8,6,2,7
3,2008,421200,15,11,4,8
4,2008,421200,19,16,3,2
5,2008,421200,19,14,5,10
6,2008,421200,20,13,7,3
7,2008,421200,21,19,2,4
8,2008,421200,16,12,4,4
9,2008,421200,13,9,4,10
10,2008,421200,10,9,1,11
11,2008,421200,14,12,2,0
12,2008,421200,4,4,0,7
1,2009,421200,9,7,2,4
2,2009,421200,6,5,1,9
3,2009,421200,14,10,4,9
4,2009,421200,10,8,2,8
5,2009,421200,10,10,0,5
6,2009,421200,16,15,1,5
7,2009,421200,21,19,2,4
8,2009,421200,26,23,3,14
9,2009,421200,14,9,5,6
10,2009,421200,14,10,4,7
11,2009,421200,13,11,2,7
12,2009,421200,11,7,4,2
1,2010,421200,14,9,5,11
2,2010,421200,12,9,3,11
3,2010,421200,11,11,0,8
4,2010,421200,19,17,2,11
5,2010,421200,15,11,4,12
6,2010,421200,18,13,5,5
7,2010,421200,13,9,4,12
8,2010,421200,17,14,3,7
9,2010,421200,13,9,4,7
10,2010,421200,8,4,4,4
11,2010,421200,9,8,1,7
12,2010,421200,4,3,1,11
1,2011,421200,14,12,2,4
2,2011,421200,5,5,0,7
1,1999,690400,20,17,3,3
2,1999,690400,30,24,6,4
3,1999,690400,26,18,8,1
4,1999,690400,26,26,0,4
5,1999,690400,41,33,8,4
6,1999,690400,27,18,9,3
7,1999,690400,29,17,12,5
8,1999,690400,24,18,6,4
9,1999,690400,32,26,6,2
10,1999,690400,30,23,7,4
11,1999,690400,28,26,2,7
12,1999,690400,22,18,4,9
1,2000,690400,12,7,5,9
2,2000,690400,11,10,1,1
3,2000,690400,41,36,5,4
4,2000,690400,26,22,4,8
5,2000,690400,24,22,2,10
6,2000,690400,31,26,5,5
7,2000,690400,28,20,8,3
8,2000,690400,26,20,6,4
9,2000,690400,17,13,4,7
10,2000,690400,33,30,3,3
11,2000,690400,27,22,5,12
12,2000,690400,27,20,7,2
1,2001,690400,21,17,4,16
2,2001,690400,30,23,7,14
3,2001,690400,29,24,5,11
4,2001,690400,21,17,4,12
5,2001,690400,30,21,9,11
6,2001,690400,33,26,7,10
7,2001,690400,47,33,14,11
8,2001,690400,39,25,14,7
9,2001,690400,28,20,8,5
10,2001,690400,28,24,4,5
11,2001,690400,25,16,9,2
12,2001,690400,22,16,6,6
1,2002,690400,28,22,6,6
2,2002,690400,23,16,7,9
3,2002,690400,25,21,4,4
4,2002,690400,25,21,4,9
5,2002,690400,28,22,6,3
6,2002,690400,23,18,5,4
7,2002,690400,36,29,7,2
8,2002,690400,20,15,5,10
9,2002,690400,22,17,5,1
10,2002,690400,20,16,4,1
11,2002,690400,18,12,6,6
12,2002,690400,23,19,4,12
1,2003,690400,22,18,4,5
2,2003,690400,26,22,4,10
3,2003,690400,20,16,4,6
4,2003,690400,32,29,3,8
5,2003,690400,33,28,5,7
6,2003,690400,36,28,8,7
7,2003,690400,30,24,6,3
8,2003,690400,28,23,5,9
9,2003,690400,29,18,11,2
10,2003,690400,28,22,6,17
11,2003,690400,30,21,9,7
12,2003,690400,39,32,7,10
1,2004,690400,23,18,5,5
2,2004,690400,33,30,3,6
3,2004,690400,30,23,7,7
4,2004,690400,30,23,7,14
5,2004,690400,33,25,8,3
6,2004,690400,24,18,6,17
7,2004,690400,41,33,8,4
8,2004,690400,27,23,4,13
9,2004,690400,24,20,4,15
10,2004,690400,30,22,8,14
11,2004,690400,40,36,4,4
12,2004,690400,28,19,9,9
1,2005,690400,29,28,1,12
2,2005,690400,23,18,5,14
3,2005,690400,25,19,6,12
4,2005,690400,27,25,2,3
5,2005,690400,28,27,1,9
6,2005,690400,28,20,8,6
7,2005,690400,36,25,11,16
8,2005,690400,32,24,8,6
9,2005,690400,28,25,3,7
10,2005,690400,37,33,4,5
11,2005,690400,40,31,9,15
12,2005,690400,19,15,4,4
1,2006,690400,31,29,2,7
2,2006,690400,27,20,7,12
3,2006,690400,35,29,6,14
4,2006,690400,24,15,9,12
5,2006,690400,29,23,6,9
6,2006,690400,18,13,5,6
7,2006,690400,44,33,11,6
8,2006,690400,31,26,5,7
9,2006,690400,23,18,5,5
10,2006,690400,39,29,10,5
11,2006,690400,22,14,8,8
12,2006,690400,27,20,7,8
1,2007,690400,27,22,5,8
2,2007,690400,13,9,4,8
3,2007,690400,20,16,4,6
4,2007,690400,23,17,6,13
5,2007,690400,30,24,6,9
6,2007,690400,23,18,5,4
7,2007,690400,28,21,7,10
8,2007,690400,32,30,2,12
9,2007,690400,30,26,4,5
10,2007,690400,30,26,4,13
11,2007,690400,29,19,10,15
12,2007,690400,24,19,5,12
1,2008,690400,29,23,6,2
2,2008,690400,13,10,3,6
3,2008,690400,24,22,2,8
4,2008,690400,26,23,3,3
5,2008,690400,38,29,9,3
6,2008,690400,27,22,5,9
7,2008,690400,33,29,4,6
8,2008,690400,42,34,8,9
9,2008,690400,30,21,9,9
10,2008,690400,33,31,2,14
11,2008,690400,26,24,2,7
12,2008,690400,22,18,4,8
1,2009,690400,15,9,6,2
2,2009,690400,19,16,3,7
3,2009,690400,23,21,2,5
4,2009,690400,31,26,5,4
5,2009,690400,38,28,10,7
6,2009,690400,39,31,8,9
7,2009,690400,29,25,4,6
8,2009,690400,33,23,10,8
9,2009,690400,18,14,4,14
10,2009,690400,31,28,3,10
11,2009,690400,25,23,2,2
12,2009,690400,23,21,2,4
1,2010,690400,15,13,2,9
2,2010,690400,18,17,1,9
3,2010,690400,14,11,3,8
4,2010,690400,29,22,7,6
5,2010,690400,25,21,4,8
6,2010,690400,27,23,4,3
7,2010,690400,27,20,7,4
8,2010,690400,33,29,4,9
9,2010,690400,33,28,5,4
10,2010,690400,35,30,5,11
11,2010,690400,24,22,2,7
12,2010,690400,19,16,3,6
1,2011,690400,12,12,0,10
2,2011,690400,13,11,2,4
1,1999,660700,14,12,2,18
2,1999,660700,10,6,4,15
3,1999,660700,17,16,1,9
4,1999,660700,17,16,1,7
5,1999,660700,26,23,3,10
6,1999,660700,30,29,1,12
7,1999,660700,23,20,3,14
8,1999,660700,28,26,2,3
9,1999,660700,18,14,4,4
10,1999,660700,27,21,6,7
11,1999,660700,13,10,3,9
12,1999,660700,20,18,2,2
1,2000,660700,15,12,3,5
2,2000,660700,17,13,4,6
3,2000,660700,19,16,3,5
4,2000,660700,20,17,3,5
5,2000,660700,18,15,3,11
6,2000,660700,13,10,3,3
7,2000,660700,25,22,3,7
8,2000,660700,25,22,3,17
9,2000,660700,23,18,5,4
10,2000,660700,21,18,3,11
11,2000,660700,19,15,4,13
12,2000,660700,17,16,1,40
1,2001,660700,13,13,0,12
2,2001,660700,13,10,3,8
3,2001,660700,14,14,0,14
4,2001,660700,12,9,3,6
5,2001,660700,23,17,6,10
6,2001,660700,11,8,3,6
7,2001,660700,21,15,6,8
8,2001,660700,21,16,5,11
9,2001,660700,18,16,2,3
10,2001,660700,30,27,3,6
11,2001,660700,28,25,3,23
12,2001,660700,14,10,4,29
1,2002,660700,17,15,2,14
2,2002,660700,12,9,3,7
3,2002,660700,16,14,2,10
4,2002,660700,21,17,4,40
5,2002,660700,15,12,3,36
6,2002,660700,23,19,4,6
7,2002,660700,23,19,4,9
8,2002,660700,25,20,5,9
9,2002,660700,32,26,6,27
10,2002,660700,18,13,5,28
11,2002,660700,11,8,3,18
12,2002,660700,23,19,4,24
1,2003,660700,15,11,4,11
2,2003,660700,24,22,2,15
3,2003,660700,20,16,4,10
4,2003,660700,25,21,4,9
5,2003,660700,20,17,3,4
6,2003,660700,20,16,4,14
7,2003,660700,22,14,8,12
8,2003,660700,19,15,4,3
9,2003,660700,30,27,3,13
10,2003,660700,22,19,3,6
11,2003,660700,15,11,4,4
12,2003,660700,22,20,2,9
1,2004,660700,26,20,6,3
2,2004,660700,20,18,2,15
3,2004,660700,24,21,3,6
4,2004,660700,19,14,5,11
5,2004,660700,23,21,2,6
6,2004,660700,18,16,2,7
7,2004,660700,23,17,6,2
8,2004,660700,26,21,5,6
9,2004,660700,21,15,6,10
10,2004,660700,15,9,6,16
11,2004,660700,21,17,4,9
12,2004,660700,16,12,4,17
1,2005,660700,14,14,0,6
2,2005,660700,10,8,2,13
3,2005,660700,14,11,3,10
4,2005,660700,14,10,4,22
5,2005,660700,16,12,4,7
6,2005,660700,28,25,3,17
7,2005,660700,18,15,3,17
8,2005,660700,35,30,5,24
9,2005,660700,21,17,4,9
10,2005,660700,23,18,5,5
11,2005,660700,26,24,2,19
12,2005,660700,21,20,1,8
1,2006,660700,16,12,4,11
2,2006,660700,8,8,0,8
3,2006,660700,19,16,3,10
4,2006,660700,19,16,3,10
5,2006,660700,21,17,4,7
6,2006,660700,27,19,8,6
7,2006,660700,26,19,7,8
8,2006,660700,35,34,1,1
9,2006,660700,37,31,6,13
10,2006,660700,27,21,6,13
11,2006,660700,22,16,6,8
12,2006,660700,14,10,4,6
1,2007,660700,18,15,3,10
2,2007,660700,13,13,0,2
3,2007,660700,26,24,2,4
4,2007,660700,13,10,3,20
5,2007,660700,20,17,3,2
6,2007,660700,24,16,8,2
7,2007,660700,22,17,5,8
8,2007,660700,24,20,4,3
9,2007,660700,30,23,7,2
10,2007,660700,20,15,5,7
11,2007,660700,14,9,5,6
12,2007,660700,13,10,3,7
1,2008,660700,12,8,4,8
2,2008,660700,10,9,1,5
3,2008,660700,20,14,6,6
4,2008,660700,19,18,1,8
5,2008,660700,19,17,2,5
6,2008,660700,22,20,2,6
7,2008,660700,25,19,6,5
8,2008,660700,15,12,3,5
9,2008,660700,32,26,6,6
10,2008,660700,19,16,3,6
11,2008,660700,13,9,4,8
12,2008,660700,12,11,1,5
1,2009,660700,17,13,4,8
2,2009,660700,16,10,6,13
3,2009,660700,12,10,2,12
4,2009,660700,19,17,2,14
5,2009,660700,16,16,0,3
6,2009,660700,21,17,4,6
7,2009,660700,23,19,4,4
8,2009,660700,21,17,4,8
9,2009,660700,28,22,6,7
10,2009,660700,17,14,3,1
11,2009,660700,18,17,1,8
12,2009,660700,13,10,3,6
1,2010,660700,21,15,6,11
2,2010,660700,14,13,1,5
3,2010,660700,21,19,2,7
4,2010,660700,18,17,1,2
5,2010,660700,18,16,2,5
6,2010,660700,15,14,1,7
7,2010,660700,19,13,6,12
8,2010,660700,16,14,2,13
9,2010,660700,15,10,5,8
10,2010,660700,17,14,3,11
11,2010,660700,21,17,4,10
12,2010,660700,10,9,1,7
1,2011,660700,16,15,1,19
2,2011,660700,11,10,1,5
1,1999,671400,23,17,6,10
2,1999,671400,25,16,9,26
3,1999,671400,23,16,7,9
4,1999,671400,27,17,10,14
5,1999,671400,16,16,0,9
6,1999,671400,36,22,14,7
7,1999,671400,36,29,7,11
8,1999,671400,30,21,9,12
9,1999,671400,31,21,10,8
10,1999,671400,29,25,4,9
11,1999,671400,25,22,3,4
12,1999,671400,22,18,4,12
1,2000,671400,23,16,7,11
2,2000,671400,12,9,3,4
3,2000,671400,24,18,6,4
4,2000,671400,27,22,5,2
5,2000,671400,20,15,5,9
6,2000,671400,23,16,7,7
7,2000,671400,31,21,10,7
8,2000,671400,30,25,5,9
9,2000,671400,27,24,3,7
10,2000,671400,28,17,11,10
11,2000,671400,23,18,5,7
12,2000,671400,19,10,9,4
1,2001,671400,23,18,5,8
2,2001,671400,23,17,6,8
3,2001,671400,23,15,8,4
4,2001,671400,18,11,7,7
5,2001,671400,17,8,9,6
6,2001,671400,28,19,9,7
7,2001,671400,27,22,5,12
8,2001,671400,33,19,14,18
9,2001,671400,32,25,7,9
10,2001,671400,29,24,5,9
11,2001,671400,33,22,11,7
12,2001,671400,34,27,7,10
1,2002,671400,18,14,4,7
2,2002,671400,16,9,7,5
3,2002,671400,22,17,5,6
4,2002,671400,24,14,10,7
5,2002,671400,30,24,6,11
6,2002,671400,30,20,10,11
7,2002,671400,22,14,8,4
8,2002,671400,25,16,9,7
9,2002,671400,27,18,9,15
10,2002,671400,39,33,6,4
11,2002,671400,29,24,5,7
12,2002,671400,24,17,7,6
1,2003,671400,18,14,4,4
2,2003,671400,13,8,5,12
3,2003,671400,29,25,4,11
4,2003,671400,26,21,5,8
5,2003,671400,25,20,5,10
6,2003,671400,35,26,9,10
7,2003,671400,38,27,11,9
8,2003,671400,50,41,9,10
9,2003,671400,35,27,8,4
10,2003,671400,30,24,6,6
11,2003,671400,26,20,6,5
12,2003,671400,25,21,4,7
1,2004,671400,27,21,6,11
2,2004,671400,18,15,3,11
3,2004,671400,17,11,6,15
4,2004,671400,17,13,4,8
5,2004,671400,23,14,9,6
6,2004,671400,25,19,6,4
7,2004,671400,25,17,8,8
8,2004,671400,28,20,8,4
9,2004,671400,26,22,4,10
10,2004,671400,25,18,7,11
11,2004,671400,27,24,3,9
12,2004,671400,26,20,6,10
1,2005,671400,21,18,3,9
2,2005,671400,10,9,1,10
3,2005,671400,26,20,6,7
4,2005,671400,23,17,6,5
5,2005,671400,32,22,10,6
6,2005,671400,25,16,9,3
7,2005,671400,35,28,7,4
8,2005,671400,29,25,4,11
9,2005,671400,35,27,8,8
10,2005,671400,23,20,3,2
11,2005,671400,25,21,4,7
12,2005,671400,23,22,1,11
1,2006,671400,21,20,1,10
2,2006,671400,22,20,2,7
3,2006,671400,23,19,4,25
4,2006,671400,28,24,4,12
5,2006,671400,22,17,5,3
6,2006,671400,34,29,5,6
7,2006,671400,44,30,14,16
8,2006,671400,33,28,5,6
9,2006,671400,22,18,4,12
10,2006,671400,31,23,8,10
11,2006,671400,40,28,12,10
12,2006,671400,20,15,5,14
1,2007,671400,25,20,5,9
2,2007,671400,16,11,5,23
3,2007,671400,25,17,8,7
4,2007,671400,24,18,6,35
5,2007,671400,31,24,7,16
6,2007,671400,34,23,11,13
7,2007,671400,40,35,5,14
8,2007,671400,38,31,7,10
9,2007,671400,32,23,9,3
10,2007,671400,28,22,6,20
11,2007,671400,27,22,5,5
12,2007,671400,20,16,4,5
1,2008,671400,32,27,5,10
2,2008,671400,23,17,6,3
3,2008,671400,21,15,6,6
4,2008,671400,19,13,6,13
5,2008,671400,20,17,3,6
6,2008,671400,32,25,7,11
7,2008,671400,35,27,8,19
8,2008,671400,47,37,10,15
9,2008,671400,45,38,7,9
10,2008,671400,35,23,12,7
11,2008,671400,17,17,0,6
12,2008,671400,22,20,2,6
1,2009,671400,21,17,4,8
2,2009,671400,22,16,6,2
3,2009,671400,14,10,4,5
4,2009,671400,18,9,9,6
5,2009,671400,31,27,4,6
6,2009,671400,26,19,7,5
7,2009,671400,35,24,11,10
8,2009,671400,21,19,2,15
9,2009,671400,40,35,5,9
10,2009,671400,23,20,3,11
11,2009,671400,33,28,5,8
12,2009,671400,39,35,4,6
1,2010,671400,21,19,2,9
2,2010,671400,17,13,4,10
3,2010,671400,26,24,2,15
4,2010,671400,26,15,11,7
5,2010,671400,19,17,2,11
6,2010,671400,25,21,4,8
7,2010,671400,23,19,4,12
8,2010,671400,29,19,10,12
9,2010,671400,30,27,3,6
10,2010,671400,34,27,7,15
11,2010,671400,36,36,0,10
12,2010,671400,31,29,2,1
1,2011,671400,21,20,1,7
2,2011,671400,15,12,3,2
1,1999,671300,38,29,9,27
2,1999,671300,46,34,12,30
3,1999,671300,44,25,19,17
4,1999,671300,34,22,12,14
5,1999,671300,44,27,17,19
6,1999,671300,40,31,9,9
7,1999,671300,55,43,12,13
8,1999,671300,58,42,16,35
9,1999,671300,40,24,16,16
10,1999,671300,39,29,10,17
11,1999,671300,31,23,8,16
12,1999,671300,36,31,5,17
1,2000,671300,30,25,5,15
2,2000,671300,33,25,8,22
3,2000,671300,32,24,8,19
4,2000,671300,36,22,14,9
5,2000,671300,33,25,8,15
6,2000,671300,27,15,12,22
7,2000,671300,37,22,15,20
8,2000,671300,33,17,16,21
9,2000,671300,48,33,15,18
10,2000,671300,49,36,13,24
11,2000,671300,32,26,6,9
12,2000,671300,25,20,5,10
1,2001,671300,25,19,6,9
2,2001,671300,22,18,4,13
3,2001,671300,39,30,9,20
4,2001,671300,19,14,5,9
5,2001,671300,34,23,11,2
6,2001,671300,25,14,11,23
7,2001,671300,39,28,11,11
8,2001,671300,41,32,9,10
9,2001,671300,38,28,10,29
10,2001,671300,46,35,11,6
11,2001,671300,31,29,2,7
12,2001,671300,24,18,6,14
1,2002,671300,32,21,11,14
2,2002,671300,26,22,4,25
3,2002,671300,14,7,7,15
4,2002,671300,28,20,8,16
5,2002,671300,39,25,14,14
6,2002,671300,27,16,11,11
7,2002,671300,31,20,11,14
8,2002,671300,36,28,8,11
9,2002,671300,39,28,11,19
10,2002,671300,41,30,11,12
11,2002,671300,31,21,10,30
12,2002,671300,32,24,8,24
1,2003,671300,35,31,4,13
2,2003,671300,26,16,10,16
3,2003,671300,38,31,7,20
4,2003,671300,22,20,2,15
5,2003,671300,43,34,9,16
6,2003,671300,25,15,10,14
7,2003,671300,34,20,14,17
8,2003,671300,52,36,16,12
9,2003,671300,45,34,11,15
10,2003,671300,42,32,10,19
11,2003,671300,32,24,8,17
12,2003,671300,33,24,9,18
1,2004,671300,23,15,8,25
2,2004,671300,24,18,6,22
3,2004,671300,36,24,12,43
4,2004,671300,33,24,9,17
5,2004,671300,19,12,7,27
6,2004,671300,26,18,8,17
7,2004,671300,46,27,19,19
8,2004,671300,30,21,9,19
9,2004,671300,39,31,8,15
10,2004,671300,33,26,7,20
11,2004,671300,37,29,8,12
12,2004,671300,24,21,3,26
1,2005,671300,30,27,3,17
2,2005,671300,21,13,8,25
3,2005,671300,23,20,3,15
4,2005,671300,31,25,6,12
5,2005,671300,30,19,11,14
6,2005,671300,32,22,10,17
7,2005,671300,30,25,5,16
8,2005,671300,29,24,5,23
9,2005,671300,21,13,8,8
10,2005,671300,27,16,11,11
11,2005,671300,27,20,7,11
12,2005,671300,17,16,1,27
1,2006,671300,20,14,6,22
2,2006,671300,17,9,8,14
3,2006,671300,29,23,6,30
4,2006,671300,17,15,2,9
5,2006,671300,26,12,14,10
6,2006,671300,27,20,7,21
7,2006,671300,24,13,11,32
8,2006,671300,33,24,9,20
9,2006,671300,35,23,12,20
10,2006,671300,28,18,10,26
11,2006,671300,19,15,4,21
12,2006,671300,26,20,6,14
1,2007,671300,20,17,3,20
2,2007,671300,18,14,4,24
3,2007,671300,22,15,7,22
4,2007,671300,26,20,6,14
5,2007,671300,27,16,11,18
6,2007,671300,28,18,10,10
7,2007,671300,24,17,7,21
8,2007,671300,30,22,8,12
9,2007,671300,31,26,5,21
10,2007,671300,32,26,6,26
11,2007,671300,16,10,6,11
12,2007,671300,19,13,6,17
1,2008,671300,32,26,6,14
2,2008,671300,23,18,5,23
3,2008,671300,21,18,3,8
4,2008,671300,22,15,7,24
5,2008,671300,37,26,11,14
6,2008,671300,34,25,9,21
7,2008,671300,27,19,8,19
8,2008,671300,35,20,15,12
9,2008,671300,38,29,9,14
10,2008,671300,39,28,11,17
11,2008,671300,24,21,3,12
12,2008,671300,23,19,4,15
1,2009,671300,23,20,3,10
2,2009,671300,26,19,7,9
3,2009,671300,29,20,9,11
4,2009,671300,31,20,11,11
5,2009,671300,25,18,7,9
6,2009,671300,27,20,7,12
7,2009,671300,28,21,7,9
8,2009,671300,33,24,9,10
9,2009,671300,29,23,6,7
10,2009,671300,43,36,7,9
11,2009,671300,41,33,8,13
12,2009,671300,24,20,4,6
1,2010,671300,48,37,11,12
2,2010,671300,23,18,5,13
3,2010,671300,40,34,6,20
4,2010,671300,24,22,2,18
5,2010,671300,27,25,2,11
6,2010,671300,19,15,4,7
7,2010,671300,23,17,6,12
8,2010,671300,25,18,7,18
9,2010,671300,19,14,5,16
10,2010,671300,21,12,9,13
11,2010,671300,22,20,2,12
12,2010,671300,23,17,6,12
1,2011,671300,18,13,5,8
2,2011,671300,12,10,2,4
1,1999,843900,55,43,12,1
2,1999,843900,57,48,9,2
3,1999,843900,47,40,7,7
4,1999,843900,62,53,9,11
5,1999,843900,38,34,4,2
6,1999,843900,59,49,10,4
7,1999,843900,73,57,16,6
8,1999,843900,56,44,12,6
9,1999,843900,58,50,8,7
10,1999,843900,42,33,9,7
11,1999,843900,46,40,6,15
12,1999,843900,47,41,6,2
1,2000,843900,36,32,4,4
2,2000,843900,30,23,7,5
3,2000,843900,43,37,6,1
4,2000,843900,41,34,7,5
5,2000,843900,52,45,7,5
6,2000,843900,54,46,8,6
7,2000,843900,50,48,2,9
8,2000,843900,54,50,4,13
9,2000,843900,56,49,7,14
10,2000,843900,42,37,5,9
11,2000,843900,41,34,7,14
12,2000,843900,47,37,10,7
1,2001,843900,37,30,7,5
2,2001,843900,41,36,5,12
3,2001,843900,46,38,8,1
4,2001,843900,38,36,2,6
5,2001,843900,66,59,7,2
6,2001,843900,57,46,11,5
7,2001,843900,60,51,9,2
8,2001,843900,60,54,6,5
9,2001,843900,67,60,7,8
10,2001,843900,57,51,6,8
11,2001,843900,41,32,9,8
12,2001,843900,34,28,6,9
1,2002,843900,43,40,3,7
2,2002,843900,31,24,7,4
3,2002,843900,57,48,9,2
4,2002,843900,42,39,3,3
5,2002,843900,55,48,7,4
6,2002,843900,42,38,4,6
7,2002,843900,57,50,7,3
8,2002,843900,55,48,7,11
9,2002,843900,50,47,3,4
10,2002,843900,50,42,8,6
11,2002,843900,44,37,7,1
12,2002,843900,50,44,6,7
1,2003,843900,50,44,6,5
2,2003,843900,46,37,9,3
3,2003,843900,50,39,11,6
4,2003,843900,42,39,3,5
5,2003,843900,45,36,9,6
6,2003,843900,37,31,6,8
7,2003,843900,57,46,11,6
8,2003,843900,43,38,5,5
9,2003,843900,48,45,3,10
10,2003,843900,54,51,3,9
11,2003,843900,43,39,4,3
12,2003,843900,43,37,6,9
1,2004,843900,43,34,9,1
2,2004,843900,57,49,8,2
3,2004,843900,53,42,11,4
4,2004,843900,42,37,5,2
5,2004,843900,58,48,10,6
6,2004,843900,53,45,8,5
7,2004,843900,68,59,9,16
8,2004,843900,45,40,5,6
9,2004,843900,36,33,3,13
10,2004,843900,55,47,8,4
11,2004,843900,44,40,4,4
12,2004,843900,39,31,8,9
1,2005,843900,37,31,6,14
2,2005,843900,23,21,2,5
3,2005,843900,44,40,4,8
4,2005,843900,50,49,1,4
5,2005,843900,33,29,4,3
6,2005,843900,43,39,4,6
7,2005,843900,51,43,8,5
8,2005,843900,59,53,6,4
9,2005,843900,61,52,9,9
10,2005,843900,46,42,4,8
11,2005,843900,39,34,5,8
12,2005,843900,42,39,3,2
1,2006,843900,48,42,6,3
2,2006,843900,33,25,8,0
3,2006,843900,33,32,1,1
4,2006,843900,33,29,4,8
5,2006,843900,45,41,4,10
6,2006,843900,57,50,7,2
7,2006,843900,50,40,10,6
8,2006,843900,48,41,7,8
9,2006,843900,45,34,11,11
10,2006,843900,45,38,7,4
11,2006,843900,50,41,9,7
12,2006,843900,40,36,4,8
1,2007,843900,45,43,2,8
2,2007,843900,34,25,9,6
3,2007,843900,40,31,9,6
4,2007,843900,36,29,7,11
5,2007,843900,44,33,11,13
6,2007,843900,65,56,9,13
7,2007,843900,50,42,8,16
8,2007,843900,49,43,6,8
9,2007,843900,53,46,7,5
10,2007,843900,48,44,4,9
11,2007,843900,53,47,6,6
12,2007,843900,54,47,7,5
1,2008,843900,52,44,8,5
2,2008,843900,28,26,2,6
3,2008,843900,54,48,6,9
4,2008,843900,40,36,4,13
5,2008,843900,38,32,6,8
6,2008,843900,40,33,7,10
7,2008,843900,51,40,11,7
8,2008,843900,57,46,11,9
9,2008,843900,45,36,9,10
10,2008,843900,46,39,7,12
11,2008,843900,52,44,8,3
12,2008,843900,30,28,2,6
1,2009,843900,40,38,2,11
2,2009,843900,36,31,5,6
3,2009,843900,53,46,7,2
4,2009,843900,48,40,8,7
5,2009,843900,44,39,5,8
6,2009,843900,56,49,7,10
7,2009,843900,47,44,3,8
8,2009,843900,57,54,3,8
9,2009,843900,42,34,8,9
10,2009,843900,34,27,7,8
11,2009,843900,41,35,6,10
12,2009,843900,37,32,5,7
1,2010,843900,38,31,7,11
2,2010,843900,25,24,1,4
3,2010,843900,54,46,8,19
4,2010,843900,44,41,3,5
5,2010,843900,37,29,8,9
6,2010,843900,35,29,6,7
7,2010,843900,57,48,9,9
8,2010,843900,55,49,6,9
9,2010,843900,44,41,3,9
10,2010,843900,48,46,2,9
11,2010,843900,36,30,6,10
12,2010,843900,25,24,1,1
1,2011,843900,42,38,4,5
2,2011,843900,24,22,2,15
1,1999,640800,3,1,2,0
2,1999,640800,3,3,0,0
3,1999,640800,3,3,0,0
4,1999,640800,0,0,0,0
5,1999,640800,4,3,1,0
6,1999,640800,3,1,2,0
7,1999,640800,2,2,0,1
8,1999,640800,1,1,0,0
9,1999,640800,3,3,0,0
10,1999,640800,2,2,0,0
11,1999,640800,1,1,0,0
12,1999,640800,3,3,0,0
1,2000,640800,2,1,1,0
2,2000,640800,2,2,0,0
3,2000,640800,2,2,0,1
4,2000,640800,4,4,0,1
5,2000,640800,1,1,0,0
6,2000,640800,3,3,0,0
7,2000,640800,3,3,0,1
8,2000,640800,2,2,0,0
9,2000,640800,1,1,0,0
10,2000,640800,2,2,0,0
11,2000,640800,1,1,0,0
12,2000,640800,0,0,0,0
1,2001,640800,3,2,1,0
2,2001,640800,2,2,0,0
3,2001,640800,4,4,0,0
4,2001,640800,7,7,0,0
5,2001,640800,4,4,0,0
6,2001,640800,1,1,0,0
7,2001,640800,2,2,0,1
8,2001,640800,3,3,0,0
9,2001,640800,4,4,0,0
10,2001,640800,1,1,0,0
11,2001,640800,3,3,0,1
12,2001,640800,3,2,1,0
1,2002,640800,9,8,1,0
2,2002,640800,3,3,0,0
3,2002,640800,1,1,0,0
4,2002,640800,0,0,0,0
5,2002,640800,3,3,0,1
6,2002,640800,2,2,0,0
7,2002,640800,3,3,0,0
8,2002,640800,1,1,0,1
9,2002,640800,1,1,0,0
10,2002,640800,0,0,0,0
11,2002,640800,3,3,0,0
12,2002,640800,2,2,0,0
1,2003,640800,6,5,1,1
2,2003,640800,2,2,0,0
3,2003,640800,0,0,0,0
4,2003,640800,2,2,0,0
5,2003,640800,2,2,0,0
6,2003,640800,0,0,0,0
7,2003,640800,4,4,0,0
8,2003,640800,2,2,0,1
9,2003,640800,1,1,0,0
10,2003,640800,5,3,2,0
11,2003,640800,6,6,0,0
12,2003,640800,3,3,0,0
1,2004,640800,0,0,0,0
2,2004,640800,5,5,0,0
3,2004,640800,1,1,0,0
4,2004,640800,1,1,0,1
5,2004,640800,4,3,1,1
6,2004,640800,6,6,0,2
7,2004,640800,2,2,0,0
8,2004,640800,5,5,0,0
9,2004,640800,5,5,0,0
10,2004,640800,6,5,1,1
11,2004,640800,2,2,0,0
12,2004,640800,5,4,1,0
1,2005,640800,4,4,0,0
2,2005,640800,1,1,0,0
3,2005,640800,2,1,1,3
4,2005,640800,1,0,1,0
5,2005,640800,3,3,0,0
6,2005,640800,2,2,0,1
7,2005,640800,2,2,0,0
8,2005,640800,5,4,1,0
9,2005,640800,0,0,0,0
10,2005,640800,4,4,0,0
11,2005,640800,1,0,1,0
12,2005,640800,6,6,0,2
1,2006,640800,3,3,0,0
2,2006,640800,2,2,0,0
3,2006,640800,2,2,0,0
4,2006,640800,3,3,0,0
5,2006,640800,1,1,0,0
6,2006,640800,1,1,0,1
7,2006,640800,4,4,0,0
8,2006,640800,13,12,1,0
9,2006,640800,3,3,0,0
10,2006,640800,4,4,0,1
11,2006,640800,4,4,0,1
12,2006,640800,3,1,2,0
1,2007,640800,2,2,0,0
2,2007,640800,2,2,0,0
3,2007,640800,3,2,1,2
4,2007,640800,7,5,2,0
5,2007,640800,5,5,0,0
6,2007,640800,5,3,2,0
7,2007,640800,1,1,0,0
8,2007,640800,1,0,1,1
9,2007,640800,3,2,1,2
10,2007,640800,1,1,0,0
11,2007,640800,2,2,0,0
12,2007,640800,2,2,0,1
1,2008,640800,2,2,0,1
2,2008,640800,1,1,0,2
3,2008,640800,1,1,0,0
4,2008,640800,2,2,0,0
5,2008,640800,1,1,0,0
6,2008,640800,5,5,0,0
7,2008,640800,5,5,0,0
8,2008,640800,3,3,0,0
9,2008,640800,5,5,0,0
10,2008,640800,0,0,0,0
11,2008,640800,6,5,1,0
12,2008,640800,4,3,1,0
1,2009,640800,0,0,0,0
2,2009,640800,3,3,0,0
3,2009,640800,9,9,0,0
4,2009,640800,3,2,1,0
5,2009,640800,3,3,0,0
6,2009,640800,3,3,0,0
7,2009,640800,0,0,0,1
8,2009,640800,1,1,0,0
9,2009,640800,1,1,0,0
10,2009,640800,3,3,0,0
11,2009,640800,2,2,0,0
12,2009,640800,4,4,0,1
1,2010,640800,5,5,0,0
2,2010,640800,1,1,0,0
3,2010,640800,3,3,0,1
4,2010,640800,1,1,0,0
5,2010,640800,4,3,1,0
6,2010,640800,6,6,0,1
7,2010,640800,6,6,0,0
8,2010,640800,2,2,0,0
9,2010,640800,4,3,1,0
10,2010,640800,5,5,0,1
11,2010,640800,2,2,0,0
12,2010,640800,5,5,0,1
1,2011,640800,1,0,1,0
2,2011,640800,3,3,0,0
1,1999,650301,14,13,1,1
2,1999,650301,9,9,0,0
3,1999,650301,12,12,0,0
4,1999,650301,11,11,0,0
5,1999,650301,18,17,1,2
6,1999,650301,14,14,0,2
7,1999,650301,18,18,0,3
8,1999,650301,15,14,1,0
9,1999,650301,9,9,0,1
10,1999,650301,21,19,2,0
11,1999,650301,13,12,1,0
12,1999,650301,15,14,1,2
1,2000,650301,14,14,0,0
2,2000,650301,15,14,1,0
3,2000,650301,18,17,1,0
4,2000,650301,12,12,0,1
5,2000,650301,20,16,4,1
6,2000,650301,10,9,1,0
7,2000,650301,17,17,0,1
8,2000,650301,7,7,0,0
9,2000,650301,9,9,0,1
10,2000,650301,17,17,0,0
11,2000,650301,24,24,0,0
12,2000,650301,10,10,0,0
1,2001,650301,10,10,0,0
2,2001,650301,17,15,2,0
3,2001,650301,9,7,2,3
4,2001,650301,7,6,1,0
5,2001,650301,6,6,0,1
6,2001,650301,12,9,3,0
7,2001,650301,19,19,0,0
8,2001,650301,20,18,2,1
9,2001,650301,17,15,2,0
10,2001,650301,21,20,1,0
11,2001,650301,22,22,0,1
12,2001,650301,25,23,2,0
1,2002,650301,20,18,2,0
2,2002,650301,14,11,3,0
3,2002,650301,14,14,0,0
4,2002,650301,14,14,0,2
5,2002,650301,21,21,0,2
6,2002,650301,20,19,1,0
7,2002,650301,22,20,2,4
8,2002,650301,18,17,1,0
9,2002,650301,17,17,0,0
10,2002,650301,15,15,0,0
11,2002,650301,19,18,1,0
12,2002,650301,20,20,0,2
1,2003,650301,16,16,0,2
2,2003,650301,2,2,0,3
3,2003,650301,16,16,0,0
4,2003,650301,8,7,1,1
5,2003,650301,13,12,1,2
6,2003,650301,16,16,0,0
7,2003,650301,13,12,1,3
8,2003,650301,19,19,0,1
9,2003,650301,16,14,2,2
10,2003,650301,22,19,3,0
11,2003,650301,16,16,0,1
12,2003,650301,17,15,2,1
1,2004,650301,19,18,1,2
2,2004,650301,8,7,1,2
3,2004,650301,13,12,1,4
4,2004,650301,9,9,0,0
5,2004,650301,9,8,1,2
6,2004,650301,20,20,0,1
7,2004,650301,24,20,4,2
8,2004,650301,25,23,2,2
9,2004,650301,15,15,0,0
10,2004,650301,17,17,0,2
11,2004,650301,19,18,1,0
12,2004,650301,18,17,1,0
1,2005,650301,14,13,1,1
2,2005,650301,10,7,3,1
3,2005,650301,10,8,2,1
4,2005,650301,14,13,1,0
5,2005,650301,11,10,1,1
6,2005,650301,21,21,0,2
7,2005,650301,23,22,1,0
8,2005,650301,10,8,2,0
9,2005,650301,10,7,3,2
10,2005,650301,8,7,1,0
11,2005,650301,25,23,2,0
12,2005,650301,11,10,1,3
1,2006,650301,23,22,1,1
2,2006,650301,17,17,0,2
3,2006,650301,15,14,1,5
4,2006,650301,11,11,0,4
5,2006,650301,29,24,5,8
6,2006,650301,17,15,2,3
7,2006,650301,14,14,0,1
8,2006,650301,16,16,0,0
9,2006,650301,15,14,1,0
10,2006,650301,16,13,3,3
11,2006,650301,15,15,0,0
12,2006,650301,16,13,3,2
1,2007,650301,10,8,2,1
2,2007,650301,10,10,0,2
3,2007,650301,12,10,2,2
4,2007,650301,15,15,0,1
5,2007,650301,14,10,4,5
6,2007,650301,16,13,3,1
7,2007,650301,21,19,2,1
8,2007,650301,15,13,2,2
9,2007,650301,21,17,4,1
10,2007,650301,12,11,1,3
11,2007,650301,8,8,0,0
12,2007,650301,9,9,0,2
1,2008,650301,15,13,2,3
2,2008,650301,9,9,0,0
3,2008,650301,17,15,2,0
4,2008,650301,12,12,0,0
5,2008,650301,12,11,1,2
6,2008,650301,19,18,1,0
7,2008,650301,20,17,3,2
8,2008,650301,21,18,3,3
9,2008,650301,18,15,3,0
10,2008,650301,17,17,0,2
11,2008,650301,16,14,2,1
12,2008,650301,12,11,1,1
1,2009,650301,15,14,1,2
2,2009,650301,20,15,5,1
3,2009,650301,15,12,3,4
4,2009,650301,19,17,2,3
5,2009,650301,15,13,2,0
6,2009,650301,17,15,2,2
7,2009,650301,17,14,3,3
8,2009,650301,12,11,1,1
9,2009,650301,9,9,0,1
10,2009,650301,14,12,2,0
11,2009,650301,14,13,1,1
12,2009,650301,12,12,0,0
1,2010,650301,8,8,0,1
2,2010,650301,7,6,1,1
3,2010,650301,10,10,0,2
4,2010,650301,12,10,2,2
5,2010,650301,19,15,4,4
6,2010,650301,19,18,1,3
7,2010,650301,12,11,1,2
8,2010,650301,15,14,1,5
9,2010,650301,13,11,2,2
10,2010,650301,12,11,1,2
11,2010,650301,5,4,1,4
12,2010,650301,14,14,0,0
1,2011,650301,15,15,0,2
2,2011,650301,9,8,1,0
1,1999,650302,7,7,0,0
2,1999,650302,5,5,0,0
3,1999,650302,12,12,0,1
4,1999,650302,9,8,1,1
5,1999,650302,5,5,0,1
6,1999,650302,9,9,0,0
7,1999,650302,5,4,1,0
8,1999,650302,10,10,0,0
9,1999,650302,10,8,2,0
10,1999,650302,5,4,1,1
11,1999,650302,7,6,1,1
12,1999,650302,10,9,1,0
1,2000,650302,9,9,0,1
2,2000,650302,9,7,2,0
3,2000,650302,6,5,1,0
4,2000,650302,15,14,1,0
5,2000,650302,10,10,0,0
6,2000,650302,11,10,1,0
7,2000,650302,16,14,2,1
8,2000,650302,14,13,1,1
9,2000,650302,12,11,1,4
10,2000,650302,14,14,0,0
11,2000,650302,7,6,1,0
12,2000,650302,10,10,0,0
1,2001,650302,11,11,0,1
2,2001,650302,7,7,0,4
3,2001,650302,6,4,2,1
4,2001,650302,6,4,2,3
5,2001,650302,8,7,1,0
6,2001,650302,6,6,0,0
7,2001,650302,14,12,2,2
8,2001,650302,6,3,3,2
9,2001,650302,16,12,4,4
10,2001,650302,15,12,3,2
11,2001,650302,14,12,2,0
12,2001,650302,9,8,1,0
1,2002,650302,11,11,0,2
2,2002,650302,7,5,2,1
3,2002,650302,8,4,4,3
4,2002,650302,7,5,2,5
5,2002,650302,11,11,0,1
6,2002,650302,7,7,0,1
7,2002,650302,10,6,4,4
8,2002,650302,12,11,1,1
9,2002,650302,6,2,4,1
10,2002,650302,10,7,3,1
11,2002,650302,13,13,0,3
12,2002,650302,16,16,0,1
1,2003,650302,11,11,0,0
2,2003,650302,4,4,0,2
3,2003,650302,4,4,0,0
4,2003,650302,12,12,0,0
5,2003,650302,6,5,1,1
6,2003,650302,14,13,1,0
7,2003,650302,14,13,1,0
8,2003,650302,20,18,2,2
9,2003,650302,11,11,0,4
10,2003,650302,9,8,1,1
11,2003,650302,4,3,1,0
12,2003,650302,12,12,0,0
1,2004,650302,9,9,0,1
2,2004,650302,10,10,0,1
3,2004,650302,7,5,2,4
4,2004,650302,17,14,3,2
5,2004,650302,16,15,1,2
6,2004,650302,10,9,1,1
7,2004,650302,12,11,1,1
8,2004,650302,9,9,0,0
9,2004,650302,11,9,2,4
10,2004,650302,16,12,4,2
11,2004,650302,13,12,1,1
12,2004,650302,13,13,0,1
1,2005,650302,6,6,0,1
2,2005,650302,12,10,2,5
3,2005,650302,6,5,1,1
4,2005,650302,16,14,2,2
5,2005,650302,14,11,3,4
6,2005,650302,8,6,2,3
7,2005,650302,6,6,0,1
8,2005,650302,11,9,2,1
9,2005,650302,8,7,1,0
10,2005,650302,7,7,0,1
11,2005,650302,10,9,1,1
12,2005,650302,10,10,0,4
1,2006,650302,11,10,1,1
2,2006,650302,13,12,1,1
3,2006,650302,9,9,0,2
4,2006,650302,12,11,1,3
5,2006,650302,24,21,3,2
6,2006,650302,11,11,0,1
7,2006,650302,11,10,1,0
8,2006,650302,14,13,1,0
9,2006,650302,10,9,1,1
10,2006,650302,12,11,1,2
11,2006,650302,11,9,2,1
12,2006,650302,11,11,0,2
1,2007,650302,12,10,2,3
2,2007,650302,3,3,0,2
3,2007,650302,11,9,2,5
4,2007,650302,9,7,2,1
5,2007,650302,17,14,3,4
6,2007,650302,13,12,1,1
7,2007,650302,13,12,1,1
8,2007,650302,9,8,1,1
9,2007,650302,10,10,0,1
10,2007,650302,10,9,1,1
11,2007,650302,7,7,0,3
12,2007,650302,12,10,2,1
1,2008,650302,8,8,0,4
2,2008,650302,2,2,0,3
3,2008,650302,3,3,0,5
4,2008,650302,3,3,0,1
5,2008,650302,4,3,1,3
6,2008,650302,7,6,1,2
7,2008,650302,14,14,0,1
8,2008,650302,10,10,0,2
9,2008,650302,12,11,1,1
10,2008,650302,9,8,1,3
11,2008,650302,11,11,0,0
12,2008,650302,10,10,0,1
1,2009,650302,5,4,1,0
2,2009,650302,7,6,1,0
3,2009,650302,5,5,0,3
4,2009,650302,6,5,1,2
5,2009,650302,10,10,0,3
6,2009,650302,8,7,1,2
7,2009,650302,3,3,0,0
8,2009,650302,6,6,0,6
9,2009,650302,5,5,0,2
10,2009,650302,7,7,0,0
11,2009,650302,9,9,0,0
12,2009,650302,9,9,0,4
1,2010,650302,17,15,2,4
2,2010,650302,8,8,0,1
3,2010,650302,19,19,0,0
4,2010,650302,16,16,0,3
5,2010,650302,9,7,2,1
6,2010,650302,10,10,0,2
7,2010,650302,13,11,2,2
8,2010,650302,7,7,0,0
9,2010,650302,8,8,0,1
10,2010,650302,13,10,3,0
11,2010,650302,8,8,0,0
12,2010,650302,7,7,0,0
1,2011,650302,6,6,0,0
2,2011,650302,5,5,0,1
1,1999,660500,25,22,3,2
2,1999,660500,19,18,1,3
3,1999,660500,11,7,4,3
4,1999,660500,22,20,2,6
5,1999,660500,21,20,1,8
6,1999,660500,25,19,6,3
7,1999,660500,26,25,1,15
8,1999,660500,52,49,3,11
9,1999,660500,31,29,2,8
10,1999,660500,34,31,3,10
11,1999,660500,25,23,2,5
12,1999,660500,17,15,2,3
1,2000,660500,17,16,1,7
2,2000,660500,28,24,4,5
3,2000,660500,20,17,3,3
4,2000,660500,32,29,3,4
5,2000,660500,28,26,2,4
6,2000,660500,30,25,5,3
7,2000,660500,23,16,7,1
8,2000,660500,29,24,5,7
9,2000,660500,40,35,5,7
10,2000,660500,29,26,3,8
11,2000,660500,17,13,4,8
12,2000,660500,17,15,2,6
1,2001,660500,32,29,3,5
2,2001,660500,17,14,3,5
3,2001,660500,19,18,1,7
4,2001,660500,26,21,5,5
5,2001,660500,33,25,8,1
6,2001,660500,19,15,4,7
7,2001,660500,40,36,4,2
8,2001,660500,27,23,4,6
9,2001,660500,28,24,4,1
10,2001,660500,35,32,3,3
11,2001,660500,31,27,4,3
12,2001,660500,30,29,1,2
1,2002,660500,20,18,2,1
2,2002,660500,22,22,0,1
3,2002,660500,23,17,6,4
4,2002,660500,22,20,2,1
5,2002,660500,27,25,2,1
6,2002,660500,35,31,4,2
7,2002,660500,49,41,8,3
8,2002,660500,39,38,1,4
9,2002,660500,24,21,3,3
10,2002,660500,30,27,3,3
11,2002,660500,28,28,0,5
12,2002,660500,21,18,3,5
1,2003,660500,24,22,2,5
2,2003,660500,17,16,1,1
3,2003,660500,26,22,4,0
4,2003,660500,22,20,2,6
5,2003,660500,32,23,9,5
6,2003,660500,26,24,2,4
7,2003,660500,22,22,0,2
8,2003,660500,44,41,3,5
9,2003,660500,31,30,1,2
10,2003,660500,27,23,4,7
11,2003,660500,27,26,1,1
12,2003,660500,33,31,2,4
1,2004,660500,18,18,0,6
2,2004,660500,22,17,5,4
3,2004,660500,27,22,5,11
4,2004,660500,28,27,1,5
5,2004,660500,16,13,3,5
6,2004,660500,31,27,4,0
7,2004,660500,34,30,4,2
8,2004,660500,32,25,7,10
9,2004,660500,41,33,8,3
10,2004,660500,20,18,2,8
11,2004,660500,15,12,3,1
12,2004,660500,17,13,4,3
1,2005,660500,17,14,3,8
2,2005,660500,15,13,2,6
3,2005,660500,24,21,3,8
4,2005,660500,16,13,3,2
5,2005,660500,29,23,6,3
6,2005,660500,32,30,2,5
7,2005,660500,34,32,2,3
8,2005,660500,33,27,6,7
9,2005,660500,21,18,3,4
10,2005,660500,26,18,8,7
11,2005,660500,29,26,3,10
12,2005,660500,25,21,4,2
1,2006,660500,25,17,8,5
2,2006,660500,22,19,3,4
3,2006,660500,27,22,5,9
4,2006,660500,26,23,3,24
5,2006,660500,37,31,6,6
6,2006,660500,26,18,8,5
7,2006,660500,29,27,2,7
8,2006,660500,35,30,5,1
9,2006,660500,28,26,2,5
10,2006,660500,29,27,2,8
11,2006,660500,25,21,4,4
12,2006,660500,23,23,0,6
1,2007,660500,15,15,0,4
2,2007,660500,15,14,1,2
3,2007,660500,20,16,4,8
4,2007,660500,23,18,5,5
5,2007,660500,22,21,1,11
6,2007,660500,37,34,3,11
7,2007,660500,37,37,0,3
8,2007,660500,17,15,2,12
9,2007,660500,21,15,6,6
10,2007,660500,30,28,2,6
11,2007,660500,22,22,0,5
12,2007,660500,17,16,1,1
1,2008,660500,22,20,2,3
2,2008,660500,13,12,1,2
3,2008,660500,18,12,6,6
4,2008,660500,20,13,7,3
5,2008,660500,22,18,4,10
6,2008,660500,35,28,7,9
7,2008,660500,22,20,2,2
8,2008,660500,32,27,5,6
9,2008,660500,34,30,4,3
10,2008,660500,26,24,2,4
11,2008,660500,24,21,3,0
12,2008,660500,22,20,2,1
1,2009,660500,24,22,2,3
2,2009,660500,21,20,1,5
3,2009,660500,22,19,3,5
4,2009,660500,23,21,2,11
5,2009,660500,20,19,1,4
6,2009,660500,22,22,0,6
7,2009,660500,36,32,4,6
8,2009,660500,23,17,6,5
9,2009,660500,22,19,3,10
10,2009,660500,22,21,1,4
11,2009,660500,16,14,2,3
12,2009,660500,21,18,3,1
1,2010,660500,34,33,1,5
2,2010,660500,12,11,1,3
3,2010,660500,21,19,2,3
4,2010,660500,17,17,0,5
5,2010,660500,28,27,1,4
6,2010,660500,25,23,2,5
7,2010,660500,24,21,3,1
8,2010,660500,41,38,3,8
9,2010,660500,22,19,3,7
10,2010,660500,29,27,2,2
11,2010,660500,33,31,2,7
12,2010,660500,18,15,3,4
1,2011,660500,24,23,1,6
2,2011,660500,7,5,2,2
1,1999,660800,24,20,4,14
2,1999,660800,23,20,3,5
3,1999,660800,32,31,1,5
4,1999,660800,39,34,5,6
5,1999,660800,43,37,6,9
6,1999,660800,39,32,7,4
7,1999,660800,41,35,6,2
8,1999,660800,32,28,4,2
9,1999,660800,35,31,4,11
10,1999,660800,42,39,3,11
11,1999,660800,35,25,10,6
12,1999,660800,27,25,2,6
1,2000,660800,31,27,4,7
2,2000,660800,23,20,3,4
3,2000,660800,27,20,7,2
4,2000,660800,28,20,8,6
5,2000,660800,35,27,8,4
6,2000,660800,27,21,6,3
7,2000,660800,37,30,7,3
8,2000,660800,50,44,6,6
9,2000,660800,46,39,7,6
10,2000,660800,34,30,4,2
11,2000,660800,30,26,4,2
12,2000,660800,34,29,5,7
1,2001,660800,27,26,1,4
2,2001,660800,30,29,1,7
3,2001,660800,47,38,9,8
4,2001,660800,41,38,3,10
5,2001,660800,46,37,9,1
6,2001,660800,31,26,5,8
7,2001,660800,30,21,9,5
8,2001,660800,35,29,6,7
9,2001,660800,33,30,3,4
10,2001,660800,58,50,8,0
11,2001,660800,37,34,3,10
12,2001,660800,25,24,1,5
1,2002,660800,30,28,2,1
2,2002,660800,29,23,6,1
3,2002,660800,31,24,7,0
4,2002,660800,31,24,7,1
5,2002,660800,33,28,5,6
6,2002,660800,33,27,6,7
7,2002,660800,45,44,1,3
8,2002,660800,51,51,0,7
9,2002,660800,33,24,9,8
10,2002,660800,37,31,6,6
11,2002,660800,17,15,2,3
12,2002,660800,36,33,3,11
1,2003,660800,13,12,1,6
2,2003,660800,12,11,1,1
3,2003,660800,16,14,2,7
4,2003,660800,30,27,3,6
5,2003,660800,35,26,9,9
6,2003,660800,24,22,2,7
7,2003,660800,25,23,2,12
8,2003,660800,30,23,7,3
9,2003,660800,34,25,9,9
10,2003,660800,28,25,3,5
11,2003,660800,30,27,3,2
12,2003,660800,25,24,1,5
1,2004,660800,19,17,2,14
2,2004,660800,26,22,4,9
3,2004,660800,23,22,1,3
4,2004,660800,32,24,8,8
5,2004,660800,35,29,6,10
6,2004,660800,41,33,8,11
7,2004,660800,35,30,5,11
8,2004,660800,29,24,5,13
9,2004,660800,39,33,6,8
10,2004,660800,29,27,2,5
11,2004,660800,31,29,2,9
12,2004,660800,27,24,3,4
1,2005,660800,31,27,4,1
2,2005,660800,20,18,2,16
3,2005,660800,31,27,4,5
4,2005,660800,22,19,3,4
5,2005,660800,29,24,5,5
6,2005,660800,39,33,6,0
7,2005,660800,38,30,8,7
8,2005,660800,48,36,12,10
9,2005,660800,51,40,11,1
10,2005,660800,36,27,9,8
11,2005,660800,31,23,8,12
12,2005,660800,39,35,4,4
1,2006,660800,35,31,4,10
2,2006,660800,32,29,3,11
3,2006,660800,28,21,7,6
4,2006,660800,29,21,8,15
5,2006,660800,28,23,5,10
6,2006,660800,34,30,4,13
7,2006,660800,36,32,4,12
8,2006,660800,60,54,6,10
9,2006,660800,46,42,4,11
10,2006,660800,31,28,3,7
11,2006,660800,35,28,7,11
12,2006,660800,25,20,5,15
1,2007,660800,33,30,3,20
2,2007,660800,33,32,1,9
3,2007,660800,31,25,6,3
4,2007,660800,36,32,4,10
5,2007,660800,29,27,2,5
6,2007,660800,42,35,7,9
7,2007,660800,36,30,6,13
8,2007,660800,31,29,2,14
9,2007,660800,32,30,2,16
10,2007,660800,42,36,6,14
11,2007,660800,38,35,3,14
12,2007,660800,36,31,5,4
1,2008,660800,30,22,8,7
2,2008,660800,26,19,7,5
3,2008,660800,28,26,2,2
4,2008,660800,39,31,8,15
5,2008,660800,28,25,3,6
6,2008,660800,31,25,6,6
7,2008,660800,51,45,6,10
8,2008,660800,51,42,9,12
9,2008,660800,40,31,9,14
10,2008,660800,50,42,8,7
11,2008,660800,33,27,6,12
12,2008,660800,53,43,10,8
1,2009,660800,30,22,8,13
2,2009,660800,35,30,5,8
3,2009,660800,28,22,6,15
4,2009,660800,28,26,2,10
5,2009,660800,37,34,3,9
6,2009,660800,54,45,9,13
7,2009,660800,42,40,2,15
8,2009,660800,35,30,5,17
9,2009,660800,19,15,4,17
10,2009,660800,26,21,5,10
11,2009,660800,28,26,2,13
12,2009,660800,29,26,3,6
1,2010,660800,35,30,5,9
2,2010,660800,21,20,1,18
3,2010,660800,36,30,6,13
4,2010,660800,37,32,5,15
5,2010,660800,35,30,5,3
6,2010,660800,41,35,6,10
7,2010,660800,41,35,6,17
8,2010,660800,39,29,10,14
9,2010,660800,34,30,4,14
10,2010,660800,35,30,5,17
11,2010,660800,28,23,5,13
12,2010,660800,24,22,2,11
1,2011,660800,25,22,3,11
2,2011,660800,18,16,2,10
1,1999,681000,54,43,11,9
2,1999,681000,48,43,5,8
3,1999,681000,44,37,7,13
4,1999,681000,64,48,16,12
5,1999,681000,60,43,17,15
6,1999,681000,57,50,7,10
7,1999,681000,95,80,15,15
8,1999,681000,72,57,15,12
9,1999,681000,80,63,17,9
10,1999,681000,64,52,12,12
11,1999,681000,61,47,14,10
12,1999,681000,67,59,8,8
1,2000,681000,55,48,7,5
2,2000,681000,76,64,12,12
3,2000,681000,56,49,7,12
4,2000,681000,37,31,6,12
5,2000,681000,53,46,7,16
6,2000,681000,57,48,9,6
7,2000,681000,64,53,11,7
8,2000,681000,59,47,12,12
9,2000,681000,68,56,12,6
10,2000,681000,67,55,12,7
11,2000,681000,63,55,8,13
12,2000,681000,51,43,8,3
1,2001,681000,65,53,12,7
2,2001,681000,53,39,14,11
3,2001,681000,48,43,5,3
4,2001,681000,57,44,13,11
5,2001,681000,50,39,11,8
6,2001,681000,53,42,11,7
7,2001,681000,71,54,17,4
8,2001,681000,56,46,10,14
9,2001,681000,61,54,7,2
10,2001,681000,68,52,16,8
11,2001,681000,55,49,6,8
12,2001,681000,62,47,15,6
1,2002,681000,47,34,13,15
2,2002,681000,43,39,4,5
3,2002,681000,42,34,8,13
4,2002,681000,69,52,17,5
5,2002,681000,62,45,17,16
6,2002,681000,55,45,10,11
7,2002,681000,71,54,17,12
8,2002,681000,51,44,7,9
9,2002,681000,59,46,13,16
10,2002,681000,71,65,6,11
11,2002,681000,48,38,10,16
12,2002,681000,41,34,7,8
1,2003,681000,46,38,8,13
2,2003,681000,30,26,4,9
3,2003,681000,32,25,7,13
4,2003,681000,26,18,8,6
5,2003,681000,48,42,6,9
6,2003,681000,49,39,10,11
7,2003,681000,41,26,15,5
8,2003,681000,56,43,13,14
9,2003,681000,41,31,10,5
10,2003,681000,48,37,11,6
11,2003,681000,48,44,4,4
12,2003,681000,49,39,10,9
1,2004,681000,31,28,3,9
2,2004,681000,33,25,8,4
3,2004,681000,55,46,9,13
4,2004,681000,41,34,7,11
5,2004,681000,49,36,13,9
6,2004,681000,25,20,5,9
7,2004,681000,39,31,8,15
8,2004,681000,46,36,10,17
9,2004,681000,56,49,7,13
10,2004,681000,54,44,10,16
11,2004,681000,34,30,4,21
12,2004,681000,36,29,7,11
1,2005,681000,27,19,8,10
2,2005,681000,28,23,5,10
3,2005,681000,34,26,8,23
4,2005,681000,46,36,10,10
5,2005,681000,46,38,8,12
6,2005,681000,56,43,13,16
7,2005,681000,55,42,13,10
8,2005,681000,44,37,7,2
9,2005,681000,34,29,5,7
10,2005,681000,29,23,6,11
11,2005,681000,42,38,4,7
12,2005,681000,42,36,6,5
1,2006,681000,47,44,3,12
2,2006,681000,32,27,5,17
3,2006,681000,51,40,11,22
4,2006,681000,49,31,18,14
5,2006,681000,36,30,6,7
6,2006,681000,44,33,11,9
7,2006,681000,54,44,10,19
8,2006,681000,42,39,3,14
9,2006,681000,48,34,14,10
10,2006,681000,43,34,9,10
11,2006,681000,41,35,6,13
12,2006,681000,47,42,5,13
1,2007,681000,39,26,13,4
2,2007,681000,28,27,1,7
3,2007,681000,39,29,10,21
4,2007,681000,54,44,10,11
5,2007,681000,48,38,10,14
6,2007,681000,61,42,19,12
7,2007,681000,50,38,12,21
8,2007,681000,43,33,10,18
9,2007,681000,57,47,10,20
10,2007,681000,65,56,9,14
11,2007,681000,48,42,6,29
12,2007,681000,44,38,6,9
1,2008,681000,44,35,9,10
2,2008,681000,28,23,5,10
3,2008,681000,42,36,6,21
4,2008,681000,47,34,13,12
5,2008,681000,56,48,8,9
6,2008,681000,54,43,11,15
7,2008,681000,65,58,7,16
8,2008,681000,80,68,12,29
9,2008,681000,56,50,6,22
10,2008,681000,56,53,3,18
11,2008,681000,53,44,9,22
12,2008,681000,37,31,6,13
1,2009,681000,42,34,8,10
2,2009,681000,41,36,5,11
3,2009,681000,36,27,9,19
4,2009,681000,39,33,6,10
5,2009,681000,48,43,5,7
6,2009,681000,52,43,9,14
7,2009,681000,40,32,8,16
8,2009,681000,37,28,9,13
9,2009,681000,38,29,9,12
10,2009,681000,47,41,6,18
11,2009,681000,48,42,6,13
12,2009,681000,43,37,6,7
1,2010,681000,37,31,6,11
2,2010,681000,30,28,2,17
3,2010,681000,41,34,7,17
4,2010,681000,32,24,8,16
5,2010,681000,41,29,12,10
6,2010,681000,43,36,7,6
7,2010,681000,54,47,7,11
8,2010,681000,57,52,5,5
9,2010,681000,52,45,7,13
10,2010,681000,62,51,11,13
11,2010,681000,35,28,7,11
12,2010,681000,37,32,5,13
1,2011,681000,37,31,6,10
2,2011,681000,24,19,5,8
1,1999,842500,32,27,5,2
2,1999,842500,16,14,2,1
3,1999,842500,32,27,5,6
4,1999,842500,29,28,1,2
5,1999,842500,38,32,6,0
6,1999,842500,28,27,1,0
7,1999,842500,38,34,4,3
8,1999,842500,44,31,13,2
9,1999,842500,32,28,4,4
10,1999,842500,25,22,3,2
11,1999,842500,26,22,4,1
12,1999,842500,26,25,1,6
1,2000,842500,32,28,4,2
2,2000,842500,20,15,5,5
3,2000,842500,24,21,3,2
4,2000,842500,25,24,1,8
5,2000,842500,17,14,3,4
6,2000,842500,27,22,5,2
7,2000,842500,20,19,1,3
8,2000,842500,27,24,3,3
9,2000,842500,24,21,3,5
10,2000,842500,29,26,3,4
11,2000,842500,26,23,3,2
12,2000,842500,18,17,1,2
1,2001,842500,20,20,0,1
2,2001,842500,24,21,3,4
3,2001,842500,12,10,2,1
4,2001,842500,20,16,4,4
5,2001,842500,24,21,3,4
6,2001,842500,24,20,4,7
7,2001,842500,20,15,5,7
8,2001,842500,14,12,2,3
9,2001,842500,29,19,10,6
10,2001,842500,28,23,5,4
11,2001,842500,15,12,3,4
12,2001,842500,23,21,2,4
1,2002,842500,20,16,4,6
2,2002,842500,18,16,2,5
3,2002,842500,20,20,0,6
4,2002,842500,21,20,1,2
5,2002,842500,28,23,5,4
6,2002,842500,18,17,1,8
7,2002,842500,18,13,5,3
8,2002,842500,25,23,2,5
9,2002,842500,24,17,7,4
10,2002,842500,22,19,3,2
11,2002,842500,19,16,3,2
12,2002,842500,19,15,4,10
1,2003,842500,20,18,2,9
2,2003,842500,9,7,2,9
3,2003,842500,19,16,3,13
4,2003,842500,18,16,2,8
5,2003,842500,16,11,5,5
6,2003,842500,19,17,2,5
7,2003,842500,29,24,5,5
8,2003,842500,18,12,6,5
9,2003,842500,20,20,0,1
10,2003,842500,21,17,4,12
11,2003,842500,20,16,4,15
12,2003,842500,14,13,1,6
1,2004,842500,16,16,0,29
2,2004,842500,18,17,1,31
3,2004,842500,12,10,2,10
4,2004,842500,21,19,2,7
5,2004,842500,16,15,1,2
6,2004,842500,16,14,2,12
7,2004,842500,29,25,4,9
8,2004,842500,13,12,1,5
9,2004,842500,21,19,2,8
10,2004,842500,22,19,3,11
11,2004,842500,14,11,3,6
12,2004,842500,20,18,2,6
1,2005,842500,12,11,1,18
2,2005,842500,14,12,2,25
3,2005,842500,16,10,6,10
4,2005,842500,14,13,1,11
5,2005,842500,18,14,4,13
6,2005,842500,26,23,3,10
7,2005,842500,21,20,1,11
8,2005,842500,14,9,5,12
9,2005,842500,23,19,4,9
10,2005,842500,25,21,4,6
11,2005,842500,23,22,1,8
12,2005,842500,17,14,3,12
1,2006,842500,17,16,1,12
2,2006,842500,9,7,2,10
3,2006,842500,11,8,3,6
4,2006,842500,19,12,7,22
5,2006,842500,14,12,2,15
6,2006,842500,17,15,2,9
7,2006,842500,24,21,3,2
8,2006,842500,26,23,3,1
9,2006,842500,21,18,3,3
10,2006,842500,22,17,5,9
11,2006,842500,25,23,2,7
12,2006,842500,13,12,1,5
1,2007,842500,18,18,0,12
2,2007,842500,16,16,0,10
3,2007,842500,17,16,1,15
4,2007,842500,12,7,5,13
5,2007,842500,23,19,4,8
6,2007,842500,28,24,4,15
7,2007,842500,22,13,9,6
8,2007,842500,25,20,5,9
9,2007,842500,22,19,3,12
10,2007,842500,20,14,6,5
11,2007,842500,13,12,1,4
12,2007,842500,15,15,0,4
1,2008,842500,21,17,4,9
2,2008,842500,15,13,2,8
3,2008,842500,9,7,2,3
4,2008,842500,12,10,2,7
5,2008,842500,22,13,9,3
6,2008,842500,23,15,8,7
7,2008,842500,19,12,7,4
8,2008,842500,29,22,7,8
9,2008,842500,19,16,3,3
10,2008,842500,23,21,2,8
11,2008,842500,17,15,2,5
12,2008,842500,12,10,2,6
1,2009,842500,8,7,1,6
2,2009,842500,8,7,1,7
3,2009,842500,14,11,3,9
4,2009,842500,21,19,2,7
5,2009,842500,27,21,6,11
6,2009,842500,22,18,4,8
7,2009,842500,17,13,4,3
8,2009,842500,27,22,5,6
9,2009,842500,15,14,1,4
10,2009,842500,13,10,3,1
11,2009,842500,9,7,2,7
12,2009,842500,15,15,0,4
1,2010,842500,7,5,2,19
2,2010,842500,7,5,2,11
3,2010,842500,12,10,2,6
4,2010,842500,17,13,4,4
5,2010,842500,14,11,3,8
6,2010,842500,17,17,0,6
7,2010,842500,15,12,3,10
8,2010,842500,14,11,3,8
9,2010,842500,22,19,3,15
10,2010,842500,25,21,4,12
11,2010,842500,13,12,1,10
12,2010,842500,13,9,4,14
1,2011,842500,13,13,0,12
2,2011,842500,8,5,3,8
1,1999,420700,44,35,9,18
2,1999,420700,35,28,7,9
3,1999,420700,45,34,11,14
4,1999,420700,58,43,15,9
5,1999,420700,36,26,10,9
6,1999,420700,54,45,9,8
7,1999,420700,59,40,19,17
8,1999,420700,57,47,10,18
9,1999,420700,58,45,13,20
10,1999,420700,61,48,13,11
11,1999,420700,45,40,5,14
12,1999,420700,50,44,6,5
1,2000,420700,44,36,8,15
2,2000,420700,37,35,2,37
3,2000,420700,57,47,10,31
4,2000,420700,63,52,11,15
5,2000,420700,48,40,8,25
6,2000,420700,61,47,14,20
7,2000,420700,58,39,19,29
8,2000,420700,61,54,7,22
9,2000,420700,72,59,13,22
10,2000,420700,84,66,18,25
11,2000,420700,69,59,10,21
12,2000,420700,46,43,3,21
1,2001,420700,49,38,11,29
2,2001,420700,46,39,7,30
3,2001,420700,61,49,12,36
4,2001,420700,60,42,18,27
5,2001,420700,61,53,8,16
6,2001,420700,58,41,17,35
7,2001,420700,70,54,16,28
8,2001,420700,60,44,16,21
9,2001,420700,51,32,19,22
10,2001,420700,73,56,17,11
11,2001,420700,41,34,7,33
12,2001,420700,44,32,12,18
1,2002,420700,38,28,10,21
2,2002,420700,37,25,12,40
3,2002,420700,53,42,11,26
4,2002,420700,40,24,16,25
5,2002,420700,42,31,11,25
6,2002,420700,52,40,12,28
7,2002,420700,53,43,10,24
8,2002,420700,68,45,23,25
9,2002,420700,59,42,17,35
10,2002,420700,52,41,11,32
11,2002,420700,40,26,14,36
12,2002,420700,33,25,8,35
1,2003,420700,50,36,14,34
2,2003,420700,41,34,7,32
3,2003,420700,49,38,11,23
4,2003,420700,56,48,8,41
5,2003,420700,53,42,11,28
6,2003,420700,44,31,13,18
7,2003,420700,51,30,21,21
8,2003,420700,57,41,16,19
9,2003,420700,45,35,10,27
10,2003,420700,50,40,10,40
11,2003,420700,56,40,16,27
12,2003,420700,39,30,9,17
1,2004,420700,40,35,5,19
2,2004,420700,34,19,15,20
3,2004,420700,55,43,12,19
4,2004,420700,56,39,17,53
5,2004,420700,70,55,15,23
6,2004,420700,57,33,24,48
7,2004,420700,43,31,12,40
8,2004,420700,57,36,21,40
9,2004,420700,49,39,10,36
10,2004,420700,46,34,12,38
11,2004,420700,41,33,8,32
12,2004,420700,48,40,8,81
1,2005,420700,49,36,13,38
2,2005,420700,53,45,8,43
3,2005,420700,55,41,14,24
4,2005,420700,61,46,15,35
5,2005,420700,51,33,18,30
6,2005,420700,64,47,17,15
7,2005,420700,70,51,19,21
8,2005,420700,64,50,14,57
9,2005,420700,46,40,6,37
10,2005,420700,44,28,16,30
11,2005,420700,48,35,13,34
12,2005,420700,41,33,8,33
1,2006,420700,51,43,8,17
2,2006,420700,41,31,10,61
3,2006,420700,39,31,8,45
4,2006,420700,52,40,12,35
5,2006,420700,45,31,14,16
6,2006,420700,45,37,8,35
7,2006,420700,83,69,14,32
8,2006,420700,68,56,12,22
9,2006,420700,52,38,14,18
10,2006,420700,52,37,15,27
11,2006,420700,49,44,5,26
12,2006,420700,58,47,11,25
1,2007,420700,49,41,8,31
2,2007,420700,31,23,8,30
3,2007,420700,54,43,11,50
4,2007,420700,56,42,14,32
5,2007,420700,49,38,11,29
6,2007,420700,70,55,15,31
7,2007,420700,70,50,20,50
8,2007,420700,75,55,20,29
9,2007,420700,71,58,13,36
10,2007,420700,85,62,23,24
11,2007,420700,55,52,3,20
12,2007,420700,57,53,4,8
1,2008,420700,68,55,13,16
2,2008,420700,30,26,4,12
3,2008,420700,43,35,8,26
4,2008,420700,65,46,19,20
5,2008,420700,72,58,14,13
6,2008,420700,74,55,19,17
7,2008,420700,51,38,13,18
8,2008,420700,68,54,14,17
9,2008,420700,67,61,6,28
10,2008,420700,49,33,16,42
11,2008,420700,60,54,6,14
12,2008,420700,41,38,3,31
1,2009,420700,42,40,2,28
2,2009,420700,37,28,9,16
3,2009,420700,48,39,9,23
4,2009,420700,52,46,6,40
5,2009,420700,59,40,19,32
6,2009,420700,59,44,15,25
7,2009,420700,55,41,14,19
8,2009,420700,62,47,15,39
9,2009,420700,47,35,12,37
10,2009,420700,58,45,13,22
11,2009,420700,51,44,7,25
12,2009,420700,45,34,11,29
1,2010,420700,36,29,7,59
2,2010,420700,27,18,9,33
3,2010,420700,52,38,14,17
4,2010,420700,47,35,12,27
5,2010,420700,48,40,8,27
6,2010,420700,53,41,12,21
7,2010,420700,53,42,11,34
8,2010,420700,56,39,17,24
9,2010,420700,44,33,11,38
10,2010,420700,36,26,10,35
11,2010,420700,35,30,5,36
12,2010,420700,32,24,8,19
1,2011,420700,34,27,7,28
2,2011,420700,23,16,7,22
1,1999,834400,16,13,3,3
2,1999,834400,14,12,2,2
3,1999,834400,16,12,4,2
4,1999,834400,27,21,6,2
5,1999,834400,19,13,6,1
6,1999,834400,22,17,5,3
7,1999,834400,19,17,2,3
8,1999,834400,29,24,5,2
9,1999,834400,36,27,9,5
10,1999,834400,15,13,2,3
11,1999,834400,28,26,2,5
12,1999,834400,29,22,7,3
1,2000,834400,13,12,1,3
2,2000,834400,19,14,5,6
3,2000,834400,31,22,9,3
4,2000,834400,19,15,4,3
5,2000,834400,26,22,4,3
6,2000,834400,31,23,8,7
7,2000,834400,27,19,8,2
8,2000,834400,27,22,5,0
9,2000,834400,25,21,4,2
10,2000,834400,36,32,4,1
11,2000,834400,24,19,5,4
12,2000,834400,21,19,2,4
1,2001,834400,16,12,4,1
2,2001,834400,11,8,3,2
3,2001,834400,21,19,2,1
4,2001,834400,27,20,7,4
5,2001,834400,31,24,7,5
6,2001,834400,18,14,4,5
7,2001,834400,27,24,3,6
8,2001,834400,38,32,6,2
9,2001,834400,34,31,3,3
10,2001,834400,22,20,2,3
11,2001,834400,16,14,2,3
12,2001,834400,23,16,7,3
1,2002,834400,23,21,2,6
2,2002,834400,17,16,1,3
3,2002,834400,36,26,10,1
4,2002,834400,29,24,5,4
5,2002,834400,29,23,6,2
6,2002,834400,15,9,6,1
7,2002,834400,17,13,4,1
8,2002,834400,20,14,6,5
9,2002,834400,21,18,3,1
10,2002,834400,33,29,4,0
11,2002,834400,19,18,1,4
12,2002,834400,16,12,4,6
1,2003,834400,13,13,0,1
2,2003,834400,22,19,3,2
3,2003,834400,17,14,3,2
4,2003,834400,23,19,4,1
5,2003,834400,26,20,6,1
6,2003,834400,20,14,6,5
7,2003,834400,24,20,4,1
8,2003,834400,35,31,4,1
9,2003,834400,16,15,1,14
10,2003,834400,25,22,3,6
11,2003,834400,19,15,4,4
12,2003,834400,29,28,1,1
1,2004,834400,25,24,1,0
2,2004,834400,16,15,1,2
3,2004,834400,21,18,3,0
4,2004,834400,13,12,1,3
5,2004,834400,21,20,1,3
6,2004,834400,16,15,1,2
7,2004,834400,28,24,4,5
8,2004,834400,23,20,3,8
9,2004,834400,17,14,3,5
10,2004,834400,13,9,4,1
11,2004,834400,20,17,3,1
12,2004,834400,21,18,3,8
1,2005,834400,15,15,0,4
2,2005,834400,14,13,1,4
3,2005,834400,15,13,2,10
4,2005,834400,18,16,2,3
5,2005,834400,16,15,1,5
6,2005,834400,29,24,5,2
7,2005,834400,26,21,5,1
8,2005,834400,49,47,2,8
9,2005,834400,23,21,2,9
10,2005,834400,22,18,4,4
11,2005,834400,14,11,3,1
12,2005,834400,17,17,0,3
1,2006,834400,21,16,5,1
2,2006,834400,14,14,0,2
3,2006,834400,16,16,0,1
4,2006,834400,24,20,4,2
5,2006,834400,17,14,3,0
6,2006,834400,18,17,1,3
7,2006,834400,35,29,6,4
8,2006,834400,28,27,1,5
9,2006,834400,27,25,2,4
10,2006,834400,17,14,3,1
11,2006,834400,26,23,3,2
12,2006,834400,31,29,2,0
1,2007,834400,25,23,2,6
2,2007,834400,15,14,1,0
3,2007,834400,18,18,0,2
4,2007,834400,21,18,3,1
5,2007,834400,28,25,3,6
6,2007,834400,29,24,5,3
7,2007,834400,18,12,6,2
8,2007,834400,23,22,1,2
9,2007,834400,22,19,3,6
10,2007,834400,29,26,3,3
11,2007,834400,19,18,1,1
12,2007,834400,12,9,3,4
1,2008,834400,15,14,1,2
2,2008,834400,17,14,3,1
3,2008,834400,21,19,2,1
4,2008,834400,30,28,2,2
5,2008,834400,24,24,0,0
6,2008,834400,19,17,2,3
7,2008,834400,23,18,5,0
8,2008,834400,23,20,3,4
9,2008,834400,22,20,2,4
10,2008,834400,22,20,2,0
11,2008,834400,19,18,1,1
12,2008,834400,14,10,4,6
1,2009,834400,18,15,3,2
2,2009,834400,14,14,0,0
3,2009,834400,24,23,1,1
4,2009,834400,17,14,3,7
5,2009,834400,27,23,4,1
6,2009,834400,18,13,5,2
7,2009,834400,32,28,4,0
8,2009,834400,32,27,5,2
9,2009,834400,13,11,2,4
10,2009,834400,18,16,2,2
11,2009,834400,27,24,3,0
12,2009,834400,18,16,2,2
1,2010,834400,14,11,3,2
2,2010,834400,10,10,0,1
3,2010,834400,5,4,1,2
4,2010,834400,12,12,0,2
5,2010,834400,16,13,3,3
6,2010,834400,21,14,7,1
7,2010,834400,19,13,6,2
8,2010,834400,22,20,2,3
9,2010,834400,16,14,2,5
10,2010,834400,15,14,1,1
11,2010,834400,15,14,1,1
12,2010,834400,8,7,1,1
1,2011,834400,28,25,3,3
2,2011,834400,8,8,0,2
1,1999,680900,53,35,18,15
2,1999,680900,45,37,8,14
3,1999,680900,60,52,8,22
4,1999,680900,49,39,10,6
5,1999,680900,68,56,12,16
6,1999,680900,55,45,10,18
7,1999,680900,59,48,11,16
8,1999,680900,100,88,12,7
9,1999,680900,71,60,11,8
10,1999,680900,52,44,8,21
11,1999,680900,52,44,8,11
12,1999,680900,49,42,7,9
1,2000,680900,54,41,13,3
2,2000,680900,45,34,11,20
3,2000,680900,51,42,9,6
4,2000,680900,42,33,9,9
5,2000,680900,52,44,8,8
6,2000,680900,44,33,11,6
7,2000,680900,45,36,9,15
8,2000,680900,58,47,11,13
9,2000,680900,75,62,13,9
10,2000,680900,74,60,14,11
11,2000,680900,58,45,13,11
12,2000,680900,40,29,11,11
1,2001,680900,51,42,9,8
2,2001,680900,50,39,11,11
3,2001,680900,46,33,13,15
4,2001,680900,50,41,9,5
5,2001,680900,49,38,11,7
6,2001,680900,54,43,11,11
7,2001,680900,76,58,18,13
8,2001,680900,94,85,9,13
9,2001,680900,56,48,8,3
10,2001,680900,55,41,14,3
11,2001,680900,40,33,7,8
12,2001,680900,50,39,11,11
1,2002,680900,35,26,9,8
2,2002,680900,42,36,6,17
3,2002,680900,36,31,5,19
4,2002,680900,34,25,9,15
5,2002,680900,60,46,14,19
6,2002,680900,64,51,13,12
7,2002,680900,89,75,14,8
8,2002,680900,67,54,13,2
9,2002,680900,83,72,11,17
10,2002,680900,65,54,11,9
11,2002,680900,47,30,17,21
12,2002,680900,39,27,12,9
1,2003,680900,48,42,6,14
2,2003,680900,55,49,6,9
3,2003,680900,43,35,8,9
4,2003,680900,45,33,12,10
5,2003,680900,46,36,10,8
6,2003,680900,72,60,12,4
7,2003,680900,68,48,20,15
8,2003,680900,65,49,16,3
9,2003,680900,50,39,11,3
10,2003,680900,51,45,6,8
11,2003,680900,40,31,9,7
12,2003,680900,39,33,6,14
1,2004,680900,51,44,7,12
2,2004,680900,35,23,12,9
3,2004,680900,47,40,7,39
4,2004,680900,46,42,4,8
5,2004,680900,57,48,9,13
6,2004,680900,57,45,12,7
7,2004,680900,63,56,7,10
8,2004,680900,57,46,11,9
9,2004,680900,47,37,10,18
10,2004,680900,64,56,8,18
11,2004,680900,37,27,10,29
12,2004,680900,34,27,7,15
1,2005,680900,44,37,7,6
2,2005,680900,42,34,8,17
3,2005,680900,52,39,13,16
4,2005,680900,46,39,7,14
5,2005,680900,51,39,12,16
6,2005,680900,61,49,12,13
7,2005,680900,64,53,11,11
8,2005,680900,57,48,9,13
9,2005,680900,49,42,7,8
10,2005,680900,53,48,5,10
11,2005,680900,38,35,3,5
12,2005,680900,53,48,5,4
1,2006,680900,54,45,9,8
2,2006,680900,48,37,11,21
3,2006,680900,53,44,9,20
4,2006,680900,45,38,7,16
5,2006,680900,49,39,10,8
6,2006,680900,58,44,14,8
7,2006,680900,53,44,9,10
8,2006,680900,43,36,7,18
9,2006,680900,55,48,7,9
10,2006,680900,53,46,7,2
11,2006,680900,32,24,8,10
12,2006,680900,42,36,6,13
1,2007,680900,39,36,3,14
2,2007,680900,36,29,7,8
3,2007,680900,31,22,9,12
4,2007,680900,38,32,6,7
5,2007,680900,48,40,8,16
6,2007,680900,59,45,14,19
7,2007,680900,61,55,6,13
8,2007,680900,70,60,10,14
9,2007,680900,44,33,11,12
10,2007,680900,55,48,7,7
11,2007,680900,47,39,8,18
12,2007,680900,46,42,4,16
1,2008,680900,49,43,6,15
2,2008,680900,33,25,8,21
3,2008,680900,57,47,10,13
4,2008,680900,50,39,11,5
5,2008,680900,70,57,13,15
6,2008,680900,67,49,18,16
7,2008,680900,80,70,10,6
8,2008,680900,51,42,9,12
9,2008,680900,61,54,7,7
10,2008,680900,72,55,17,3
11,2008,680900,46,36,10,14
12,2008,680900,47,39,8,10
1,2009,680900,42,35,7,14
2,2009,680900,52,45,7,25
3,2009,680900,40,32,8,14
4,2009,680900,60,50,10,7
5,2009,680900,63,54,9,16
6,2009,680900,41,35,6,11
7,2009,680900,76,64,12,11
8,2009,680900,54,48,6,13
9,2009,680900,73,60,13,9
10,2009,680900,62,51,11,4
11,2009,680900,47,41,6,7
12,2009,680900,56,50,6,8
1,2010,680900,53,49,4,8
2,2010,680900,31,26,5,10
3,2010,680900,44,34,10,13
4,2010,680900,48,38,10,6
5,2010,680900,49,41,8,7
6,2010,680900,43,35,8,5
7,2010,680900,40,37,3,12
8,2010,680900,42,38,4,11
9,2010,680900,67,61,6,7
10,2010,680900,61,54,7,5
11,2010,680900,48,44,4,4
12,2010,680900,37,33,4,8
1,2011,680900,41,37,4,5
2,2011,680900,34,29,5,2
1,1999,671100,9,7,2,3
2,1999,671100,11,8,3,4
3,1999,671100,12,8,4,1
4,1999,671100,9,6,3,2
5,1999,671100,19,14,5,2
6,1999,671100,9,5,4,5
7,1999,671100,16,12,4,1
8,1999,671100,15,5,10,6
9,1999,671100,10,8,2,1
10,1999,671100,17,11,6,4
11,1999,671100,14,8,6,3
12,1999,671100,17,14,3,0
1,2000,671100,9,7,2,9
2,2000,671100,11,7,4,4
3,2000,671100,20,17,3,3
4,2000,671100,16,13,3,3
5,2000,671100,19,16,3,7
6,2000,671100,20,11,9,4
7,2000,671100,13,10,3,4
8,2000,671100,23,15,8,3
9,2000,671100,17,12,5,6
10,2000,671100,17,12,5,4
11,2000,671100,20,11,9,3
12,2000,671100,14,11,3,6
1,2001,671100,15,15,0,2
2,2001,671100,13,8,5,0
3,2001,671100,19,10,9,3
4,2001,671100,10,7,3,3
5,2001,671100,20,14,6,2
6,2001,671100,20,16,4,13
7,2001,671100,26,19,7,1
8,2001,671100,12,9,3,6
9,2001,671100,9,6,3,1
10,2001,671100,17,14,3,2
11,2001,671100,11,6,5,5
12,2001,671100,13,10,3,4
1,2002,671100,15,7,8,5
2,2002,671100,10,9,1,11
3,2002,671100,8,5,3,9
4,2002,671100,8,6,2,7
5,2002,671100,15,11,4,5
6,2002,671100,12,8,4,4
7,2002,671100,23,15,8,2
8,2002,671100,25,23,2,6
9,2002,671100,23,17,6,4
10,2002,671100,21,18,3,3
11,2002,671100,18,17,1,1
12,2002,671100,18,10,8,1
1,2003,671100,10,8,2,4
2,2003,671100,7,7,0,2
3,2003,671100,17,11,6,3
4,2003,671100,17,12,5,5
5,2003,671100,22,13,9,7
6,2003,671100,13,10,3,1
7,2003,671100,20,16,4,11
8,2003,671100,13,9,4,1
9,2003,671100,7,7,0,1
10,2003,671100,17,8,9,3
11,2003,671100,10,6,4,3
12,2003,671100,11,9,2,3
1,2004,671100,8,8,0,4
2,2004,671100,9,5,4,4
3,2004,671100,12,8,4,3
4,2004,671100,8,6,2,1
5,2004,671100,18,11,7,1
6,2004,671100,19,15,4,3
7,2004,671100,9,7,2,4
8,2004,671100,10,9,1,7
9,2004,671100,5,4,1,6
10,2004,671100,15,11,4,5
11,2004,671100,7,6,1,2
12,2004,671100,13,11,2,3
1,2005,671100,20,19,1,4
2,2005,671100,7,6,1,1
3,2005,671100,13,11,2,10
4,2005,671100,17,9,8,4
5,2005,671100,14,12,2,2
6,2005,671100,6,5,1,5
7,2005,671100,13,9,4,6
8,2005,671100,26,18,8,18
9,2005,671100,13,10,3,6
10,2005,671100,15,10,5,6
11,2005,671100,13,9,4,4
12,2005,671100,13,12,1,1
1,2006,671100,11,8,3,6
2,2006,671100,21,16,5,3
3,2006,671100,10,5,5,5
4,2006,671100,11,7,4,3
5,2006,671100,6,3,3,2
6,2006,671100,23,20,3,2
7,2006,671100,10,10,0,6
8,2006,671100,19,13,6,6
9,2006,671100,10,9,1,2
10,2006,671100,16,12,4,1
11,2006,671100,10,10,0,3
12,2006,671100,15,11,4,2
1,2007,671100,9,6,3,0
2,2007,671100,12,8,4,6
3,2007,671100,16,11,5,12
4,2007,671100,15,14,1,2
5,2007,671100,19,13,6,7
6,2007,671100,15,10,5,5
7,2007,671100,30,21,9,11
8,2007,671100,33,25,8,4
9,2007,671100,12,6,6,6
10,2007,671100,26,18,8,0
11,2007,671100,19,11,8,1
12,2007,671100,22,20,2,5
1,2008,671100,11,9,2,6
2,2008,671100,11,9,2,10
3,2008,671100,10,9,1,4
4,2008,671100,20,19,1,8
5,2008,671100,13,12,1,10
6,2008,671100,26,20,6,3
7,2008,671100,22,18,4,5
8,2008,671100,35,31,4,12
9,2008,671100,30,27,3,7
10,2008,671100,21,19,2,10
11,2008,671100,16,13,3,4
12,2008,671100,17,14,3,3
1,2009,671100,11,11,0,7
2,2009,671100,10,8,2,4
3,2009,671100,12,10,2,16
4,2009,671100,12,12,0,7
5,2009,671100,12,10,2,4
6,2009,671100,6,4,2,9
7,2009,671100,18,11,7,10
8,2009,671100,18,10,8,11
9,2009,671100,10,9,1,2
10,2009,671100,6,5,1,4
11,2009,671100,13,11,2,4
12,2009,671100,12,11,1,8
1,2010,671100,13,12,1,2
2,2010,671100,8,7,1,6
3,2010,671100,17,16,1,4
4,2010,671100,21,19,2,7
5,2010,671100,20,13,7,3
6,2010,671100,16,13,3,4
7,2010,671100,9,7,2,4
8,2010,671100,13,10,3,1
9,2010,671100,10,7,3,3
10,2010,671100,10,8,2,3
11,2010,671100,18,14,4,4
12,2010,671100,9,5,4,2
1,2011,671100,10,10,0,2
2,2011,671100,4,4,0,4
1,1999,640600,2,2,0,0
2,1999,640600,2,1,1,0
3,1999,640600,3,3,0,0
4,1999,640600,5,4,1,0
5,1999,640600,2,2,0,0
6,1999,640600,3,2,1,0
7,1999,640600,7,6,1,0
8,1999,640600,5,5,0,0
9,1999,640600,1,1,0,0
10,1999,640600,6,6,0,0
11,1999,640600,4,4,0,0
12,1999,640600,2,2,0,0
1,2000,640600,4,4,0,0
2,2000,640600,5,4,1,0
3,2000,640600,5,4,1,0
4,2000,640600,1,1,0,0
5,2000,640600,5,5,0,1
6,2000,640600,7,7,0,0
7,2000,640600,3,2,1,0
8,2000,640600,4,4,0,0
9,2000,640600,4,4,0,0
10,2000,640600,5,5,0,0
11,2000,640600,6,6,0,0
12,2000,640600,2,2,0,0
1,2001,640600,2,2,0,0
2,2001,640600,2,2,0,0
3,2001,640600,4,4,0,0
4,2001,640600,7,6,1,0
5,2001,640600,6,6,0,1
6,2001,640600,4,2,2,0
7,2001,640600,7,6,1,0
8,2001,640600,7,6,1,0
9,2001,640600,5,4,1,0
10,2001,640600,6,5,1,1
11,2001,640600,5,5,0,0
12,2001,640600,4,3,1,0
1,2002,640600,4,4,0,1
2,2002,640600,3,3,0,0
3,2002,640600,5,5,0,2
4,2002,640600,5,3,2,0
5,2002,640600,6,5,1,0
6,2002,640600,8,8,0,0
7,2002,640600,5,5,0,0
8,2002,640600,1,1,0,0
9,2002,640600,8,7,1,0
10,2002,640600,8,8,0,0
11,2002,640600,5,5,0,0
12,2002,640600,3,3,0,0
1,2003,640600,4,4,0,0
2,2003,640600,2,2,0,0
3,2003,640600,4,4,0,1
4,2003,640600,7,7,0,0
5,2003,640600,4,4,0,0
6,2003,640600,3,2,1,2
7,2003,640600,7,7,0,1
8,2003,640600,11,10,1,0
9,2003,640600,6,5,1,0
10,2003,640600,1,1,0,1
11,2003,640600,5,5,0,0
12,2003,640600,7,7,0,0
1,2004,640600,6,6,0,2
2,2004,640600,2,2,0,1
3,2004,640600,8,6,2,0
4,2004,640600,5,5,0,0
5,2004,640600,10,9,1,0
6,2004,640600,6,6,0,1
7,2004,640600,8,8,0,0
8,2004,640600,2,2,0,1
9,2004,640600,9,9,0,0
10,2004,640600,5,5,0,0
11,2004,640600,11,10,1,0
12,2004,640600,7,7,0,0
1,2005,640600,7,7,0,0
2,2005,640600,3,3,0,0
3,2005,640600,2,2,0,0
4,2005,640600,6,5,1,0
5,2005,640600,2,2,0,0
6,2005,640600,8,7,1,0
7,2005,640600,5,5,0,0
8,2005,640600,2,2,0,0
9,2005,640600,2,2,0,0
10,2005,640600,5,4,1,0
11,2005,640600,3,3,0,0
12,2005,640600,6,6,0,0
1,2006,640600,3,3,0,0
2,2006,640600,2,2,0,0
3,2006,640600,4,4,0,0
4,2006,640600,7,7,0,0
5,2006,640600,3,3,0,1
6,2006,640600,4,4,0,0
7,2006,640600,5,4,1,0
8,2006,640600,2,2,0,0
9,2006,640600,4,3,1,0
10,2006,640600,5,5,0,0
11,2006,640600,5,5,0,0
12,2006,640600,2,2,0,0
1,2007,640600,2,1,1,0
2,2007,640600,2,2,0,0
3,2007,640600,2,1,1,3
4,2007,640600,4,3,1,3
5,2007,640600,1,1,0,1
6,2007,640600,3,2,1,0
7,2007,640600,9,9,0,4
8,2007,640600,2,2,0,1
9,2007,640600,5,5,0,2
10,2007,640600,7,7,0,1
11,2007,640600,4,4,0,2
12,2007,640600,0,0,0,0
1,2008,640600,5,5,0,2
2,2008,640600,5,5,0,0
3,2008,640600,5,5,0,1
4,2008,640600,7,7,0,1
5,2008,640600,1,1,0,3
6,2008,640600,7,7,0,0
7,2008,640600,13,12,1,0
8,2008,640600,7,7,0,1
9,2008,640600,3,3,0,7
10,2008,640600,2,2,0,3
11,2008,640600,9,9,0,0
12,2008,640600,8,7,1,2
1,2009,640600,3,3,0,0
2,2009,640600,3,3,0,0
3,2009,640600,6,5,1,0
4,2009,640600,3,2,1,0
5,2009,640600,7,6,1,3
6,2009,640600,3,3,0,0
7,2009,640600,5,4,1,0
8,2009,640600,1,1,0,1
9,2009,640600,3,2,1,0
10,2009,640600,10,10,0,0
11,2009,640600,1,1,0,0
12,2009,640600,2,2,0,0
1,2010,640600,2,2,0,0
2,2010,640600,4,4,0,0
3,2010,640600,2,2,0,0
4,2010,640600,5,5,0,0
5,2010,640600,3,3,0,0
6,2010,640600,2,1,1,0
7,2010,640600,2,2,0,0
8,2010,640600,4,4,0,0
9,2010,640600,4,4,0,0
10,2010,640600,6,5,1,0
11,2010,640600,2,2,0,1
12,2010,640600,5,5,0,0
1,2011,640600,1,1,0,0
2,2011,640600,2,2,0,0
1,1999,640500,1,1,0,0
2,1999,640500,1,1,0,0
3,1999,640500,3,3,0,0
4,1999,640500,1,1,0,0
5,1999,640500,2,2,0,0
6,1999,640500,2,2,0,0
7,1999,640500,1,1,0,0
8,1999,640500,3,3,0,0
9,1999,640500,4,4,0,0
10,1999,640500,2,2,0,0
11,1999,640500,2,2,0,0
12,1999,640500,1,1,0,0
1,2000,640500,3,3,0,0
2,2000,640500,3,3,0,0
3,2000,640500,1,1,0,0
4,2000,640500,2,2,0,0
5,2000,640500,4,3,1,0
6,2000,640500,5,5,0,0
7,2000,640500,2,2,0,0
8,2000,640500,2,2,0,1
9,2000,640500,3,3,0,2
10,2000,640500,4,4,0,0
11,2000,640500,0,0,0,0
12,2000,640500,1,1,0,0
1,2001,640500,3,3,0,0
2,2001,640500,4,4,0,0
3,2001,640500,5,5,0,0
4,2001,640500,7,7,0,0
5,2001,640500,10,10,0,0
6,2001,640500,2,2,0,0
7,2001,640500,2,2,0,0
8,2001,640500,4,4,0,0
9,2001,640500,1,1,0,0
10,2001,640500,5,3,2,0
11,2001,640500,5,4,1,0
12,2001,640500,2,2,0,0
1,2002,640500,3,3,0,0
2,2002,640500,1,1,0,0
3,2002,640500,2,2,0,0
4,2002,640500,4,4,0,1
5,2002,640500,3,3,0,1
6,2002,640500,12,12,0,0
7,2002,640500,5,5,0,0
8,2002,640500,3,3,0,0
9,2002,640500,4,4,0,0
10,2002,640500,4,4,0,1
11,2002,640500,4,4,0,0
12,2002,640500,2,2,0,1
1,2003,640500,7,7,0,0
2,2003,640500,5,5,0,0
3,2003,640500,3,2,1,0
4,2003,640500,12,11,1,0
5,2003,640500,1,1,0,1
6,2003,640500,3,3,0,0
7,2003,640500,2,2,0,0
8,2003,640500,7,7,0,0
9,2003,640500,7,7,0,0
10,2003,640500,6,6,0,0
11,2003,640500,4,4,0,0
12,2003,640500,4,3,1,0
1,2004,640500,3,3,0,0
2,2004,640500,3,3,0,0
3,2004,640500,2,2,0,0
4,2004,640500,1,1,0,0
5,2004,640500,3,3,0,0
6,2004,640500,4,4,0,0
7,2004,640500,8,8,0,0
8,2004,640500,7,6,1,0
9,2004,640500,3,3,0,0
10,2004,640500,2,2,0,0
11,2004,640500,10,10,0,0
12,2004,640500,4,3,1,0
1,2005,640500,5,4,1,0
2,2005,640500,3,3,0,0
3,2005,640500,1,1,0,0
4,2005,640500,2,2,0,0
5,2005,640500,0,0,0,0
6,2005,640500,5,5,0,0
7,2005,640500,5,5,0,0
8,2005,640500,5,5,0,0
9,2005,640500,1,1,0,0
10,2005,640500,2,2,0,0
11,2005,640500,5,4,1,0
12,2005,640500,6,6,0,0
1,2006,640500,4,3,1,0
2,2006,640500,3,3,0,0
3,2006,640500,3,3,0,0
4,2006,640500,1,1,0,0
5,2006,640500,5,5,0,0
6,2006,640500,3,3,0,0
7,2006,640500,1,1,0,0
8,2006,640500,2,2,0,0
9,2006,640500,4,4,0,0
10,2006,640500,0,0,0,0
11,2006,640500,3,3,0,0
12,2006,640500,3,3,0,1
1,2007,640500,2,2,0,0
2,2007,640500,0,0,0,1
3,2007,640500,4,4,0,0
4,2007,640500,7,7,0,1
5,2007,640500,4,4,0,0
6,2007,640500,12,12,0,0
7,2007,640500,8,8,0,0
8,2007,640500,2,2,0,0
9,2007,640500,3,2,1,1
10,2007,640500,6,6,0,0
11,2007,640500,5,5,0,0
12,2007,640500,1,1,0,1
1,2008,640500,4,4,0,2
2,2008,640500,1,1,0,0
3,2008,640500,0,0,0,0
4,2008,640500,3,3,0,0
5,2008,640500,3,3,0,0
6,2008,640500,7,7,0,0
7,2008,640500,5,5,0,0
8,2008,640500,4,4,0,0
9,2008,640500,4,4,0,0
10,2008,640500,4,4,0,0
11,2008,640500,1,1,0,1
12,2008,640500,6,5,1,0
1,2009,640500,4,4,0,0
2,2009,640500,3,3,0,0
3,2009,640500,2,2,0,0
4,2009,640500,2,2,0,1
5,2009,640500,6,5,1,0
6,2009,640500,5,4,1,0
7,2009,640500,6,6,0,0
8,2009,640500,3,2,1,2
9,2009,640500,3,3,0,0
10,2009,640500,3,3,0,0
11,2009,640500,1,1,0,0
12,2009,640500,2,2,0,0
1,2010,640500,5,5,0,0
2,2010,640500,1,1,0,1
3,2010,640500,2,2,0,0
4,2010,640500,3,3,0,0
5,2010,640500,7,6,1,0
6,2010,640500,1,1,0,0
7,2010,640500,4,3,1,0
8,2010,640500,5,3,2,0
9,2010,640500,8,8,0,0
10,2010,640500,5,5,0,0
11,2010,640500,2,1,1,0
12,2010,640500,3,3,0,0
1,2011,640500,2,2,0,0
2,2011,640500,4,3,1,0
1,1999,420800,14,12,2,4
2,1999,420800,18,16,2,1
3,1999,420800,29,22,7,6
4,1999,420800,31,24,7,7
5,1999,420800,27,21,6,7
6,1999,420800,25,19,6,3
7,1999,420800,29,28,1,2
8,1999,420800,28,24,4,3
9,1999,420800,28,24,4,3
10,1999,420800,17,12,5,3
11,1999,420800,26,20,6,8
12,1999,420800,11,9,2,2
1,2000,420800,14,11,3,4
2,2000,420800,12,10,2,5
3,2000,420800,19,12,7,5
4,2000,420800,20,10,10,3
5,2000,420800,30,21,9,3
6,2000,420800,31,20,11,4
7,2000,420800,47,37,10,6
8,2000,420800,25,21,4,8
9,2000,420800,24,18,6,9
10,2000,420800,23,21,2,5
11,2000,420800,24,19,5,3
12,2000,420800,19,16,3,3
1,2001,420800,19,18,1,2
2,2001,420800,18,17,1,5
3,2001,420800,21,19,2,10
4,2001,420800,21,19,2,5
5,2001,420800,20,14,6,3
6,2001,420800,14,12,2,2
7,2001,420800,24,23,1,7
8,2001,420800,27,20,7,1
9,2001,420800,27,20,7,3
10,2001,420800,15,10,5,4
11,2001,420800,11,7,4,2
12,2001,420800,22,16,6,4
1,2002,420800,13,9,4,6
2,2002,420800,7,7,0,9
3,2002,420800,14,13,1,7
4,2002,420800,17,13,4,5
5,2002,420800,10,9,1,0
6,2002,420800,15,14,1,3
7,2002,420800,19,15,4,0
8,2002,420800,15,12,3,2
9,2002,420800,15,12,3,3
10,2002,420800,10,8,2,0
11,2002,420800,18,13,5,13
12,2002,420800,16,12,4,4
1,2003,420800,10,10,0,8
2,2003,420800,10,7,3,4
3,2003,420800,15,15,0,1
4,2003,420800,14,12,2,2
5,2003,420800,18,13,5,4
6,2003,420800,16,14,2,7
7,2003,420800,14,12,2,3
8,2003,420800,18,13,5,1
9,2003,420800,18,13,5,3
10,2003,420800,16,15,1,4
11,2003,420800,16,11,5,0
12,2003,420800,16,11,5,0
1,2004,420800,8,7,1,2
2,2004,420800,13,11,2,6
3,2004,420800,13,10,3,2
4,2004,420800,13,11,2,2
5,2004,420800,9,6,3,8
6,2004,420800,14,13,1,4
7,2004,420800,21,15,6,10
8,2004,420800,18,15,3,7
9,2004,420800,24,18,6,4
10,2004,420800,12,10,2,0
11,2004,420800,19,14,5,7
12,2004,420800,15,11,4,12
1,2005,420800,15,14,1,4
2,2005,420800,13,9,4,5
3,2005,420800,10,7,3,4
4,2005,420800,7,3,4,6
5,2005,420800,12,9,3,11
6,2005,420800,22,15,7,1
7,2005,420800,32,23,9,4
8,2005,420800,31,24,7,8
9,2005,420800,19,13,6,11
10,2005,420800,17,14,3,3
11,2005,420800,12,11,1,7
12,2005,420800,21,20,1,2
1,2006,420800,15,14,1,2
2,2006,420800,11,9,2,5
3,2006,420800,20,17,3,2
4,2006,420800,11,7,4,3
5,2006,420800,19,14,5,7
6,2006,420800,17,14,3,2
7,2006,420800,32,27,5,4
8,2006,420800,25,21,4,3
9,2006,420800,23,20,3,2
10,2006,420800,15,14,1,4
11,2006,420800,27,24,3,5
12,2006,420800,34,28,6,6
1,2007,420800,23,22,1,4
2,2007,420800,16,14,2,3
3,2007,420800,20,16,4,4
4,2007,420800,18,15,3,4
5,2007,420800,29,21,8,19
6,2007,420800,24,16,8,13
7,2007,420800,33,30,3,14
8,2007,420800,29,23,6,4
9,2007,420800,29,25,4,11
10,2007,420800,17,15,2,4
11,2007,420800,9,9,0,9
12,2007,420800,20,20,0,2
1,2008,420800,15,14,1,2
2,2008,420800,12,8,4,2
3,2008,420800,14,10,4,5
4,2008,420800,14,10,4,2
5,2008,420800,26,22,4,7
6,2008,420800,30,25,5,4
7,2008,420800,22,18,4,1
8,2008,420800,25,19,6,8
9,2008,420800,21,18,3,5
10,2008,420800,13,10,3,9
11,2008,420800,10,10,0,5
12,2008,420800,17,12,5,8
1,2009,420800,8,5,3,3
2,2009,420800,21,17,4,3
3,2009,420800,24,20,4,1
4,2009,420800,25,21,4,10
5,2009,420800,19,13,6,7
6,2009,420800,14,10,4,3
7,2009,420800,32,29,3,3
8,2009,420800,20,18,2,9
9,2009,420800,18,14,4,7
10,2009,420800,25,20,5,12
11,2009,420800,21,16,5,8
12,2009,420800,22,17,5,7
1,2010,420800,14,10,4,8
2,2010,420800,9,8,1,2
3,2010,420800,13,10,3,3
4,2010,420800,23,16,7,8
5,2010,420800,13,5,8,3
6,2010,420800,16,12,4,3
7,2010,420800,17,14,3,10
8,2010,420800,16,12,4,4
9,2010,420800,10,8,2,6
10,2010,420800,12,8,4,8
11,2010,420800,16,15,1,7
12,2010,420800,6,4,2,7
1,2011,420800,16,13,3,11
2,2011,420800,14,12,2,3
1,1999,640700,5,4,1,0
2,1999,640700,3,2,1,1
3,1999,640700,4,4,0,0
4,1999,640700,1,1,0,0
5,1999,640700,3,3,0,1
6,1999,640700,3,3,0,0
7,1999,640700,1,1,0,1
8,1999,640700,4,4,0,0
9,1999,640700,6,6,0,0
10,1999,640700,9,9,0,1
11,1999,640700,3,3,0,0
12,1999,640700,4,4,0,1
1,2000,640700,2,2,0,0
2,2000,640700,6,6,0,0
3,2000,640700,3,3,0,0
4,2000,640700,1,1,0,0
5,2000,640700,4,3,1,1
6,2000,640700,4,3,1,1
7,2000,640700,6,6,0,0
8,2000,640700,4,4,0,0
9,2000,640700,5,4,1,0
10,2000,640700,5,3,2,0
11,2000,640700,1,1,0,0
12,2000,640700,3,3,0,0
1,2001,640700,2,1,1,0
2,2001,640700,0,0,0,0
3,2001,640700,8,6,2,2
4,2001,640700,5,4,1,0
5,2001,640700,9,8,1,2
6,2001,640700,6,3,3,0
7,2001,640700,4,4,0,0
8,2001,640700,2,2,0,0
9,2001,640700,9,8,1,0
10,2001,640700,7,6,1,0
11,2001,640700,4,4,0,0
12,2001,640700,4,4,0,0
1,2002,640700,7,5,2,1
2,2002,640700,3,1,2,0
3,2002,640700,5,5,0,1
4,2002,640700,4,3,1,1
5,2002,640700,6,5,1,1
6,2002,640700,6,4,2,0
7,2002,640700,6,5,1,0
8,2002,640700,3,3,0,1
9,2002,640700,6,5,1,0
10,2002,640700,6,6,0,0
11,2002,640700,5,5,0,0
12,2002,640700,6,5,1,0
1,2003,640700,3,3,0,1
2,2003,640700,3,3,0,0
3,2003,640700,0,0,0,0
4,2003,640700,4,4,0,1
5,2003,640700,8,7,1,0
6,2003,640700,1,1,0,0
7,2003,640700,2,2,0,0
8,2003,640700,8,7,1,0
9,2003,640700,4,4,0,0
10,2003,640700,3,2,1,0
11,2003,640700,6,5,1,1
12,2003,640700,5,5,0,0
1,2004,640700,3,2,1,0
2,2004,640700,0,0,0,0
3,2004,640700,1,1,0,1
4,2004,640700,2,2,0,0
5,2004,640700,3,2,1,1
6,2004,640700,2,2,0,0
7,2004,640700,4,4,0,0
8,2004,640700,6,6,0,3
9,2004,640700,3,3,0,0
10,2004,640700,4,4,0,0
11,2004,640700,5,3,2,0
12,2004,640700,8,8,0,0
1,2005,640700,9,9,0,0
2,2005,640700,6,5,1,0
3,2005,640700,4,4,0,0
4,2005,640700,2,1,1,0
5,2005,640700,8,7,1,1
6,2005,640700,4,3,1,0
7,2005,640700,1,1,0,0
8,2005,640700,8,7,1,0
9,2005,640700,6,5,1,0
10,2005,640700,2,2,0,0
11,2005,640700,4,2,2,0
12,2005,640700,2,2,0,0
1,2006,640700,4,3,1,1
2,2006,640700,1,1,0,0
3,2006,640700,3,3,0,0
4,2006,640700,8,7,1,0
5,2006,640700,2,2,0,2
6,2006,640700,7,4,3,0
7,2006,640700,6,6,0,0
8,2006,640700,5,4,1,1
9,2006,640700,4,4,0,1
10,2006,640700,6,6,0,0
11,2006,640700,5,5,0,1
12,2006,640700,0,0,0,0
1,2007,640700,5,4,1,3
2,2007,640700,4,4,0,0
3,2007,640700,4,4,0,2
4,2007,640700,2,2,0,3
5,2007,640700,4,3,1,2
6,2007,640700,5,4,1,4
7,2007,640700,3,2,1,4
8,2007,640700,6,5,1,1
9,2007,640700,3,3,0,4
10,2007,640700,5,3,2,0
11,2007,640700,4,3,1,1
12,2007,640700,5,4,1,0
1,2008,640700,3,3,0,0
2,2008,640700,4,4,0,2
3,2008,640700,8,6,2,1
4,2008,640700,2,2,0,1
5,2008,640700,9,8,1,0
6,2008,640700,10,1,9,1
7,2008,640700,2,1,1,1
8,2008,640700,9,7,2,0
9,2008,640700,10,7,3,0
10,2008,640700,8,8,0,0
11,2008,640700,10,9,1,0
12,2008,640700,4,4,0,0
1,2009,640700,2,1,1,0
2,2009,640700,2,2,0,0
3,2009,640700,4,4,0,0
4,2009,640700,3,3,0,0
5,2009,640700,1,1,0,0
6,2009,640700,2,1,1,2
7,2009,640700,6,6,0,2
8,2009,640700,4,4,0,1
9,2009,640700,2,1,1,1
10,2009,640700,7,7,0,1
11,2009,640700,7,5,2,1
12,2009,640700,3,3,0,1
1,2010,640700,5,5,0,1
2,2010,640700,5,5,0,0
3,2010,640700,5,4,1,0
4,2010,640700,3,3,0,0
5,2010,640700,7,7,0,2
6,2010,640700,4,4,0,0
7,2010,640700,7,7,0,0
8,2010,640700,7,6,1,0
9,2010,640700,2,0,2,0
10,2010,640700,2,1,1,0
11,2010,640700,2,2,0,0
12,2010,640700,2,2,0,0
1,2011,640700,5,4,1,0
2,2011,640700,3,2,1,0
1,1999,660600,25,21,4,18
2,1999,660600,19,16,3,7
3,1999,660600,33,30,3,10
4,1999,660600,39,27,12,10
5,1999,660600,49,41,8,7
6,1999,660600,38,28,10,14
7,1999,660600,39,35,4,14
8,1999,660600,43,40,3,10
9,1999,660600,30,25,5,12
10,1999,660600,31,27,4,22
11,1999,660600,37,32,5,24
12,1999,660600,40,34,6,18
1,2000,660600,32,25,7,14
2,2000,660600,26,23,3,19
3,2000,660600,34,26,8,12
4,2000,660600,27,25,2,10
5,2000,660600,33,28,5,11
6,2000,660600,32,28,4,4
7,2000,660600,34,25,9,12
8,2000,660600,38,31,7,14
9,2000,660600,29,23,6,12
10,2000,660600,36,29,7,21
11,2000,660600,27,25,2,6
12,2000,660600,28,27,1,2
1,2001,660600,31,27,4,14
2,2001,660600,29,22,7,5
3,2001,660600,29,22,7,7
4,2001,660600,36,26,10,4
5,2001,660600,38,30,8,9
6,2001,660600,30,28,2,17
7,2001,660600,38,34,4,11
8,2001,660600,32,28,4,4
9,2001,660600,43,37,6,9
10,2001,660600,40,36,4,8
11,2001,660600,44,36,8,7
12,2001,660600,41,31,10,7
1,2002,660600,35,30,5,4
2,2002,660600,24,21,3,3
3,2002,660600,42,36,6,3
4,2002,660600,38,30,8,3
5,2002,660600,40,33,7,4
6,2002,660600,38,24,14,9
7,2002,660600,37,32,5,11
8,2002,660600,48,39,9,4
9,2002,660600,45,37,8,11
10,2002,660600,35,30,5,6
11,2002,660600,34,27,7,8
12,2002,660600,30,23,7,13
1,2003,660600,27,25,2,10
2,2003,660600,18,18,0,8
3,2003,660600,28,23,5,8
4,2003,660600,39,35,4,9
5,2003,660600,29,24,5,14
6,2003,660600,46,42,4,14
7,2003,660600,40,35,5,15
8,2003,660600,49,43,6,4
9,2003,660600,43,33,10,13
10,2003,660600,51,46,5,7
11,2003,660600,27,23,4,12
12,2003,660600,31,26,5,3
1,2004,660600,20,18,2,10
2,2004,660600,35,31,4,10
3,2004,660600,34,30,4,10
4,2004,660600,27,25,2,5
5,2004,660600,25,20,5,7
6,2004,660600,38,34,4,16
7,2004,660600,33,26,7,16
8,2004,660600,42,33,9,8
9,2004,660600,49,42,7,12
10,2004,660600,39,35,4,10
11,2004,660600,41,34,7,3
12,2004,660600,33,27,6,6
1,2005,660600,25,23,2,8
2,2005,660600,25,17,8,9
3,2005,660600,22,17,5,6
4,2005,660600,27,23,4,18
5,2005,660600,39,31,8,1
6,2005,660600,39,30,9,13
7,2005,660600,32,24,8,9
8,2005,660600,37,32,5,14
9,2005,660600,44,38,6,6
10,2005,660600,38,30,8,16
11,2005,660600,35,32,3,10
12,2005,660600,39,37,2,10
1,2006,660600,30,22,8,8
2,2006,660600,25,20,5,15
3,2006,660600,24,21,3,21
4,2006,660600,19,13,6,27
5,2006,660600,40,31,9,12
6,2006,660600,28,22,6,17
7,2006,660600,33,27,6,31
8,2006,660600,36,33,3,15
9,2006,660600,33,26,7,28
10,2006,660600,35,32,3,25
11,2006,660600,47,38,9,16
12,2006,660600,22,19,3,15
1,2007,660600,11,11,0,28
2,2007,660600,24,20,4,19
3,2007,660600,35,30,5,12
4,2007,660600,19,14,5,13
5,2007,660600,33,27,6,13
6,2007,660600,36,31,5,12
7,2007,660600,44,37,7,14
8,2007,660600,32,28,4,20
9,2007,660600,38,31,7,13
10,2007,660600,45,36,9,18
11,2007,660600,38,27,11,15
12,2007,660600,31,26,5,7
1,2008,660600,38,28,10,12
2,2008,660600,22,18,4,13
3,2008,660600,28,18,10,8
4,2008,660600,36,30,6,16
5,2008,660600,39,26,13,10
6,2008,660600,63,51,12,17
7,2008,660600,37,31,6,15
8,2008,660600,41,29,12,15
9,2008,660600,55,48,7,13
10,2008,660600,45,35,10,23
11,2008,660600,39,35,4,18
12,2008,660600,34,31,3,7
1,2009,660600,27,25,2,16
2,2009,660600,14,10,4,12
3,2009,660600,42,37,5,19
4,2009,660600,42,40,2,9
5,2009,660600,37,30,7,24
6,2009,660600,39,31,8,11
7,2009,660600,43,33,10,16
8,2009,660600,54,45,9,22
9,2009,660600,46,38,8,19
10,2009,660600,38,32,6,9
11,2009,660600,40,34,6,9
12,2009,660600,44,40,4,8
1,2010,660600,38,34,4,10
2,2010,660600,25,20,5,21
3,2010,660600,48,35,13,16
4,2010,660600,36,28,8,17
5,2010,660600,39,30,9,14
6,2010,660600,43,35,8,15
7,2010,660600,36,31,5,13
8,2010,660600,41,38,3,13
9,2010,660600,30,29,1,17
10,2010,660600,28,23,5,17
11,2010,660600,32,29,3,12
12,2010,660600,42,39,3,11
1,2011,660600,25,20,5,25
2,2011,660600,15,12,3,14
1,1999,671200,38,34,4,9
2,1999,671200,36,31,5,8
3,1999,671200,40,31,9,5
4,1999,671200,31,27,4,10
5,1999,671200,41,36,5,5
6,1999,671200,23,19,4,2
7,1999,671200,41,32,9,4
8,1999,671200,36,31,5,4
9,1999,671200,26,24,2,4
10,1999,671200,27,19,8,6
11,1999,671200,25,24,1,11
12,1999,671200,23,17,6,5
1,2000,671200,28,23,5,11
2,2000,671200,17,13,4,5
3,2000,671200,23,16,7,6
4,2000,671200,23,18,5,6
5,2000,671200,26,22,4,4
6,2000,671200,27,22,5,13
7,2000,671200,34,26,8,6
8,2000,671200,31,23,8,4
9,2000,671200,36,32,4,9
10,2000,671200,43,35,8,4
11,2000,671200,33,27,6,12
12,2000,671200,19,16,3,6
1,2001,671200,23,17,6,8
2,2001,671200,20,15,5,13
3,2001,671200,28,21,7,3
4,2001,671200,21,17,4,8
5,2001,671200,29,23,6,1
6,2001,671200,27,20,7,5
7,2001,671200,34,25,9,5
8,2001,671200,28,20,8,1
9,2001,671200,25,21,4,3
10,2001,671200,31,29,2,2
11,2001,671200,29,22,7,5
12,2001,671200,25,22,3,2
1,2002,671200,25,22,3,7
2,2002,671200,21,15,6,8
3,2002,671200,29,22,7,7
4,2002,671200,21,18,3,1
5,2002,671200,24,14,10,5
6,2002,671200,29,22,7,3
7,2002,671200,40,36,4,7
8,2002,671200,30,25,5,4
9,2002,671200,20,17,3,4
10,2002,671200,28,19,9,4
11,2002,671200,29,20,9,4
12,2002,671200,25,20,5,5
1,2003,671200,26,22,4,4
2,2003,671200,15,12,3,7
3,2003,671200,18,16,2,10
4,2003,671200,26,21,5,3
5,2003,671200,25,18,7,10
6,2003,671200,27,22,5,9
7,2003,671200,41,36,5,8
8,2003,671200,33,26,7,2
9,2003,671200,27,22,5,6
10,2003,671200,29,15,14,4
11,2003,671200,31,28,3,4
12,2003,671200,25,21,4,8
1,2004,671200,20,16,4,8
2,2004,671200,18,12,6,19
3,2004,671200,28,24,4,12
4,2004,671200,23,20,3,3
5,2004,671200,18,14,4,5
6,2004,671200,29,24,5,6
7,2004,671200,25,21,4,6
8,2004,671200,25,19,6,17
9,2004,671200,26,23,3,13
10,2004,671200,22,19,3,16
11,2004,671200,25,20,5,7
12,2004,671200,18,15,3,9
1,2005,671200,22,17,5,4
2,2005,671200,18,15,3,11
3,2005,671200,21,17,4,17
4,2005,671200,19,18,1,5
5,2005,671200,27,24,3,4
6,2005,671200,32,26,6,8
7,2005,671200,29,22,7,6
8,2005,671200,29,22,7,6
9,2005,671200,32,28,4,6
10,2005,671200,35,32,3,2
11,2005,671200,17,15,2,3
12,2005,671200,18,15,3,1
1,2006,671200,24,20,4,7
2,2006,671200,14,11,3,6
3,2006,671200,17,16,1,11
4,2006,671200,16,14,2,12
5,2006,671200,33,28,5,3
6,2006,671200,26,21,5,8
7,2006,671200,25,21,4,7
8,2006,671200,22,19,3,8
9,2006,671200,17,16,1,17
10,2006,671200,24,19,5,4
11,2006,671200,22,17,5,12
12,2006,671200,18,14,4,10
1,2007,671200,21,19,2,1
2,2007,671200,15,14,1,13
3,2007,671200,21,17,4,9
4,2007,671200,21,19,2,6
5,2007,671200,23,19,4,7
6,2007,671200,26,23,3,13
7,2007,671200,15,12,3,21
8,2007,671200,19,15,4,9
9,2007,671200,23,21,2,6
10,2007,671200,17,15,2,6
11,2007,671200,16,14,2,2
12,2007,671200,33,28,5,1
1,2008,671200,23,20,3,4
2,2008,671200,20,18,2,11
3,2008,671200,20,15,5,12
4,2008,671200,17,15,2,6
5,2008,671200,14,11,3,5
6,2008,671200,24,18,6,8
7,2008,671200,31,24,7,12
8,2008,671200,23,18,5,13
9,2008,671200,29,24,5,15
10,2008,671200,17,13,4,8
11,2008,671200,13,11,2,7
12,2008,671200,11,9,2,3
1,2009,671200,21,19,2,5
2,2009,671200,16,15,1,3
3,2009,671200,22,15,7,8
4,2009,671200,18,10,8,3
5,2009,671200,27,24,3,6
6,2009,671200,23,19,4,16
7,2009,671200,28,24,4,6
8,2009,671200,31,26,5,8
9,2009,671200,27,19,8,7
10,2009,671200,29,25,4,9
11,2009,671200,25,17,8,5
12,2009,671200,17,15,2,8
1,2010,671200,17,15,2,10
2,2010,671200,12,10,2,9
3,2010,671200,13,12,1,7
4,2010,671200,28,21,7,8
5,2010,671200,15,12,3,7
6,2010,671200,17,12,5,8
7,2010,671200,21,15,6,14
8,2010,671200,17,13,4,8
9,2010,671200,22,20,2,8
10,2010,671200,12,10,2,9
11,2010,671200,26,25,1,10
12,2010,671200,15,14,1,7
1,2011,671200,22,19,3,5
2,2011,671200,14,14,0,0
1,1999,640400,10,9,1,1
2,1999,640400,6,6,0,3
3,1999,640400,12,12,0,0
4,1999,640400,8,6,2,0
5,1999,640400,9,9,0,0
6,1999,640400,9,8,1,0
7,1999,640400,14,12,2,0
8,1999,640400,12,11,1,0
9,1999,640400,10,10,0,0
10,1999,640400,8,8,0,1
11,1999,640400,5,5,0,0
12,1999,640400,14,12,2,0
1,2000,640400,9,9,0,0
2,2000,640400,2,2,0,0
3,2000,640400,5,4,1,0
4,2000,640400,8,6,2,0
5,2000,640400,11,10,1,0
6,2000,640400,10,9,1,1
7,2000,640400,9,8,1,0
8,2000,640400,8,8,0,0
9,2000,640400,9,9,0,0
10,2000,640400,6,5,1,0
11,2000,640400,7,7,0,1
12,2000,640400,7,7,0,0
1,2001,640400,11,11,0,0
2,2001,640400,7,7,0,2
3,2001,640400,14,12,2,0
4,2001,640400,12,9,3,0
5,2001,640400,9,8,1,0
6,2001,640400,11,11,0,0
7,2001,640400,13,11,2,0
8,2001,640400,5,4,1,0
9,2001,640400,4,4,0,0
10,2001,640400,15,15,0,0
11,2001,640400,12,12,0,0
12,2001,640400,9,9,0,0
1,2002,640400,7,6,1,0
2,2002,640400,6,6,0,0
3,2002,640400,7,7,0,1
4,2002,640400,11,10,1,0
5,2002,640400,6,6,0,0
6,2002,640400,15,11,4,0
7,2002,640400,9,8,1,1
8,2002,640400,11,11,0,0
9,2002,640400,7,6,1,0
10,2002,640400,9,9,0,0
11,2002,640400,17,17,0,0
12,2002,640400,11,10,1,0
1,2003,640400,11,9,2,1
2,2003,640400,10,9,1,1
3,2003,640400,9,8,1,2
4,2003,640400,12,12,0,0
5,2003,640400,5,4,1,2
6,2003,640400,4,4,0,0
7,2003,640400,11,10,1,0
8,2003,640400,13,11,2,0
9,2003,640400,8,8,0,2
10,2003,640400,14,12,2,0
11,2003,640400,9,9,0,0
12,2003,640400,9,9,0,0
1,2004,640400,7,7,0,1
2,2004,640400,5,4,1,1
3,2004,640400,5,4,1,2
4,2004,640400,19,19,0,0
5,2004,640400,11,10,1,0
6,2004,640400,11,11,0,0
7,2004,640400,10,9,1,3
8,2004,640400,10,7,3,2
9,2004,640400,12,10,2,2
10,2004,640400,13,11,2,0
11,2004,640400,12,11,1,1
12,2004,640400,11,11,0,0
1,2005,640400,12,10,2,0
2,2005,640400,9,9,0,0
3,2005,640400,7,6,1,0
4,2005,640400,9,8,1,1
5,2005,640400,6,6,0,0
6,2005,640400,2,2,0,0
7,2005,640400,8,8,0,0
8,2005,640400,3,3,0,2
9,2005,640400,8,8,0,0
10,2005,640400,7,5,2,0
11,2005,640400,7,6,1,1
12,2005,640400,9,8,1,0
1,2006,640400,9,6,3,2
2,2006,640400,3,3,0,0
3,2006,640400,8,7,1,2
4,2006,640400,11,10,1,0
5,2006,640400,10,8,2,1
6,2006,640400,10,9,1,4
7,2006,640400,14,11,3,0
8,2006,640400,6,6,0,0
9,2006,640400,5,5,0,1
10,2006,640400,9,8,1,7
11,2006,640400,2,2,0,2
12,2006,640400,9,7,2,1
1,2007,640400,1,0,1,2
2,2007,640400,2,2,0,0
3,2007,640400,6,6,0,1
4,2007,640400,7,7,0,1
5,2007,640400,3,3,0,2
6,2007,640400,14,14,0,1
7,2007,640400,8,8,0,0
8,2007,640400,13,12,1,2
9,2007,640400,8,6,2,0
10,2007,640400,14,13,1,0
11,2007,640400,6,6,0,0
12,2007,640400,5,5,0,4
1,2008,640400,7,7,0,0
2,2008,640400,6,5,1,4
3,2008,640400,11,9,2,1
4,2008,640400,7,6,1,2
5,2008,640400,13,13,0,2
6,2008,640400,6,6,0,0
7,2008,640400,3,3,0,0
8,2008,640400,9,8,1,0
9,2008,640400,6,6,0,1
10,2008,640400,11,11,0,0
11,2008,640400,15,15,0,1
12,2008,640400,16,14,2,1
1,2009,640400,7,7,0,1
2,2009,640400,3,3,0,1
3,2009,640400,9,7,2,3
4,2009,640400,13,13,0,1
5,2009,640400,6,5,1,3
6,2009,640400,5,4,1,2
7,2009,640400,7,6,1,2
8,2009,640400,11,9,2,1
9,2009,640400,8,8,0,1
10,2009,640400,6,5,1,0
11,2009,640400,4,4,0,1
12,2009,640400,7,7,0,1
1,2010,640400,8,8,0,2
2,2010,640400,0,0,0,3
3,2010,640400,2,2,0,2
4,2010,640400,5,4,1,1
5,2010,640400,4,2,2,3
6,2010,640400,3,3,0,0
7,2010,640400,10,10,0,0
8,2010,640400,12,11,1,0
9,2010,640400,6,6,0,1
10,2010,640400,9,8,1,2
11,2010,640400,4,3,1,4
12,2010,640400,2,1,1,1
1,2011,640400,7,7,0,2
2,2011,640400,3,2,1,0
1,1999,640300,5,5,0,0
2,1999,640300,11,9,2,0
3,1999,640300,12,11,1,1
4,1999,640300,7,6,1,1
5,1999,640300,9,8,1,0
6,1999,640300,11,10,1,2
7,1999,640300,16,14,2,0
8,1999,640300,10,9,1,0
9,1999,640300,12,11,1,0
10,1999,640300,7,6,1,0
11,1999,640300,14,13,1,0
12,1999,640300,14,13,1,2
1,2000,640300,12,9,3,1
2,2000,640300,15,13,2,0
3,2000,640300,24,22,2,1
4,2000,640300,13,11,2,1
5,2000,640300,11,10,1,0
6,2000,640300,10,10,0,1
7,2000,640300,15,13,2,4
8,2000,640300,25,21,4,0
9,2000,640300,16,15,1,2
10,2000,640300,12,12,0,2
11,2000,640300,14,14,0,2
12,2000,640300,6,6,0,1
1,2001,640300,9,9,0,0
2,2001,640300,13,13,0,0
3,2001,640300,17,16,1,1
4,2001,640300,17,16,1,0
5,2001,640300,17,16,1,0
6,2001,640300,22,20,2,0
7,2001,640300,24,22,2,2
8,2001,640300,15,14,1,0
9,2001,640300,6,6,0,2
10,2001,640300,24,24,0,0
11,2001,640300,16,15,1,0
12,2001,640300,7,7,0,0
1,2002,640300,23,23,0,2
2,2002,640300,9,9,0,2
3,2002,640300,14,13,1,1
4,2002,640300,19,18,1,1
5,2002,640300,23,20,3,1
6,2002,640300,12,11,1,1
7,2002,640300,12,10,2,1
8,2002,640300,12,11,1,0
9,2002,640300,17,15,2,2
10,2002,640300,12,8,4,0
11,2002,640300,15,15,0,1
12,2002,640300,15,15,0,4
1,2003,640300,14,14,0,1
2,2003,640300,15,13,2,0
3,2003,640300,21,18,3,2
4,2003,640300,15,15,0,3
5,2003,640300,16,15,1,1
6,2003,640300,12,11,1,1
7,2003,640300,23,19,4,5
8,2003,640300,5,5,0,3
9,2003,640300,12,10,2,2
10,2003,640300,8,8,0,0
11,2003,640300,22,19,3,1
12,2003,640300,19,18,1,0
1,2004,640300,9,9,0,1
2,2004,640300,9,7,2,0
3,2004,640300,13,13,0,4
4,2004,640300,13,12,1,8
5,2004,640300,22,20,2,4
6,2004,640300,11,7,4,6
7,2004,640300,26,22,4,4
8,2004,640300,16,15,1,1
9,2004,640300,18,17,1,0
10,2004,640300,16,15,1,1
11,2004,640300,27,25,2,0
12,2004,640300,15,14,1,1
1,2005,640300,11,10,1,2
2,2005,640300,16,15,1,2
3,2005,640300,13,11,2,1
4,2005,640300,17,16,1,3
5,2005,640300,16,15,1,0
6,2005,640300,11,10,1,5
7,2005,640300,15,14,1,2
8,2005,640300,19,16,3,1
9,2005,640300,9,7,2,4
10,2005,640300,9,8,1,3
11,2005,640300,14,10,4,2
12,2005,640300,9,8,1,1
1,2006,640300,14,12,2,3
2,2006,640300,4,3,1,3
3,2006,640300,9,6,3,5
4,2006,640300,11,9,2,5
5,2006,640300,12,10,2,1
6,2006,640300,7,5,2,1
7,2006,640300,15,13,2,3
8,2006,640300,11,9,2,2
9,2006,640300,13,11,2,3
10,2006,640300,17,17,0,2
11,2006,640300,9,9,0,1
12,2006,640300,19,16,3,0
1,2007,640300,10,8,2,1
2,2007,640300,7,7,0,4
3,2007,640300,10,9,1,1
4,2007,640300,12,12,0,8
5,2007,640300,12,11,1,2
6,2007,640300,10,9,1,5
7,2007,640300,19,14,5,4
8,2007,640300,19,19,0,3
9,2007,640300,17,15,2,2
10,2007,640300,11,10,1,4
11,2007,640300,10,10,0,5
12,2007,640300,10,9,1,5
1,2008,640300,5,5,0,2
2,2008,640300,10,9,1,1
3,2008,640300,14,14,0,2
4,2008,640300,10,9,1,6
5,2008,640300,18,18,0,0
6,2008,640300,10,7,3,1
7,2008,640300,11,10,1,8
8,2008,640300,12,12,0,1
9,2008,640300,16,13,3,1
10,2008,640300,13,13,0,2
11,2008,640300,14,13,1,4
12,2008,640300,12,12,0,3
1,2009,640300,13,11,2,2
2,2009,640300,5,2,3,4
3,2009,640300,7,6,1,1
4,2009,640300,8,7,1,0
5,2009,640300,9,8,1,3
6,2009,640300,16,15,1,0
7,2009,640300,14,12,2,0
8,2009,640300,8,8,0,5
9,2009,640300,11,9,2,2
10,2009,640300,10,9,1,1
11,2009,640300,16,14,2,5
12,2009,640300,11,11,0,3
1,2010,640300,5,5,0,3
2,2010,640300,8,7,1,3
3,2010,640300,9,9,0,1
4,2010,640300,9,7,2,5
5,2010,640300,10,5,5,1
6,2010,640300,12,11,1,2
7,2010,640300,8,8,0,2
8,2010,640300,8,8,0,0
9,2010,640300,8,7,1,2
10,2010,640300,5,5,0,2
11,2010,640300,4,4,0,0
12,2010,640300,10,10,0,3
1,2011,640300,3,3,0,1
2,2011,640300,7,6,1,1
1,1999,980100,2,2,0,1
2,1999,980100,4,3,1,1
3,1999,980100,6,5,1,0
4,1999,980100,6,3,3,0
5,1999,980100,7,6,1,0
6,1999,980100,8,6,2,1
7,1999,980100,7,5,2,0
8,1999,980100,9,9,0,0
9,1999,980100,7,6,1,0
10,1999,980100,8,8,0,0
11,1999,980100,12,11,1,1
12,1999,980100,8,8,0,0
1,2000,980100,12,10,2,0
2,2000,980100,12,10,2,0
3,2000,980100,7,7,0,0
4,2000,980100,6,6,0,0
5,2000,980100,6,6,0,0
6,2000,980100,4,4,0,1
7,2000,980100,5,5,0,0
8,2000,980100,15,13,2,1
9,2000,980100,8,8,0,0
10,2000,980100,4,4,0,1
11,2000,980100,13,13,0,0
12,2000,980100,8,8,0,0
1,2001,980100,13,12,1,1
2,2001,980100,2,2,0,0
3,2001,980100,8,8,0,1
4,2001,980100,8,7,1,0
5,2001,980100,12,10,2,2
6,2001,980100,5,4,1,0
7,2001,980100,8,7,1,0
8,2001,980100,10,10,0,0
9,2001,980100,10,10,0,0
10,2001,980100,6,5,1,1
11,2001,980100,13,10,3,0
12,2001,980100,7,6,1,0
1,2002,980100,5,4,1,1
2,2002,980100,6,6,0,0
3,2002,980100,6,5,1,0
4,2002,980100,10,9,1,1
5,2002,980100,7,5,2,1
6,2002,980100,7,6,1,0
7,2002,980100,10,9,1,1
8,2002,980100,7,7,0,0
9,2002,980100,5,5,0,1
10,2002,980100,2,2,0,0
11,2002,980100,8,6,2,1
12,2002,980100,11,11,0,0
1,2003,980100,14,13,1,0
2,2003,980100,7,6,1,0
3,2003,980100,7,7,0,0
4,2003,980100,8,7,1,2
5,2003,980100,3,3,0,1
6,2003,980100,3,3,0,0
7,2003,980100,13,12,1,0
8,2003,980100,7,7,0,0
9,2003,980100,7,6,1,0
10,2003,980100,10,10,0,0
11,2003,980100,10,9,1,0
12,2003,980100,10,9,1,0
1,2004,980100,1,1,0,0
2,2004,980100,1,1,0,0
3,2004,980100,9,9,0,0
4,2004,980100,6,6,0,0
5,2004,980100,8,7,1,0
6,2004,980100,9,7,2,1
7,2004,980100,9,7,2,0
8,2004,980100,7,7,0,0
9,2004,980100,8,8,0,0
10,2004,980100,11,8,3,0
11,2004,980100,6,5,1,0
12,2004,980100,8,7,1,1
1,2005,980100,11,10,1,0
2,2005,980100,9,9,0,1
3,2005,980100,3,3,0,0
4,2005,980100,10,9,1,0
5,2005,980100,9,8,1,2
6,2005,980100,9,8,1,1
7,2005,980100,10,9,1,2
8,2005,980100,14,14,0,2
9,2005,980100,7,6,1,0
10,2005,980100,11,10,1,0
11,2005,980100,5,5,0,0
12,2005,980100,5,5,0,1
1,2006,980100,8,7,1,0
2,2006,980100,5,4,1,0
3,2006,980100,7,7,0,2
4,2006,980100,7,7,0,1
5,2006,980100,7,7,0,2
6,2006,980100,7,6,1,1
7,2006,980100,4,4,0,5
8,2006,980100,6,5,1,4
9,2006,980100,3,3,0,1
10,2006,980100,3,2,1,2
11,2006,980100,4,4,0,0
12,2006,980100,1,0,1,0
1,2007,980100,8,8,0,0
2,2007,980100,10,9,1,3
3,2007,980100,3,3,0,2
4,2007,980100,9,9,0,1
5,2007,980100,12,11,1,0
6,2007,980100,10,9,1,1
7,2007,980100,8,6,2,3
8,2007,980100,4,4,0,1
9,2007,980100,1,0,1,1
10,2007,980100,9,6,3,0
11,2007,980100,4,4,0,3
12,2007,980100,7,7,0,4
1,2008,980100,7,7,0,1
2,2008,980100,2,2,0,0
3,2008,980100,7,5,2,2
4,2008,980100,4,4,0,2
5,2008,980100,7,7,0,3
6,2008,980100,7,5,2,0
7,2008,980100,5,4,1,2
8,2008,980100,11,9,2,1
9,2008,980100,13,12,1,2
10,2008,980100,12,11,1,2
11,2008,980100,6,6,0,0
12,2008,980100,13,13,0,0
1,2009,980100,4,4,0,0
2,2009,980100,7,7,0,2
3,2009,980100,1,0,1,1
4,2009,980100,8,6,2,1
5,2009,980100,8,7,1,0
6,2009,980100,8,7,1,0
7,2009,980100,11,9,2,2
8,2009,980100,9,9,0,2
9,2009,980100,8,6,2,1
10,2009,980100,7,7,0,2
11,2009,980100,5,5,0,1
12,2009,980100,7,7,0,1
1,2010,980100,12,11,1,0
2,2010,980100,3,2,1,5
3,2010,980100,8,6,2,1
4,2010,980100,5,4,1,0
5,2010,980100,3,3,0,1
6,2010,980100,6,5,1,0
7,2010,980100,5,4,1,1
8,2010,980100,6,5,1,0
9,2010,980100,7,4,3,2
10,2010,980100,6,4,2,0
11,2010,980100,3,3,0,1
12,2010,980100,2,2,0,0
1,2011,980100,1,1,0,1
2,2011,980100,2,1,1,1
1,1999,640100,4,3,1,0
2,1999,640100,7,7,0,0
3,1999,640100,6,6,0,0
4,1999,640100,4,4,0,2
5,1999,640100,4,4,0,0
6,1999,640100,3,3,0,0
7,1999,640100,2,2,0,0
8,1999,640100,10,8,2,0
9,1999,640100,8,7,1,1
10,1999,640100,5,4,1,0
11,1999,640100,6,5,1,0
12,1999,640100,13,13,0,1
1,2000,640100,12,11,1,0
2,2000,640100,1,1,0,0
3,2000,640100,7,7,0,2
4,2000,640100,6,6,0,1
5,2000,640100,6,5,1,2
6,2000,640100,7,6,1,0
7,2000,640100,7,6,1,0
8,2000,640100,9,8,1,1
9,2000,640100,3,3,0,1
10,2000,640100,0,0,0,0
11,2000,640100,5,5,0,0
12,2000,640100,4,2,2,1
1,2001,640100,5,4,1,0
2,2001,640100,3,3,0,0
3,2001,640100,7,7,0,0
4,2001,640100,5,5,0,1
5,2001,640100,2,2,0,0
6,2001,640100,1,1,0,0
7,2001,640100,5,3,2,1
8,2001,640100,6,4,2,0
9,2001,640100,3,3,0,0
10,2001,640100,6,6,0,0
11,2001,640100,8,8,0,3
12,2001,640100,3,3,0,0
1,2002,640100,3,3,0,0
2,2002,640100,0,0,0,1
3,2002,640100,4,3,1,0
4,2002,640100,3,3,0,0
5,2002,640100,5,3,2,2
6,2002,640100,10,9,1,3
7,2002,640100,12,10,2,1
8,2002,640100,6,6,0,2
9,2002,640100,6,6,0,1
10,2002,640100,2,2,0,1
11,2002,640100,8,7,1,0
12,2002,640100,6,5,1,4
1,2003,640100,6,5,1,2
2,2003,640100,4,4,0,0
3,2003,640100,13,9,4,1
4,2003,640100,4,3,1,2
5,2003,640100,3,1,2,2
6,2003,640100,3,3,0,2
7,2003,640100,5,5,0,0
8,2003,640100,10,9,1,0
9,2003,640100,7,7,0,0
10,2003,640100,11,9,2,0
11,2003,640100,8,8,0,0
12,2003,640100,6,5,1,0
1,2004,640100,4,4,0,3
2,2004,640100,6,5,1,2
3,2004,640100,3,2,1,0
4,2004,640100,11,10,1,3
5,2004,640100,5,5,0,0
6,2004,640100,8,6,2,0
7,2004,640100,11,11,0,0
8,2004,640100,6,6,0,0
9,2004,640100,6,5,1,1
10,2004,640100,7,6,1,1
11,2004,640100,7,7,0,0
12,2004,640100,5,5,0,0
1,2005,640100,5,5,0,0
2,2005,640100,3,3,0,3
3,2005,640100,5,5,0,1
4,2005,640100,7,6,1,0
5,2005,640100,9,6,3,0
6,2005,640100,6,4,2,0
7,2005,640100,4,3,1,0
8,2005,640100,5,4,1,0
9,2005,640100,5,4,1,0
10,2005,640100,5,5,0,0
11,2005,640100,4,4,0,2
12,2005,640100,5,4,1,0
1,2006,640100,3,2,1,0
2,2006,640100,4,4,0,1
3,2006,640100,5,4,1,0
4,2006,640100,2,1,1,0
5,2006,640100,3,3,0,1
6,2006,640100,6,4,2,1
7,2006,640100,3,3,0,0
8,2006,640100,4,2,2,0
9,2006,640100,8,6,2,0
10,2006,640100,5,5,0,0
11,2006,640100,5,5,0,0
12,2006,640100,4,4,0,0
1,2007,640100,0,0,0,0
2,2007,640100,5,4,1,1
3,2007,640100,5,4,1,0
4,2007,640100,7,7,0,2
5,2007,640100,5,5,0,0
6,2007,640100,7,6,1,1
7,2007,640100,4,4,0,2
8,2007,640100,4,4,0,0
9,2007,640100,3,3,0,0
10,2007,640100,2,2,0,0
11,2007,640100,8,7,1,0
12,2007,640100,5,5,0,0
1,2008,640100,1,0,1,0
2,2008,640100,5,5,0,0
3,2008,640100,4,3,1,1
4,2008,640100,5,5,0,0
5,2008,640100,5,4,1,0
6,2008,640100,5,5,0,0
7,2008,640100,7,7,0,1
8,2008,640100,7,5,2,1
9,2008,640100,3,3,0,1
10,2008,640100,6,5,1,0
11,2008,640100,6,6,0,0
12,2008,640100,7,7,0,0
1,2009,640100,3,3,0,1
2,2009,640100,6,6,0,2
3,2009,640100,7,4,3,0
4,2009,640100,7,6,1,1
5,2009,640100,7,5,2,1
6,2009,640100,4,3,1,0
7,2009,640100,8,8,0,1
8,2009,640100,4,3,1,0
9,2009,640100,7,5,2,0
10,2009,640100,5,5,0,0
11,2009,640100,3,3,0,1
12,2009,640100,4,3,1,0
1,2010,640100,3,2,1,1
2,2010,640100,2,2,0,1
3,2010,640100,2,2,0,0
4,2010,640100,2,1,1,3
5,2010,640100,2,2,0,0
6,2010,640100,4,3,1,1
7,2010,640100,4,4,0,1
8,2010,640100,4,3,1,0
9,2010,640100,1,1,0,0
10,2010,640100,8,8,0,0
11,2010,640100,5,4,1,0
12,2010,640100,1,1,0,0
1,2011,640100,2,2,0,1
2,2011,640100,1,0,1,0
1,1999,650200,22,20,2,1
2,1999,650200,19,19,0,1
3,1999,650200,19,19,0,0
4,1999,650200,22,21,1,0
5,1999,650200,12,12,0,0
6,1999,650200,19,17,2,2
7,1999,650200,30,26,4,3
8,1999,650200,18,18,0,2
9,1999,650200,29,26,3,5
10,1999,650200,19,19,0,6
11,1999,650200,23,23,0,3
12,1999,650200,20,19,1,5
1,2000,650200,17,16,1,1
2,2000,650200,26,23,3,2
3,2000,650200,13,10,3,0
4,2000,650200,17,16,1,2
5,2000,650200,16,16,0,1
6,2000,650200,19,15,4,1
7,2000,650200,20,19,1,2
8,2000,650200,23,22,1,0
9,2000,650200,17,17,0,0
10,2000,650200,25,25,0,0
11,2000,650200,20,18,2,2
12,2000,650200,17,17,0,3
1,2001,650200,22,20,2,1
2,2001,650200,12,11,1,0
3,2001,650200,17,15,2,0
4,2001,650200,12,12,0,1
5,2001,650200,16,15,1,0
6,2001,650200,14,13,1,1
7,2001,650200,24,23,1,1
8,2001,650200,23,21,2,0
9,2001,650200,22,21,1,1
10,2001,650200,24,20,4,2
11,2001,650200,22,21,1,3
12,2001,650200,28,28,0,0
1,2002,650200,36,35,1,2
2,2002,650200,22,20,2,0
3,2002,650200,13,12,1,3
4,2002,650200,24,23,1,2
5,2002,650200,18,18,0,1
6,2002,650200,17,15,2,2
7,2002,650200,22,20,2,0
8,2002,650200,28,25,3,0
9,2002,650200,20,20,0,0
10,2002,650200,16,15,1,1
11,2002,650200,26,25,1,0
12,2002,650200,26,24,2,2
1,2003,650200,20,18,2,1
2,2003,650200,15,15,0,2
3,2003,650200,9,9,0,1
4,2003,650200,15,13,2,1
5,2003,650200,16,15,1,5
6,2003,650200,16,13,3,2
7,2003,650200,17,17,0,0
8,2003,650200,24,23,1,0
9,2003,650200,22,19,3,4
10,2003,650200,18,17,1,1
11,2003,650200,17,16,1,0
12,2003,650200,24,23,1,2
1,2004,650200,13,11,2,1
2,2004,650200,16,13,3,2
3,2004,650200,21,18,3,0
4,2004,650200,20,18,2,4
5,2004,650200,23,23,0,4
6,2004,650200,19,18,1,2
7,2004,650200,18,16,2,2
8,2004,650200,20,18,2,4
9,2004,650200,20,19,1,1
10,2004,650200,19,16,3,3
11,2004,650200,23,22,1,0
12,2004,650200,25,24,1,2
1,2005,650200,22,21,1,1
2,2005,650200,8,6,2,1
3,2005,650200,13,12,1,0
4,2005,650200,12,8,4,1
5,2005,650200,20,19,1,1
6,2005,650200,19,17,2,1
7,2005,650200,32,29,3,3
8,2005,650200,22,20,2,5
9,2005,650200,22,19,3,3
10,2005,650200,15,15,0,3
11,2005,650200,22,21,1,1
12,2005,650200,13,12,1,3
1,2006,650200,21,18,3,5
2,2006,650200,19,16,3,1
3,2006,650200,23,20,3,6
4,2006,650200,21,18,3,1
5,2006,650200,20,19,1,5
6,2006,650200,15,14,1,6
7,2006,650200,18,16,2,0
8,2006,650200,18,17,1,1
9,2006,650200,12,12,0,1
10,2006,650200,20,18,2,3
11,2006,650200,12,12,0,4
12,2006,650200,15,12,3,1
1,2007,650200,25,20,5,5
2,2007,650200,10,10,0,0
3,2007,650200,13,13,0,13
4,2007,650200,15,14,1,2
5,2007,650200,19,16,3,6
6,2007,650200,27,27,0,8
7,2007,650200,25,23,2,2
8,2007,650200,27,26,1,4
9,2007,650200,14,12,2,6
10,2007,650200,26,23,3,2
11,2007,650200,15,13,2,2
12,2007,650200,16,15,1,3
1,2008,650200,14,11,3,3
2,2008,650200,17,16,1,2
3,2008,650200,10,10,0,4
4,2008,650200,12,11,1,6
5,2008,650200,9,8,1,1
6,2008,650200,18,15,3,2
7,2008,650200,24,22,2,6
8,2008,650200,18,16,2,0
9,2008,650200,25,24,1,1
10,2008,650200,23,21,2,1
11,2008,650200,32,31,1,2
12,2008,650200,24,24,0,0
1,2009,650200,14,14,0,2
2,2009,650200,23,23,0,1
3,2009,650200,24,23,1,4
4,2009,650200,22,18,4,4
5,2009,650200,22,22,0,2
6,2009,650200,27,26,1,5
7,2009,650200,17,16,1,4
8,2009,650200,19,17,2,1
9,2009,650200,20,20,0,1
10,2009,650200,29,22,7,2
11,2009,650200,21,19,2,2
12,2009,650200,11,11,0,2
1,2010,650200,16,16,0,7
2,2010,650200,18,16,2,5
3,2010,650200,11,8,3,2
4,2010,650200,10,9,1,0
5,2010,650200,23,21,2,4
6,2010,650200,21,20,1,2
7,2010,650200,16,13,3,2
8,2010,650200,12,9,3,1
9,2010,650200,18,13,5,4
10,2010,650200,8,7,1,4
11,2010,650200,18,16,2,1
12,2010,650200,11,10,1,0
1,2011,650200,10,10,0,3
2,2011,650200,8,7,1,1
1,1999,650100,15,13,2,2
2,1999,650100,5,5,0,1
3,1999,650100,14,12,2,4
4,1999,650100,10,10,0,4
5,1999,650100,5,5,0,1
6,1999,650100,13,13,0,1
7,1999,650100,6,6,0,2
8,1999,650100,11,11,0,2
9,1999,650100,13,11,2,4
10,1999,650100,15,13,2,2
11,1999,650100,7,7,0,3
12,1999,650100,12,11,1,3
1,2000,650100,10,7,3,0
2,2000,650100,8,5,3,0
3,2000,650100,14,13,1,2
4,2000,650100,6,4,2,1
5,2000,650100,9,9,0,0
6,2000,650100,18,16,2,3
7,2000,650100,12,12,0,0
8,2000,650100,11,9,2,0
9,2000,650100,7,7,0,1
10,2000,650100,7,6,1,6
11,2000,650100,13,13,0,1
12,2000,650100,14,13,1,4
1,2001,650100,7,5,2,4
2,2001,650100,15,10,5,1
3,2001,650100,9,8,1,5
4,2001,650100,12,9,3,1
5,2001,650100,10,7,3,0
6,2001,650100,5,3,2,5
7,2001,650100,15,14,1,3
8,2001,650100,13,10,3,1
9,2001,650100,13,11,2,2
10,2001,650100,19,19,0,2
11,2001,650100,9,9,0,1
12,2001,650100,17,16,1,1
1,2002,650100,14,13,1,2
2,2002,650100,7,7,0,0
3,2002,650100,13,11,2,4
4,2002,650100,12,10,2,3
5,2002,650100,12,10,2,2
6,2002,650100,17,15,2,4
7,2002,650100,13,11,2,3
8,2002,650100,11,10,1,2
9,2002,650100,16,15,1,3
10,2002,650100,19,13,6,1
11,2002,650100,9,8,1,2
12,2002,650100,11,9,2,4
1,2003,650100,19,17,2,5
2,2003,650100,11,10,1,1
3,2003,650100,13,12,1,10
4,2003,650100,13,11,2,2
5,2003,650100,12,11,1,4
6,2003,650100,13,10,3,1
7,2003,650100,8,7,1,4
8,2003,650100,10,8,2,2
9,2003,650100,13,11,2,3
10,2003,650100,18,15,3,2
11,2003,650100,6,5,1,0
12,2003,650100,9,9,0,2
1,2004,650100,13,12,1,1
2,2004,650100,16,15,1,2
3,2004,650100,6,5,1,3
4,2004,650100,10,10,0,1
5,2004,650100,11,9,2,4
6,2004,650100,13,10,3,4
7,2004,650100,16,14,2,2
8,2004,650100,8,7,1,5
9,2004,650100,9,9,0,4
10,2004,650100,14,13,1,2
11,2004,650100,21,20,1,5
12,2004,650100,19,18,1,5
1,2005,650100,11,9,2,2
2,2005,650100,7,7,0,5
3,2005,650100,13,11,2,6
4,2005,650100,15,12,3,5
5,2005,650100,10,9,1,3
6,2005,650100,12,10,2,0
7,2005,650100,12,10,2,0
8,2005,650100,10,8,2,6
9,2005,650100,7,6,1,1
10,2005,650100,20,18,2,6
11,2005,650100,16,15,1,6
12,2005,650100,13,12,1,9
1,2006,650100,13,11,2,3
2,2006,650100,5,4,1,6
3,2006,650100,18,13,5,2
4,2006,650100,15,13,2,8
5,2006,650100,16,14,2,4
6,2006,650100,7,5,2,5
7,2006,650100,14,10,4,2
8,2006,650100,20,14,6,1
9,2006,650100,10,9,1,2
10,2006,650100,11,9,2,1
11,2006,650100,8,6,2,13
12,2006,650100,11,11,0,3
1,2007,650100,5,5,0,1
2,2007,650100,7,7,0,2
3,2007,650100,7,6,1,4
4,2007,650100,11,8,3,3
5,2007,650100,22,16,6,10
6,2007,650100,10,7,3,6
7,2007,650100,17,16,1,2
8,2007,650100,16,14,2,5
9,2007,650100,6,6,0,7
10,2007,650100,12,10,2,1
11,2007,650100,10,9,1,3
12,2007,650100,6,4,2,4
1,2008,650100,8,7,1,4
2,2008,650100,10,8,2,4
3,2008,650100,8,6,2,2
4,2008,650100,10,8,2,0
5,2008,650100,10,7,3,3
6,2008,650100,10,7,3,2
7,2008,650100,20,18,2,3
8,2008,650100,7,5,2,6
9,2008,650100,20,16,4,8
10,2008,650100,15,14,1,2
11,2008,650100,21,20,1,1
12,2008,650100,10,9,1,4
1,2009,650100,8,6,2,5
2,2009,650100,14,12,2,4
3,2009,650100,13,11,2,6
4,2009,650100,16,14,2,5
5,2009,650100,6,5,1,1
6,2009,650100,14,11,3,4
7,2009,650100,9,9,0,2
8,2009,650100,6,5,1,1
9,2009,650100,15,13,2,2
10,2009,650100,11,11,0,5
11,2009,650100,13,10,3,4
12,2009,650100,15,14,1,3
1,2010,650100,15,11,4,1
2,2010,650100,6,5,1,3
3,2010,650100,10,9,1,2
4,2010,650100,7,5,2,3
5,2010,650100,10,9,1,2
6,2010,650100,13,12,1,2
7,2010,650100,8,6,2,1
8,2010,650100,8,7,1,1
9,2010,650100,14,13,1,1
10,2010,650100,8,7,1,1
11,2010,650100,13,13,0,1
12,2010,650100,8,7,1,1
1,2011,650100,25,25,0,1
2,2011,650100,12,11,1,2
1,1999,660400,19,16,3,3
2,1999,660400,11,10,1,1
3,1999,660400,18,15,3,3
4,1999,660400,16,15,1,5
5,1999,660400,16,13,3,1
6,1999,660400,24,21,3,4
7,1999,660400,23,23,0,0
8,1999,660400,24,20,4,4
9,1999,660400,23,22,1,8
10,1999,660400,29,28,1,3
11,1999,660400,21,17,4,1
12,1999,660400,21,19,2,1
1,2000,660400,21,17,4,1
2,2000,660400,22,22,0,2
3,2000,660400,22,22,0,8
4,2000,660400,17,17,0,1
5,2000,660400,29,26,3,2
6,2000,660400,16,14,2,5
7,2000,660400,27,24,3,0
8,2000,660400,23,20,3,4
9,2000,660400,23,22,1,1
10,2000,660400,26,26,0,2
11,2000,660400,21,18,3,5
12,2000,660400,15,13,2,5
1,2001,660400,29,28,1,3
2,2001,660400,15,14,1,5
3,2001,660400,24,22,2,2
4,2001,660400,20,20,0,5
5,2001,660400,19,17,2,6
6,2001,660400,15,15,0,9
7,2001,660400,28,23,5,1
8,2001,660400,32,26,6,4
9,2001,660400,26,23,3,2
10,2001,660400,26,25,1,5
11,2001,660400,20,19,1,3
12,2001,660400,16,16,0,0
1,2002,660400,17,15,2,3
2,2002,660400,16,16,0,2
3,2002,660400,16,16,0,5
4,2002,660400,21,18,3,7
5,2002,660400,18,17,1,4
6,2002,660400,30,28,2,1
7,2002,660400,18,14,4,1
8,2002,660400,32,29,3,2
9,2002,660400,26,24,2,3
10,2002,660400,21,15,6,1
11,2002,660400,16,14,2,3
12,2002,660400,25,25,0,5
1,2003,660400,20,19,1,3
2,2003,660400,14,9,5,4
3,2003,660400,26,24,2,6
4,2003,660400,23,22,1,2
5,2003,660400,15,14,1,6
6,2003,660400,33,29,4,4
7,2003,660400,21,18,3,0
8,2003,660400,29,26,3,7
9,2003,660400,20,15,5,1
10,2003,660400,15,15,0,3
11,2003,660400,32,29,3,5
12,2003,660400,15,14,1,2
1,2004,660400,16,16,0,0
2,2004,660400,16,15,1,1
3,2004,660400,15,15,0,3
4,2004,660400,17,12,5,1
5,2004,660400,16,13,3,1
6,2004,660400,27,21,6,2
7,2004,660400,20,18,2,5
8,2004,660400,25,21,4,1
9,2004,660400,16,13,3,4
10,2004,660400,15,15,0,2
11,2004,660400,27,25,2,3
12,2004,660400,12,9,3,4
1,2005,660400,16,14,2,7
2,2005,660400,13,12,1,2
3,2005,660400,20,15,5,3
4,2005,660400,19,14,5,8
5,2005,660400,15,13,2,4
6,2005,660400,21,18,3,4
7,2005,660400,26,24,2,4
8,2005,660400,23,21,2,4
9,2005,660400,21,18,3,2
10,2005,660400,27,23,4,5
11,2005,660400,23,21,2,7
12,2005,660400,17,15,2,2
1,2006,660400,30,28,2,1
2,2006,660400,14,11,3,1
3,2006,660400,21,20,1,3
4,2006,660400,13,9,4,12
5,2006,660400,20,16,4,6
6,2006,660400,14,14,0,9
7,2006,660400,26,21,5,3
8,2006,660400,14,11,3,5
9,2006,660400,13,11,2,2
10,2006,660400,16,13,3,4
11,2006,660400,10,8,2,2
12,2006,660400,12,11,1,3
1,2007,660400,8,7,1,5
2,2007,660400,11,10,1,1
3,2007,660400,10,8,2,5
4,2007,660400,10,7,3,9
5,2007,660400,20,18,2,7
6,2007,660400,21,19,2,8
7,2007,660400,20,17,3,10
8,2007,660400,16,13,3,9
9,2007,660400,18,15,3,2
10,2007,660400,28,26,2,4
11,2007,660400,14,12,2,5
12,2007,660400,17,17,0,2
1,2008,660400,14,12,2,1
2,2008,660400,7,4,3,9
3,2008,660400,16,14,2,7
4,2008,660400,16,15,1,3
5,2008,660400,14,13,1,11
6,2008,660400,23,21,2,2
7,2008,660400,20,15,5,5
8,2008,660400,15,13,2,3
9,2008,660400,21,15,6,6
10,2008,660400,21,17,4,2
11,2008,660400,14,11,3,7
12,2008,660400,17,14,3,2
1,2009,660400,16,16,0,6
2,2009,660400,10,10,0,1
3,2009,660400,12,11,1,2
4,2009,660400,6,5,1,5
5,2009,660400,20,17,3,3
6,2009,660400,21,21,0,3
7,2009,660400,22,19,3,2
8,2009,660400,29,27,2,4
9,2009,660400,17,14,3,0
10,2009,660400,19,17,2,3
11,2009,660400,15,14,1,5
12,2009,660400,16,13,3,2
1,2010,660400,21,20,1,1
2,2010,660400,11,10,1,1
3,2010,660400,16,16,0,5
4,2010,660400,22,20,2,0
5,2010,660400,22,20,2,3
6,2010,660400,16,14,2,2
7,2010,660400,27,24,3,4
8,2010,660400,27,21,6,2
9,2010,660400,20,20,0,4
10,2010,660400,25,25,0,2
11,2010,660400,22,22,0,4
12,2010,660400,19,17,2,3
1,2011,660400,18,15,3,5
2,2011,660400,6,6,0,4
1,1999,660301,15,11,4,4
2,1999,660301,15,14,1,9
3,1999,660301,16,14,2,12
4,1999,660301,25,20,5,5
5,1999,660301,22,19,3,12
6,1999,660301,22,19,3,19
7,1999,660301,31,26,5,7
8,1999,660301,37,30,7,16
9,1999,660301,31,26,5,11
10,1999,660301,30,29,1,13
11,1999,660301,18,15,3,7
12,1999,660301,20,15,5,4
1,2000,660301,20,20,0,11
2,2000,660301,23,19,4,10
3,2000,660301,24,20,4,5
4,2000,660301,19,17,2,17
5,2000,660301,27,26,1,24
6,2000,660301,30,24,6,22
7,2000,660301,25,21,4,9
8,2000,660301,32,26,6,17
9,2000,660301,30,23,7,14
10,2000,660301,33,28,5,19
11,2000,660301,15,11,4,12
12,2000,660301,16,11,5,8
1,2001,660301,25,20,5,5
2,2001,660301,15,13,2,13
3,2001,660301,17,16,1,10
4,2001,660301,20,15,5,26
5,2001,660301,23,19,4,21
6,2001,660301,18,11,7,28
7,2001,660301,30,24,6,12
8,2001,660301,22,19,3,19
9,2001,660301,29,22,7,9
10,2001,660301,18,15,3,6
11,2001,660301,23,21,2,5
12,2001,660301,15,11,4,2
1,2002,660301,24,21,3,8
2,2002,660301,22,20,2,16
3,2002,660301,27,20,7,8
4,2002,660301,24,16,8,8
5,2002,660301,22,16,6,10
6,2002,660301,23,19,4,10
7,2002,660301,36,31,5,10
8,2002,660301,39,37,2,7
9,2002,660301,24,18,6,5
10,2002,660301,23,14,9,9
11,2002,660301,18,15,3,12
12,2002,660301,21,17,4,13
1,2003,660301,27,24,3,10
2,2003,660301,16,14,2,12
3,2003,660301,19,18,1,12
4,2003,660301,16,11,5,13
5,2003,660301,24,21,3,30
6,2003,660301,29,22,7,16
7,2003,660301,25,23,2,16
8,2003,660301,31,25,6,17
9,2003,660301,28,23,5,10
10,2003,660301,25,19,6,3
11,2003,660301,33,29,4,10
12,2003,660301,26,20,6,8
1,2004,660301,14,13,1,5
2,2004,660301,26,23,3,13
3,2004,660301,18,13,5,12
4,2004,660301,17,14,3,11
5,2004,660301,28,22,6,6
6,2004,660301,36,28,8,5
7,2004,660301,21,13,8,12
8,2004,660301,35,31,4,5
9,2004,660301,26,24,2,11
10,2004,660301,33,30,3,15
11,2004,660301,17,14,3,11
12,2004,660301,23,18,5,7
1,2005,660301,15,12,3,12
2,2005,660301,16,10,6,13
3,2005,660301,17,16,1,6
4,2005,660301,25,18,7,10
5,2005,660301,22,16,6,6
6,2005,660301,23,18,5,17
7,2005,660301,36,30,6,13
8,2005,660301,42,37,5,16
9,2005,660301,30,24,6,14
10,2005,660301,26,25,1,20
11,2005,660301,32,32,0,33
12,2005,660301,25,23,2,8
1,2006,660301,25,21,4,19
2,2006,660301,26,24,2,16
3,2006,660301,31,27,4,17
4,2006,660301,29,21,8,33
5,2006,660301,26,18,8,26
6,2006,660301,20,17,3,35
7,2006,660301,39,29,10,13
8,2006,660301,33,27,6,14
9,2006,660301,26,18,8,14
10,2006,660301,31,29,2,23
11,2006,660301,25,20,5,19
12,2006,660301,19,11,8,11
1,2007,660301,24,17,7,23
2,2007,660301,10,9,1,9
3,2007,660301,38,34,4,17
4,2007,660301,23,19,4,13
5,2007,660301,27,21,6,24
6,2007,660301,23,17,6,9
7,2007,660301,23,19,4,12
8,2007,660301,27,24,3,26
9,2007,660301,21,15,6,11
10,2007,660301,24,21,3,5
11,2007,660301,31,28,3,8
12,2007,660301,22,18,4,7
1,2008,660301,23,22,1,12
2,2008,660301,18,15,3,21
3,2008,660301,30,27,3,7
4,2008,660301,18,13,5,12
5,2008,660301,26,19,7,5
6,2008,660301,27,22,5,5
7,2008,660301,33,29,4,10
8,2008,660301,35,27,8,11
9,2008,660301,34,27,7,14
10,2008,660301,30,28,2,14
11,2008,660301,29,26,3,12
12,2008,660301,21,19,2,5
1,2009,660301,25,21,4,4
2,2009,660301,21,15,6,8
3,2009,660301,18,15,3,4
4,2009,660301,27,20,7,5
5,2009,660301,24,19,5,12
6,2009,660301,21,17,4,5
7,2009,660301,38,30,8,9
8,2009,660301,24,17,7,7
9,2009,660301,22,19,3,13
10,2009,660301,27,21,6,5
11,2009,660301,26,24,2,8
12,2009,660301,18,17,1,5
1,2010,660301,31,27,4,8
2,2010,660301,15,13,2,8
3,2010,660301,20,16,4,9
4,2010,660301,25,18,7,10
5,2010,660301,19,17,2,10
6,2010,660301,23,18,5,9
7,2010,660301,12,10,2,8
8,2010,660301,36,33,3,9
9,2010,660301,21,16,5,19
10,2010,660301,13,10,3,8
11,2010,660301,23,21,2,10
12,2010,660301,22,18,4,5
1,2011,660301,12,10,2,9
2,2011,660301,12,11,1,2
1,1999,835000,63,56,7,23
2,1999,835000,39,33,6,30
3,1999,835000,70,60,10,13
4,1999,835000,82,74,8,15
5,1999,835000,83,76,7,14
6,1999,835000,108,97,11,27
7,1999,835000,93,80,13,18
8,1999,835000,103,91,12,22
9,1999,835000,99,90,9,23
10,1999,835000,109,96,13,18
11,1999,835000,91,85,6,17
12,1999,835000,87,79,8,29
1,2000,835000,93,84,9,25
2,2000,835000,82,73,9,17
3,2000,835000,94,88,6,20
4,2000,835000,76,65,11,22
5,2000,835000,81,74,7,16
6,2000,835000,87,78,9,19
7,2000,835000,82,70,12,7
8,2000,835000,84,72,12,11
9,2000,835000,99,91,8,18
10,2000,835000,101,87,14,20
11,2000,835000,88,80,8,21
12,2000,835000,96,84,12,13
1,2001,835000,93,86,7,32
2,2001,835000,54,46,8,28
3,2001,835000,62,53,9,19
4,2001,835000,79,66,13,25
5,2001,835000,82,71,11,30
6,2001,835000,67,54,13,28
7,2001,835000,72,66,6,29
8,2001,835000,79,69,10,25
9,2001,835000,81,70,11,47
10,2001,835000,118,108,10,17
11,2001,835000,72,65,7,41
12,2001,835000,63,58,5,26
1,2002,835000,58,50,8,37
2,2002,835000,62,51,11,22
3,2002,835000,71,56,15,19
4,2002,835000,70,55,15,29
5,2002,835000,73,60,13,54
6,2002,835000,65,60,5,20
7,2002,835000,82,69,13,26
8,2002,835000,98,87,11,32
9,2002,835000,80,75,5,20
10,2002,835000,74,66,8,22
11,2002,835000,82,78,4,31
12,2002,835000,78,67,11,29
1,2003,835000,69,58,11,37
2,2003,835000,79,73,6,40
3,2003,835000,60,52,8,37
4,2003,835000,62,51,11,32
5,2003,835000,76,63,13,60
6,2003,835000,73,68,5,62
7,2003,835000,78,71,7,29
8,2003,835000,80,71,9,26
9,2003,835000,66,53,13,22
10,2003,835000,79,70,9,10
11,2003,835000,83,78,5,18
12,2003,835000,75,68,7,18
1,2004,835000,65,61,4,22
2,2004,835000,62,60,2,25
3,2004,835000,60,50,10,29
4,2004,835000,61,55,6,21
5,2004,835000,68,51,17,20
6,2004,835000,66,54,12,21
7,2004,835000,87,79,8,28
8,2004,835000,77,70,7,21
9,2004,835000,70,59,11,16
10,2004,835000,58,50,8,19
11,2004,835000,63,49,14,15
12,2004,835000,81,75,6,36
1,2005,835000,71,63,8,18
2,2005,835000,52,48,4,31
3,2005,835000,60,53,7,22
4,2005,835000,68,59,9,38
5,2005,835000,76,65,11,16
6,2005,835000,98,85,13,21
7,2005,835000,76,62,14,23
8,2005,835000,81,61,20,29
9,2005,835000,67,52,15,23
10,2005,835000,85,71,14,34
11,2005,835000,69,59,10,35
12,2005,835000,54,51,3,20
1,2006,835000,87,77,10,23
2,2006,835000,60,55,5,44
3,2006,835000,72,65,7,35
4,2006,835000,76,66,10,47
5,2006,835000,75,64,11,13
6,2006,835000,77,65,12,31
7,2006,835000,72,62,10,24
8,2006,835000,64,57,7,19
9,2006,835000,72,57,15,35
10,2006,835000,88,77,11,36
11,2006,835000,52,45,7,44
12,2006,835000,66,58,8,30
1,2007,835000,57,53,4,57
2,2007,835000,47,41,6,16
3,2007,835000,54,47,7,28
4,2007,835000,65,55,10,37
5,2007,835000,73,67,6,34
6,2007,835000,86,77,9,27
7,2007,835000,76,61,15,21
8,2007,835000,64,55,9,26
9,2007,835000,72,61,11,37
10,2007,835000,84,68,16,37
11,2007,835000,61,54,7,43
12,2007,835000,46,42,4,21
1,2008,835000,57,43,14,21
2,2008,835000,41,36,5,40
3,2008,835000,67,54,13,25
4,2008,835000,70,61,9,21
5,2008,835000,70,60,10,41
6,2008,835000,71,64,7,38
7,2008,835000,86,70,16,46
8,2008,835000,79,69,10,39
9,2008,835000,81,74,7,31
10,2008,835000,76,71,5,34
11,2008,835000,75,67,8,34
12,2008,835000,63,59,4,17
1,2009,835000,52,48,4,25
2,2009,835000,48,43,5,30
3,2009,835000,73,57,16,23
4,2009,835000,66,60,6,33
5,2009,835000,63,58,5,25
6,2009,835000,69,62,7,22
7,2009,835000,69,60,9,28
8,2009,835000,77,72,5,34
9,2009,835000,68,58,10,23
10,2009,835000,63,55,8,30
11,2009,835000,69,59,10,25
12,2009,835000,58,53,5,13
1,2010,835000,54,46,8,24
2,2010,835000,52,49,3,33
3,2010,835000,53,41,12,29
4,2010,835000,63,60,3,17
5,2010,835000,62,56,6,32
6,2010,835000,77,69,8,26
7,2010,835000,59,52,7,29
8,2010,835000,81,69,12,30
9,2010,835000,74,70,4,24
10,2010,835000,64,58,6,41
11,2010,835000,57,53,4,32
12,2010,835000,68,62,6,20
1,2011,835000,54,52,2,39
2,2011,835000,24,22,2,19
1,1999,834600,34,32,2,12
2,1999,834600,54,41,13,15
3,1999,834600,35,27,8,12
4,1999,834600,43,33,10,10
5,1999,834600,50,34,16,13
6,1999,834600,46,35,11,14
7,1999,834600,43,31,12,9
8,1999,834600,55,42,13,20
9,1999,834600,38,25,13,21
10,1999,834600,58,52,6,15
11,1999,834600,37,31,6,9
12,1999,834600,34,26,8,16
1,2000,834600,31,24,7,14
2,2000,834600,46,37,9,14
3,2000,834600,50,38,12,17
4,2000,834600,44,36,8,15
5,2000,834600,39,29,10,14
6,2000,834600,45,39,6,11
7,2000,834600,59,38,21,25
8,2000,834600,53,39,14,7
9,2000,834600,44,35,9,11
10,2000,834600,44,34,10,11
11,2000,834600,50,37,13,18
12,2000,834600,39,31,8,20
1,2001,834600,36,29,7,11
2,2001,834600,25,23,2,17
3,2001,834600,41,28,13,18
4,2001,834600,51,37,14,17
5,2001,834600,44,31,13,22
6,2001,834600,41,33,8,12
7,2001,834600,52,32,20,6
8,2001,834600,44,36,8,7
9,2001,834600,43,30,13,13
10,2001,834600,39,23,16,16
11,2001,834600,33,25,8,7
12,2001,834600,26,22,4,12
1,2002,834600,34,26,8,17
2,2002,834600,20,14,6,13
3,2002,834600,41,33,8,8
4,2002,834600,39,25,14,17
5,2002,834600,44,33,11,17
6,2002,834600,54,34,20,12
7,2002,834600,62,45,17,8
8,2002,834600,49,38,11,13
9,2002,834600,51,39,12,16
10,2002,834600,59,47,12,18
11,2002,834600,32,23,9,21
12,2002,834600,30,26,4,16
1,2003,834600,31,24,7,20
2,2003,834600,28,20,8,15
3,2003,834600,41,30,11,13
4,2003,834600,41,33,8,21
5,2003,834600,45,34,11,30
6,2003,834600,29,22,7,48
7,2003,834600,41,33,8,8
8,2003,834600,44,36,8,11
9,2003,834600,56,48,8,10
10,2003,834600,46,33,13,32
11,2003,834600,39,27,12,24
12,2003,834600,53,42,11,17
1,2004,834600,36,27,9,21
2,2004,834600,36,28,8,20
3,2004,834600,37,24,13,22
4,2004,834600,33,24,9,12
5,2004,834600,46,36,10,19
6,2004,834600,48,33,15,10
7,2004,834600,48,36,12,20
8,2004,834600,55,44,11,10
9,2004,834600,46,40,6,31
10,2004,834600,62,50,12,12
11,2004,834600,44,34,10,16
12,2004,834600,32,31,1,22
1,2005,834600,32,26,6,12
2,2005,834600,30,24,6,14
3,2005,834600,34,25,9,21
4,2005,834600,46,37,9,20
5,2005,834600,52,41,11,56
6,2005,834600,47,38,9,46
7,2005,834600,61,42,19,25
8,2005,834600,55,48,7,10
9,2005,834600,46,36,10,12
10,2005,834600,47,41,6,24
11,2005,834600,46,37,9,17
12,2005,834600,30,24,6,33
1,2006,834600,53,41,12,31
2,2006,834600,34,29,5,28
3,2006,834600,44,39,5,43
4,2006,834600,39,30,9,28
5,2006,834600,50,33,17,25
6,2006,834600,44,36,8,16
7,2006,834600,67,54,13,24
8,2006,834600,63,52,11,31
9,2006,834600,49,44,5,19
10,2006,834600,44,38,6,16
11,2006,834600,44,37,7,23
12,2006,834600,40,30,10,23
1,2007,834600,47,39,8,20
2,2007,834600,27,23,4,21
3,2007,834600,41,34,7,28
4,2007,834600,44,37,7,14
5,2007,834600,45,34,11,15
6,2007,834600,44,35,9,19
7,2007,834600,74,60,14,28
8,2007,834600,64,46,18,31
9,2007,834600,49,40,9,25
10,2007,834600,65,53,12,18
11,2007,834600,74,66,8,19
12,2007,834600,60,48,12,38
1,2008,834600,51,46,5,28
2,2008,834600,35,28,7,18
3,2008,834600,47,38,9,14
4,2008,834600,54,36,18,10
5,2008,834600,55,44,11,10
6,2008,834600,48,36,12,17
7,2008,834600,41,36,5,33
8,2008,834600,62,45,17,30
9,2008,834600,61,47,14,18
10,2008,834600,49,37,12,33
11,2008,834600,54,47,7,28
12,2008,834600,48,42,6,29
1,2009,834600,36,32,4,31
2,2009,834600,33,26,7,14
3,2009,834600,35,34,1,17
4,2009,834600,33,22,11,20
5,2009,834600,45,33,12,16
6,2009,834600,48,35,13,11
7,2009,834600,40,33,7,19
8,2009,834600,47,40,7,14
9,2009,834600,44,35,9,15
10,2009,834600,39,31,8,15
11,2009,834600,45,29,16,26
12,2009,834600,35,29,6,15
1,2010,834600,34,33,1,28
2,2010,834600,18,15,3,28
3,2010,834600,36,30,6,29
4,2010,834600,31,23,8,19
5,2010,834600,39,34,5,9
6,2010,834600,38,30,8,10
7,2010,834600,38,33,5,10
8,2010,834600,39,27,12,11
9,2010,834600,35,22,13,17
10,2010,834600,41,31,10,9
11,2010,834600,27,25,2,9
12,2010,834600,35,33,2,6
1,2011,834600,19,17,2,10
2,2011,834600,17,15,2,5
1,1999,420200,15,11,4,2
2,1999,420200,11,10,1,0
3,1999,420200,12,10,2,1
4,1999,420200,7,6,1,1
5,1999,420200,7,6,1,1
6,1999,420200,9,8,1,1
7,1999,420200,12,6,6,0
8,1999,420200,14,12,2,2
9,1999,420200,14,11,3,1
10,1999,420200,12,9,3,5
11,1999,420200,17,16,1,0
12,1999,420200,11,8,3,0
1,2000,420200,7,5,2,1
2,2000,420200,3,1,2,3
3,2000,420200,8,6,2,4
4,2000,420200,6,6,0,1
5,2000,420200,12,8,4,1
6,2000,420200,19,14,5,1
7,2000,420200,11,8,3,0
8,2000,420200,12,11,1,0
9,2000,420200,14,14,0,0
10,2000,420200,11,10,1,0
11,2000,420200,8,5,3,1
12,2000,420200,6,6,0,1
1,2001,420200,7,7,0,0
2,2001,420200,8,7,1,0
3,2001,420200,8,6,2,0
4,2001,420200,7,7,0,0
5,2001,420200,12,11,1,0
6,2001,420200,13,10,3,1
7,2001,420200,17,15,2,0
8,2001,420200,10,7,3,0
9,2001,420200,13,11,2,0
10,2001,420200,8,8,0,0
11,2001,420200,11,9,2,0
12,2001,420200,15,15,0,0
1,2002,420200,7,5,2,0
2,2002,420200,2,2,0,0
3,2002,420200,6,5,1,0
4,2002,420200,4,3,1,2
5,2002,420200,14,14,0,0
6,2002,420200,8,6,2,2
7,2002,420200,11,10,1,0
8,2002,420200,7,7,0,1
9,2002,420200,7,7,0,0
10,2002,420200,15,10,5,0
11,2002,420200,6,4,2,1
12,2002,420200,5,4,1,1
1,2003,420200,5,5,0,0
2,2003,420200,7,7,0,0
3,2003,420200,11,10,1,0
4,2003,420200,8,7,1,1
5,2003,420200,7,7,0,0
6,2003,420200,3,3,0,2
7,2003,420200,8,8,0,1
8,2003,420200,10,9,1,1
9,2003,420200,7,4,3,1
10,2003,420200,6,5,1,1
11,2003,420200,6,6,0,0
12,2003,420200,6,6,0,0
1,2004,420200,5,5,0,2
2,2004,420200,8,7,1,0
3,2004,420200,14,14,0,0
4,2004,420200,7,6,1,0
5,2004,420200,8,7,1,0
6,2004,420200,8,7,1,0
7,2004,420200,8,6,2,0
8,2004,420200,10,8,2,3
9,2004,420200,16,15,1,1
10,2004,420200,7,6,1,0
11,2004,420200,12,11,1,0
12,2004,420200,4,4,0,0
1,2005,420200,10,8,2,0
2,2005,420200,4,3,1,2
3,2005,420200,11,8,3,3
4,2005,420200,7,7,0,1
5,2005,420200,5,4,1,0
6,2005,420200,6,5,1,1
7,2005,420200,15,13,2,0
8,2005,420200,16,14,2,0
9,2005,420200,7,5,2,0
10,2005,420200,9,9,0,0
11,2005,420200,6,4,2,3
12,2005,420200,5,5,0,0
1,2006,420200,11,7,4,3
2,2006,420200,1,1,0,0
3,2006,420200,7,6,1,0
4,2006,420200,5,4,1,0
5,2006,420200,13,13,0,1
6,2006,420200,14,12,2,0
7,2006,420200,7,6,1,1
8,2006,420200,6,5,1,0
9,2006,420200,5,5,0,2
10,2006,420200,1,1,0,1
11,2006,420200,6,5,1,3
12,2006,420200,10,9,1,0
1,2007,420200,9,9,0,1
2,2007,420200,3,3,0,0
3,2007,420200,6,5,1,1
4,2007,420200,5,3,2,0
5,2007,420200,14,14,0,0
6,2007,420200,12,10,2,0
7,2007,420200,7,6,1,1
8,2007,420200,6,6,0,1
9,2007,420200,9,7,2,0
10,2007,420200,14,12,2,0
11,2007,420200,3,3,0,3
12,2007,420200,7,6,1,2
1,2008,420200,10,10,0,3
2,2008,420200,8,8,0,1
3,2008,420200,8,7,1,1
4,2008,420200,7,6,1,1
5,2008,420200,4,3,1,1
6,2008,420200,6,4,2,3
7,2008,420200,12,9,3,0
8,2008,420200,7,5,2,5
9,2008,420200,5,4,1,0
10,2008,420200,6,4,2,0
11,2008,420200,9,8,1,1
12,2008,420200,2,1,1,1
1,2009,420200,6,6,0,0
2,2009,420200,12,10,2,1
3,2009,420200,7,6,1,0
4,2009,420200,10,10,0,0
5,2009,420200,9,5,4,2
6,2009,420200,11,10,1,1
7,2009,420200,6,6,0,0
8,2009,420200,4,3,1,3
9,2009,420200,5,1,4,0
10,2009,420200,15,12,3,0
11,2009,420200,7,7,0,3
12,2009,420200,9,4,5,0
1,2010,420200,6,6,0,0
2,2010,420200,5,5,0,0
3,2010,420200,5,2,3,1
4,2010,420200,12,12,0,1
5,2010,420200,3,2,1,1
6,2010,420200,8,8,0,1
7,2010,420200,4,4,0,1
8,2010,420200,6,4,2,3
9,2010,420200,7,6,1,1
10,2010,420200,7,5,2,0
11,2010,420200,11,10,1,0
12,2010,420200,5,4,1,0
1,2011,420200,6,6,0,0
2,2011,420200,7,7,0,0
1,1999,420100,8,7,1,3
2,1999,420100,8,5,3,1
3,1999,420100,4,3,1,2
4,1999,420100,3,3,0,4
5,1999,420100,3,3,0,0
6,1999,420100,5,5,0,2
7,1999,420100,6,6,0,3
8,1999,420100,10,10,0,3
9,1999,420100,9,8,1,1
10,1999,420100,6,5,1,1
11,1999,420100,5,5,0,4
12,1999,420100,2,2,0,1
1,2000,420100,4,4,0,1
2,2000,420100,4,4,0,2
3,2000,420100,4,4,0,0
4,2000,420100,4,3,1,0
5,2000,420100,5,5,0,0
6,2000,420100,5,5,0,0
7,2000,420100,4,2,2,2
8,2000,420100,7,7,0,1
9,2000,420100,6,5,1,1
10,2000,420100,9,8,1,0
11,2000,420100,8,7,1,0
12,2000,420100,2,2,0,0
1,2001,420100,3,3,0,0
2,2001,420100,3,2,1,2
3,2001,420100,3,2,1,1
4,2001,420100,8,8,0,1
5,2001,420100,6,4,2,1
6,2001,420100,1,0,1,1
7,2001,420100,6,4,2,0
8,2001,420100,11,10,1,0
9,2001,420100,3,3,0,0
10,2001,420100,9,9,0,3
11,2001,420100,9,8,1,2
12,2001,420100,2,2,0,2
1,2002,420100,9,7,2,1
2,2002,420100,8,6,2,0
3,2002,420100,9,8,1,1
4,2002,420100,10,8,2,1
5,2002,420100,8,5,3,2
6,2002,420100,9,7,2,0
7,2002,420100,7,6,1,1
8,2002,420100,4,4,0,0
9,2002,420100,7,7,0,2
10,2002,420100,5,5,0,1
11,2002,420100,2,1,1,0
12,2002,420100,4,3,1,0
1,2003,420100,7,7,0,3
2,2003,420100,8,7,1,1
3,2003,420100,9,9,0,2
4,2003,420100,3,3,0,3
5,2003,420100,8,7,1,0
6,2003,420100,6,6,0,1
7,2003,420100,6,5,1,1
8,2003,420100,8,8,0,1
9,2003,420100,7,7,0,1
10,2003,420100,8,8,0,0
11,2003,420100,7,7,0,0
12,2003,420100,8,8,0,0
1,2004,420100,10,9,1,3
2,2004,420100,7,7,0,2
3,2004,420100,14,12,2,3
4,2004,420100,12,10,2,2
5,2004,420100,6,5,1,2
6,2004,420100,9,5,4,0
7,2004,420100,11,8,3,0
8,2004,420100,10,10,0,0
9,2004,420100,15,12,3,0
10,2004,420100,13,10,3,1
11,2004,420100,5,5,0,5
12,2004,420100,10,10,0,1
1,2005,420100,4,4,0,1
2,2005,420100,13,11,2,2
3,2005,420100,5,4,1,2
4,2005,420100,13,12,1,1
5,2005,420100,8,7,1,1
6,2005,420100,10,9,1,1
7,2005,420100,4,4,0,0
8,2005,420100,9,9,0,0
9,2005,420100,12,11,1,1
10,2005,420100,15,13,2,1
11,2005,420100,15,11,4,0
12,2005,420100,4,2,2,1
1,2006,420100,10,10,0,2
2,2006,420100,3,3,0,3
3,2006,420100,9,9,0,0
4,2006,420100,5,5,0,1
5,2006,420100,14,13,1,1
6,2006,420100,4,3,1,1
7,2006,420100,9,6,3,1
8,2006,420100,5,5,0,0
9,2006,420100,9,8,1,3
10,2006,420100,7,6,1,0
11,2006,420100,5,5,0,3
12,2006,420100,5,4,1,1
1,2007,420100,5,4,1,1
2,2007,420100,4,3,1,0
3,2007,420100,8,6,2,2
4,2007,420100,3,3,0,4
5,2007,420100,11,9,2,2
6,2007,420100,6,5,1,0
7,2007,420100,6,4,2,0
8,2007,420100,8,7,1,1
9,2007,420100,13,13,0,2
10,2007,420100,12,11,1,0
11,2007,420100,9,8,1,0
12,2007,420100,7,6,1,4
1,2008,420100,8,5,3,2
2,2008,420100,4,3,1,2
3,2008,420100,4,4,0,0
4,2008,420100,7,5,2,0
5,2008,420100,10,9,1,1
6,2008,420100,4,3,1,1
7,2008,420100,8,6,2,1
8,2008,420100,8,7,1,0
9,2008,420100,7,5,2,1
10,2008,420100,8,7,1,1
11,2008,420100,0,0,0,0
12,2008,420100,8,6,2,1
1,2009,420100,11,10,1,1
2,2009,420100,10,9,1,0
3,2009,420100,2,2,0,1
4,2009,420100,3,3,0,1
5,2009,420100,9,8,1,2
6,2009,420100,4,2,2,1
7,2009,420100,14,9,5,1
8,2009,420100,4,3,1,2
9,2009,420100,12,10,2,0
10,2009,420100,6,6,0,2
11,2009,420100,12,11,1,0
12,2009,420100,5,5,0,0
1,2010,420100,3,3,0,1
2,2010,420100,4,4,0,1
3,2010,420100,7,6,1,2
4,2010,420100,5,5,0,0
5,2010,420100,5,5,0,1
6,2010,420100,4,3,1,0
7,2010,420100,9,8,1,0
8,2010,420100,6,6,0,0
9,2010,420100,2,2,0,4
10,2010,420100,6,5,1,0
11,2010,420100,10,9,1,1
12,2010,420100,1,1,0,2
1,2011,420100,4,2,2,0
2,2011,420100,7,6,1,1
1,1999,670500,9,8,1,2
2,1999,670500,15,11,4,1
3,1999,670500,26,16,10,3
4,1999,670500,20,16,4,1
5,1999,670500,21,14,7,4
6,1999,670500,34,25,9,2
7,1999,670500,33,27,6,2
8,1999,670500,22,17,5,4
9,1999,670500,25,18,7,2
10,1999,670500,23,21,2,0
11,1999,670500,23,17,6,1
12,1999,670500,14,13,1,2
1,2000,670500,10,8,2,1
2,2000,670500,18,16,2,0
3,2000,670500,18,15,3,2
4,2000,670500,19,16,3,1
5,2000,670500,17,13,4,3
6,2000,670500,28,24,4,3
7,2000,670500,33,30,3,2
8,2000,670500,22,20,2,3
9,2000,670500,18,17,1,2
10,2000,670500,22,16,6,0
11,2000,670500,15,12,3,3
12,2000,670500,12,12,0,2
1,2001,670500,15,10,5,1
2,2001,670500,11,8,3,0
3,2001,670500,18,13,5,0
4,2001,670500,13,11,2,0
5,2001,670500,22,17,5,1
6,2001,670500,20,16,4,0
7,2001,670500,22,17,5,2
8,2001,670500,24,15,9,1
9,2001,670500,20,19,1,0
10,2001,670500,30,23,7,0
11,2001,670500,16,12,4,1
12,2001,670500,21,17,4,2
1,2002,670500,9,6,3,4
2,2002,670500,6,6,0,5
3,2002,670500,6,5,1,0
4,2002,670500,9,7,2,3
5,2002,670500,8,5,3,0
6,2002,670500,13,7,6,2
7,2002,670500,13,10,3,0
8,2002,670500,16,10,6,3
9,2002,670500,16,12,4,2
10,2002,670500,29,25,4,4
11,2002,670500,17,15,2,2
12,2002,670500,16,14,2,4
1,2003,670500,17,16,1,3
2,2003,670500,8,7,1,3
3,2003,670500,12,10,2,1
4,2003,670500,13,12,1,3
5,2003,670500,24,18,6,1
6,2003,670500,21,13,8,0
7,2003,670500,12,10,2,3
8,2003,670500,29,23,6,1
9,2003,670500,19,15,4,1
10,2003,670500,17,15,2,0
11,2003,670500,22,19,3,2
12,2003,670500,18,16,2,2
1,2004,670500,13,11,2,7
2,2004,670500,10,7,3,6
3,2004,670500,8,7,1,6
4,2004,670500,18,15,3,1
5,2004,670500,16,10,6,5
6,2004,670500,23,17,6,2
7,2004,670500,19,18,1,6
8,2004,670500,21,20,1,3
9,2004,670500,18,12,6,10
10,2004,670500,14,13,1,7
11,2004,670500,15,12,3,0
12,2004,670500,14,9,5,2
1,2005,670500,8,7,1,6
2,2005,670500,8,7,1,2
3,2005,670500,19,13,6,5
4,2005,670500,12,8,4,7
5,2005,670500,12,11,1,4
6,2005,670500,22,13,9,3
7,2005,670500,13,9,4,8
8,2005,670500,16,9,7,2
9,2005,670500,15,11,4,3
10,2005,670500,19,17,2,8
11,2005,670500,10,8,2,6
12,2005,670500,9,8,1,4
1,2006,670500,13,12,1,11
2,2006,670500,14,11,3,8
3,2006,670500,20,19,1,15
4,2006,670500,20,19,1,9
5,2006,670500,16,15,1,2
6,2006,670500,16,11,5,10
7,2006,670500,14,10,4,10
8,2006,670500,16,13,3,9
9,2006,670500,20,16,4,7
10,2006,670500,17,16,1,5
11,2006,670500,19,15,4,3
12,2006,670500,22,18,4,2
1,2007,670500,19,15,4,3
2,2007,670500,14,12,2,2
3,2007,670500,14,10,4,5
4,2007,670500,21,19,2,18
5,2007,670500,14,7,7,7
6,2007,670500,19,13,6,5
7,2007,670500,26,18,8,1
8,2007,670500,21,17,4,4
9,2007,670500,28,21,7,4
10,2007,670500,30,24,6,8
11,2007,670500,19,14,5,1
12,2007,670500,19,16,3,12
1,2008,670500,18,17,1,4
2,2008,670500,11,9,2,9
3,2008,670500,15,10,5,3
4,2008,670500,20,17,3,0
5,2008,670500,23,14,9,11
6,2008,670500,16,12,4,2
7,2008,670500,31,21,10,2
8,2008,670500,30,28,2,7
9,2008,670500,24,19,5,4
10,2008,670500,23,21,2,13
11,2008,670500,16,13,3,4
12,2008,670500,21,17,4,6
1,2009,670500,13,13,0,3
2,2009,670500,7,6,1,4
3,2009,670500,13,9,4,3
4,2009,670500,15,14,1,6
5,2009,670500,9,7,2,2
6,2009,670500,15,12,3,11
7,2009,670500,9,8,1,0
8,2009,670500,19,15,4,1
9,2009,670500,13,12,1,3
10,2009,670500,27,26,1,5
11,2009,670500,22,15,7,3
12,2009,670500,13,12,1,3
1,2010,670500,14,14,0,6
2,2010,670500,7,6,1,7
3,2010,670500,14,12,2,4
4,2010,670500,15,11,4,1
5,2010,670500,15,11,4,6
6,2010,670500,23,22,1,4
7,2010,670500,21,18,3,2
8,2010,670500,37,31,6,8
9,2010,670500,11,11,0,4
10,2010,670500,28,22,6,1
11,2010,670500,20,19,1,3
12,2010,670500,15,11,4,7
1,2011,670500,18,15,3,9
2,2011,670500,2,1,1,2
1,1999,670600,22,14,8,4
2,1999,670600,22,13,9,10
3,1999,670600,22,18,4,4
4,1999,670600,18,14,4,7
5,1999,670600,19,12,7,3
6,1999,670600,9,7,2,3
7,1999,670600,21,12,9,9
8,1999,670600,19,14,5,13
9,1999,670600,15,8,7,3
10,1999,670600,11,10,1,4
11,1999,670600,25,16,9,4
12,1999,670600,19,13,6,7
1,2000,670600,9,5,4,8
2,2000,670600,13,12,1,11
3,2000,670600,11,8,3,7
4,2000,670600,9,7,2,10
5,2000,670600,16,10,6,13
6,2000,670600,14,12,2,9
7,2000,670600,23,12,11,6
8,2000,670600,24,20,4,10
9,2000,670600,20,15,5,8
10,2000,670600,18,12,6,10
11,2000,670600,17,13,4,5
12,2000,670600,20,17,3,4
1,2001,670600,15,13,2,7
2,2001,670600,17,14,3,7
3,2001,670600,13,6,7,4
4,2001,670600,15,10,5,8
5,2001,670600,20,12,8,4
6,2001,670600,23,13,10,4
7,2001,670600,21,17,4,2
8,2001,670600,26,20,6,12
9,2001,670600,28,22,6,6
10,2001,670600,29,21,8,5
11,2001,670600,22,17,5,8
12,2001,670600,24,19,5,1
1,2002,670600,10,10,0,14
2,2002,670600,15,10,5,7
3,2002,670600,17,11,6,5
4,2002,670600,20,17,3,3
5,2002,670600,19,11,8,5
6,2002,670600,15,8,7,3
7,2002,670600,24,14,10,4
8,2002,670600,20,13,7,2
9,2002,670600,18,17,1,3
10,2002,670600,26,21,5,5
11,2002,670600,13,11,2,5
12,2002,670600,24,20,4,3
1,2003,670600,11,8,3,8
2,2003,670600,14,11,3,4
3,2003,670600,21,17,4,1
4,2003,670600,19,17,2,4
5,2003,670600,14,9,5,4
6,2003,670600,20,14,6,5
7,2003,670600,8,8,0,6
8,2003,670600,18,12,6,3
9,2003,670600,11,8,3,3
10,2003,670600,16,14,2,3
11,2003,670600,12,10,2,5
12,2003,670600,11,7,4,5
1,2004,670600,7,3,4,8
2,2004,670600,13,10,3,11
3,2004,670600,15,11,4,10
4,2004,670600,12,9,3,4
5,2004,670600,12,8,4,8
6,2004,670600,13,8,5,6
7,2004,670600,14,7,7,1
8,2004,670600,24,15,9,19
9,2004,670600,14,10,4,3
10,2004,670600,15,12,3,8
11,2004,670600,11,9,2,3
12,2004,670600,9,6,3,5
1,2005,670600,13,11,2,3
2,2005,670600,4,3,1,4
3,2005,670600,15,12,3,4
4,2005,670600,11,8,3,6
5,2005,670600,11,8,3,3
6,2005,670600,14,12,2,4
7,2005,670600,14,13,1,4
8,2005,670600,18,14,4,8
9,2005,670600,12,8,4,4
10,2005,670600,16,13,3,4
11,2005,670600,12,9,3,4
12,2005,670600,13,10,3,5
1,2006,670600,14,11,3,9
2,2006,670600,9,6,3,7
3,2006,670600,16,14,2,14
4,2006,670600,19,14,5,6
5,2006,670600,14,8,6,7
6,2006,670600,17,15,2,1
7,2006,670600,21,13,8,13
8,2006,670600,13,9,4,10
9,2006,670600,9,7,2,6
10,2006,670600,17,13,4,6
11,2006,670600,14,9,5,17
12,2006,670600,14,13,1,27
1,2007,670600,12,10,2,11
2,2007,670600,8,6,2,3
3,2007,670600,17,12,5,6
4,2007,670600,19,12,7,6
5,2007,670600,14,9,5,6
6,2007,670600,14,8,6,8
7,2007,670600,8,7,1,16
8,2007,670600,17,14,3,6
9,2007,670600,21,20,1,8
10,2007,670600,22,16,6,4
11,2007,670600,20,13,7,3
12,2007,670600,17,13,4,5
1,2008,670600,18,14,4,7
2,2008,670600,17,15,2,3
3,2008,670600,11,8,3,0
4,2008,670600,11,8,3,2
5,2008,670600,11,7,4,5
6,2008,670600,19,15,4,3
7,2008,670600,25,20,5,6
8,2008,670600,20,17,3,7
9,2008,670600,18,12,6,3
10,2008,670600,12,11,1,1
11,2008,670600,17,10,7,3
12,2008,670600,10,9,1,1
1,2009,670600,11,10,1,4
2,2009,670600,15,15,0,7
3,2009,670600,11,8,3,1
4,2009,670600,14,12,2,2
5,2009,670600,14,13,1,3
6,2009,670600,19,16,3,10
7,2009,670600,13,9,4,4
8,2009,670600,11,8,3,1
9,2009,670600,16,15,1,3
10,2009,670600,19,18,1,4
11,2009,670600,16,14,2,0
12,2009,670600,7,7,0,1
1,2010,670600,7,6,1,2
2,2010,670600,9,8,1,9
3,2010,670600,9,8,1,4
4,2010,670600,14,11,3,2
5,2010,670600,12,10,2,4
6,2010,670600,23,14,9,3
7,2010,670600,14,12,2,2
8,2010,670600,16,14,2,1
9,2010,670600,16,16,0,1
10,2010,670600,14,13,1,1
11,2010,670600,20,18,2,4
12,2010,670600,12,11,1,6
1,2011,670600,9,9,0,7
2,2011,670600,1,1,0,1
1,1999,670700,21,19,2,2
2,1999,670700,17,11,6,8
3,1999,670700,18,10,8,7
4,1999,670700,38,30,8,3
5,1999,670700,20,17,3,9
6,1999,670700,26,17,9,9
7,1999,670700,27,21,6,9
8,1999,670700,30,27,3,15
9,1999,670700,25,17,8,5
10,1999,670700,18,13,5,5
11,1999,670700,18,14,4,17
12,1999,670700,23,18,5,6
1,2000,670700,16,14,2,22
2,2000,670700,18,12,6,15
3,2000,670700,20,14,6,11
4,2000,670700,24,17,7,11
5,2000,670700,21,15,6,8
6,2000,670700,18,13,5,9
7,2000,670700,28,20,8,6
8,2000,670700,28,22,6,6
9,2000,670700,24,19,5,8
10,2000,670700,22,18,4,5
11,2000,670700,15,11,4,10
12,2000,670700,16,15,1,14
1,2001,670700,17,12,5,13
2,2001,670700,13,11,2,9
3,2001,670700,10,9,1,8
4,2001,670700,12,9,3,10
5,2001,670700,23,20,3,5
6,2001,670700,29,18,11,6
7,2001,670700,17,14,3,7
8,2001,670700,25,21,4,8
9,2001,670700,35,32,3,3
10,2001,670700,25,16,9,5
11,2001,670700,25,21,4,6
12,2001,670700,28,18,10,5
1,2002,670700,23,19,4,15
2,2002,670700,15,13,2,17
3,2002,670700,18,12,6,10
4,2002,670700,16,11,5,8
5,2002,670700,19,17,2,13
6,2002,670700,29,21,8,9
7,2002,670700,29,19,10,12
8,2002,670700,38,29,9,7
9,2002,670700,38,24,14,9
10,2002,670700,30,17,13,19
11,2002,670700,18,15,3,10
12,2002,670700,29,23,6,21
1,2003,670700,29,23,6,5
2,2003,670700,16,16,0,10
3,2003,670700,24,18,6,4
4,2003,670700,38,29,9,9
5,2003,670700,25,21,4,10
6,2003,670700,34,27,7,12
7,2003,670700,27,24,3,11
8,2003,670700,37,32,5,2
9,2003,670700,37,30,7,0
10,2003,670700,37,25,12,18
11,2003,670700,29,24,5,10
12,2003,670700,19,15,4,6
1,2004,670700,21,19,2,22
2,2004,670700,22,16,6,13
3,2004,670700,21,16,5,20
4,2004,670700,20,18,2,14
5,2004,670700,15,10,5,4
6,2004,670700,15,13,2,18
7,2004,670700,25,20,5,12
8,2004,670700,23,17,6,12
9,2004,670700,23,16,7,9
10,2004,670700,24,21,3,5
11,2004,670700,16,14,2,7
12,2004,670700,21,17,4,17
1,2005,670700,20,19,1,6
2,2005,670700,17,14,3,6
3,2005,670700,29,22,7,21
4,2005,670700,23,17,6,7
5,2005,670700,16,9,7,4
6,2005,670700,24,20,4,13
7,2005,670700,30,22,8,16
8,2005,670700,24,21,3,11
9,2005,670700,23,17,6,21
10,2005,670700,29,23,6,3
11,2005,670700,24,16,8,8
12,2005,670700,22,15,7,1
1,2006,670700,15,11,4,12
2,2006,670700,18,15,3,7
3,2006,670700,16,10,6,16
4,2006,670700,15,11,4,9
5,2006,670700,14,13,1,3
6,2006,670700,24,19,5,3
7,2006,670700,17,17,0,13
8,2006,670700,31,26,5,8
9,2006,670700,21,18,3,7
10,2006,670700,23,19,4,11
11,2006,670700,25,17,8,11
12,2006,670700,26,20,6,11
1,2007,670700,27,24,3,10
2,2007,670700,13,10,3,1
3,2007,670700,44,35,9,11
4,2007,670700,17,16,1,11
5,2007,670700,26,23,3,13
6,2007,670700,27,24,3,11
7,2007,670700,51,43,8,15
8,2007,670700,28,22,6,8
9,2007,670700,35,28,7,5
10,2007,670700,33,28,5,12
11,2007,670700,31,29,2,6
12,2007,670700,30,25,5,11
1,2008,670700,32,29,3,2
2,2008,670700,15,15,0,11
3,2008,670700,28,23,5,6
4,2008,670700,25,19,6,3
5,2008,670700,25,23,2,12
6,2008,670700,35,27,8,6
7,2008,670700,34,24,10,14
8,2008,670700,36,28,8,17
9,2008,670700,32,30,2,16
10,2008,670700,27,24,3,10
11,2008,670700,16,16,0,11
12,2008,670700,17,15,2,11
1,2009,670700,11,8,3,14
2,2009,670700,22,20,2,3
3,2009,670700,25,20,5,10
4,2009,670700,19,16,3,12
5,2009,670700,21,21,0,7
6,2009,670700,22,15,7,20
7,2009,670700,30,28,2,9
8,2009,670700,24,21,3,5
9,2009,670700,31,21,10,9
10,2009,670700,39,34,5,15
11,2009,670700,37,32,5,10
12,2009,670700,19,17,2,2
1,2010,670700,29,27,2,6
2,2010,670700,14,12,2,9
3,2010,670700,17,13,4,9
4,2010,670700,17,13,4,11
5,2010,670700,25,20,5,8
6,2010,670700,33,27,6,12
7,2010,670700,35,32,3,6
8,2010,670700,36,32,4,6
9,2010,670700,23,20,3,18
10,2010,670700,17,15,2,5
11,2010,670700,27,25,2,9
12,2010,670700,14,13,1,7
1,2011,670700,22,22,0,6
2,2011,670700,5,3,2,8
1,1999,670800,8,6,2,12
2,1999,670800,11,7,4,2
3,1999,670800,8,7,1,4
4,1999,670800,16,10,6,3
5,1999,670800,17,10,7,7
6,1999,670800,9,6,3,12
7,1999,670800,12,8,4,6
8,1999,670800,14,11,3,7
9,1999,670800,18,9,9,5
10,1999,670800,17,14,3,5
11,1999,670800,7,6,1,1
12,1999,670800,12,6,6,11
1,2000,670800,17,13,4,3
2,2000,670800,5,3,2,5
3,2000,670800,12,9,3,10
4,2000,670800,13,12,1,5
5,2000,670800,15,14,1,6
6,2000,670800,12,9,3,6
7,2000,670800,21,11,10,4
8,2000,670800,18,14,4,3
9,2000,670800,13,8,5,5
10,2000,670800,18,14,4,15
11,2000,670800,14,14,0,0
12,2000,670800,10,9,1,1
1,2001,670800,9,8,1,3
2,2001,670800,8,6,2,1
3,2001,670800,13,9,4,3
4,2001,670800,13,12,1,0
5,2001,670800,8,4,4,1
6,2001,670800,21,17,4,0
7,2001,670800,24,20,4,3
8,2001,670800,24,21,3,4
9,2001,670800,17,13,4,5
10,2001,670800,22,18,4,3
11,2001,670800,14,12,2,4
12,2001,670800,13,11,2,7
1,2002,670800,9,7,2,12
2,2002,670800,12,10,2,14
3,2002,670800,10,8,2,12
4,2002,670800,16,14,2,6
5,2002,670800,20,13,7,7
6,2002,670800,21,15,6,9
7,2002,670800,17,11,6,6
8,2002,670800,18,15,3,6
9,2002,670800,15,8,7,16
10,2002,670800,15,12,3,13
11,2002,670800,17,15,2,13
12,2002,670800,12,10,2,15
1,2003,670800,6,2,4,5
2,2003,670800,10,9,1,13
3,2003,670800,11,9,2,3
4,2003,670800,19,13,6,7
5,2003,670800,13,9,4,15
6,2003,670800,27,17,10,11
7,2003,670800,19,18,1,8
8,2003,670800,13,9,4,2
9,2003,670800,12,10,2,7
10,2003,670800,17,17,0,4
11,2003,670800,20,15,5,7
12,2003,670800,18,16,2,11
1,2004,670800,11,9,2,13
2,2004,670800,9,8,1,5
3,2004,670800,14,11,3,10
4,2004,670800,18,14,4,17
5,2004,670800,19,13,6,4
6,2004,670800,20,15,5,5
7,2004,670800,17,13,4,3
8,2004,670800,24,18,6,15
9,2004,670800,20,13,7,15
10,2004,670800,15,6,9,6
11,2004,670800,8,6,2,9
12,2004,670800,12,11,1,10
1,2005,670800,14,11,3,10
2,2005,670800,9,6,3,7
3,2005,670800,13,12,1,22
4,2005,670800,18,13,5,7
5,2005,670800,12,10,2,4
6,2005,670800,22,15,7,11
7,2005,670800,21,14,7,15
8,2005,670800,18,15,3,8
9,2005,670800,18,13,5,9
10,2005,670800,15,11,4,6
11,2005,670800,15,13,2,6
12,2005,670800,7,5,2,4
1,2006,670800,19,16,3,17
2,2006,670800,10,8,2,4
3,2006,670800,11,10,1,17
4,2006,670800,21,18,3,13
5,2006,670800,22,15,7,3
6,2006,670800,16,14,2,7
7,2006,670800,16,10,6,9
8,2006,670800,23,18,5,8
9,2006,670800,34,29,5,8
10,2006,670800,41,37,4,5
11,2006,670800,32,26,6,4
12,2006,670800,25,24,1,2
1,2007,670800,15,14,1,10
2,2007,670800,11,9,2,9
3,2007,670800,28,21,7,8
4,2007,670800,23,18,5,1
5,2007,670800,19,16,3,5
6,2007,670800,30,21,9,7
7,2007,670800,30,27,3,8
8,2007,670800,24,22,2,5
9,2007,670800,23,16,7,3
10,2007,670800,21,20,1,5
11,2007,670800,27,24,3,1
12,2007,670800,32,30,2,2
1,2008,670800,25,23,2,3
2,2008,670800,21,21,0,5
3,2008,670800,16,13,3,2
4,2008,670800,23,17,6,2
5,2008,670800,28,23,5,2
6,2008,670800,32,29,3,3
7,2008,670800,38,36,2,7
8,2008,670800,35,35,0,5
9,2008,670800,25,21,4,4
10,2008,670800,36,35,1,7
11,2008,670800,26,24,2,6
12,2008,670800,15,12,3,3
1,2009,670800,14,14,0,4
2,2009,670800,11,9,2,1
3,2009,670800,17,16,1,5
4,2009,670800,21,17,4,4
5,2009,670800,20,20,0,2
6,2009,670800,17,13,4,15
7,2009,670800,13,11,2,3
8,2009,670800,14,13,1,3
9,2009,670800,9,5,4,3
10,2009,670800,12,12,0,1
11,2009,670800,15,14,1,7
12,2009,670800,15,9,6,2
1,2010,670800,14,11,3,7
2,2010,670800,11,9,2,10
3,2010,670800,17,12,5,2
4,2010,670800,21,14,7,5
5,2010,670800,28,23,5,1
6,2010,670800,21,17,4,3
7,2010,670800,20,15,5,3
8,2010,670800,20,16,4,5
9,2010,670800,15,14,1,11
10,2010,670800,16,13,3,6
11,2010,670800,15,14,1,7
12,2010,670800,16,14,2,5
1,2011,670800,12,7,5,4
2,2011,670800,8,6,2,3
1,1999,670900,27,22,5,6
2,1999,670900,19,11,8,6
3,1999,670900,16,12,4,2
4,1999,670900,24,21,3,4
5,1999,670900,33,21,12,7
6,1999,670900,15,13,2,4
7,1999,670900,24,16,8,0
8,1999,670900,32,26,6,5
9,1999,670900,22,20,2,2
10,1999,670900,21,15,6,4
11,1999,670900,26,21,5,1
12,1999,670900,19,16,3,6
1,2000,670900,21,13,8,3
2,2000,670900,19,12,7,4
3,2000,670900,15,6,9,8
4,2000,670900,18,14,4,4
5,2000,670900,19,17,2,5
6,2000,670900,17,9,8,6
7,2000,670900,31,24,7,1
8,2000,670900,19,14,5,5
9,2000,670900,21,15,6,2
10,2000,670900,15,10,5,5
11,2000,670900,23,16,7,4
12,2000,670900,23,19,4,1
1,2001,670900,22,18,4,12
2,2001,670900,7,3,4,2
3,2001,670900,21,16,5,2
4,2001,670900,20,17,3,2
5,2001,670900,16,10,6,1
6,2001,670900,25,17,8,6
7,2001,670900,20,18,2,3
8,2001,670900,17,14,3,3
9,2001,670900,19,12,7,3
10,2001,670900,10,8,2,5
11,2001,670900,12,11,1,3
12,2001,670900,7,4,3,3
1,2002,670900,8,7,1,5
2,2002,670900,8,5,3,2
3,2002,670900,18,14,4,6
4,2002,670900,25,17,8,3
5,2002,670900,21,16,5,13
6,2002,670900,21,12,9,5
7,2002,670900,10,9,1,8
8,2002,670900,23,18,5,6
9,2002,670900,17,13,4,19
10,2002,670900,19,17,2,5
11,2002,670900,18,13,5,5
12,2002,670900,14,12,2,2
1,2003,670900,8,8,0,6
2,2003,670900,20,17,3,5
3,2003,670900,20,18,2,1
4,2003,670900,14,11,3,9
5,2003,670900,19,17,2,8
6,2003,670900,29,24,5,2
7,2003,670900,21,18,3,2
8,2003,670900,16,16,0,4
9,2003,670900,27,21,6,2
10,2003,670900,32,30,2,9
11,2003,670900,17,16,1,10
12,2003,670900,28,25,3,7
1,2004,670900,9,8,1,10
2,2004,670900,8,7,1,6
3,2004,670900,18,12,6,5
4,2004,670900,17,13,4,5
5,2004,670900,15,12,3,1
6,2004,670900,14,9,5,6
7,2004,670900,27,23,4,3
8,2004,670900,17,16,1,2
9,2004,670900,18,14,4,8
10,2004,670900,23,19,4,6
11,2004,670900,25,21,4,13
12,2004,670900,16,15,1,4
1,2005,670900,17,15,2,3
2,2005,670900,9,8,1,0
3,2005,670900,21,17,4,7
4,2005,670900,21,16,5,5
5,2005,670900,15,13,2,7
6,2005,670900,21,17,4,12
7,2005,670900,27,23,4,8
8,2005,670900,26,22,4,2
9,2005,670900,23,20,3,4
10,2005,670900,24,21,3,15
11,2005,670900,21,21,0,2
12,2005,670900,18,15,3,5
1,2006,670900,13,9,4,5
2,2006,670900,18,17,1,5
3,2006,670900,25,22,3,10
4,2006,670900,14,11,3,6
5,2006,670900,21,15,6,8
6,2006,670900,34,29,5,1
7,2006,670900,18,16,2,2
8,2006,670900,23,19,4,7
9,2006,670900,14,10,4,9
10,2006,670900,18,13,5,7
11,2006,670900,25,24,1,2
12,2006,670900,20,19,1,3
1,2007,670900,19,14,5,5
2,2007,670900,14,11,3,4
3,2007,670900,15,12,3,10
4,2007,670900,19,14,5,6
5,2007,670900,19,15,4,7
6,2007,670900,19,12,7,2
7,2007,670900,23,18,5,9
8,2007,670900,27,19,8,3
9,2007,670900,24,21,3,4
10,2007,670900,10,7,3,5
11,2007,670900,18,14,4,2
12,2007,670900,19,15,4,3
1,2008,670900,12,10,2,3
2,2008,670900,12,9,3,3
3,2008,670900,16,14,2,3
4,2008,670900,9,6,3,0
5,2008,670900,16,12,4,8
6,2008,670900,20,15,5,2
7,2008,670900,16,12,4,5
8,2008,670900,24,18,6,6
9,2008,670900,28,26,2,3
10,2008,670900,16,9,7,3
11,2008,670900,12,12,0,2
12,2008,670900,19,17,2,5
1,2009,670900,13,13,0,10
2,2009,670900,11,9,2,8
3,2009,670900,16,14,2,4
4,2009,670900,11,8,3,3
5,2009,670900,14,11,3,3
6,2009,670900,16,12,4,9
7,2009,670900,26,23,3,0
8,2009,670900,18,14,4,3
9,2009,670900,29,24,5,4
10,2009,670900,10,10,0,0
11,2009,670900,14,10,4,3
12,2009,670900,17,15,2,3
1,2010,670900,18,16,2,1
2,2010,670900,8,7,1,3
3,2010,670900,8,7,1,9
4,2010,670900,14,13,1,6
5,2010,670900,13,13,0,2
6,2010,670900,18,16,2,8
7,2010,670900,20,12,8,5
8,2010,670900,7,4,3,5
9,2010,670900,14,10,4,5
10,2010,670900,11,10,1,11
11,2010,670900,7,6,1,3
12,2010,670900,10,9,1,2
1,2011,670900,14,12,2,4
2,2011,670900,6,6,0,4
1,1999,680600,18,15,3,12
2,1999,680600,15,11,4,17
3,1999,680600,23,15,8,10
4,1999,680600,25,19,6,18
5,1999,680600,17,13,4,7
6,1999,680600,15,12,3,5
7,1999,680600,29,16,13,7
8,1999,680600,22,13,9,9
9,1999,680600,17,8,9,3
10,1999,680600,24,15,9,9
11,1999,680600,22,15,7,7
12,1999,680600,20,14,6,3
1,2000,680600,18,15,3,4
2,2000,680600,16,11,5,8
3,2000,680600,19,16,3,6
4,2000,680600,22,15,7,7
5,2000,680600,14,9,5,6
6,2000,680600,19,10,9,8
7,2000,680600,35,22,13,9
8,2000,680600,21,10,11,15
9,2000,680600,22,16,6,8
10,2000,680600,14,13,1,8
11,2000,680600,28,25,3,9
12,2000,680600,22,16,6,5
1,2001,680600,11,7,4,11
2,2001,680600,21,15,6,6
3,2001,680600,11,7,4,9
4,2001,680600,18,13,5,11
5,2001,680600,20,16,4,3
6,2001,680600,21,16,5,5
7,2001,680600,19,12,7,6
8,2001,680600,24,10,14,6
9,2001,680600,20,12,8,4
10,2001,680600,18,14,4,10
11,2001,680600,20,12,8,11
12,2001,680600,20,14,6,3
1,2002,680600,18,14,4,20
2,2002,680600,16,9,7,9
3,2002,680600,13,9,4,11
4,2002,680600,7,4,3,8
5,2002,680600,28,16,12,14
6,2002,680600,20,14,6,2
7,2002,680600,28,17,11,3
8,2002,680600,16,8,8,4
9,2002,680600,19,12,7,11
10,2002,680600,17,12,5,12
11,2002,680600,21,17,4,3
12,2002,680600,16,13,3,14
1,2003,680600,19,14,5,9
2,2003,680600,16,14,2,3
3,2003,680600,11,8,3,9
4,2003,680600,14,11,3,9
5,2003,680600,16,8,8,12
6,2003,680600,11,8,3,13
7,2003,680600,18,11,7,9
8,2003,680600,15,8,7,5
9,2003,680600,20,10,10,12
10,2003,680600,22,16,6,10
11,2003,680600,26,18,8,14
12,2003,680600,21,18,3,15
1,2004,680600,8,7,1,10
2,2004,680600,19,16,3,13
3,2004,680600,18,14,4,15
4,2004,680600,24,16,8,19
5,2004,680600,18,15,3,4
6,2004,680600,19,13,6,8
7,2004,680600,23,15,8,12
8,2004,680600,15,11,4,4
9,2004,680600,18,16,2,32
10,2004,680600,24,22,2,25
11,2004,680600,26,20,6,8
12,2004,680600,22,20,2,10
1,2005,680600,15,13,2,10
2,2005,680600,20,18,2,4
3,2005,680600,24,19,5,10
4,2005,680600,23,16,7,7
5,2005,680600,21,16,5,13
6,2005,680600,22,16,6,19
7,2005,680600,20,16,4,8
8,2005,680600,14,10,4,4
9,2005,680600,19,12,7,4
10,2005,680600,21,19,2,18
11,2005,680600,20,14,6,4
12,2005,680600,9,7,2,3
1,2006,680600,24,21,3,8
2,2006,680600,10,8,2,7
3,2006,680600,18,15,3,23
4,2006,680600,15,13,2,17
5,2006,680600,33,25,8,13
6,2006,680600,14,9,5,14
7,2006,680600,22,12,10,3
8,2006,680600,27,20,7,12
9,2006,680600,19,16,3,2
10,2006,680600,17,13,4,6
11,2006,680600,19,17,2,5
12,2006,680600,33,26,7,0
1,2007,680600,14,12,2,4
2,2007,680600,12,10,2,2
3,2007,680600,19,17,2,6
4,2007,680600,16,13,3,6
5,2007,680600,26,22,4,1
6,2007,680600,21,18,3,8
7,2007,680600,36,32,4,12
8,2007,680600,37,31,6,2
9,2007,680600,24,16,8,3
10,2007,680600,16,13,3,2
11,2007,680600,25,24,1,2
12,2007,680600,25,19,6,10
1,2008,680600,20,17,3,7
2,2008,680600,9,8,1,7
3,2008,680600,16,14,2,11
4,2008,680600,22,17,5,5
5,2008,680600,11,7,4,2
6,2008,680600,26,22,4,6
7,2008,680600,20,15,5,6
8,2008,680600,20,19,1,4
9,2008,680600,24,14,10,4
10,2008,680600,18,17,1,5
11,2008,680600,19,16,3,4
12,2008,680600,9,9,0,0
1,2009,680600,14,11,3,1
2,2009,680600,15,13,2,0
3,2009,680600,18,15,3,5
4,2009,680600,19,16,3,9
5,2009,680600,18,17,1,5
6,2009,680600,14,11,3,5
7,2009,680600,16,10,6,6
8,2009,680600,20,17,3,3
9,2009,680600,19,14,5,6
10,2009,680600,29,24,5,7
11,2009,680600,15,11,4,4
12,2009,680600,17,16,1,7
1,2010,680600,12,11,1,5
2,2010,680600,14,12,2,10
3,2010,680600,16,10,6,8
4,2010,680600,13,7,6,8
5,2010,680600,14,12,2,11
6,2010,680600,13,12,1,3
7,2010,680600,15,11,4,7
8,2010,680600,24,19,5,5
9,2010,680600,19,17,2,8
10,2010,680600,28,23,5,4
11,2010,680600,10,9,1,5
12,2010,680600,10,6,4,0
1,2011,680600,9,9,0,8
2,2011,680600,4,4,0,2
1,1999,834800,26,17,9,33
2,1999,834800,18,16,2,27
3,1999,834800,17,14,3,10
4,1999,834800,22,20,2,16
5,1999,834800,30,18,12,6
6,1999,834800,39,25,14,10
7,1999,834800,43,34,9,5
8,1999,834800,25,21,4,10
9,1999,834800,41,29,12,13
10,1999,834800,20,17,3,21
11,1999,834800,29,20,9,15
12,1999,834800,29,22,7,17
1,2000,834800,15,12,3,11
2,2000,834800,24,21,3,12
3,2000,834800,24,19,5,2
4,2000,834800,27,23,4,8
5,2000,834800,28,25,3,14
6,2000,834800,29,23,6,11
7,2000,834800,41,32,9,8
8,2000,834800,26,23,3,12
9,2000,834800,39,31,8,8
10,2000,834800,24,15,9,8
11,2000,834800,24,20,4,8
12,2000,834800,22,18,4,6
1,2001,834800,18,16,2,9
2,2001,834800,20,17,3,1
3,2001,834800,26,20,6,5
4,2001,834800,32,25,7,9
5,2001,834800,37,25,12,4
6,2001,834800,41,26,15,11
7,2001,834800,32,22,10,7
8,2001,834800,33,26,7,5
9,2001,834800,36,28,8,5
10,2001,834800,38,24,14,16
11,2001,834800,27,23,4,15
12,2001,834800,39,29,10,11
1,2002,834800,37,30,7,22
2,2002,834800,22,17,5,14
3,2002,834800,24,19,5,8
4,2002,834800,20,11,9,6
5,2002,834800,31,22,9,7
6,2002,834800,35,28,7,6
7,2002,834800,41,27,14,3
8,2002,834800,33,24,9,3
9,2002,834800,29,24,5,8
10,2002,834800,39,32,7,5
11,2002,834800,27,21,6,7
12,2002,834800,27,24,3,7
1,2003,834800,23,21,2,6
2,2003,834800,20,16,4,8
3,2003,834800,21,16,5,1
4,2003,834800,25,22,3,8
5,2003,834800,23,17,6,24
6,2003,834800,23,17,6,9
7,2003,834800,28,24,4,10
8,2003,834800,29,24,5,1
9,2003,834800,26,20,6,7
10,2003,834800,27,23,4,4
11,2003,834800,22,18,4,5
12,2003,834800,25,21,4,8
1,2004,834800,20,18,2,5
2,2004,834800,29,25,4,14
3,2004,834800,35,29,6,13
4,2004,834800,27,20,7,10
5,2004,834800,27,23,4,8
6,2004,834800,18,17,1,6
7,2004,834800,28,23,5,13
8,2004,834800,32,28,4,11
9,2004,834800,21,17,4,32
10,2004,834800,20,18,2,6
11,2004,834800,23,19,4,15
12,2004,834800,20,15,5,8
1,2005,834800,14,12,2,14
2,2005,834800,12,8,4,11
3,2005,834800,20,15,5,15
4,2005,834800,21,14,7,21
5,2005,834800,27,19,8,9
6,2005,834800,25,17,8,23
7,2005,834800,20,15,5,13
8,2005,834800,17,13,4,6
9,2005,834800,17,10,7,8
10,2005,834800,17,12,5,4
11,2005,834800,20,13,7,6
12,2005,834800,18,17,1,9
1,2006,834800,11,9,2,17
2,2006,834800,16,15,1,14
3,2006,834800,19,16,3,21
4,2006,834800,15,13,2,12
5,2006,834800,11,7,4,3
6,2006,834800,12,9,3,9
7,2006,834800,23,16,7,13
8,2006,834800,24,15,9,16
9,2006,834800,23,19,4,8
10,2006,834800,17,12,5,6
11,2006,834800,25,23,2,9
12,2006,834800,21,17,4,14
1,2007,834800,18,14,4,2
2,2007,834800,16,7,9,3
3,2007,834800,16,12,4,5
4,2007,834800,11,10,1,4
5,2007,834800,27,20,7,5
6,2007,834800,26,20,6,4
7,2007,834800,28,18,10,9
8,2007,834800,15,10,5,9
9,2007,834800,29,24,5,5
10,2007,834800,31,25,6,6
11,2007,834800,25,24,1,5
12,2007,834800,13,10,3,10
1,2008,834800,20,18,2,6
2,2008,834800,11,9,2,2
3,2008,834800,12,10,2,0
4,2008,834800,18,12,6,1
5,2008,834800,12,5,7,4
6,2008,834800,33,31,2,1
7,2008,834800,12,10,2,4
8,2008,834800,33,23,10,13
9,2008,834800,14,12,2,6
10,2008,834800,12,9,3,6
11,2008,834800,18,14,4,5
12,2008,834800,16,14,2,2
1,2009,834800,13,10,3,4
2,2009,834800,13,12,1,1
3,2009,834800,17,17,0,2
4,2009,834800,14,11,3,6
5,2009,834800,19,13,6,7
6,2009,834800,10,10,0,2
7,2009,834800,31,27,4,2
8,2009,834800,16,12,4,4
9,2009,834800,21,13,8,2
10,2009,834800,25,23,2,4
11,2009,834800,22,16,6,3
12,2009,834800,14,12,2,4
1,2010,834800,13,10,3,8
2,2010,834800,10,4,6,10
3,2010,834800,13,10,3,10
4,2010,834800,12,11,1,6
5,2010,834800,22,17,5,3
6,2010,834800,16,12,4,5
7,2010,834800,13,12,1,7
8,2010,834800,17,14,3,11
9,2010,834800,11,10,1,3
10,2010,834800,16,14,2,1
11,2010,834800,12,12,0,2
12,2010,834800,8,7,1,4
1,2011,834800,16,13,3,8
2,2011,834800,9,8,1,0
1,1999,400800,21,15,6,19
2,1999,400800,29,23,6,10
3,1999,400800,37,22,15,14
4,1999,400800,36,26,10,17
5,1999,400800,38,32,6,13
6,1999,400800,24,19,5,10
7,1999,400800,37,28,9,9
8,1999,400800,42,34,8,7
9,1999,400800,35,28,7,8
10,1999,400800,48,39,9,3
11,1999,400800,38,31,7,5
12,1999,400800,17,14,3,1
1,2000,400800,29,24,5,7
2,2000,400800,30,27,3,9
3,2000,400800,41,32,9,9
4,2000,400800,20,14,6,10
5,2000,400800,31,17,14,10
6,2000,400800,36,29,7,7
7,2000,400800,32,26,6,14
8,2000,400800,26,20,6,6
9,2000,400800,34,30,4,8
10,2000,400800,32,27,5,13
11,2000,400800,27,22,5,9
12,2000,400800,19,13,6,9
1,2001,400800,29,22,7,4
2,2001,400800,32,24,8,27
3,2001,400800,23,20,3,16
4,2001,400800,14,12,2,7
5,2001,400800,25,18,7,18
6,2001,400800,28,16,12,18
7,2001,400800,26,22,4,17
8,2001,400800,25,20,5,18
9,2001,400800,29,24,5,19
10,2001,400800,31,24,7,22
11,2001,400800,31,23,8,76
12,2001,400800,22,17,5,23
1,2002,400800,19,15,4,2
2,2002,400800,10,9,1,6
3,2002,400800,17,14,3,5
4,2002,400800,21,20,1,4
5,2002,400800,34,29,5,3
6,2002,400800,28,20,8,9
7,2002,400800,20,14,6,4
8,2002,400800,33,27,6,6
9,2002,400800,24,17,7,9
10,2002,400800,24,17,7,12
11,2002,400800,22,18,4,13
12,2002,400800,15,10,5,5
1,2003,400800,14,11,3,13
2,2003,400800,15,13,2,36
3,2003,400800,15,10,5,23
4,2003,400800,23,14,9,14
5,2003,400800,19,15,4,16
6,2003,400800,33,27,6,6
7,2003,400800,30,24,6,8
8,2003,400800,30,24,6,9
9,2003,400800,25,16,9,5
10,2003,400800,30,25,5,22
11,2003,400800,14,13,1,6
12,2003,400800,18,14,4,23
1,2004,400800,26,16,10,26
2,2004,400800,24,18,6,35
3,2004,400800,13,11,2,11
4,2004,400800,18,15,3,19
5,2004,400800,24,16,8,17
6,2004,400800,19,16,3,9
7,2004,400800,25,19,6,5
8,2004,400800,23,14,9,9
9,2004,400800,12,9,3,6
10,2004,400800,10,8,2,16
11,2004,400800,17,15,2,19
12,2004,400800,22,20,2,18
1,2005,400800,13,10,3,48
2,2005,400800,18,13,5,38
3,2005,400800,24,15,9,31
4,2005,400800,23,14,9,14
5,2005,400800,25,21,4,26
6,2005,400800,29,18,11,41
7,2005,400800,21,17,4,22
8,2005,400800,23,18,5,28
9,2005,400800,21,16,5,16
10,2005,400800,42,33,9,21
11,2005,400800,30,23,7,28
12,2005,400800,13,10,3,138
1,2006,400800,23,13,10,51
2,2006,400800,15,15,0,77
3,2006,400800,16,15,1,12
4,2006,400800,19,14,5,9
5,2006,400800,31,26,5,4
6,2006,400800,24,22,2,9
7,2006,400800,31,29,2,11
8,2006,400800,41,34,7,8
9,2006,400800,29,29,0,5
10,2006,400800,24,24,0,8
11,2006,400800,18,18,0,5
12,2006,400800,23,18,5,11
1,2007,400800,19,16,3,5
2,2007,400800,5,4,1,9
3,2007,400800,13,9,4,8
4,2007,400800,11,9,2,3
5,2007,400800,28,22,6,4
6,2007,400800,31,23,8,2
7,2007,400800,20,15,5,4
8,2007,400800,25,19,6,9
9,2007,400800,24,20,4,3
10,2007,400800,21,19,2,6
11,2007,400800,18,13,5,4
12,2007,400800,12,9,3,4
1,2008,400800,14,11,3,3
2,2008,400800,14,10,4,4
3,2008,400800,12,10,2,4
4,2008,400800,13,11,2,3
5,2008,400800,18,15,3,1
6,2008,400800,24,21,3,4
7,2008,400800,22,18,4,8
8,2008,400800,22,15,7,8
9,2008,400800,28,19,9,8
10,2008,400800,27,21,6,11
11,2008,400800,21,20,1,4
12,2008,400800,13,10,3,2
1,2009,400800,12,11,1,7
2,2009,400800,7,5,2,4
3,2009,400800,13,9,4,5
4,2009,400800,16,12,4,7
5,2009,400800,13,8,5,5
6,2009,400800,20,14,6,3
7,2009,400800,19,17,2,4
8,2009,400800,14,10,4,9
9,2009,400800,17,13,4,6
10,2009,400800,27,24,3,7
11,2009,400800,18,15,3,9
12,2009,400800,18,17,1,7
1,2010,400800,15,11,4,7
2,2010,400800,10,7,3,9
3,2010,400800,16,12,4,13
4,2010,400800,17,10,7,3
5,2010,400800,19,18,1,11
6,2010,400800,23,19,4,3
7,2010,400800,15,10,5,5
8,2010,400800,19,15,4,3
9,2010,400800,23,19,4,9
10,2010,400800,22,16,6,9
11,2010,400800,27,23,4,4
12,2010,400800,8,8,0,5
1,2011,400800,12,11,1,5
2,2011,400800,5,2,3,3
1,1999,420600,9,4,5,14
2,1999,420600,17,15,2,15
3,1999,420600,19,13,6,15
4,1999,420600,21,13,8,16
5,1999,420600,23,21,2,9
6,1999,420600,32,22,10,12
7,1999,420600,32,26,6,12
8,1999,420600,22,15,7,11
9,1999,420600,20,16,4,11
10,1999,420600,12,8,4,12
11,1999,420600,15,10,5,11
12,1999,420600,15,12,3,5
1,2000,420600,18,15,3,9
2,2000,420600,12,7,5,13
3,2000,420600,25,19,6,9
4,2000,420600,21,13,8,13
5,2000,420600,19,11,8,10
6,2000,420600,32,28,4,10
7,2000,420600,27,19,8,8
8,2000,420600,24,19,5,5
9,2000,420600,24,19,5,15
10,2000,420600,28,21,7,4
11,2000,420600,11,8,3,13
12,2000,420600,13,10,3,12
1,2001,420600,15,13,2,12
2,2001,420600,17,15,2,14
3,2001,420600,18,11,7,27
4,2001,420600,36,25,11,15
5,2001,420600,23,17,6,13
6,2001,420600,21,14,7,21
7,2001,420600,39,29,10,22
8,2001,420600,32,27,5,11
9,2001,420600,16,7,9,29
10,2001,420600,14,10,4,23
11,2001,420600,14,11,3,21
12,2001,420600,13,10,3,21
1,2002,420600,16,14,2,24
2,2002,420600,16,11,5,25
3,2002,420600,16,11,5,23
4,2002,420600,23,16,7,16
5,2002,420600,17,9,8,12
6,2002,420600,17,12,5,34
7,2002,420600,20,16,4,18
8,2002,420600,19,13,6,6
9,2002,420600,24,18,6,11
10,2002,420600,19,17,2,12
11,2002,420600,21,17,4,14
12,2002,420600,13,12,1,17
1,2003,420600,17,14,3,9
2,2003,420600,10,8,2,14
3,2003,420600,15,11,4,16
4,2003,420600,18,15,3,17
5,2003,420600,14,12,2,22
6,2003,420600,22,16,6,29
7,2003,420600,24,14,10,24
8,2003,420600,24,17,7,18
9,2003,420600,18,14,4,22
10,2003,420600,23,21,2,14
11,2003,420600,18,14,4,13
12,2003,420600,15,10,5,12
1,2004,420600,12,7,5,6
2,2004,420600,5,3,2,6
3,2004,420600,10,7,3,9
4,2004,420600,14,7,7,5
5,2004,420600,14,7,7,5
6,2004,420600,15,7,8,19
7,2004,420600,9,8,1,9
8,2004,420600,13,11,2,12
9,2004,420600,24,18,6,9
10,2004,420600,13,9,4,10
11,2004,420600,12,8,4,11
12,2004,420600,11,9,2,14
1,2005,420600,7,7,0,16
2,2005,420600,20,16,4,14
3,2005,420600,11,7,4,6
4,2005,420600,17,11,6,6
5,2005,420600,17,13,4,36
6,2005,420600,16,12,4,6
7,2005,420600,24,20,4,16
8,2005,420600,30,18,12,6
9,2005,420600,15,11,4,17
10,2005,420600,18,13,5,10
11,2005,420600,16,9,7,3
12,2005,420600,12,11,1,14
1,2006,420600,20,15,5,10
2,2006,420600,15,12,3,29
3,2006,420600,14,12,2,8
4,2006,420600,16,12,4,37
5,2006,420600,12,10,2,4
6,2006,420600,17,12,5,6
7,2006,420600,19,13,6,6
8,2006,420600,33,25,8,8
9,2006,420600,23,19,4,5
10,2006,420600,25,25,0,10
11,2006,420600,13,10,3,14
12,2006,420600,13,11,2,8
1,2007,420600,16,12,4,10
2,2007,420600,12,11,1,5
3,2007,420600,12,10,2,10
4,2007,420600,22,18,4,7
5,2007,420600,29,18,11,9
6,2007,420600,26,20,6,14
7,2007,420600,22,16,6,9
8,2007,420600,25,23,2,14
9,2007,420600,29,23,6,16
10,2007,420600,15,11,4,13
11,2007,420600,19,18,1,6
12,2007,420600,18,15,3,6
1,2008,420600,17,17,0,15
2,2008,420600,9,8,1,4
3,2008,420600,21,18,3,6
4,2008,420600,12,10,2,3
5,2008,420600,22,18,4,14
6,2008,420600,30,28,2,10
7,2008,420600,34,30,4,11
8,2008,420600,23,19,4,12
9,2008,420600,23,14,9,14
10,2008,420600,29,26,3,19
11,2008,420600,20,16,4,10
12,2008,420600,21,18,3,8
1,2009,420600,14,13,1,4
2,2009,420600,13,12,1,12
3,2009,420600,21,16,5,4
4,2009,420600,20,10,10,12
5,2009,420600,11,9,2,4
6,2009,420600,21,17,4,3
7,2009,420600,20,17,3,7
8,2009,420600,31,21,10,11
9,2009,420600,27,25,2,2
10,2009,420600,24,22,2,2
11,2009,420600,15,12,3,10
12,2009,420600,9,7,2,3
1,2010,420600,13,10,3,18
2,2010,420600,9,9,0,9
3,2010,420600,22,16,6,9
4,2010,420600,18,13,5,13
5,2010,420600,18,13,5,4
6,2010,420600,17,14,3,8
7,2010,420600,24,18,6,10
8,2010,420600,17,14,3,13
9,2010,420600,18,16,2,6
10,2010,420600,24,22,2,12
11,2010,420600,12,11,1,3
12,2010,420600,26,22,4,9
1,2011,420600,8,7,1,5
2,2011,420600,6,3,3,6
1,1999,420500,15,11,4,2
2,1999,420500,15,14,1,14
3,1999,420500,7,6,1,6
4,1999,420500,14,12,2,9
5,1999,420500,20,12,8,3
6,1999,420500,12,9,3,11
7,1999,420500,18,14,4,6
8,1999,420500,28,19,9,10
9,1999,420500,25,21,4,6
10,1999,420500,25,19,6,4
11,1999,420500,22,15,7,3
12,1999,420500,18,15,3,8
1,2000,420500,13,8,5,1
2,2000,420500,18,14,4,4
3,2000,420500,34,23,11,1
4,2000,420500,18,13,5,2
5,2000,420500,23,15,8,1
6,2000,420500,11,6,5,9
7,2000,420500,26,23,3,5
8,2000,420500,32,26,6,2
9,2000,420500,22,18,4,5
10,2000,420500,23,17,6,4
11,2000,420500,26,22,4,4
12,2000,420500,17,12,5,2
1,2001,420500,21,15,6,3
2,2001,420500,9,4,5,6
3,2001,420500,22,13,9,9
4,2001,420500,26,19,7,6
5,2001,420500,23,14,9,9
6,2001,420500,16,13,3,12
7,2001,420500,23,19,4,4
8,2001,420500,21,19,2,6
9,2001,420500,21,18,3,4
10,2001,420500,18,14,4,3
11,2001,420500,17,16,1,9
12,2001,420500,20,15,5,10
1,2002,420500,12,5,7,29
2,2002,420500,19,17,2,18
3,2002,420500,15,11,4,15
4,2002,420500,28,22,6,28
5,2002,420500,30,21,9,52
6,2002,420500,29,18,11,24
7,2002,420500,29,23,6,13
8,2002,420500,22,14,8,23
9,2002,420500,33,24,9,20
10,2002,420500,20,12,8,24
11,2002,420500,19,16,3,20
12,2002,420500,22,16,6,17
1,2003,420500,19,14,5,12
2,2003,420500,17,14,3,24
3,2003,420500,27,22,5,7
4,2003,420500,26,19,7,12
5,2003,420500,30,27,3,12
6,2003,420500,23,17,6,15
7,2003,420500,31,25,6,13
8,2003,420500,25,23,2,10
9,2003,420500,26,20,6,13
10,2003,420500,34,27,7,16
11,2003,420500,26,18,8,12
12,2003,420500,16,12,4,15
1,2004,420500,30,20,10,19
2,2004,420500,21,18,3,13
3,2004,420500,24,21,3,10
4,2004,420500,16,11,5,8
5,2004,420500,28,21,7,12
6,2004,420500,29,18,11,20
7,2004,420500,19,12,7,9
8,2004,420500,31,24,7,34
9,2004,420500,22,14,8,11
10,2004,420500,21,15,6,12
11,2004,420500,11,9,2,22
12,2004,420500,14,11,3,26
1,2005,420500,13,13,0,12
2,2005,420500,21,16,5,16
3,2005,420500,18,13,5,15
4,2005,420500,19,15,4,18
5,2005,420500,16,9,7,18
6,2005,420500,27,15,12,4
7,2005,420500,38,30,8,8
8,2005,420500,49,40,9,18
9,2005,420500,31,26,5,12
10,2005,420500,29,17,12,13
11,2005,420500,32,28,4,15
12,2005,420500,21,14,7,12
1,2006,420500,26,21,5,24
2,2006,420500,13,10,3,27
3,2006,420500,22,20,2,12
4,2006,420500,17,16,1,12
5,2006,420500,45,34,11,8
6,2006,420500,24,18,6,18
7,2006,420500,35,27,8,6
8,2006,420500,34,24,10,5
9,2006,420500,24,17,7,9
10,2006,420500,31,25,6,5
11,2006,420500,26,23,3,13
12,2006,420500,22,18,4,17
1,2007,420500,25,20,5,10
2,2007,420500,10,8,2,5
3,2007,420500,21,17,4,12
4,2007,420500,22,15,7,9
5,2007,420500,28,23,5,15
6,2007,420500,24,21,3,9
7,2007,420500,25,21,4,6
8,2007,420500,31,20,11,9
9,2007,420500,38,22,16,22
10,2007,420500,26,21,5,16
11,2007,420500,10,7,3,10
12,2007,420500,17,12,5,6
1,2008,420500,11,6,5,3
2,2008,420500,12,8,4,3
3,2008,420500,24,16,8,4
4,2008,420500,20,13,7,7
5,2008,420500,22,21,1,6
6,2008,420500,17,9,8,11
7,2008,420500,22,19,3,10
8,2008,420500,22,14,8,14
9,2008,420500,18,16,2,11
10,2008,420500,21,16,5,16
11,2008,420500,20,15,5,6
12,2008,420500,17,11,6,9
1,2009,420500,17,12,5,5
2,2009,420500,12,7,5,2
3,2009,420500,19,12,7,3
4,2009,420500,17,12,5,11
5,2009,420500,18,12,6,7
6,2009,420500,24,14,10,5
7,2009,420500,16,10,6,12
8,2009,420500,25,16,9,10
9,2009,420500,18,13,5,9
10,2009,420500,24,20,4,3
11,2009,420500,9,8,1,7
12,2009,420500,8,6,2,6
1,2010,420500,7,5,2,9
2,2010,420500,12,6,6,6
3,2010,420500,11,8,3,7
4,2010,420500,19,11,8,8
5,2010,420500,18,13,5,3
6,2010,420500,22,18,4,4
7,2010,420500,21,17,4,2
8,2010,420500,19,12,7,8
9,2010,420500,12,9,3,8
10,2010,420500,12,11,1,7
11,2010,420500,18,15,3,7
12,2010,420500,12,11,1,6
1,2011,420500,13,11,2,5
2,2011,420500,10,6,4,3
1,1999,420400,10,8,2,0
2,1999,420400,12,12,0,0
3,1999,420400,16,14,2,0
4,1999,420400,8,8,0,0
5,1999,420400,11,11,0,2
6,1999,420400,10,10,0,0
7,1999,420400,15,14,1,1
8,1999,420400,8,8,0,2
9,1999,420400,16,11,5,4
10,1999,420400,11,10,1,1
11,1999,420400,11,10,1,0
12,1999,420400,8,8,0,1
1,2000,420400,7,5,2,4
2,2000,420400,7,6,1,0
3,2000,420400,9,8,1,0
4,2000,420400,11,10,1,1
5,2000,420400,16,15,1,0
6,2000,420400,12,6,6,1
7,2000,420400,14,12,2,0
8,2000,420400,10,9,1,2
9,2000,420400,15,15,0,1
10,2000,420400,9,8,1,2
11,2000,420400,19,18,1,0
12,2000,420400,4,3,1,1
1,2001,420400,9,9,0,1
2,2001,420400,10,8,2,0
3,2001,420400,13,11,2,0
4,2001,420400,12,11,1,2
5,2001,420400,8,7,1,2
6,2001,420400,11,10,1,1
7,2001,420400,15,13,2,2
8,2001,420400,13,12,1,2
9,2001,420400,10,9,1,1
10,2001,420400,17,16,1,1
11,2001,420400,16,13,3,0
12,2001,420400,8,7,1,1
1,2002,420400,11,9,2,1
2,2002,420400,6,6,0,0
3,2002,420400,13,12,1,2
4,2002,420400,5,5,0,1
5,2002,420400,10,8,2,1
6,2002,420400,7,4,3,1
7,2002,420400,12,10,2,7
8,2002,420400,7,6,1,1
9,2002,420400,11,9,2,1
10,2002,420400,4,3,1,2
11,2002,420400,9,5,4,0
12,2002,420400,7,5,2,0
1,2003,420400,10,10,0,0
2,2003,420400,5,5,0,0
3,2003,420400,11,9,2,2
4,2003,420400,16,15,1,5
5,2003,420400,4,4,0,0
6,2003,420400,6,4,2,2
7,2003,420400,10,8,2,0
8,2003,420400,5,5,0,0
9,2003,420400,11,11,0,0
10,2003,420400,13,12,1,1
11,2003,420400,15,14,1,0
12,2003,420400,9,9,0,1
1,2004,420400,15,13,2,0
2,2004,420400,4,3,1,0
3,2004,420400,8,8,0,3
4,2004,420400,8,8,0,1
5,2004,420400,7,7,0,1
6,2004,420400,10,10,0,0
7,2004,420400,11,5,6,1
8,2004,420400,4,3,1,4
9,2004,420400,19,17,2,0
10,2004,420400,8,6,2,1
11,2004,420400,8,8,0,0
12,2004,420400,9,9,0,3
1,2005,420400,4,4,0,3
2,2005,420400,9,8,1,0
3,2005,420400,6,5,1,2
4,2005,420400,10,9,1,2
5,2005,420400,8,7,1,3
6,2005,420400,6,6,0,3
7,2005,420400,12,12,0,1
8,2005,420400,12,11,1,2
9,2005,420400,12,10,2,0
10,2005,420400,10,9,1,1
11,2005,420400,11,9,2,0
12,2005,420400,7,7,0,0
1,2006,420400,8,7,1,1
2,2006,420400,1,1,0,0
3,2006,420400,12,11,1,1
4,2006,420400,8,8,0,1
5,2006,420400,5,2,3,0
6,2006,420400,11,10,1,7
7,2006,420400,9,5,4,3
8,2006,420400,11,10,1,2
9,2006,420400,7,7,0,0
10,2006,420400,12,12,0,0
11,2006,420400,7,7,0,3
12,2006,420400,15,14,1,1
1,2007,420400,5,5,0,0
2,2007,420400,6,5,1,1
3,2007,420400,4,4,0,1
4,2007,420400,5,5,0,1
5,2007,420400,6,6,0,0
6,2007,420400,12,11,1,4
7,2007,420400,10,9,1,4
8,2007,420400,10,7,3,1
9,2007,420400,5,5,0,2
10,2007,420400,12,11,1,2
11,2007,420400,5,3,2,2
12,2007,420400,1,1,0,0
1,2008,420400,0,0,0,0
2,2008,420400,4,3,1,1
3,2008,420400,6,6,0,0
4,2008,420400,5,2,3,1
5,2008,420400,5,5,0,0
6,2008,420400,10,9,1,0
7,2008,420400,4,2,2,1
8,2008,420400,15,15,0,0
9,2008,420400,6,5,1,0
10,2008,420400,15,12,3,1
11,2008,420400,9,9,0,0
12,2008,420400,0,0,0,1
1,2009,420400,5,4,1,1
2,2009,420400,5,3,2,1
3,2009,420400,4,3,1,0
4,2009,420400,5,5,0,2
5,2009,420400,5,5,0,0
6,2009,420400,7,5,2,0
7,2009,420400,6,6,0,2
8,2009,420400,8,7,1,2
9,2009,420400,15,13,2,3
10,2009,420400,9,8,1,3
11,2009,420400,10,10,0,0
12,2009,420400,8,7,1,1
1,2010,420400,6,6,0,0
2,2010,420400,1,1,0,0
3,2010,420400,2,2,0,1
4,2010,420400,4,4,0,0
5,2010,420400,5,4,1,1
6,2010,420400,11,9,2,0
7,2010,420400,7,6,1,1
8,2010,420400,13,12,1,3
9,2010,420400,6,5,1,1
10,2010,420400,3,3,0,1
11,2010,420400,11,11,0,5
12,2010,420400,8,8,0,1
1,2011,420400,4,4,0,1
2,2011,420400,5,5,0,0
1,1999,420300,11,7,4,0
2,1999,420300,8,8,0,2
3,1999,420300,11,8,3,0
4,1999,420300,7,6,1,0
5,1999,420300,9,7,2,0
6,1999,420300,12,11,1,0
7,1999,420300,8,7,1,1
8,1999,420300,12,10,2,0
9,1999,420300,13,11,2,0
10,1999,420300,15,12,3,0
11,1999,420300,7,7,0,0
12,1999,420300,4,2,2,0
1,2000,420300,4,2,2,0
2,2000,420300,6,5,1,0
3,2000,420300,5,3,2,0
4,2000,420300,6,6,0,2
5,2000,420300,11,10,1,1
6,2000,420300,9,9,0,0
7,2000,420300,7,4,3,1
8,2000,420300,11,10,1,0
9,2000,420300,14,12,2,1
10,2000,420300,12,10,2,1
11,2000,420300,9,7,2,2
12,2000,420300,9,9,0,0
1,2001,420300,11,8,3,0
2,2001,420300,5,5,0,0
3,2001,420300,6,5,1,3
4,2001,420300,10,9,1,0
5,2001,420300,12,10,2,0
6,2001,420300,17,15,2,2
7,2001,420300,18,17,1,2
8,2001,420300,11,10,1,0
9,2001,420300,16,15,1,1
10,2001,420300,7,7,0,0
11,2001,420300,8,8,0,0
12,2001,420300,8,7,1,0
1,2002,420300,5,4,1,1
2,2002,420300,4,3,1,0
3,2002,420300,5,4,1,0
4,2002,420300,8,8,0,0
5,2002,420300,8,8,0,0
6,2002,420300,14,14,0,1
7,2002,420300,7,7,0,1
8,2002,420300,4,3,1,0
9,2002,420300,4,4,0,1
10,2002,420300,6,4,2,0
11,2002,420300,5,4,1,0
12,2002,420300,10,10,0,0
1,2003,420300,10,10,0,0
2,2003,420300,5,5,0,0
3,2003,420300,6,6,0,0
4,2003,420300,13,12,1,2
5,2003,420300,8,7,1,0
6,2003,420300,4,4,0,0
7,2003,420300,4,2,2,0
8,2003,420300,7,5,2,3
9,2003,420300,11,11,0,0
10,2003,420300,7,5,2,1
11,2003,420300,8,7,1,0
12,2003,420300,10,8,2,0
1,2004,420300,14,14,0,0
2,2004,420300,5,4,1,1
3,2004,420300,9,8,1,0
4,2004,420300,11,10,1,0
5,2004,420300,8,4,4,1
6,2004,420300,9,8,1,0
7,2004,420300,8,8,0,1
8,2004,420300,11,11,0,2
9,2004,420300,6,6,0,1
10,2004,420300,11,11,0,0
11,2004,420300,7,6,1,0
12,2004,420300,7,6,1,1
1,2005,420300,6,5,1,0
2,2005,420300,6,4,2,0
3,2005,420300,2,2,0,0
4,2005,420300,10,7,3,0
5,2005,420300,8,8,0,0
6,2005,420300,7,7,0,0
7,2005,420300,6,6,0,0
8,2005,420300,15,14,1,1
9,2005,420300,2,2,0,0
10,2005,420300,7,7,0,0
11,2005,420300,5,5,0,0
12,2005,420300,5,5,0,0
1,2006,420300,8,7,1,0
2,2006,420300,2,1,1,0
3,2006,420300,3,3,0,0
4,2006,420300,5,5,0,0
5,2006,420300,5,5,0,0
6,2006,420300,3,3,0,0
7,2006,420300,3,3,0,0
8,2006,420300,7,6,1,0
9,2006,420300,7,4,3,1
10,2006,420300,2,2,0,1
11,2006,420300,0,0,0,1
12,2006,420300,3,3,0,0
1,2007,420300,3,2,1,0
2,2007,420300,6,5,1,0
3,2007,420300,3,3,0,0
4,2007,420300,11,11,0,2
5,2007,420300,15,14,1,0
6,2007,420300,8,6,2,0
7,2007,420300,5,2,3,0
8,2007,420300,7,6,1,1
9,2007,420300,2,1,1,2
10,2007,420300,6,6,0,1
11,2007,420300,7,6,1,1
12,2007,420300,1,1,0,0
1,2008,420300,4,4,0,0
2,2008,420300,11,11,0,0
3,2008,420300,8,6,2,0
4,2008,420300,6,6,0,1
5,2008,420300,10,10,0,0
6,2008,420300,4,4,0,0
7,2008,420300,9,9,0,0
8,2008,420300,12,11,1,0
9,2008,420300,13,11,2,0
10,2008,420300,4,4,0,0
11,2008,420300,4,3,1,0
12,2008,420300,5,5,0,1
1,2009,420300,3,3,0,1
2,2009,420300,5,5,0,0
3,2009,420300,4,4,0,0
4,2009,420300,6,6,0,0
5,2009,420300,9,9,0,1
6,2009,420300,3,3,0,0
7,2009,420300,8,7,1,0
8,2009,420300,2,2,0,1
9,2009,420300,10,10,0,0
10,2009,420300,11,10,1,0
11,2009,420300,11,11,0,0
12,2009,420300,2,2,0,0
1,2010,420300,4,4,0,0
2,2010,420300,1,1,0,0
3,2010,420300,8,4,4,0
4,2010,420300,5,4,1,1
5,2010,420300,7,7,0,0
6,2010,420300,4,4,0,1
7,2010,420300,6,4,2,0
8,2010,420300,7,7,0,0
9,2010,420300,3,3,0,0
10,2010,420300,3,3,0,1
11,2010,420300,5,5,0,0
12,2010,420300,4,3,1,0
1,2011,420300,3,2,1,0
2,2011,420300,0,0,0,2
1,1999,660302,21,20,1,3
2,1999,660302,12,12,0,10
3,1999,660302,18,18,0,6
4,1999,660302,18,15,3,4
5,1999,660302,16,13,3,7
6,1999,660302,35,34,1,4
7,1999,660302,17,16,1,2
8,1999,660302,22,21,1,1
9,1999,660302,22,21,1,3
10,1999,660302,24,20,4,6
11,1999,660302,20,18,2,1
12,1999,660302,19,17,2,8
1,2000,660302,18,16,2,14
2,2000,660302,14,12,2,6
3,2000,660302,15,11,4,10
4,2000,660302,19,18,1,6
5,2000,660302,25,23,2,9
6,2000,660302,29,22,7,9
7,2000,660302,37,32,5,9
8,2000,660302,25,20,5,3
9,2000,660302,25,21,4,6
10,2000,660302,27,19,8,9
11,2000,660302,20,17,3,2
12,2000,660302,22,16,6,1
1,2001,660302,28,25,3,7
2,2001,660302,17,16,1,4
3,2001,660302,12,10,2,11
4,2001,660302,29,24,5,13
5,2001,660302,23,20,3,5
6,2001,660302,30,26,4,3
7,2001,660302,40,35,5,2
8,2001,660302,22,14,8,5
9,2001,660302,35,26,9,6
10,2001,660302,29,26,3,6
11,2001,660302,34,32,2,0
12,2001,660302,24,20,4,3
1,2002,660302,43,40,3,5
2,2002,660302,16,14,2,6
3,2002,660302,28,23,5,0
4,2002,660302,23,21,2,4
5,2002,660302,30,20,10,6
6,2002,660302,35,28,7,7
7,2002,660302,27,24,3,9
8,2002,660302,37,32,5,3
9,2002,660302,33,27,6,4
10,2002,660302,22,16,6,8
11,2002,660302,25,23,2,3
12,2002,660302,31,30,1,6
1,2003,660302,26,25,1,10
2,2003,660302,28,25,3,16
3,2003,660302,20,18,2,11
4,2003,660302,20,17,3,4
5,2003,660302,26,20,6,7
6,2003,660302,17,17,0,16
7,2003,660302,44,38,6,11
8,2003,660302,30,20,10,6
9,2003,660302,22,21,1,8
10,2003,660302,32,25,7,11
11,2003,660302,30,30,0,7
12,2003,660302,24,21,3,3
1,2004,660302,29,27,2,3
2,2004,660302,23,23,0,12
3,2004,660302,20,16,4,2
4,2004,660302,24,19,5,2
5,2004,660302,30,22,8,2
6,2004,660302,18,15,3,6
7,2004,660302,21,16,5,6
8,2004,660302,28,23,5,2
9,2004,660302,28,25,3,10
10,2004,660302,25,23,2,7
11,2004,660302,18,12,6,3
12,2004,660302,18,18,0,9
1,2005,660302,19,15,4,2
2,2005,660302,17,14,3,7
3,2005,660302,17,16,1,4
4,2005,660302,18,13,5,8
5,2005,660302,33,28,5,5
6,2005,660302,23,19,4,5
7,2005,660302,23,20,3,2
8,2005,660302,20,19,1,15
9,2005,660302,34,30,4,7
10,2005,660302,31,23,8,9
11,2005,660302,24,17,7,7
12,2005,660302,19,18,1,4
1,2006,660302,31,26,5,11
2,2006,660302,17,14,3,7
3,2006,660302,12,8,4,8
4,2006,660302,19,14,5,9
5,2006,660302,18,12,6,3
6,2006,660302,16,11,5,9
7,2006,660302,19,14,5,7
8,2006,660302,38,35,3,5
9,2006,660302,15,11,4,1
10,2006,660302,27,26,1,10
11,2006,660302,20,18,2,8
12,2006,660302,15,13,2,2
1,2007,660302,14,10,4,1
2,2007,660302,16,13,3,6
3,2007,660302,18,14,4,14
4,2007,660302,25,19,6,11
5,2007,660302,19,13,6,9
6,2007,660302,31,23,8,8
7,2007,660302,26,21,5,7
8,2007,660302,22,16,6,6
9,2007,660302,25,17,8,8
10,2007,660302,29,23,6,5
11,2007,660302,31,27,4,6
12,2007,660302,23,20,3,9
1,2008,660302,24,20,4,9
2,2008,660302,13,11,2,12
3,2008,660302,13,12,1,23
4,2008,660302,20,20,0,7
5,2008,660302,30,26,4,14
6,2008,660302,18,15,3,13
7,2008,660302,25,23,2,11
8,2008,660302,34,31,3,7
9,2008,660302,20,16,4,4
10,2008,660302,24,22,2,8
11,2008,660302,25,22,3,8
12,2008,660302,20,13,7,8
1,2009,660302,15,11,4,5
2,2009,660302,7,6,1,6
3,2009,660302,15,14,1,11
4,2009,660302,12,9,3,13
5,2009,660302,16,15,1,7
6,2009,660302,29,26,3,5
7,2009,660302,30,24,6,10
8,2009,660302,14,11,3,4
9,2009,660302,17,12,5,12
10,2009,660302,25,22,3,9
11,2009,660302,26,23,3,5
12,2009,660302,17,17,0,3
1,2010,660302,23,21,2,12
2,2010,660302,14,13,1,4
3,2010,660302,18,14,4,3
4,2010,660302,27,25,2,2
5,2010,660302,35,30,5,7
6,2010,660302,30,27,3,8
7,2010,660302,28,25,3,5
8,2010,660302,18,15,3,6
9,2010,660302,26,24,2,6
10,2010,660302,27,24,3,6
11,2010,660302,27,27,0,3
12,2010,660302,23,22,1,4
1,2011,660302,16,13,3,7
2,2011,660302,15,14,1,3
1,1999,834500,21,10,11,6
2,1999,834500,15,10,5,3
3,1999,834500,19,13,6,4
4,1999,834500,32,27,5,9
5,1999,834500,36,24,12,9
6,1999,834500,35,26,9,7
7,1999,834500,50,39,11,6
8,1999,834500,38,29,9,6
9,1999,834500,39,29,10,8
10,1999,834500,24,17,7,7
11,1999,834500,24,16,8,5
12,1999,834500,28,22,6,6
1,2000,834500,16,16,0,3
2,2000,834500,22,20,2,3
3,2000,834500,15,13,2,7
4,2000,834500,29,26,3,5
5,2000,834500,22,14,8,9
6,2000,834500,27,16,11,7
7,2000,834500,26,18,8,1
8,2000,834500,34,24,10,8
9,2000,834500,23,18,5,10
10,2000,834500,29,23,6,11
11,2000,834500,25,18,7,10
12,2000,834500,11,9,2,1
1,2001,834500,19,12,7,8
2,2001,834500,23,16,7,15
3,2001,834500,26,15,11,8
4,2001,834500,22,14,8,6
5,2001,834500,35,29,6,12
6,2001,834500,23,20,3,9
7,2001,834500,32,20,12,5
8,2001,834500,28,21,7,10
9,2001,834500,17,12,5,3
10,2001,834500,22,14,8,10
11,2001,834500,18,12,6,13
12,2001,834500,21,14,7,14
1,2002,834500,20,16,4,6
2,2002,834500,15,14,1,7
3,2002,834500,15,8,7,7
4,2002,834500,15,10,5,5
5,2002,834500,20,14,6,10
6,2002,834500,23,14,9,9
7,2002,834500,21,14,7,5
8,2002,834500,31,20,11,3
9,2002,834500,20,16,4,3
10,2002,834500,23,17,6,2
11,2002,834500,15,14,1,6
12,2002,834500,17,14,3,3
1,2003,834500,14,10,4,4
2,2003,834500,15,11,4,2
3,2003,834500,22,13,9,3
4,2003,834500,17,12,5,8
5,2003,834500,21,15,6,4
6,2003,834500,22,19,3,7
7,2003,834500,30,25,5,7
8,2003,834500,13,10,3,5
9,2003,834500,24,17,7,9
10,2003,834500,22,14,8,4
11,2003,834500,31,24,7,9
12,2003,834500,34,28,6,10
1,2004,834500,17,14,3,6
2,2004,834500,18,15,3,19
3,2004,834500,30,25,5,5
4,2004,834500,35,27,8,6
5,2004,834500,17,8,9,7
6,2004,834500,19,14,5,7
7,2004,834500,23,16,7,3
8,2004,834500,21,18,3,7
9,2004,834500,24,16,8,5
10,2004,834500,24,16,8,13
11,2004,834500,22,16,6,9
12,2004,834500,20,16,4,14
1,2005,834500,21,20,1,5
2,2005,834500,10,9,1,13
3,2005,834500,18,13,5,6
4,2005,834500,21,18,3,4
5,2005,834500,16,11,5,19
6,2005,834500,17,12,5,7
7,2005,834500,27,22,5,8
8,2005,834500,39,29,10,7
9,2005,834500,21,13,8,12
10,2005,834500,26,22,4,7
11,2005,834500,14,11,3,6
12,2005,834500,19,16,3,4
1,2006,834500,19,15,4,6
2,2006,834500,19,15,4,4
3,2006,834500,16,14,2,3
4,2006,834500,22,15,7,7
5,2006,834500,16,10,6,11
6,2006,834500,24,17,7,2
7,2006,834500,28,24,4,1
8,2006,834500,22,18,4,4
9,2006,834500,28,20,8,2
10,2006,834500,28,18,10,8
11,2006,834500,24,20,4,1
12,2006,834500,21,18,3,8
1,2007,834500,11,10,1,8
2,2007,834500,10,7,3,6
3,2007,834500,19,15,4,5
4,2007,834500,14,11,3,3
5,2007,834500,34,28,6,5
6,2007,834500,33,27,6,3
7,2007,834500,33,23,10,6
8,2007,834500,34,23,11,6
9,2007,834500,12,11,1,9
10,2007,834500,16,15,1,5
11,2007,834500,16,13,3,6
12,2007,834500,15,11,4,3
1,2008,834500,8,6,2,15
2,2008,834500,12,9,3,2
3,2008,834500,18,15,3,4
4,2008,834500,16,13,3,1
5,2008,834500,17,12,5,5
6,2008,834500,18,10,8,5
7,2008,834500,22,18,4,10
8,2008,834500,24,18,6,9
9,2008,834500,30,25,5,3
10,2008,834500,18,16,2,9
11,2008,834500,10,8,2,3
12,2008,834500,20,19,1,4
1,2009,834500,8,7,1,3
2,2009,834500,8,5,3,7
3,2009,834500,12,10,2,14
4,2009,834500,19,15,4,10
5,2009,834500,12,10,2,12
6,2009,834500,22,17,5,12
7,2009,834500,17,13,4,5
8,2009,834500,21,19,2,11
9,2009,834500,16,13,3,8
10,2009,834500,20,13,7,10
11,2009,834500,8,6,2,7
12,2009,834500,11,6,5,4
1,2010,834500,13,12,1,9
2,2010,834500,9,8,1,8
3,2010,834500,24,19,5,9
4,2010,834500,18,14,4,7
5,2010,834500,10,8,2,9
6,2010,834500,15,11,4,5
7,2010,834500,13,12,1,12
8,2010,834500,20,18,2,9
9,2010,834500,27,23,4,5
10,2010,834500,22,16,6,9
11,2010,834500,15,11,4,16
12,2010,834500,17,12,5,11
1,2011,834500,7,3,4,16
2,2011,834500,9,7,2,6
1,1999,561000,2,2,0,0
2,1999,561000,3,3,0,0
3,1999,561000,6,5,1,0
4,1999,561000,5,5,0,0
5,1999,561000,7,7,0,0
6,1999,561000,7,7,0,0
7,1999,561000,4,3,1,0
8,1999,561000,5,5,0,1
9,1999,561000,3,1,2,1
10,1999,561000,7,6,1,0
11,1999,561000,8,8,0,0
12,1999,561000,6,5,1,0
1,2000,561000,10,10,0,0
2,2000,561000,4,4,0,0
3,2000,561000,3,2,1,1
4,2000,561000,8,8,0,2
5,2000,561000,4,4,0,1
6,2000,561000,4,4,0,0
7,2000,561000,2,1,1,1
8,2000,561000,2,2,0,0
9,2000,561000,4,4,0,0
10,2000,561000,5,5,0,0
11,2000,561000,8,7,1,0
12,2000,561000,5,5,0,0
1,2001,561000,4,4,0,1
2,2001,561000,2,2,0,0
3,2001,561000,8,7,1,0
4,2001,561000,8,8,0,0
5,2001,561000,7,7,0,0
6,2001,561000,7,6,1,0
7,2001,561000,4,4,0,0
8,2001,561000,3,3,0,0
9,2001,561000,7,7,0,0
10,2001,561000,4,4,0,0
11,2001,561000,6,6,0,0
12,2001,561000,8,8,0,0
1,2002,561000,1,1,0,1
2,2002,561000,3,3,0,0
3,2002,561000,10,9,1,0
4,2002,561000,7,5,2,0
5,2002,561000,13,13,0,0
6,2002,561000,7,6,1,0
7,2002,561000,8,6,2,0
8,2002,561000,14,13,1,0
9,2002,561000,1,1,0,0
10,2002,561000,5,5,0,0
11,2002,561000,4,4,0,1
12,2002,561000,6,6,0,0
1,2003,561000,4,4,0,0
2,2003,561000,3,3,0,0
3,2003,561000,4,4,0,0
4,2003,561000,6,6,0,0
5,2003,561000,6,6,0,0
6,2003,561000,5,5,0,0
7,2003,561000,8,7,1,1
8,2003,561000,3,3,0,0
9,2003,561000,10,10,0,0
10,2003,561000,4,4,0,0
11,2003,561000,6,5,1,1
12,2003,561000,7,7,0,0
1,2004,561000,2,2,0,0
2,2004,561000,4,4,0,0
3,2004,561000,7,6,1,0
4,2004,561000,6,6,0,0
5,2004,561000,11,11,0,0
6,2004,561000,3,3,0,0
7,2004,561000,10,8,2,0
8,2004,561000,9,8,1,0
9,2004,561000,8,8,0,0
10,2004,561000,9,8,1,0
11,2004,561000,7,7,0,0
12,2004,561000,7,7,0,0
1,2005,561000,3,3,0,0
2,2005,561000,1,1,0,0
3,2005,561000,4,4,0,0
4,2005,561000,2,1,1,0
5,2005,561000,4,4,0,0
6,2005,561000,7,6,1,0
7,2005,561000,1,0,1,0
8,2005,561000,6,6,0,0
9,2005,561000,10,8,2,1
10,2005,561000,5,5,0,2
11,2005,561000,3,3,0,0
12,2005,561000,6,6,0,1
1,2006,561000,5,4,1,0
2,2006,561000,8,8,0,0
3,2006,561000,8,7,1,0
4,2006,561000,5,2,3,1
5,2006,561000,4,4,0,0
6,2006,561000,4,4,0,0
7,2006,561000,9,6,3,1
8,2006,561000,4,2,2,0
9,2006,561000,2,2,0,0
10,2006,561000,8,7,1,0
11,2006,561000,7,7,0,0
12,2006,561000,11,11,0,0
1,2007,561000,10,8,2,0
2,2007,561000,1,0,1,0
3,2007,561000,3,3,0,2
4,2007,561000,4,4,0,1
5,2007,561000,3,3,0,0
6,2007,561000,1,1,0,1
7,2007,561000,4,3,1,0
8,2007,561000,8,7,1,0
9,2007,561000,4,4,0,2
10,2007,561000,8,8,0,0
11,2007,561000,6,6,0,2
12,2007,561000,6,6,0,0
1,2008,561000,3,3,0,0
2,2008,561000,4,4,0,1
3,2008,561000,2,2,0,0
4,2008,561000,1,1,0,0
5,2008,561000,4,4,0,0
6,2008,561000,7,6,1,0
7,2008,561000,6,6,0,0
8,2008,561000,7,6,1,0
9,2008,561000,4,4,0,0
10,2008,561000,5,5,0,1
11,2008,561000,2,2,0,0
12,2008,561000,6,6,0,0
1,2009,561000,3,2,1,0
2,2009,561000,3,3,0,0
3,2009,561000,3,3,0,1
4,2009,561000,4,3,1,1
5,2009,561000,5,5,0,0
6,2009,561000,8,8,0,1
7,2009,561000,5,5,0,0
8,2009,561000,5,4,1,0
9,2009,561000,1,1,0,0
10,2009,561000,8,8,0,0
11,2009,561000,4,4,0,0
12,2009,561000,3,3,0,1
1,2010,561000,4,3,1,0
2,2010,561000,4,4,0,0
3,2010,561000,3,3,0,0
4,2010,561000,4,4,0,1
5,2010,561000,7,6,1,0
6,2010,561000,3,3,0,0
7,2010,561000,7,6,1,0
8,2010,561000,6,5,1,2
9,2010,561000,11,10,1,0
10,2010,561000,5,4,1,0
11,2010,561000,0,0,0,0
12,2010,561000,6,6,0,1
1,2011,561000,1,1,0,2
2,2011,561000,6,6,0,0
1,1999,561100,10,10,0,2
2,1999,561100,8,8,0,3
3,1999,561100,4,4,0,2
4,1999,561100,3,3,0,4
5,1999,561100,3,3,0,1
6,1999,561100,4,4,0,0
7,1999,561100,6,5,1,0
8,1999,561100,8,8,0,0
9,1999,561100,8,8,0,5
10,1999,561100,12,12,0,0
11,1999,561100,2,2,0,6
12,1999,561100,5,5,0,5
1,2000,561100,16,16,0,0
2,2000,561100,7,7,0,2
3,2000,561100,9,8,1,1
4,2000,561100,10,10,0,1
5,2000,561100,10,10,0,5
6,2000,561100,4,4,0,1
7,2000,561100,11,10,1,0
8,2000,561100,4,4,0,1
9,2000,561100,6,5,1,0
10,2000,561100,9,9,0,0
11,2000,561100,12,10,2,4
12,2000,561100,8,7,1,3
1,2001,561100,5,5,0,0
2,2001,561100,7,7,0,1
3,2001,561100,9,9,0,4
4,2001,561100,8,7,1,0
5,2001,561100,9,9,0,0
6,2001,561100,5,5,0,2
7,2001,561100,11,9,2,0
8,2001,561100,12,10,2,0
9,2001,561100,12,11,1,0
10,2001,561100,5,5,0,1
11,2001,561100,13,12,1,0
12,2001,561100,5,5,0,0
1,2002,561100,11,10,1,0
2,2002,561100,8,8,0,2
3,2002,561100,11,11,0,3
4,2002,561100,6,6,0,1
5,2002,561100,7,7,0,0
6,2002,561100,9,7,2,0
7,2002,561100,8,8,0,0
8,2002,561100,12,12,0,0
9,2002,561100,7,7,0,2
10,2002,561100,5,5,0,0
11,2002,561100,8,6,2,1
12,2002,561100,10,10,0,4
1,2003,561100,12,11,1,5
2,2003,561100,8,8,0,2
3,2003,561100,12,10,2,2
4,2003,561100,7,7,0,6
5,2003,561100,14,12,2,5
6,2003,561100,15,14,1,0
7,2003,561100,11,10,1,0
8,2003,561100,7,7,0,0
9,2003,561100,10,10,0,3
10,2003,561100,9,7,2,2
11,2003,561100,6,5,1,3
12,2003,561100,6,5,1,2
1,2004,561100,7,6,1,3
2,2004,561100,5,5,0,4
3,2004,561100,9,9,0,3
4,2004,561100,8,8,0,2
5,2004,561100,8,8,0,0
6,2004,561100,9,8,1,0
7,2004,561100,6,6,0,1
8,2004,561100,12,12,0,1
9,2004,561100,3,3,0,4
10,2004,561100,15,15,0,2
11,2004,561100,17,17,0,6
12,2004,561100,12,11,1,2
1,2005,561100,7,7,0,1
2,2005,561100,6,5,1,3
3,2005,561100,9,9,0,5
4,2005,561100,2,2,0,2
5,2005,561100,14,13,1,3
6,2005,561100,7,6,1,1
7,2005,561100,9,7,2,0
8,2005,561100,8,7,1,1
9,2005,561100,11,9,2,2
10,2005,561100,9,9,0,2
11,2005,561100,10,7,3,0
12,2005,561100,8,6,2,2
1,2006,561100,6,5,1,3
2,2006,561100,6,6,0,7
3,2006,561100,8,6,2,5
4,2006,561100,7,5,2,1
5,2006,561100,9,8,1,3
6,2006,561100,11,8,3,4
7,2006,561100,7,6,1,3
8,2006,561100,10,10,0,3
9,2006,561100,19,18,1,6
10,2006,561100,5,5,0,3
11,2006,561100,7,6,1,1
12,2006,561100,9,9,0,0
1,2007,561100,16,14,2,6
2,2007,561100,4,3,1,1
3,2007,561100,5,5,0,3
4,2007,561100,7,7,0,5
5,2007,561100,6,5,1,1
6,2007,561100,10,10,0,0
7,2007,561100,11,11,0,2
8,2007,561100,9,9,0,1
9,2007,561100,4,4,0,4
10,2007,561100,6,5,1,4
11,2007,561100,10,9,1,1
12,2007,561100,6,6,0,1
1,2008,561100,7,7,0,1
2,2008,561100,6,6,0,3
3,2008,561100,10,9,1,2
4,2008,561100,13,12,1,1
5,2008,561100,6,4,2,1
6,2008,561100,7,7,0,1
7,2008,561100,5,5,0,2
8,2008,561100,9,8,1,0
9,2008,561100,8,6,2,0
10,2008,561100,9,9,0,1
11,2008,561100,11,11,0,1
12,2008,561100,11,10,1,1
1,2009,561100,5,5,0,0
2,2009,561100,7,5,2,3
3,2009,561100,14,13,1,1
4,2009,561100,9,8,1,2
5,2009,561100,10,9,1,2
6,2009,561100,7,7,0,2
7,2009,561100,4,3,1,0
8,2009,561100,6,6,0,1
9,2009,561100,7,6,1,4
10,2009,561100,10,10,0,3
11,2009,561100,8,8,0,1
12,2009,561100,2,2,0,5
1,2010,561100,5,5,0,2
2,2010,561100,4,3,1,6
3,2010,561100,5,5,0,3
4,2010,561100,4,3,1,7
5,2010,561100,9,8,1,6
6,2010,561100,4,3,1,2
7,2010,561100,8,7,1,2
8,2010,561100,5,5,0,1
9,2010,561100,6,6,0,2
10,2010,561100,10,8,2,2
11,2010,561100,4,3,1,3
12,2010,561100,4,2,2,1
1,2011,561100,2,2,0,2
2,2011,561100,0,0,0,2
1,1999,620300,18,18,0,0
2,1999,620300,12,11,1,4
3,1999,620300,19,19,0,2
4,1999,620300,19,18,1,1
5,1999,620300,17,16,1,1
6,1999,620300,20,18,2,0
7,1999,620300,11,9,2,1
8,1999,620300,13,13,0,0
9,1999,620300,18,17,1,2
10,1999,620300,25,24,1,1
11,1999,620300,12,12,0,1
12,1999,620300,20,19,1,4
1,2000,620300,17,16,1,1
2,2000,620300,23,22,1,1
3,2000,620300,16,15,1,1
4,2000,620300,19,18,1,1
5,2000,620300,18,17,1,0
6,2000,620300,24,22,2,2
7,2000,620300,23,20,3,1
8,2000,620300,18,18,0,0
9,2000,620300,21,20,1,1
10,2000,620300,11,11,0,2
11,2000,620300,17,16,1,2
12,2000,620300,20,19,1,4
1,2001,620300,19,18,1,1
2,2001,620300,14,12,2,1
3,2001,620300,11,10,1,3
4,2001,620300,10,10,0,1
5,2001,620300,23,21,2,0
6,2001,620300,18,18,0,0
7,2001,620300,28,25,3,0
8,2001,620300,16,16,0,2
9,2001,620300,16,15,1,1
10,2001,620300,23,21,2,2
11,2001,620300,23,20,3,2
12,2001,620300,18,18,0,6
1,2002,620300,16,13,3,0
2,2002,620300,17,17,0,3
3,2002,620300,11,10,1,2
4,2002,620300,24,23,1,4
5,2002,620300,24,21,3,1
6,2002,620300,23,22,1,5
7,2002,620300,27,27,0,0
8,2002,620300,30,28,2,1
9,2002,620300,22,21,1,2
10,2002,620300,25,24,1,0
11,2002,620300,20,20,0,0
12,2002,620300,21,19,2,2
1,2003,620300,22,21,1,1
2,2003,620300,15,13,2,4
3,2003,620300,14,12,2,4
4,2003,620300,20,19,1,3
5,2003,620300,26,23,3,4
6,2003,620300,20,20,0,3
7,2003,620300,23,22,1,0
8,2003,620300,28,24,4,1
9,2003,620300,14,13,1,2
10,2003,620300,20,17,3,1
11,2003,620300,34,31,3,1
12,2003,620300,26,25,1,0
1,2004,620300,15,12,3,1
2,2004,620300,15,14,1,0
3,2004,620300,7,7,0,2
4,2004,620300,17,15,2,3
5,2004,620300,24,22,2,1
6,2004,620300,24,23,1,1
7,2004,620300,19,18,1,1
8,2004,620300,34,34,0,2
9,2004,620300,22,19,3,1
10,2004,620300,26,24,2,2
11,2004,620300,17,16,1,0
12,2004,620300,14,14,0,1
1,2005,620300,19,16,3,0
2,2005,620300,15,14,1,1
3,2005,620300,18,16,2,0
4,2005,620300,23,21,2,0
5,2005,620300,19,15,4,2
6,2005,620300,19,17,2,0
7,2005,620300,21,17,4,3
8,2005,620300,20,20,0,2
9,2005,620300,15,15,0,4
10,2005,620300,18,15,3,3
11,2005,620300,17,16,1,2
12,2005,620300,15,13,2,1
1,2006,620300,18,15,3,4
2,2006,620300,16,16,0,3
3,2006,620300,23,20,3,1
4,2006,620300,21,19,2,1
5,2006,620300,15,15,0,5
6,2006,620300,18,15,3,5
7,2006,620300,28,26,2,2
8,2006,620300,13,12,1,1
9,2006,620300,12,10,2,2
10,2006,620300,24,22,2,1
11,2006,620300,15,12,3,2
12,2006,620300,15,13,2,4
1,2007,620300,10,10,0,2
2,2007,620300,12,10,2,3
3,2007,620300,15,12,3,3
4,2007,620300,18,17,1,2
5,2007,620300,17,14,3,2
6,2007,620300,13,13,0,1
7,2007,620300,20,19,1,1
8,2007,620300,23,21,2,1
9,2007,620300,22,18,4,6
10,2007,620300,16,13,3,1
11,2007,620300,14,13,1,3
12,2007,620300,12,11,1,1
1,2008,620300,12,11,1,0
2,2008,620300,16,13,3,8
3,2008,620300,14,13,1,2
4,2008,620300,18,14,4,1
5,2008,620300,13,12,1,2
6,2008,620300,22,22,0,0
7,2008,620300,22,20,2,0
8,2008,620300,34,32,2,2
9,2008,620300,30,28,2,4
10,2008,620300,27,25,2,5
11,2008,620300,27,26,1,4
12,2008,620300,33,30,3,4
1,2009,620300,23,23,0,1
2,2009,620300,30,27,3,4
3,2009,620300,26,25,1,3
4,2009,620300,17,17,0,0
5,2009,620300,26,26,0,0
6,2009,620300,16,14,2,3
7,2009,620300,24,23,1,2
8,2009,620300,25,24,1,0
9,2009,620300,20,19,1,1
10,2009,620300,18,15,3,1
11,2009,620300,25,25,0,5
12,2009,620300,17,17,0,5
1,2010,620300,17,17,0,1
2,2010,620300,17,16,1,3
3,2010,620300,17,17,0,3
4,2010,620300,19,16,3,4
5,2010,620300,17,17,0,4
6,2010,620300,17,12,5,4
7,2010,620300,15,13,2,1
8,2010,620300,13,12,1,1
9,2010,620300,22,20,2,0
10,2010,620300,24,23,1,5
11,2010,620300,23,22,1,1
12,2010,620300,16,16,0,1
1,2011,620300,8,8,0,3
2,2011,620300,7,7,0,4
1,1999,620400,10,9,1,0
2,1999,620400,3,3,0,0
3,1999,620400,7,6,1,0
4,1999,620400,5,4,1,0
5,1999,620400,6,4,2,0
6,1999,620400,12,12,0,1
7,1999,620400,10,9,1,4
8,1999,620400,11,11,0,3
9,1999,620400,8,7,1,0
10,1999,620400,6,5,1,1
11,1999,620400,9,6,3,0
12,1999,620400,6,6,0,0
1,2000,620400,12,10,2,0
2,2000,620400,6,4,2,1
3,2000,620400,6,6,0,2
4,2000,620400,9,8,1,0
5,2000,620400,15,15,0,1
6,2000,620400,5,3,2,0
7,2000,620400,9,8,1,0
8,2000,620400,12,12,0,0
9,2000,620400,14,13,1,0
10,2000,620400,7,5,2,0
11,2000,620400,11,10,1,2
12,2000,620400,11,11,0,0
1,2001,620400,5,5,0,0
2,2001,620400,7,5,2,0
3,2001,620400,5,5,0,0
4,2001,620400,9,7,2,0
5,2001,620400,12,12,0,1
6,2001,620400,5,4,1,1
7,2001,620400,5,4,1,3
8,2001,620400,7,5,2,0
9,2001,620400,13,13,0,3
10,2001,620400,14,13,1,0
11,2001,620400,13,11,2,0
12,2001,620400,9,8,1,2
1,2002,620400,9,7,2,0
2,2002,620400,5,2,3,0
3,2002,620400,11,9,2,0
4,2002,620400,11,9,2,1
5,2002,620400,11,11,0,0
6,2002,620400,11,10,1,0
7,2002,620400,14,14,0,0
8,2002,620400,9,8,1,1
9,2002,620400,10,8,2,2
10,2002,620400,9,7,2,1
11,2002,620400,13,11,2,0
12,2002,620400,11,11,0,0
1,2003,620400,6,6,0,1
2,2003,620400,5,4,1,2
3,2003,620400,12,9,3,6
4,2003,620400,15,13,2,1
5,2003,620400,17,15,2,2
6,2003,620400,8,8,0,1
7,2003,620400,15,14,1,1
8,2003,620400,17,16,1,3
9,2003,620400,9,6,3,2
10,2003,620400,13,11,2,0
11,2003,620400,7,6,1,0
12,2003,620400,2,2,0,2
1,2004,620400,7,6,1,0
2,2004,620400,7,6,1,1
3,2004,620400,10,9,1,1
4,2004,620400,7,5,2,1
5,2004,620400,7,5,2,2
6,2004,620400,12,11,1,1
7,2004,620400,11,11,0,2
8,2004,620400,6,6,0,3
9,2004,620400,3,3,0,1
10,2004,620400,11,8,3,1
11,2004,620400,11,11,0,2
12,2004,620400,10,10,0,0
1,2005,620400,9,9,0,0
2,2005,620400,4,4,0,2
3,2005,620400,9,8,1,0
4,2005,620400,7,5,2,4
5,2005,620400,12,10,2,1
6,2005,620400,9,8,1,3
7,2005,620400,3,3,0,1
8,2005,620400,3,2,1,1
9,2005,620400,10,7,3,1
10,2005,620400,10,9,1,1
11,2005,620400,3,3,0,1
12,2005,620400,7,7,0,2
1,2006,620400,7,6,1,1
2,2006,620400,2,2,0,2
3,2006,620400,13,10,3,3
4,2006,620400,7,5,2,4
5,2006,620400,8,8,0,2
6,2006,620400,7,7,0,3
7,2006,620400,11,11,0,0
8,2006,620400,5,2,3,0
9,2006,620400,3,3,0,1
10,2006,620400,6,5,1,0
11,2006,620400,5,4,1,0
12,2006,620400,7,7,0,1
1,2007,620400,5,5,0,1
2,2007,620400,5,5,0,1
3,2007,620400,11,8,3,3
4,2007,620400,12,11,1,2
5,2007,620400,5,4,1,7
6,2007,620400,11,11,0,1
7,2007,620400,5,5,0,0
8,2007,620400,11,9,2,2
9,2007,620400,6,4,2,0
10,2007,620400,12,12,0,0
11,2007,620400,6,6,0,4
12,2007,620400,5,4,1,1
1,2008,620400,9,7,2,2
2,2008,620400,2,2,0,0
3,2008,620400,4,2,2,2
4,2008,620400,6,6,0,0
5,2008,620400,3,3,0,0
6,2008,620400,8,8,0,0
7,2008,620400,13,10,3,2
8,2008,620400,13,13,0,4
9,2008,620400,6,6,0,0
10,2008,620400,13,11,2,0
11,2008,620400,9,9,0,2
12,2008,620400,18,15,3,1
1,2009,620400,8,8,0,4
2,2009,620400,5,4,1,2
3,2009,620400,7,6,1,2
4,2009,620400,5,5,0,3
5,2009,620400,11,11,0,1
6,2009,620400,6,6,0,3
7,2009,620400,6,6,0,2
8,2009,620400,9,8,1,4
9,2009,620400,8,7,1,0
10,2009,620400,9,7,2,3
11,2009,620400,10,9,1,1
12,2009,620400,6,6,0,0
1,2010,620400,9,8,1,3
2,2010,620400,5,5,0,2
3,2010,620400,8,7,1,0
4,2010,620400,7,7,0,3
5,2010,620400,9,7,2,1
6,2010,620400,8,6,2,3
7,2010,620400,8,8,0,0
8,2010,620400,10,10,0,1
9,2010,620400,6,5,1,3
10,2010,620400,7,7,0,1
11,2010,620400,11,11,0,3
12,2010,620400,13,11,2,0
1,2011,620400,6,5,1,4
2,2011,620400,4,4,0,1
1,1999,630900,15,15,0,6
2,1999,630900,5,4,1,3
3,1999,630900,7,7,0,0
4,1999,630900,11,9,2,4
5,1999,630900,17,16,1,2
6,1999,630900,8,6,2,5
7,1999,630900,19,16,3,2
8,1999,630900,19,17,2,0
9,1999,630900,14,13,1,0
10,1999,630900,18,17,1,0
11,1999,630900,11,10,1,0
12,1999,630900,12,12,0,2
1,2000,630900,7,6,1,1
2,2000,630900,16,13,3,1
3,2000,630900,19,15,4,1
4,2000,630900,15,14,1,1
5,2000,630900,14,12,2,2
6,2000,630900,8,8,0,2
7,2000,630900,12,8,4,1
8,2000,630900,11,9,2,9
9,2000,630900,17,14,3,1
10,2000,630900,12,10,2,1
11,2000,630900,16,13,3,2
12,2000,630900,17,16,1,0
1,2001,630900,21,18,3,3
2,2001,630900,15,13,2,2
3,2001,630900,14,13,1,5
4,2001,630900,6,4,2,9
5,2001,630900,7,4,3,3
6,2001,630900,13,11,2,0
7,2001,630900,16,14,2,3
8,2001,630900,15,9,6,2
9,2001,630900,22,17,5,0
10,2001,630900,22,22,0,2
11,2001,630900,13,11,2,4
12,2001,630900,10,9,1,2
1,2002,630900,14,12,2,0
2,2002,630900,14,11,3,2
3,2002,630900,11,10,1,1
4,2002,630900,7,7,0,4
5,2002,630900,18,14,4,2
6,2002,630900,24,18,6,8
7,2002,630900,18,15,3,3
8,2002,630900,12,10,2,2
9,2002,630900,22,18,4,2
10,2002,630900,17,10,7,0
11,2002,630900,14,12,2,4
12,2002,630900,23,17,6,2
1,2003,630900,22,21,1,0
2,2003,630900,8,5,3,6
3,2003,630900,11,11,0,3
4,2003,630900,20,12,8,3
5,2003,630900,6,5,1,4
6,2003,630900,14,11,3,6
7,2003,630900,22,17,5,5
8,2003,630900,30,24,6,2
9,2003,630900,22,19,3,4
10,2003,630900,8,8,0,3
11,2003,630900,10,8,2,1
12,2003,630900,10,9,1,0
1,2004,630900,13,10,3,1
2,2004,630900,10,9,1,5
3,2004,630900,9,9,0,2
4,2004,630900,11,10,1,4
5,2004,630900,14,10,4,7
6,2004,630900,15,14,1,2
7,2004,630900,19,15,4,1
8,2004,630900,7,7,0,0
9,2004,630900,6,4,2,3
10,2004,630900,19,17,2,2
11,2004,630900,13,13,0,4
12,2004,630900,15,15,0,7
1,2005,630900,10,8,2,2
2,2005,630900,8,8,0,4
3,2005,630900,9,9,0,2
4,2005,630900,19,15,4,5
5,2005,630900,11,8,3,4
6,2005,630900,9,6,3,6
7,2005,630900,18,11,7,4
8,2005,630900,17,15,2,2
9,2005,630900,14,11,3,2
10,2005,630900,15,13,2,6
11,2005,630900,7,6,1,3
12,2005,630900,11,8,3,4
1,2006,630900,15,13,2,4
2,2006,630900,11,10,1,2
3,2006,630900,13,10,3,7
4,2006,630900,8,6,2,2
5,2006,630900,9,6,3,4
6,2006,630900,8,6,2,2
7,2006,630900,9,7,2,3
8,2006,630900,6,5,1,3
9,2006,630900,8,7,1,3
10,2006,630900,12,9,3,1
11,2006,630900,7,5,2,5
12,2006,630900,15,11,4,5
1,2007,630900,11,9,2,3
2,2007,630900,12,9,3,5
3,2007,630900,10,7,3,8
4,2007,630900,6,6,0,5
5,2007,630900,9,9,0,7
6,2007,630900,12,11,1,5
7,2007,630900,8,5,3,5
8,2007,630900,7,6,1,3
9,2007,630900,13,13,0,2
10,2007,630900,12,11,1,1
11,2007,630900,16,15,1,4
12,2007,630900,8,6,2,5
1,2008,630900,4,4,0,3
2,2008,630900,6,5,1,3
3,2008,630900,16,9,7,2
4,2008,630900,14,12,2,6
5,2008,630900,14,13,1,5
6,2008,630900,11,9,2,3
7,2008,630900,13,11,2,4
8,2008,630900,13,10,3,1
9,2008,630900,12,10,2,3
10,2008,630900,13,10,3,3
11,2008,630900,18,15,3,1
12,2008,630900,8,7,1,4
1,2009,630900,10,10,0,5
2,2009,630900,9,8,1,6
3,2009,630900,16,12,4,7
4,2009,630900,11,10,1,3
5,2009,630900,12,9,3,6
6,2009,630900,13,9,4,3
7,2009,630900,17,13,4,2
8,2009,630900,17,16,1,3
9,2009,630900,12,12,0,1
10,2009,630900,15,15,0,2
11,2009,630900,12,11,1,4
12,2009,630900,17,15,2,3
1,2010,630900,10,8,2,7
2,2010,630900,11,8,3,0
3,2010,630900,10,8,2,5
4,2010,630900,7,6,1,2
5,2010,630900,19,15,4,4
6,2010,630900,9,7,2,3
7,2010,630900,18,17,1,2
8,2010,630900,13,9,4,6
9,2010,630900,18,14,4,4
10,2010,630900,10,8,2,6
11,2010,630900,20,20,0,3
12,2010,630900,15,15,0,2
1,2011,630900,17,14,3,1
2,2011,630900,7,7,0,5
1,1999,411000,11,11,0,0
2,1999,411000,9,9,0,0
3,1999,411000,9,8,1,1
4,1999,411000,6,6,0,0
5,1999,411000,16,16,0,0
6,1999,411000,14,12,2,0
7,1999,411000,8,7,1,2
8,1999,411000,7,7,0,0
9,1999,411000,12,12,0,0
10,1999,411000,5,5,0,0
11,1999,411000,1,1,0,0
12,1999,411000,6,6,0,0
1,2000,411000,4,4,0,0
2,2000,411000,11,11,0,1
3,2000,411000,5,5,0,0
4,2000,411000,7,6,1,0
5,2000,411000,5,5,0,0
6,2000,411000,6,6,0,0
7,2000,411000,6,6,0,0
8,2000,411000,5,5,0,1
9,2000,411000,8,7,1,0
10,2000,411000,6,6,0,0
11,2000,411000,10,10,0,0
12,2000,411000,5,4,1,0
1,2001,411000,3,2,1,0
2,2001,411000,3,1,2,0
3,2001,411000,4,4,0,0
4,2001,411000,11,11,0,0
5,2001,411000,9,9,0,0
6,2001,411000,9,9,0,0
7,2001,411000,7,7,0,0
8,2001,411000,4,4,0,0
9,2001,411000,8,7,1,0
10,2001,411000,2,2,0,0
11,2001,411000,4,4,0,1
12,2001,411000,5,5,0,0
1,2002,411000,7,7,0,0
2,2002,411000,2,2,0,0
3,2002,411000,2,2,0,0
4,2002,411000,5,5,0,1
5,2002,411000,3,3,0,0
6,2002,411000,2,2,0,0
7,2002,411000,5,5,0,0
8,2002,411000,1,1,0,0
9,2002,411000,5,5,0,0
10,2002,411000,2,2,0,0
11,2002,411000,5,5,0,0
12,2002,411000,4,4,0,0
1,2003,411000,0,0,0,0
2,2003,411000,6,5,1,0
3,2003,411000,2,1,1,0
4,2003,411000,5,5,0,0
5,2003,411000,5,5,0,0
6,2003,411000,8,8,0,0
7,2003,411000,5,4,1,0
8,2003,411000,3,3,0,0
9,2003,411000,2,1,1,0
10,2003,411000,3,3,0,0
11,2003,411000,7,5,2,0
12,2003,411000,3,3,0,0
1,2004,411000,2,2,0,0
2,2004,411000,4,3,1,0
3,2004,411000,6,6,0,0
4,2004,411000,6,6,0,0
5,2004,411000,3,3,0,0
6,2004,411000,5,5,0,0
7,2004,411000,7,7,0,0
8,2004,411000,7,7,0,0
9,2004,411000,9,9,0,0
10,2004,411000,13,13,0,0
11,2004,411000,3,3,0,0
12,2004,411000,4,4,0,0
1,2005,411000,4,3,1,0
2,2005,411000,1,1,0,0
3,2005,411000,6,6,0,0
4,2005,411000,8,7,1,0
5,2005,411000,9,9,0,0
6,2005,411000,4,4,0,0
7,2005,411000,6,6,0,0
8,2005,411000,1,1,0,0
9,2005,411000,12,10,2,0
10,2005,411000,9,6,3,0
11,2005,411000,9,8,1,0
12,2005,411000,8,7,1,0
1,2006,411000,9,9,0,1
2,2006,411000,2,2,0,0
3,2006,411000,3,2,1,0
4,2006,411000,4,4,0,0
5,2006,411000,4,4,0,0
6,2006,411000,4,4,0,0
7,2006,411000,3,2,1,0
8,2006,411000,4,4,0,0
9,2006,411000,7,7,0,0
10,2006,411000,13,13,0,0
11,2006,411000,4,4,0,0
12,2006,411000,6,6,0,0
1,2007,411000,6,6,0,0
2,2007,411000,2,2,0,0
3,2007,411000,5,5,0,1
4,2007,411000,8,7,1,0
5,2007,411000,7,7,0,0
6,2007,411000,8,8,0,0
7,2007,411000,10,10,0,0
8,2007,411000,9,8,1,0
9,2007,411000,7,7,0,0
10,2007,411000,10,10,0,0
11,2007,411000,4,4,0,0
12,2007,411000,6,5,1,0
1,2008,411000,4,4,0,0
2,2008,411000,2,2,0,0
3,2008,411000,6,6,0,0
4,2008,411000,7,7,0,2
5,2008,411000,9,9,0,0
6,2008,411000,6,5,1,0
7,2008,411000,5,5,0,1
8,2008,411000,2,1,1,1
9,2008,411000,6,6,0,1
10,2008,411000,4,4,0,0
11,2008,411000,4,4,0,0
12,2008,411000,4,4,0,0
1,2009,411000,1,1,0,0
2,2009,411000,4,4,0,0
3,2009,411000,4,4,0,0
4,2009,411000,8,8,0,0
5,2009,411000,5,5,0,0
6,2009,411000,8,7,1,0
7,2009,411000,5,5,0,0
8,2009,411000,6,5,1,0
9,2009,411000,6,6,0,1
10,2009,411000,5,5,0,0
11,2009,411000,3,3,0,0
12,2009,411000,8,8,0,0
1,2010,411000,6,6,0,0
2,2010,411000,5,5,0,0
3,2010,411000,1,1,0,1
4,2010,411000,7,6,1,0
5,2010,411000,10,10,0,1
6,2010,411000,6,6,0,1
7,2010,411000,5,5,0,1
8,2010,411000,4,4,0,0
9,2010,411000,4,4,0,0
10,2010,411000,9,9,0,0
11,2010,411000,5,5,0,0
12,2010,411000,3,3,0,0
1,2011,411000,3,3,0,0
2,2011,411000,1,1,0,0
1,1999,835100,23,18,5,10
2,1999,835100,15,14,1,3
3,1999,835100,24,23,1,3
4,1999,835100,15,15,0,5
5,1999,835100,24,19,5,3
6,1999,835100,34,32,2,4
7,1999,835100,33,27,6,7
8,1999,835100,31,28,3,3
9,1999,835100,28,22,6,13
10,1999,835100,29,24,5,14
11,1999,835100,26,24,2,3
12,1999,835100,19,18,1,7
1,2000,835100,26,25,1,0
2,2000,835100,16,15,1,11
3,2000,835100,26,22,4,10
4,2000,835100,17,15,2,5
5,2000,835100,26,21,5,3
6,2000,835100,21,20,1,3
7,2000,835100,32,25,7,2
8,2000,835100,32,28,4,3
9,2000,835100,33,24,9,6
10,2000,835100,29,24,5,13
11,2000,835100,22,20,2,7
12,2000,835100,23,20,3,6
1,2001,835100,20,18,2,14
2,2001,835100,31,25,6,10
3,2001,835100,27,22,5,17
4,2001,835100,21,17,4,7
5,2001,835100,26,20,6,4
6,2001,835100,28,24,4,7
7,2001,835100,23,21,2,11
8,2001,835100,28,21,7,3
9,2001,835100,36,33,3,7
10,2001,835100,30,25,5,7
11,2001,835100,25,20,5,7
12,2001,835100,24,20,4,6
1,2002,835100,24,18,6,8
2,2002,835100,29,24,5,5
3,2002,835100,22,16,6,4
4,2002,835100,31,22,9,11
5,2002,835100,38,35,3,8
6,2002,835100,26,21,5,2
7,2002,835100,27,22,5,9
8,2002,835100,39,32,7,7
9,2002,835100,32,24,8,6
10,2002,835100,32,25,7,5
11,2002,835100,20,17,3,5
12,2002,835100,29,22,7,13
1,2003,835100,25,22,3,10
2,2003,835100,29,22,7,10
3,2003,835100,19,15,4,20
4,2003,835100,24,18,6,9
5,2003,835100,22,15,7,16
6,2003,835100,26,25,1,11
7,2003,835100,38,35,3,8
8,2003,835100,30,22,8,13
9,2003,835100,25,20,5,5
10,2003,835100,34,29,5,7
11,2003,835100,27,20,7,5
12,2003,835100,27,25,2,4
1,2004,835100,22,17,5,5
2,2004,835100,21,18,3,12
3,2004,835100,27,22,5,15
4,2004,835100,26,22,4,9
5,2004,835100,29,24,5,17
6,2004,835100,35,28,7,6
7,2004,835100,33,27,6,2
8,2004,835100,37,28,9,10
9,2004,835100,23,17,6,10
10,2004,835100,21,18,3,6
11,2004,835100,23,20,3,11
12,2004,835100,24,21,3,5
1,2005,835100,32,30,2,17
2,2005,835100,14,8,6,12
3,2005,835100,27,23,4,18
4,2005,835100,24,22,2,28
5,2005,835100,27,24,3,11
6,2005,835100,44,37,7,14
7,2005,835100,37,32,5,7
8,2005,835100,29,23,6,13
9,2005,835100,51,46,5,7
10,2005,835100,45,41,4,7
11,2005,835100,35,33,2,8
12,2005,835100,45,41,4,8
1,2006,835100,35,31,4,6
2,2006,835100,20,18,2,13
3,2006,835100,25,20,5,13
4,2006,835100,26,20,6,9
5,2006,835100,35,26,9,10
6,2006,835100,30,21,9,14
7,2006,835100,31,23,8,0
8,2006,835100,27,23,4,2
9,2006,835100,47,41,6,7
10,2006,835100,33,28,5,6
11,2006,835100,38,30,8,5
12,2006,835100,23,19,4,5
1,2007,835100,21,20,1,5
2,2007,835100,17,14,3,1
3,2007,835100,20,19,1,8
4,2007,835100,20,16,4,6
5,2007,835100,29,25,4,12
6,2007,835100,36,35,1,8
7,2007,835100,37,30,7,2
8,2007,835100,24,21,3,1
9,2007,835100,18,15,3,2
10,2007,835100,24,22,2,6
11,2007,835100,27,20,7,8
12,2007,835100,32,26,6,6
1,2008,835100,20,17,3,5
2,2008,835100,13,9,4,7
3,2008,835100,17,14,3,1
4,2008,835100,24,24,0,5
5,2008,835100,24,20,4,4
6,2008,835100,29,26,3,4
7,2008,835100,29,25,4,13
8,2008,835100,18,17,1,3
9,2008,835100,25,23,2,3
10,2008,835100,16,15,1,4
11,2008,835100,20,16,4,3
12,2008,835100,18,16,2,8
1,2009,835100,22,19,3,1
2,2009,835100,21,17,4,6
3,2009,835100,26,22,4,4
4,2009,835100,28,25,3,6
5,2009,835100,23,20,3,15
6,2009,835100,24,17,7,5
7,2009,835100,50,44,6,5
8,2009,835100,39,34,5,16
9,2009,835100,42,34,8,5
10,2009,835100,31,30,1,5
11,2009,835100,23,21,2,7
12,2009,835100,26,24,2,4
1,2010,835100,36,30,6,6
2,2010,835100,18,14,4,17
3,2010,835100,18,13,5,9
4,2010,835100,22,16,6,9
5,2010,835100,24,20,4,19
6,2010,835100,18,15,3,6
7,2010,835100,29,25,4,6
8,2010,835100,36,26,10,14
9,2010,835100,25,22,3,14
10,2010,835100,21,18,3,5
11,2010,835100,22,17,5,7
12,2010,835100,27,23,4,8
1,2011,835100,24,21,3,6
2,2011,835100,12,12,0,4
1,1999,400300,28,20,8,2
2,1999,400300,28,20,8,0
3,1999,400300,19,15,4,1
4,1999,400300,19,16,3,4
5,1999,400300,33,25,8,6
6,1999,400300,32,24,8,1
7,1999,400300,41,29,12,2
8,1999,400300,34,28,6,1
9,1999,400300,26,23,3,2
10,1999,400300,39,29,10,4
11,1999,400300,25,21,4,2
12,1999,400300,26,24,2,4
1,2000,400300,20,16,4,5
2,2000,400300,22,19,3,0
3,2000,400300,32,27,5,10
4,2000,400300,15,11,4,5
5,2000,400300,24,17,7,9
6,2000,400300,39,30,9,2
7,2000,400300,34,26,8,8
8,2000,400300,36,33,3,8
9,2000,400300,42,38,4,12
10,2000,400300,35,27,8,5
11,2000,400300,18,15,3,8
12,2000,400300,18,14,4,6
1,2001,400300,21,14,7,6
2,2001,400300,23,20,3,5
3,2001,400300,18,12,6,9
4,2001,400300,35,27,8,11
5,2001,400300,26,17,9,8
6,2001,400300,35,25,10,15
7,2001,400300,42,30,12,15
8,2001,400300,40,25,15,15
9,2001,400300,34,29,5,7
10,2001,400300,23,18,5,10
11,2001,400300,32,25,7,13
12,2001,400300,19,14,5,6
1,2002,400300,26,23,3,9
2,2002,400300,19,16,3,9
3,2002,400300,19,17,2,10
4,2002,400300,38,31,7,9
5,2002,400300,24,22,2,3
6,2002,400300,27,22,5,6
7,2002,400300,38,28,10,5
8,2002,400300,29,23,6,7
9,2002,400300,34,27,7,6
10,2002,400300,46,41,5,9
11,2002,400300,20,19,1,8
12,2002,400300,21,17,4,14
1,2003,400300,22,20,2,12
2,2003,400300,19,15,4,6
3,2003,400300,29,23,6,8
4,2003,400300,29,18,11,7
5,2003,400300,30,24,6,5
6,2003,400300,31,24,7,11
7,2003,400300,36,28,8,15
8,2003,400300,34,26,8,13
9,2003,400300,37,31,6,9
10,2003,400300,40,32,8,11
11,2003,400300,34,24,10,6
12,2003,400300,27,25,2,7
1,2004,400300,21,20,1,13
2,2004,400300,26,25,1,12
3,2004,400300,35,31,4,8
4,2004,400300,39,33,6,15
5,2004,400300,26,21,5,14
6,2004,400300,31,23,8,8
7,2004,400300,25,21,4,5
8,2004,400300,40,35,5,2
9,2004,400300,32,28,4,4
10,2004,400300,33,28,5,2
11,2004,400300,21,18,3,4
12,2004,400300,22,21,1,4
1,2005,400300,15,10,5,2
2,2005,400300,22,16,6,6
3,2005,400300,20,17,3,6
4,2005,400300,19,17,2,7
5,2005,400300,17,14,3,3
6,2005,400300,38,33,5,3
7,2005,400300,39,33,6,4
8,2005,400300,33,29,4,1
9,2005,400300,26,19,7,5
10,2005,400300,20,18,2,1
11,2005,400300,31,28,3,2
12,2005,400300,22,17,5,3
1,2006,400300,22,20,2,3
2,2006,400300,19,18,1,1
3,2006,400300,21,19,2,3
4,2006,400300,21,17,4,3
5,2006,400300,26,22,4,3
6,2006,400300,32,25,7,4
7,2006,400300,38,29,9,3
8,2006,400300,32,29,3,7
9,2006,400300,30,26,4,3
10,2006,400300,27,25,2,2
11,2006,400300,27,26,1,2
12,2006,400300,25,18,7,4
1,2007,400300,24,23,1,1
2,2007,400300,9,9,0,2
3,2007,400300,22,14,8,2
4,2007,400300,26,23,3,4
5,2007,400300,30,26,4,6
6,2007,400300,25,22,3,4
7,2007,400300,32,30,2,4
8,2007,400300,42,36,6,3
9,2007,400300,23,17,6,6
10,2007,400300,25,21,4,0
11,2007,400300,31,27,4,4
12,2007,400300,16,14,2,4
1,2008,400300,17,15,2,9
2,2008,400300,13,12,1,2
3,2008,400300,15,13,2,2
4,2008,400300,20,19,1,2
5,2008,400300,23,19,4,2
6,2008,400300,23,18,5,6
7,2008,400300,32,29,3,11
8,2008,400300,32,28,4,4
9,2008,400300,20,14,6,6
10,2008,400300,26,24,2,2
11,2008,400300,16,15,1,4
12,2008,400300,18,16,2,6
1,2009,400300,25,22,3,2
2,2009,400300,16,12,4,5
3,2009,400300,18,18,0,5
4,2009,400300,27,24,3,4
5,2009,400300,29,25,4,6
6,2009,400300,27,24,3,4
7,2009,400300,24,22,2,3
8,2009,400300,21,19,2,7
9,2009,400300,22,21,1,1
10,2009,400300,28,25,3,2
11,2009,400300,20,19,1,2
12,2009,400300,26,23,3,4
1,2010,400300,17,15,2,0
2,2010,400300,18,14,4,3
3,2010,400300,13,9,4,5
4,2010,400300,23,23,0,2
5,2010,400300,34,29,5,4
6,2010,400300,20,20,0,5
7,2010,400300,27,22,5,0
8,2010,400300,29,22,7,3
9,2010,400300,37,33,4,8
10,2010,400300,33,31,2,3
11,2010,400300,22,21,1,6
12,2010,400300,19,18,1,9
1,2011,400300,14,12,2,1
2,2011,400300,9,8,1,5
1,1999,411200,7,7,0,0
2,1999,411200,10,10,0,0
3,1999,411200,15,14,1,0
4,1999,411200,16,16,0,1
5,1999,411200,13,11,2,0
6,1999,411200,21,21,0,1
7,1999,411200,9,9,0,1
8,1999,411200,12,12,0,0
9,1999,411200,12,11,1,0
10,1999,411200,6,6,0,1
11,1999,411200,5,5,0,0
12,1999,411200,10,10,0,0
1,2000,411200,4,4,0,0
2,2000,411200,11,11,0,0
3,2000,411200,7,7,0,1
4,2000,411200,8,8,0,0
5,2000,411200,14,14,0,0
6,2000,411200,5,5,0,0
7,2000,411200,15,15,0,0
8,2000,411200,8,8,0,0
9,2000,411200,10,10,0,0
10,2000,411200,11,10,1,0
11,2000,411200,13,13,0,0
12,2000,411200,12,12,0,0
1,2001,411200,6,6,0,0
2,2001,411200,7,6,1,1
3,2001,411200,3,3,0,0
4,2001,411200,4,4,0,0
5,2001,411200,9,9,0,1
6,2001,411200,11,11,0,0
7,2001,411200,13,13,0,0
8,2001,411200,6,5,1,0
9,2001,411200,6,6,0,0
10,2001,411200,14,13,1,0
11,2001,411200,13,13,0,0
12,2001,411200,11,10,1,0
1,2002,411200,10,10,0,1
2,2002,411200,3,3,0,0
3,2002,411200,7,6,1,0
4,2002,411200,12,12,0,0
5,2002,411200,11,11,0,0
6,2002,411200,4,4,0,0
7,2002,411200,8,8,0,0
8,2002,411200,8,8,0,0
9,2002,411200,16,16,0,0
10,2002,411200,14,14,0,0
11,2002,411200,4,3,1,1
12,2002,411200,8,8,0,0
1,2003,411200,11,11,0,0
2,2003,411200,8,8,0,0
3,2003,411200,12,12,0,2
4,2003,411200,11,11,0,0
5,2003,411200,9,8,1,0
6,2003,411200,16,16,0,0
7,2003,411200,15,13,2,0
8,2003,411200,8,8,0,0
9,2003,411200,8,8,0,0
10,2003,411200,9,8,1,0
11,2003,411200,7,6,1,0
12,2003,411200,4,4,0,0
1,2004,411200,5,4,1,0
2,2004,411200,6,6,0,0
3,2004,411200,8,8,0,2
4,2004,411200,10,10,0,0
5,2004,411200,10,9,1,0
6,2004,411200,3,3,0,0
7,2004,411200,10,10,0,1
8,2004,411200,15,14,1,0
9,2004,411200,16,15,1,0
10,2004,411200,12,12,0,0
11,2004,411200,4,4,0,0
12,2004,411200,7,6,1,0
1,2005,411200,9,9,0,0
2,2005,411200,10,10,0,0
3,2005,411200,9,9,0,0
4,2005,411200,10,10,0,0
5,2005,411200,8,8,0,0
6,2005,411200,11,11,0,0
7,2005,411200,7,7,0,0
8,2005,411200,10,10,0,0
9,2005,411200,10,9,1,0
10,2005,411200,7,7,0,0
11,2005,411200,13,13,0,0
12,2005,411200,12,12,0,0
1,2006,411200,8,7,1,0
2,2006,411200,4,4,0,1
3,2006,411200,10,10,0,0
4,2006,411200,10,10,0,0
5,2006,411200,12,12,0,0
6,2006,411200,15,15,0,1
7,2006,411200,7,7,0,0
8,2006,411200,14,14,0,0
9,2006,411200,11,8,3,0
10,2006,411200,9,9,0,0
11,2006,411200,8,7,1,0
12,2006,411200,8,7,1,0
1,2007,411200,8,8,0,0
2,2007,411200,4,4,0,0
3,2007,411200,9,9,0,0
4,2007,411200,5,5,0,0
5,2007,411200,6,6,0,0
6,2007,411200,7,7,0,0
7,2007,411200,5,5,0,0
8,2007,411200,5,5,0,0
9,2007,411200,9,8,1,0
10,2007,411200,6,6,0,0
11,2007,411200,13,13,0,0
12,2007,411200,3,3,0,0
1,2008,411200,6,5,1,0
2,2008,411200,3,2,1,0
3,2008,411200,6,6,0,0
4,2008,411200,5,5,0,0
5,2008,411200,7,7,0,0
6,2008,411200,4,4,0,0
7,2008,411200,2,2,0,0
8,2008,411200,6,6,0,1
9,2008,411200,9,9,0,0
10,2008,411200,11,11,0,0
11,2008,411200,6,6,0,0
12,2008,411200,4,4,0,0
1,2009,411200,6,5,1,0
2,2009,411200,4,3,1,0
3,2009,411200,6,6,0,0
4,2009,411200,4,4,0,0
5,2009,411200,6,6,0,0
6,2009,411200,5,5,0,0
7,2009,411200,7,7,0,0
8,2009,411200,6,6,0,0
9,2009,411200,9,9,0,0
10,2009,411200,10,10,0,0
11,2009,411200,7,7,0,0
12,2009,411200,5,4,1,0
1,2010,411200,2,2,0,0
2,2010,411200,1,1,0,0
3,2010,411200,5,4,1,0
4,2010,411200,8,7,1,0
5,2010,411200,3,3,0,0
6,2010,411200,5,5,0,0
7,2010,411200,4,4,0,0
8,2010,411200,9,9,0,0
9,2010,411200,4,4,0,0
10,2010,411200,4,4,0,1
11,2010,411200,3,3,0,0
12,2010,411200,9,9,0,0
1,2011,411200,3,3,0,0
2,2011,411200,5,5,0,0
1,1999,670300,22,16,6,28
2,1999,670300,12,7,5,20
3,1999,670300,19,14,5,13
4,1999,670300,14,12,2,6
5,1999,670300,22,15,7,14
6,1999,670300,28,22,6,6
7,1999,670300,27,21,6,5
8,1999,670300,19,16,3,15
9,1999,670300,18,15,3,6
10,1999,670300,19,18,1,6
11,1999,670300,18,14,4,14
12,1999,670300,15,12,3,12
1,2000,670300,15,12,3,7
2,2000,670300,16,12,4,17
3,2000,670300,14,13,1,7
4,2000,670300,19,16,3,5
5,2000,670300,21,17,4,10
6,2000,670300,30,24,6,9
7,2000,670300,23,17,6,7
8,2000,670300,20,15,5,11
9,2000,670300,12,9,3,5
10,2000,670300,21,15,6,2
11,2000,670300,15,13,2,11
12,2000,670300,15,12,3,15
1,2001,670300,14,11,3,21
2,2001,670300,14,9,5,8
3,2001,670300,15,11,4,7
4,2001,670300,20,18,2,13
5,2001,670300,23,17,6,7
6,2001,670300,25,18,7,7
7,2001,670300,19,12,7,3
8,2001,670300,33,22,11,4
9,2001,670300,45,31,14,3
10,2001,670300,30,24,6,6
11,2001,670300,17,13,4,7
12,2001,670300,15,11,4,6
1,2002,670300,15,12,3,6
2,2002,670300,14,10,4,7
3,2002,670300,13,10,3,8
4,2002,670300,28,16,12,4
5,2002,670300,24,15,9,3
6,2002,670300,7,6,1,8
7,2002,670300,21,14,7,5
8,2002,670300,15,9,6,15
9,2002,670300,11,8,3,13
10,2002,670300,9,7,2,3
11,2002,670300,13,9,4,10
12,2002,670300,12,11,1,10
1,2003,670300,22,17,5,11
2,2003,670300,8,5,3,16
3,2003,670300,14,12,2,4
4,2003,670300,19,12,7,5
5,2003,670300,18,15,3,15
6,2003,670300,12,11,1,18
7,2003,670300,17,13,4,14
8,2003,670300,26,21,5,7
9,2003,670300,25,21,4,2
10,2003,670300,20,19,1,16
11,2003,670300,26,18,8,8
12,2003,670300,12,11,1,6
1,2004,670300,16,12,4,4
2,2004,670300,8,6,2,5
3,2004,670300,16,13,3,9
4,2004,670300,17,10,7,9
5,2004,670300,13,9,4,2
6,2004,670300,15,13,2,6
7,2004,670300,18,15,3,8
8,2004,670300,25,19,6,6
9,2004,670300,20,16,4,9
10,2004,670300,14,12,2,12
11,2004,670300,10,9,1,7
12,2004,670300,15,14,1,16
1,2005,670300,12,10,2,8
2,2005,670300,17,13,4,5
3,2005,670300,7,6,1,13
4,2005,670300,12,9,3,9
5,2005,670300,13,10,3,4
6,2005,670300,14,12,2,14
7,2005,670300,22,14,8,11
8,2005,670300,20,15,5,2
9,2005,670300,23,19,4,19
10,2005,670300,16,12,4,6
11,2005,670300,20,16,4,8
12,2005,670300,14,13,1,3
1,2006,670300,9,8,1,8
2,2006,670300,10,9,1,11
3,2006,670300,19,14,5,14
4,2006,670300,18,13,5,10
5,2006,670300,14,9,5,5
6,2006,670300,20,16,4,8
7,2006,670300,16,10,6,7
8,2006,670300,6,4,2,2
9,2006,670300,18,14,4,9
10,2006,670300,16,14,2,7
11,2006,670300,20,13,7,9
12,2006,670300,21,19,2,6
1,2007,670300,16,14,2,8
2,2007,670300,8,7,1,0
3,2007,670300,16,9,7,3
4,2007,670300,20,14,6,10
5,2007,670300,18,16,2,3
6,2007,670300,18,15,3,5
7,2007,670300,20,15,5,13
8,2007,670300,22,16,6,9
9,2007,670300,25,17,8,10
10,2007,670300,28,23,5,12
11,2007,670300,20,17,3,4
12,2007,670300,11,10,1,12
1,2008,670300,24,21,3,6
2,2008,670300,12,12,0,4
3,2008,670300,11,10,1,3
4,2008,670300,19,14,5,5
5,2008,670300,17,13,4,8
6,2008,670300,20,18,2,4
7,2008,670300,24,23,1,8
8,2008,670300,14,6,8,13
9,2008,670300,18,16,2,7
10,2008,670300,21,10,11,13
11,2008,670300,21,20,1,20
12,2008,670300,16,14,2,9
1,2009,670300,9,7,2,2
2,2009,670300,7,5,2,4
3,2009,670300,12,8,4,10
4,2009,670300,16,11,5,10
5,2009,670300,10,9,1,6
6,2009,670300,14,11,3,13
7,2009,670300,12,10,2,4
8,2009,670300,18,15,3,6
9,2009,670300,19,16,3,4
10,2009,670300,16,12,4,7
11,2009,670300,13,8,5,8
12,2009,670300,13,13,0,4
1,2010,670300,16,13,3,2
2,2010,670300,15,13,2,7
3,2010,670300,17,14,3,7
4,2010,670300,13,10,3,4
5,2010,670300,9,7,2,9
6,2010,670300,13,12,1,5
7,2010,670300,17,12,5,9
8,2010,670300,16,14,2,3
9,2010,670300,9,7,2,7
10,2010,670300,9,5,4,8
11,2010,670300,13,7,6,14
12,2010,670300,9,7,2,4
1,2011,670300,10,7,3,3
2,2011,670300,1,1,0,4
1,1999,836200,23,23,0,0
2,1999,836200,31,31,0,1
3,1999,836200,21,21,0,0
4,1999,836200,17,16,1,0
5,1999,836200,25,24,1,0
6,1999,836200,24,22,2,0
7,1999,836200,26,25,1,1
8,1999,836200,23,23,0,0
9,1999,836200,15,15,0,1
10,1999,836200,23,21,2,0
11,1999,836200,13,13,0,0
12,1999,836200,21,21,0,0
1,2000,836200,23,23,0,1
2,2000,836200,12,12,0,0
3,2000,836200,27,27,0,1
4,2000,836200,21,21,0,1
5,2000,836200,29,28,1,0
6,2000,836200,39,37,2,3
7,2000,836200,28,27,1,0
8,2000,836200,22,22,0,1
9,2000,836200,24,24,0,1
10,2000,836200,33,33,0,1
11,2000,836200,26,25,1,0
12,2000,836200,19,18,1,0
1,2001,836200,19,19,0,0
2,2001,836200,17,15,2,0
3,2001,836200,8,8,0,1
4,2001,836200,9,9,0,1
5,2001,836200,22,22,0,0
6,2001,836200,18,18,0,0
7,2001,836200,27,25,2,2
8,2001,836200,17,17,0,0
9,2001,836200,21,19,2,1
10,2001,836200,28,27,1,0
11,2001,836200,15,15,0,0
12,2001,836200,7,7,0,0
1,2002,836200,21,21,0,0
2,2002,836200,4,4,0,0
3,2002,836200,17,17,0,0
4,2002,836200,13,13,0,1
5,2002,836200,13,12,1,0
6,2002,836200,19,19,0,0
7,2002,836200,25,23,2,1
8,2002,836200,26,25,1,0
9,2002,836200,32,32,0,0
10,2002,836200,28,28,0,1
11,2002,836200,14,14,0,1
12,2002,836200,18,17,1,0
1,2003,836200,24,24,0,0
2,2003,836200,23,22,1,0
3,2003,836200,22,20,2,0
4,2003,836200,14,14,0,0
5,2003,836200,13,13,0,0
6,2003,836200,16,16,0,0
7,2003,836200,19,19,0,1
8,2003,836200,22,22,0,1
9,2003,836200,24,24,0,0
10,2003,836200,17,17,0,1
11,2003,836200,20,20,0,0
12,2003,836200,20,20,0,3
1,2004,836200,17,17,0,0
2,2004,836200,16,16,0,0
3,2004,836200,14,13,1,1
4,2004,836200,24,24,0,2
5,2004,836200,16,16,0,0
6,2004,836200,22,21,1,0
7,2004,836200,28,25,3,0
8,2004,836200,23,23,0,1
9,2004,836200,18,18,0,0
10,2004,836200,33,32,1,0
11,2004,836200,23,23,0,1
12,2004,836200,24,23,1,2
1,2005,836200,19,19,0,0
2,2005,836200,16,16,0,0
3,2005,836200,21,20,1,1
4,2005,836200,17,17,0,3
5,2005,836200,15,15,0,0
6,2005,836200,17,16,1,1
7,2005,836200,11,10,1,1
8,2005,836200,15,14,1,5
9,2005,836200,32,32,0,1
10,2005,836200,17,16,1,2
11,2005,836200,24,19,5,1
12,2005,836200,14,14,0,0
1,2006,836200,13,13,0,0
2,2006,836200,4,3,1,0
3,2006,836200,20,20,0,0
4,2006,836200,13,13,0,0
5,2006,836200,17,16,1,0
6,2006,836200,4,4,0,1
7,2006,836200,11,11,0,0
8,2006,836200,21,21,0,0
9,2006,836200,26,26,0,0
10,2006,836200,22,21,1,1
11,2006,836200,14,12,2,2
12,2006,836200,9,9,0,0
1,2007,836200,15,15,0,0
2,2007,836200,13,12,1,0
3,2007,836200,11,11,0,3
4,2007,836200,9,9,0,0
5,2007,836200,21,20,1,0
6,2007,836200,12,12,0,1
7,2007,836200,17,17,0,0
8,2007,836200,20,20,0,0
9,2007,836200,22,22,0,0
10,2007,836200,16,14,2,1
11,2007,836200,18,17,1,0
12,2007,836200,15,15,0,0
1,2008,836200,12,11,1,0
2,2008,836200,11,11,0,0
3,2008,836200,10,10,0,0
4,2008,836200,12,12,0,0
5,2008,836200,11,8,3,0
6,2008,836200,14,14,0,0
7,2008,836200,18,18,0,0
8,2008,836200,15,15,0,0
9,2008,836200,15,14,1,0
10,2008,836200,17,16,1,1
11,2008,836200,15,15,0,0
12,2008,836200,5,4,1,0
1,2009,836200,12,11,1,0
2,2009,836200,11,9,2,0
3,2009,836200,8,8,0,0
4,2009,836200,9,8,1,0
5,2009,836200,22,21,1,0
6,2009,836200,8,8,0,0
7,2009,836200,13,12,1,0
8,2009,836200,15,15,0,1
9,2009,836200,11,11,0,0
10,2009,836200,11,11,0,0
11,2009,836200,18,16,2,0
12,2009,836200,12,12,0,0
1,2010,836200,13,13,0,0
2,2010,836200,4,4,0,1
3,2010,836200,6,5,1,0
4,2010,836200,13,13,0,0
5,2010,836200,19,19,0,0
6,2010,836200,19,19,0,0
7,2010,836200,11,11,0,2
8,2010,836200,9,9,0,1
9,2010,836200,16,16,0,0
10,2010,836200,11,11,0,0
11,2010,836200,16,16,0,0
12,2010,836200,9,9,0,0
1,2011,836200,12,12,0,0
2,2011,836200,7,7,0,0
1,1999,411100,5,5,0,0
2,1999,411100,7,7,0,0
3,1999,411100,8,8,0,0
4,1999,411100,5,5,0,0
5,1999,411100,9,8,1,1
6,1999,411100,12,11,1,0
7,1999,411100,25,25,0,0
8,1999,411100,10,10,0,0
9,1999,411100,20,17,3,0
10,1999,411100,5,5,0,0
11,1999,411100,7,6,1,0
12,1999,411100,11,10,1,0
1,2000,411100,6,6,0,0
2,2000,411100,4,4,0,0
3,2000,411100,3,3,0,0
4,2000,411100,11,11,0,1
5,2000,411100,8,8,0,0
6,2000,411100,3,3,0,0
7,2000,411100,15,15,0,0
8,2000,411100,11,11,0,0
9,2000,411100,8,8,0,0
10,2000,411100,10,9,1,0
11,2000,411100,8,8,0,0
12,2000,411100,8,7,1,2
1,2001,411100,4,4,0,0
2,2001,411100,6,5,1,0
3,2001,411100,5,5,0,1
4,2001,411100,7,7,0,0
5,2001,411100,7,7,0,0
6,2001,411100,5,5,0,0
7,2001,411100,11,11,0,0
8,2001,411100,7,6,1,0
9,2001,411100,6,5,1,0
10,2001,411100,6,5,1,0
11,2001,411100,7,6,1,0
12,2001,411100,8,8,0,0
1,2002,411100,3,3,0,0
2,2002,411100,2,2,0,0
3,2002,411100,8,8,0,0
4,2002,411100,9,8,1,0
5,2002,411100,4,3,1,0
6,2002,411100,6,6,0,1
7,2002,411100,13,13,0,0
8,2002,411100,6,6,0,0
9,2002,411100,12,12,0,0
10,2002,411100,11,11,0,0
11,2002,411100,7,7,0,0
12,2002,411100,8,8,0,0
1,2003,411100,13,12,1,0
2,2003,411100,9,9,0,0
3,2003,411100,6,6,0,0
4,2003,411100,9,9,0,0
5,2003,411100,10,9,1,0
6,2003,411100,4,4,0,0
7,2003,411100,8,8,0,0
8,2003,411100,4,4,0,0
9,2003,411100,10,10,0,2
10,2003,411100,5,5,0,1
11,2003,411100,5,5,0,0
12,2003,411100,10,10,0,0
1,2004,411100,7,6,1,0
2,2004,411100,2,2,0,0
3,2004,411100,6,6,0,0
4,2004,411100,7,7,0,0
5,2004,411100,10,9,1,1
6,2004,411100,9,9,0,1
7,2004,411100,10,10,0,1
8,2004,411100,9,9,0,0
9,2004,411100,9,9,0,0
10,2004,411100,12,12,0,0
11,2004,411100,11,11,0,0
12,2004,411100,10,10,0,0
1,2005,411100,5,5,0,0
2,2005,411100,5,5,0,0
3,2005,411100,5,5,0,1
4,2005,411100,8,8,0,0
5,2005,411100,1,1,0,0
6,2005,411100,1,1,0,0
7,2005,411100,10,10,0,0
8,2005,411100,5,5,0,0
9,2005,411100,6,6,0,0
10,2005,411100,10,10,0,0
11,2005,411100,4,4,0,0
12,2005,411100,8,8,0,0
1,2006,411100,6,6,0,0
2,2006,411100,3,3,0,0
3,2006,411100,9,9,0,0
4,2006,411100,3,3,0,0
5,2006,411100,7,7,0,0
6,2006,411100,7,7,0,0
7,2006,411100,5,5,0,0
8,2006,411100,6,5,1,0
9,2006,411100,5,4,1,0
10,2006,411100,4,4,0,0
11,2006,411100,7,7,0,0
12,2006,411100,5,5,0,0
1,2007,411100,7,7,0,0
2,2007,411100,2,2,0,0
3,2007,411100,1,1,0,0
4,2007,411100,7,7,0,0
5,2007,411100,7,7,0,0
6,2007,411100,6,6,0,0
7,2007,411100,7,7,0,0
8,2007,411100,3,3,0,0
9,2007,411100,4,4,0,0
10,2007,411100,4,4,0,0
11,2007,411100,3,3,0,0
12,2007,411100,6,6,0,0
1,2008,411100,6,6,0,1
2,2008,411100,5,5,0,0
3,2008,411100,4,4,0,0
4,2008,411100,2,2,0,1
5,2008,411100,5,5,0,0
6,2008,411100,8,8,0,0
7,2008,411100,5,5,0,0
8,2008,411100,4,4,0,0
9,2008,411100,1,1,0,1
10,2008,411100,4,3,1,0
11,2008,411100,4,4,0,0
12,2008,411100,0,0,0,0
1,2009,411100,3,3,0,0
2,2009,411100,8,8,0,0
3,2009,411100,3,3,0,0
4,2009,411100,2,2,0,0
5,2009,411100,3,2,1,2
6,2009,411100,4,4,0,0
7,2009,411100,6,6,0,0
8,2009,411100,7,7,0,0
9,2009,411100,6,6,0,0
10,2009,411100,7,7,0,0
11,2009,411100,6,6,0,4
12,2009,411100,2,2,0,0
1,2010,411100,5,5,0,0
2,2010,411100,2,2,0,0
3,2010,411100,2,2,0,0
4,2010,411100,3,3,0,0
5,2010,411100,6,5,1,0
6,2010,411100,7,7,0,1
7,2010,411100,6,6,0,0
8,2010,411100,8,8,0,2
9,2010,411100,2,2,0,0
10,2010,411100,4,4,0,0
11,2010,411100,9,9,0,0
12,2010,411100,1,1,0,0
1,2011,411100,3,3,0,0
2,2011,411100,1,1,0,0
1,1999,630800,14,12,2,0
2,1999,630800,8,7,1,2
3,1999,630800,12,11,1,3
4,1999,630800,13,13,0,0
5,1999,630800,17,14,3,0
6,1999,630800,14,11,3,0
7,1999,630800,19,18,1,3
8,1999,630800,13,13,0,2
9,1999,630800,15,14,1,1
10,1999,630800,21,18,3,2
11,1999,630800,12,12,0,1
12,1999,630800,15,13,2,1
1,2000,630800,9,8,1,1
2,2000,630800,14,12,2,2
3,2000,630800,10,10,0,4
4,2000,630800,23,20,3,1
5,2000,630800,17,11,6,3
6,2000,630800,13,8,5,2
7,2000,630800,13,11,2,2
8,2000,630800,13,9,4,2
9,2000,630800,14,12,2,0
10,2000,630800,17,15,2,0
11,2000,630800,20,17,3,1
12,2000,630800,12,7,5,0
1,2001,630800,15,14,1,0
2,2001,630800,17,16,1,2
3,2001,630800,26,25,1,2
4,2001,630800,13,11,2,4
5,2001,630800,14,14,0,7
6,2001,630800,15,13,2,6
7,2001,630800,20,17,3,4
8,2001,630800,17,14,3,1
9,2001,630800,19,16,3,1
10,2001,630800,27,24,3,0
11,2001,630800,21,18,3,1
12,2001,630800,14,13,1,0
1,2002,630800,29,26,3,9
2,2002,630800,25,23,2,7
3,2002,630800,18,13,5,1
4,2002,630800,8,8,0,1
5,2002,630800,16,12,4,4
6,2002,630800,19,14,5,1
7,2002,630800,22,19,3,7
8,2002,630800,26,21,5,4
9,2002,630800,17,13,4,0
10,2002,630800,29,20,9,1
11,2002,630800,13,9,4,0
12,2002,630800,22,18,4,5
1,2003,630800,19,18,1,6
2,2003,630800,23,21,2,1
3,2003,630800,19,17,2,3
4,2003,630800,13,13,0,1
5,2003,630800,21,19,2,2
6,2003,630800,11,9,2,1
7,2003,630800,16,13,3,2
8,2003,630800,16,9,7,5
9,2003,630800,15,12,3,3
10,2003,630800,19,15,4,2
11,2003,630800,15,12,3,4
12,2003,630800,9,8,1,2
1,2004,630800,7,5,2,1
2,2004,630800,13,12,1,2
3,2004,630800,9,8,1,1
4,2004,630800,12,10,2,5
5,2004,630800,11,8,3,0
6,2004,630800,19,15,4,0
7,2004,630800,10,7,3,3
8,2004,630800,22,18,4,0
9,2004,630800,23,18,5,2
10,2004,630800,7,6,1,1
11,2004,630800,9,8,1,3
12,2004,630800,7,6,1,4
1,2005,630800,28,22,6,8
2,2005,630800,15,12,3,6
3,2005,630800,13,10,3,3
4,2005,630800,11,11,0,5
5,2005,630800,16,14,2,4
6,2005,630800,13,12,1,13
7,2005,630800,15,12,3,3
8,2005,630800,19,16,3,4
9,2005,630800,21,15,6,2
10,2005,630800,20,15,5,8
11,2005,630800,9,8,1,8
12,2005,630800,20,18,2,1
1,2006,630800,15,14,1,3
2,2006,630800,12,10,2,2
3,2006,630800,12,10,2,5
4,2006,630800,11,8,3,7
5,2006,630800,11,9,2,8
6,2006,630800,16,13,3,10
7,2006,630800,7,5,2,2
8,2006,630800,12,8,4,6
9,2006,630800,10,6,4,1
10,2006,630800,17,14,3,2
11,2006,630800,13,10,3,0
12,2006,630800,7,6,1,7
1,2007,630800,13,11,2,9
2,2007,630800,10,7,3,3
3,2007,630800,9,8,1,8
4,2007,630800,9,7,2,5
5,2007,630800,12,9,3,8
6,2007,630800,10,8,2,2
7,2007,630800,15,13,2,5
8,2007,630800,12,10,2,7
9,2007,630800,18,12,6,0
10,2007,630800,17,15,2,4
11,2007,630800,15,12,3,4
12,2007,630800,15,11,4,8
1,2008,630800,5,3,2,6
2,2008,630800,14,12,2,9
3,2008,630800,15,14,1,3
4,2008,630800,15,11,4,4
5,2008,630800,15,10,5,10
6,2008,630800,11,11,0,2
7,2008,630800,18,15,3,5
8,2008,630800,14,10,4,4
9,2008,630800,22,21,1,2
10,2008,630800,11,10,1,4
11,2008,630800,15,13,2,0
12,2008,630800,19,12,7,3
1,2009,630800,6,5,1,7
2,2009,630800,15,13,2,3
3,2009,630800,13,12,1,2
4,2009,630800,13,13,0,1
5,2009,630800,15,12,3,4
6,2009,630800,24,20,4,5
7,2009,630800,11,10,1,2
8,2009,630800,12,7,5,2
9,2009,630800,19,16,3,3
10,2009,630800,16,16,0,4
11,2009,630800,21,17,4,5
12,2009,630800,13,11,2,2
1,2010,630800,16,16,0,4
2,2010,630800,11,9,2,5
3,2010,630800,16,10,6,3
4,2010,630800,12,10,2,5
5,2010,630800,16,13,3,4
6,2010,630800,18,15,3,3
7,2010,630800,16,11,5,2
8,2010,630800,15,14,1,7
9,2010,630800,15,14,1,2
10,2010,630800,14,12,2,1
11,2010,630800,27,21,6,1
12,2010,630800,21,20,1,3
1,2011,630800,18,17,1,4
2,2011,630800,8,5,3,1
1,1999,670400,9,4,5,0
2,1999,670400,18,14,4,6
3,1999,670400,12,5,7,2
4,1999,670400,9,8,1,2
5,1999,670400,17,11,6,1
6,1999,670400,12,11,1,1
7,1999,670400,25,21,4,4
8,1999,670400,14,7,7,6
9,1999,670400,18,14,4,0
10,1999,670400,12,4,8,1
11,1999,670400,10,8,2,0
12,1999,670400,15,11,4,0
1,2000,670400,7,4,3,2
2,2000,670400,16,12,4,3
3,2000,670400,8,4,4,5
4,2000,670400,14,10,4,1
5,2000,670400,7,4,3,1
6,2000,670400,14,8,6,2
7,2000,670400,23,14,9,4
8,2000,670400,14,9,5,2
9,2000,670400,13,11,2,0
10,2000,670400,10,7,3,1
11,2000,670400,13,11,2,1
12,2000,670400,5,3,2,1
1,2001,670400,10,7,3,3
2,2001,670400,8,4,4,1
3,2001,670400,12,11,1,0
4,2001,670400,10,8,2,7
5,2001,670400,10,6,4,2
6,2001,670400,14,7,7,1
7,2001,670400,15,10,5,1
8,2001,670400,10,5,5,1
9,2001,670400,13,10,3,3
10,2001,670400,19,11,8,2
11,2001,670400,9,7,2,0
12,2001,670400,15,10,5,3
1,2002,670400,12,9,3,1
2,2002,670400,10,6,4,2
3,2002,670400,9,6,3,2
4,2002,670400,15,8,7,5
5,2002,670400,14,8,6,0
6,2002,670400,12,9,3,1
7,2002,670400,10,6,4,2
8,2002,670400,9,4,5,1
9,2002,670400,18,13,5,2
10,2002,670400,15,12,3,0
11,2002,670400,11,5,6,4
12,2002,670400,11,6,5,2
1,2003,670400,5,4,1,2
2,2003,670400,8,7,1,2
3,2003,670400,16,11,5,0
4,2003,670400,15,12,3,1
5,2003,670400,16,12,4,1
6,2003,670400,7,6,1,3
7,2003,670400,15,11,4,4
8,2003,670400,17,14,3,1
9,2003,670400,9,9,0,0
10,2003,670400,8,7,1,2
11,2003,670400,11,8,3,4
12,2003,670400,11,9,2,6
1,2004,670400,14,12,2,8
2,2004,670400,9,6,3,1
3,2004,670400,13,10,3,0
4,2004,670400,22,15,7,1
5,2004,670400,20,17,3,2
6,2004,670400,22,19,3,3
7,2004,670400,22,14,8,4
8,2004,670400,9,7,2,3
9,2004,670400,11,9,2,1
10,2004,670400,16,12,4,3
11,2004,670400,12,8,4,4
12,2004,670400,7,5,2,1
1,2005,670400,4,2,2,0
2,2005,670400,5,3,2,1
3,2005,670400,8,4,4,7
4,2005,670400,10,7,3,6
5,2005,670400,16,8,8,2
6,2005,670400,18,12,6,3
7,2005,670400,16,12,4,3
8,2005,670400,10,6,4,1
9,2005,670400,8,4,4,3
10,2005,670400,12,10,2,2
11,2005,670400,14,13,1,3
12,2005,670400,10,7,3,1
1,2006,670400,11,7,4,1
2,2006,670400,9,8,1,5
3,2006,670400,8,6,2,4
4,2006,670400,16,8,8,6
5,2006,670400,13,8,5,3
6,2006,670400,10,5,5,3
7,2006,670400,8,5,3,3
8,2006,670400,11,9,2,2
9,2006,670400,9,8,1,7
10,2006,670400,14,12,2,4
11,2006,670400,11,11,0,1
12,2006,670400,6,4,2,3
1,2007,670400,8,7,1,2
2,2007,670400,9,6,3,1
3,2007,670400,10,5,5,5
4,2007,670400,11,9,2,6
5,2007,670400,9,5,4,10
6,2007,670400,15,12,3,1
7,2007,670400,17,10,7,2
8,2007,670400,10,9,1,4
9,2007,670400,13,8,5,5
10,2007,670400,11,9,2,3
11,2007,670400,16,12,4,1
12,2007,670400,6,5,1,5
1,2008,670400,13,10,3,0
2,2008,670400,4,4,0,3
3,2008,670400,12,8,4,7
4,2008,670400,8,5,3,0
5,2008,670400,8,6,2,2
6,2008,670400,14,11,3,0
7,2008,670400,10,5,5,1
8,2008,670400,16,13,3,1
9,2008,670400,12,8,4,3
10,2008,670400,9,4,5,2
11,2008,670400,13,10,3,2
12,2008,670400,2,2,0,3
1,2009,670400,6,4,2,1
2,2009,670400,3,2,1,4
3,2009,670400,8,7,1,2
4,2009,670400,7,4,3,3
5,2009,670400,13,10,3,4
6,2009,670400,11,8,3,1
7,2009,670400,13,9,4,2
8,2009,670400,9,6,3,2
9,2009,670400,5,5,0,4
10,2009,670400,7,7,0,4
11,2009,670400,9,7,2,4
12,2009,670400,9,7,2,2
1,2010,670400,12,8,4,3
2,2010,670400,7,6,1,2
3,2010,670400,11,3,8,5
4,2010,670400,8,6,2,4
5,2010,670400,8,6,2,2
6,2010,670400,7,6,1,5
7,2010,670400,9,8,1,4
8,2010,670400,18,14,4,3
9,2010,670400,13,9,4,4
10,2010,670400,12,9,3,1
11,2010,670400,10,7,3,4
12,2010,670400,6,4,2,4
1,2011,670400,13,11,2,4
2,2011,670400,6,5,1,2
1,1999,670200,12,10,2,7
2,1999,670200,13,8,5,7
3,1999,670200,6,4,2,5
4,1999,670200,12,6,6,1
5,1999,670200,4,3,1,2
6,1999,670200,8,4,4,1
7,1999,670200,17,9,8,7
8,1999,670200,19,13,6,3
9,1999,670200,21,17,4,5
10,1999,670200,12,7,5,6
11,1999,670200,11,8,3,6
12,1999,670200,9,6,3,11
1,2000,670200,12,11,1,7
2,2000,670200,8,6,2,8
3,2000,670200,7,4,3,14
4,2000,670200,10,8,2,5
5,2000,670200,11,7,4,4
6,2000,670200,10,7,3,10
7,2000,670200,10,7,3,8
8,2000,670200,13,6,7,10
9,2000,670200,15,7,8,4
10,2000,670200,11,4,7,13
11,2000,670200,14,9,5,13
12,2000,670200,12,7,5,2
1,2001,670200,11,7,4,9
2,2001,670200,7,6,1,9
3,2001,670200,9,4,5,11
4,2001,670200,12,10,2,10
5,2001,670200,15,6,9,12
6,2001,670200,13,7,6,8
7,2001,670200,22,14,8,10
8,2001,670200,17,13,4,10
9,2001,670200,10,6,4,4
10,2001,670200,4,3,1,6
11,2001,670200,14,8,6,10
12,2001,670200,13,10,3,10
1,2002,670200,11,8,3,20
2,2002,670200,7,5,2,9
3,2002,670200,9,7,2,6
4,2002,670200,8,5,3,12
5,2002,670200,10,5,5,15
6,2002,670200,14,11,3,9
7,2002,670200,15,7,8,13
8,2002,670200,17,11,6,7
9,2002,670200,24,12,12,8
10,2002,670200,8,6,2,21
11,2002,670200,17,10,7,11
12,2002,670200,13,11,2,16
1,2003,670200,15,11,4,16
2,2003,670200,7,6,1,18
3,2003,670200,13,6,7,18
4,2003,670200,9,5,4,12
5,2003,670200,10,5,5,31
6,2003,670200,4,4,0,24
7,2003,670200,11,5,6,11
8,2003,670200,12,8,4,16
9,2003,670200,12,5,7,13
10,2003,670200,13,12,1,14
11,2003,670200,14,12,2,39
12,2003,670200,13,10,3,18
1,2004,670200,12,10,2,10
2,2004,670200,8,7,1,12
3,2004,670200,10,7,3,13
4,2004,670200,11,7,4,9
5,2004,670200,14,8,6,13
6,2004,670200,9,5,4,28
7,2004,670200,11,7,4,16
8,2004,670200,12,11,1,17
9,2004,670200,19,14,5,68
10,2004,670200,9,5,4,54
11,2004,670200,10,7,3,31
12,2004,670200,11,10,1,55
1,2005,670200,18,12,6,70
2,2005,670200,8,8,0,45
3,2005,670200,11,9,2,19
4,2005,670200,13,12,1,18
5,2005,670200,14,9,5,26
6,2005,670200,12,6,6,13
7,2005,670200,12,7,5,14
8,2005,670200,14,10,4,8
9,2005,670200,13,9,4,16
10,2005,670200,7,4,3,16
11,2005,670200,12,9,3,17
12,2005,670200,12,11,1,22
1,2006,670200,13,12,1,27
2,2006,670200,11,8,3,29
3,2006,670200,13,12,1,38
4,2006,670200,16,12,4,15
5,2006,670200,14,14,0,5
6,2006,670200,12,9,3,16
7,2006,670200,14,10,4,17
8,2006,670200,20,17,3,21
9,2006,670200,19,14,5,18
10,2006,670200,10,6,4,5
11,2006,670200,12,11,1,15
12,2006,670200,11,9,2,7
1,2007,670200,16,10,6,8
2,2007,670200,4,3,1,6
3,2007,670200,16,13,3,6
4,2007,670200,11,8,3,4
5,2007,670200,14,9,5,14
6,2007,670200,13,12,1,6
7,2007,670200,20,11,9,20
8,2007,670200,12,8,4,11
9,2007,670200,22,18,4,7
10,2007,670200,13,8,5,10
11,2007,670200,19,14,5,4
12,2007,670200,14,12,2,12
1,2008,670200,10,7,3,11
2,2008,670200,10,8,2,26
3,2008,670200,13,11,2,13
4,2008,670200,20,16,4,9
5,2008,670200,18,13,5,9
6,2008,670200,16,15,1,5
7,2008,670200,21,16,5,20
8,2008,670200,22,17,5,14
9,2008,670200,19,17,2,22
10,2008,670200,20,15,5,32
11,2008,670200,10,9,1,15
12,2008,670200,6,6,0,17
1,2009,670200,12,12,0,10
2,2009,670200,8,5,3,22
3,2009,670200,11,9,2,4
4,2009,670200,7,4,3,11
5,2009,670200,14,7,7,8
6,2009,670200,9,6,3,9
7,2009,670200,15,14,1,6
8,2009,670200,6,5,1,16
9,2009,670200,10,8,2,14
10,2009,670200,10,7,3,13
11,2009,670200,7,4,3,20
12,2009,670200,10,6,4,11
1,2010,670200,12,11,1,15
2,2010,670200,3,3,0,11
3,2010,670200,12,8,4,10
4,2010,670200,5,2,3,11
5,2010,670200,11,9,2,14
6,2010,670200,12,10,2,11
7,2010,670200,11,7,4,12
8,2010,670200,9,3,6,9
9,2010,670200,10,8,2,13
10,2010,670200,8,4,4,11
11,2010,670200,9,7,2,14
12,2010,670200,6,5,1,16
1,2011,670200,4,4,0,10
2,2011,670200,3,3,0,5
1,1999,670100,11,10,1,30
2,1999,670100,9,5,4,21
3,1999,670100,17,9,8,8
4,1999,670100,12,6,6,9
5,1999,670100,10,8,2,6
6,1999,670100,14,7,7,14
7,1999,670100,12,8,4,8
8,1999,670100,10,6,4,34
9,1999,670100,11,8,3,7
10,1999,670100,9,4,5,5
11,1999,670100,9,6,3,5
12,1999,670100,7,5,2,16
1,2000,670100,13,8,5,11
2,2000,670100,5,4,1,3
3,2000,670100,16,11,5,4
4,2000,670100,12,8,4,5
5,2000,670100,17,11,6,9
6,2000,670100,19,14,5,4
7,2000,670100,15,10,5,4
8,2000,670100,22,15,7,13
9,2000,670100,14,8,6,0
10,2000,670100,12,8,4,4
11,2000,670100,8,5,3,4
12,2000,670100,7,6,1,2
1,2001,670100,12,8,4,5
2,2001,670100,8,7,1,17
3,2001,670100,8,7,1,10
4,2001,670100,14,4,10,9
5,2001,670100,8,7,1,8
6,2001,670100,14,10,4,13
7,2001,670100,15,11,4,24
8,2001,670100,18,14,4,13
9,2001,670100,19,14,5,7
10,2001,670100,11,8,3,24
11,2001,670100,14,10,4,18
12,2001,670100,12,8,4,7
1,2002,670100,15,14,1,23
2,2002,670100,6,5,1,18
3,2002,670100,7,4,3,18
4,2002,670100,8,4,4,17
5,2002,670100,10,7,3,50
6,2002,670100,11,10,1,9
7,2002,670100,9,7,2,4
8,2002,670100,14,9,5,43
9,2002,670100,10,5,5,10
10,2002,670100,11,8,3,17
11,2002,670100,11,8,3,8
12,2002,670100,9,8,1,16
1,2003,670100,11,10,1,22
2,2003,670100,9,7,2,30
3,2003,670100,13,8,5,27
4,2003,670100,12,10,2,23
5,2003,670100,11,7,4,37
6,2003,670100,10,7,3,27
7,2003,670100,18,12,6,16
8,2003,670100,7,6,1,8
9,2003,670100,14,8,6,39
10,2003,670100,10,9,1,16
11,2003,670100,6,6,0,11
12,2003,670100,17,15,2,8
1,2004,670100,9,8,1,17
2,2004,670100,6,5,1,7
3,2004,670100,11,8,3,11
4,2004,670100,2,2,0,11
5,2004,670100,13,12,1,24
6,2004,670100,8,6,2,11
7,2004,670100,13,5,8,18
8,2004,670100,28,24,4,13
9,2004,670100,16,10,6,11
10,2004,670100,19,11,8,15
11,2004,670100,7,7,0,12
12,2004,670100,8,7,1,23
1,2005,670100,9,5,4,18
2,2005,670100,10,8,2,5
3,2005,670100,10,9,1,20
4,2005,670100,16,9,7,47
5,2005,670100,23,14,9,13
6,2005,670100,21,15,6,15
7,2005,670100,14,12,2,9
8,2005,670100,12,8,4,10
9,2005,670100,16,9,7,7
10,2005,670100,15,13,2,8
11,2005,670100,16,13,3,27
12,2005,670100,4,4,0,21
1,2006,670100,9,9,0,23
2,2006,670100,8,6,2,14
3,2006,670100,14,14,0,20
4,2006,670100,4,3,1,7
5,2006,670100,11,7,4,37
6,2006,670100,15,13,2,4
7,2006,670100,11,8,3,17
8,2006,670100,17,12,5,5
9,2006,670100,13,6,7,26
10,2006,670100,11,10,1,25
11,2006,670100,3,1,2,8
12,2006,670100,14,14,0,6
1,2007,670100,9,8,1,25
2,2007,670100,3,1,2,1
3,2007,670100,11,9,2,9
4,2007,670100,6,5,1,19
5,2007,670100,14,12,2,7
6,2007,670100,12,11,1,2
7,2007,670100,16,10,6,13
8,2007,670100,17,10,7,10
9,2007,670100,12,11,1,4
10,2007,670100,16,10,6,14
11,2007,670100,6,5,1,7
12,2007,670100,7,5,2,10
1,2008,670100,6,4,2,7
2,2008,670100,11,10,1,20
3,2008,670100,7,4,3,6
4,2008,670100,10,7,3,5
5,2008,670100,15,10,5,7
6,2008,670100,10,7,3,17
7,2008,670100,15,14,1,9
8,2008,670100,7,7,0,26
9,2008,670100,10,8,2,7
10,2008,670100,7,4,3,13
11,2008,670100,9,9,0,11
12,2008,670100,8,7,1,13
1,2009,670100,2,2,0,7
2,2009,670100,12,11,1,8
3,2009,670100,10,7,3,10
4,2009,670100,3,3,0,5
5,2009,670100,8,6,2,5
6,2009,670100,5,5,0,10
7,2009,670100,17,15,2,6
8,2009,670100,7,6,1,10
9,2009,670100,14,13,1,14
10,2009,670100,4,4,0,11
11,2009,670100,8,6,2,4
12,2009,670100,10,9,1,10
1,2010,670100,5,5,0,19
2,2010,670100,4,4,0,12
3,2010,670100,10,8,2,19
4,2010,670100,10,8,2,12
5,2010,670100,13,6,7,7
6,2010,670100,11,8,3,10
7,2010,670100,13,11,2,11
8,2010,670100,10,7,3,6
9,2010,670100,11,10,1,20
10,2010,670100,13,12,1,6
11,2010,670100,6,6,0,11
12,2010,670100,5,5,0,11
1,2011,670100,7,4,3,4
2,2011,670100,2,2,0,6
1,1999,680500,16,9,7,16
2,1999,680500,12,6,6,5
3,1999,680500,12,7,5,10
4,1999,680500,15,9,6,12
5,1999,680500,19,14,5,6
6,1999,680500,11,7,4,4
7,1999,680500,12,6,6,6
8,1999,680500,9,4,5,9
9,1999,680500,17,12,5,3
10,1999,680500,22,16,6,7
11,1999,680500,11,5,6,10
12,1999,680500,14,7,7,10
1,2000,680500,5,4,1,14
2,2000,680500,3,1,2,9
3,2000,680500,13,9,4,13
4,2000,680500,16,6,10,15
5,2000,680500,7,6,1,23
6,2000,680500,9,5,4,9
7,2000,680500,12,9,3,13
8,2000,680500,14,8,6,14
9,2000,680500,20,15,5,8
10,2000,680500,20,16,4,10
11,2000,680500,13,11,2,13
12,2000,680500,11,6,5,9
1,2001,680500,12,9,3,18
2,2001,680500,10,7,3,15
3,2001,680500,11,9,2,13
4,2001,680500,12,7,5,14
5,2001,680500,13,10,3,14
6,2001,680500,15,13,2,6
7,2001,680500,13,7,6,2
8,2001,680500,12,5,7,4
9,2001,680500,7,4,3,9
10,2001,680500,7,6,1,34
11,2001,680500,10,6,4,8
12,2001,680500,10,8,2,9
1,2002,680500,8,7,1,21
2,2002,680500,11,6,5,15
3,2002,680500,9,5,4,15
4,2002,680500,11,9,2,6
5,2002,680500,11,7,4,14
6,2002,680500,20,9,11,14
7,2002,680500,9,6,3,8
8,2002,680500,18,12,6,9
9,2002,680500,16,14,2,10
10,2002,680500,17,13,4,18
11,2002,680500,10,7,3,11
12,2002,680500,13,8,5,22
1,2003,680500,13,11,2,16
2,2003,680500,9,8,1,24
3,2003,680500,7,6,1,23
4,2003,680500,5,3,2,14
5,2003,680500,13,8,5,30
6,2003,680500,19,15,4,21
7,2003,680500,20,10,10,17
8,2003,680500,13,8,5,8
9,2003,680500,13,12,1,3
10,2003,680500,19,13,6,28
11,2003,680500,25,23,2,35
12,2003,680500,14,14,0,22
1,2004,680500,14,11,3,24
2,2004,680500,8,3,5,18
3,2004,680500,7,4,3,15
4,2004,680500,10,5,5,21
5,2004,680500,15,11,4,15
6,2004,680500,12,10,2,10
7,2004,680500,16,12,4,7
8,2004,680500,6,5,1,9
9,2004,680500,9,6,3,16
10,2004,680500,14,11,3,5
11,2004,680500,11,9,2,6
12,2004,680500,15,11,4,10
1,2005,680500,11,10,1,7
2,2005,680500,4,4,0,13
3,2005,680500,12,9,3,38
4,2005,680500,15,11,4,22
5,2005,680500,20,19,1,57
6,2005,680500,14,6,8,55
7,2005,680500,6,3,3,11
8,2005,680500,15,10,5,5
9,2005,680500,9,5,4,6
10,2005,680500,14,12,2,5
11,2005,680500,10,10,0,3
12,2005,680500,10,9,1,9
1,2006,680500,13,11,2,4
2,2006,680500,8,5,3,5
3,2006,680500,11,9,2,17
4,2006,680500,11,9,2,5
5,2006,680500,9,8,1,2
6,2006,680500,17,12,5,2
7,2006,680500,11,7,4,7
8,2006,680500,22,17,5,11
9,2006,680500,6,5,1,6
10,2006,680500,13,12,1,5
11,2006,680500,8,4,4,3
12,2006,680500,14,12,2,16
1,2007,680500,8,6,2,15
2,2007,680500,8,6,2,5
3,2007,680500,14,8,6,6
4,2007,680500,7,5,2,0
5,2007,680500,13,10,3,8
6,2007,680500,13,9,4,2
7,2007,680500,19,16,3,3
8,2007,680500,13,9,4,5
9,2007,680500,17,14,3,4
10,2007,680500,11,9,2,6
11,2007,680500,12,10,2,2
12,2007,680500,16,15,1,17
1,2008,680500,6,3,3,3
2,2008,680500,7,6,1,7
3,2008,680500,9,7,2,6
4,2008,680500,11,10,1,8
5,2008,680500,12,9,3,1
6,2008,680500,7,6,1,3
7,2008,680500,13,11,2,0
8,2008,680500,10,7,3,6
9,2008,680500,10,9,1,9
10,2008,680500,17,14,3,5
11,2008,680500,7,6,1,10
12,2008,680500,9,7,2,5
1,2009,680500,11,11,0,12
2,2009,680500,7,6,1,11
3,2009,680500,11,8,3,9
4,2009,680500,2,1,1,5
5,2009,680500,9,6,3,10
6,2009,680500,9,5,4,11
7,2009,680500,12,11,1,4
8,2009,680500,9,5,4,5
9,2009,680500,9,8,1,6
10,2009,680500,13,10,3,3
11,2009,680500,11,9,2,7
12,2009,680500,4,4,0,13
1,2010,680500,7,6,1,8
2,2010,680500,3,1,2,6
3,2010,680500,4,2,2,5
4,2010,680500,7,5,2,3
5,2010,680500,6,4,2,4
6,2010,680500,5,3,2,8
7,2010,680500,14,8,6,5
8,2010,680500,12,11,1,8
9,2010,680500,7,4,3,8
10,2010,680500,9,7,2,5
11,2010,680500,6,6,0,13
12,2010,680500,7,5,2,12
1,2011,680500,6,4,2,5
2,2011,680500,7,7,0,4
1,1999,834700,27,21,6,23
2,1999,834700,23,18,5,15
3,1999,834700,31,24,7,13
4,1999,834700,19,12,7,11
5,1999,834700,24,13,11,7
6,1999,834700,23,15,8,9
7,1999,834700,30,23,7,17
8,1999,834700,21,14,7,13
9,1999,834700,27,18,9,10
10,1999,834700,22,17,5,10
11,1999,834700,30,24,6,14
12,1999,834700,21,18,3,10
1,2000,834700,28,21,7,18
2,2000,834700,29,23,6,18
3,2000,834700,32,27,5,22
4,2000,834700,22,20,2,8
5,2000,834700,28,21,7,13
6,2000,834700,23,19,4,11
7,2000,834700,24,21,3,13
8,2000,834700,40,29,11,7
9,2000,834700,37,29,8,9
10,2000,834700,39,28,11,16
11,2000,834700,36,32,4,17
12,2000,834700,18,15,3,9
1,2001,834700,24,15,9,16
2,2001,834700,15,11,4,12
3,2001,834700,18,13,5,17
4,2001,834700,29,20,9,10
5,2001,834700,41,28,13,8
6,2001,834700,34,24,10,12
7,2001,834700,31,18,13,10
8,2001,834700,38,25,13,10
9,2001,834700,31,19,12,10
10,2001,834700,28,18,10,20
11,2001,834700,32,20,12,14
12,2001,834700,14,11,3,11
1,2002,834700,27,21,6,30
2,2002,834700,15,10,5,11
3,2002,834700,21,16,5,17
4,2002,834700,24,14,10,14
5,2002,834700,24,14,10,11
6,2002,834700,29,20,9,16
7,2002,834700,34,27,7,6
8,2002,834700,34,21,13,15
9,2002,834700,32,24,8,16
10,2002,834700,22,12,10,24
11,2002,834700,25,19,6,22
12,2002,834700,25,22,3,21
1,2003,834700,26,20,6,30
2,2003,834700,24,19,5,16
3,2003,834700,23,14,9,21
4,2003,834700,27,20,7,23
5,2003,834700,35,28,7,31
6,2003,834700,25,21,4,34
7,2003,834700,34,26,8,10
8,2003,834700,27,22,5,9
9,2003,834700,24,21,3,7
10,2003,834700,27,21,6,27
11,2003,834700,32,22,10,20
12,2003,834700,26,23,3,37
1,2004,834700,27,22,5,12
2,2004,834700,21,16,5,29
3,2004,834700,37,33,4,22
4,2004,834700,32,20,12,23
5,2004,834700,37,23,14,20
6,2004,834700,31,15,16,21
7,2004,834700,27,22,5,27
8,2004,834700,28,23,5,19
9,2004,834700,27,20,7,20
10,2004,834700,24,19,5,20
11,2004,834700,28,22,6,43
12,2004,834700,17,15,2,63
1,2005,834700,23,17,6,22
2,2005,834700,21,18,3,10
3,2005,834700,18,16,2,21
4,2005,834700,32,23,9,27
5,2005,834700,22,11,11,30
6,2005,834700,28,20,8,34
7,2005,834700,24,18,6,17
8,2005,834700,28,24,4,10
9,2005,834700,27,23,4,3
10,2005,834700,23,20,3,9
11,2005,834700,15,12,3,13
12,2005,834700,14,13,1,13
1,2006,834700,21,15,6,16
2,2006,834700,13,10,3,14
3,2006,834700,32,22,10,21
4,2006,834700,27,21,6,23
5,2006,834700,24,19,5,11
6,2006,834700,25,17,8,13
7,2006,834700,32,25,7,13
8,2006,834700,30,20,10,36
9,2006,834700,32,29,3,9
10,2006,834700,20,16,4,6
11,2006,834700,18,17,1,9
12,2006,834700,25,22,3,10
1,2007,834700,24,20,4,14
2,2007,834700,12,9,3,5
3,2007,834700,19,14,5,15
4,2007,834700,21,17,4,12
5,2007,834700,36,30,6,10
6,2007,834700,39,32,7,11
7,2007,834700,36,29,7,12
8,2007,834700,32,30,2,15
9,2007,834700,33,25,8,19
10,2007,834700,38,28,10,26
11,2007,834700,35,29,6,26
12,2007,834700,25,20,5,15
1,2008,834700,34,29,5,27
2,2008,834700,24,20,4,13
3,2008,834700,25,15,10,12
4,2008,834700,39,27,12,6
5,2008,834700,33,24,9,7
6,2008,834700,39,33,6,12
7,2008,834700,33,29,4,12
8,2008,834700,40,34,6,12
9,2008,834700,40,35,5,15
10,2008,834700,32,26,6,10
11,2008,834700,27,21,6,19
12,2008,834700,24,23,1,5
1,2009,834700,28,25,3,25
2,2009,834700,22,18,4,8
3,2009,834700,22,15,7,22
4,2009,834700,26,17,9,13
5,2009,834700,30,24,6,12
6,2009,834700,22,17,5,7
7,2009,834700,22,14,8,7
8,2009,834700,24,20,4,16
9,2009,834700,21,18,3,17
10,2009,834700,30,25,5,7
11,2009,834700,19,18,1,11
12,2009,834700,17,16,1,14
1,2010,834700,21,18,3,22
2,2010,834700,19,11,8,11
3,2010,834700,15,13,2,9
4,2010,834700,25,24,1,17
5,2010,834700,35,33,2,7
6,2010,834700,33,26,7,11
7,2010,834700,50,45,5,9
8,2010,834700,38,28,10,6
9,2010,834700,29,27,2,12
10,2010,834700,29,23,6,16
11,2010,834700,12,11,1,10
12,2010,834700,17,13,4,7
1,2011,834700,20,17,3,14
2,2011,834700,15,12,3,2
1,1999,400500,22,17,5,1
2,1999,400500,27,20,7,5
3,1999,400500,19,14,5,9
4,1999,400500,21,17,4,3
5,1999,400500,26,17,9,4
6,1999,400500,26,17,9,5
7,1999,400500,36,23,13,2
8,1999,400500,39,37,2,4
9,1999,400500,48,38,10,7
10,1999,400500,34,28,6,5
11,1999,400500,35,23,12,5
12,1999,400500,25,21,4,8
1,2000,400500,26,21,5,1
2,2000,400500,37,28,9,1
3,2000,400500,26,22,4,11
4,2000,400500,21,13,8,3
5,2000,400500,24,12,12,9
6,2000,400500,40,26,14,0
7,2000,400500,27,16,11,13
8,2000,400500,33,24,9,11
9,2000,400500,23,14,9,5
10,2000,400500,36,29,7,12
11,2000,400500,18,12,6,4
12,2000,400500,16,14,2,2
1,2001,400500,23,17,6,4
2,2001,400500,12,11,1,3
3,2001,400500,17,11,6,10
4,2001,400500,24,11,13,4
5,2001,400500,18,9,9,7
6,2001,400500,23,20,3,4
7,2001,400500,22,18,4,8
8,2001,400500,23,21,2,5
9,2001,400500,22,14,8,4
10,2001,400500,19,13,6,12
11,2001,400500,24,17,7,2
12,2001,400500,16,10,6,4
1,2002,400500,29,19,10,2
2,2002,400500,15,11,4,5
3,2002,400500,12,11,1,2
4,2002,400500,10,7,3,8
5,2002,400500,24,17,7,5
6,2002,400500,26,23,3,1
7,2002,400500,24,17,7,4
8,2002,400500,20,14,6,3
9,2002,400500,29,24,5,2
10,2002,400500,23,12,11,0
11,2002,400500,17,16,1,0
12,2002,400500,14,11,3,2
1,2003,400500,16,13,3,4
2,2003,400500,11,8,3,1
3,2003,400500,15,10,5,5
4,2003,400500,21,15,6,3
5,2003,400500,30,23,7,4
6,2003,400500,30,24,6,4
7,2003,400500,27,17,10,1
8,2003,400500,27,18,9,4
9,2003,400500,24,16,8,3
10,2003,400500,27,23,4,11
11,2003,400500,18,15,3,8
12,2003,400500,18,18,0,8
1,2004,400500,28,20,8,4
2,2004,400500,13,10,3,13
3,2004,400500,18,17,1,1
4,2004,400500,27,23,4,3
5,2004,400500,17,11,6,4
6,2004,400500,27,20,7,1
7,2004,400500,33,25,8,4
8,2004,400500,20,16,4,3
9,2004,400500,21,18,3,1
10,2004,400500,22,17,5,9
11,2004,400500,15,11,4,4
12,2004,400500,20,17,3,4
1,2005,400500,18,15,3,5
2,2005,400500,24,20,4,1
3,2005,400500,10,7,3,2
4,2005,400500,17,16,1,1
5,2005,400500,25,16,9,8
6,2005,400500,17,10,7,1
7,2005,400500,24,23,1,3
8,2005,400500,21,16,5,2
9,2005,400500,21,14,7,6
10,2005,400500,14,11,3,8
11,2005,400500,18,15,3,3
12,2005,400500,10,9,1,1
1,2006,400500,12,11,1,1
2,2006,400500,13,12,1,4
3,2006,400500,16,14,2,5
4,2006,400500,19,11,8,2
5,2006,400500,14,10,4,5
6,2006,400500,23,18,5,5
7,2006,400500,26,21,5,3
8,2006,400500,23,20,3,2
9,2006,400500,24,20,4,1
10,2006,400500,21,17,4,1
11,2006,400500,24,22,2,4
12,2006,400500,19,15,4,3
1,2007,400500,13,12,1,2
2,2007,400500,11,11,0,2
3,2007,400500,19,14,5,2
4,2007,400500,21,17,4,1
5,2007,400500,24,18,6,4
6,2007,400500,25,22,3,2
7,2007,400500,21,18,3,1
8,2007,400500,18,12,6,0
9,2007,400500,26,22,4,0
10,2007,400500,18,16,2,5
11,2007,400500,10,10,0,7
12,2007,400500,18,16,2,8
1,2008,400500,18,14,4,8
2,2008,400500,17,13,4,2
3,2008,400500,21,16,5,3
4,2008,400500,31,27,4,1
5,2008,400500,15,12,3,2
6,2008,400500,23,19,4,7
7,2008,400500,13,8,5,1
8,2008,400500,19,18,1,8
9,2008,400500,24,20,4,4
10,2008,400500,24,19,5,5
11,2008,400500,15,14,1,2
12,2008,400500,12,12,0,2
1,2009,400500,17,17,0,6
2,2009,400500,9,9,0,3
3,2009,400500,7,6,1,11
4,2009,400500,16,14,2,2
5,2009,400500,21,18,3,10
6,2009,400500,20,14,6,3
7,2009,400500,28,23,5,4
8,2009,400500,20,15,5,9
9,2009,400500,20,18,2,4
10,2009,400500,22,16,6,9
11,2009,400500,19,13,6,7
12,2009,400500,17,15,2,4
1,2010,400500,16,10,6,9
2,2010,400500,11,9,2,7
3,2010,400500,8,5,3,9
4,2010,400500,13,9,4,6
5,2010,400500,10,7,3,6
6,2010,400500,20,18,2,11
7,2010,400500,16,9,7,5
8,2010,400500,11,7,4,9
9,2010,400500,20,16,4,12
10,2010,400500,17,14,3,8
11,2010,400500,15,13,2,10
12,2010,400500,17,16,1,11
1,2011,400500,19,17,2,7
2,2011,400500,11,11,0,8
1,1999,400400,8,6,2,9
2,1999,400400,13,9,4,15
3,1999,400400,8,5,3,14
4,1999,400400,7,3,4,0
5,1999,400400,15,9,6,7
6,1999,400400,10,8,2,5
7,1999,400400,21,15,6,4
8,1999,400400,14,11,3,4
9,1999,400400,12,10,2,1
10,1999,400400,9,5,4,12
11,1999,400400,16,9,7,5
12,1999,400400,15,10,5,7
1,2000,400400,13,10,3,5
2,2000,400400,7,6,1,5
3,2000,400400,11,10,1,6
4,2000,400400,13,12,1,5
5,2000,400400,12,9,3,4
6,2000,400400,11,9,2,8
7,2000,400400,15,12,3,10
8,2000,400400,19,17,2,11
9,2000,400400,12,8,4,5
10,2000,400400,14,10,4,4
11,2000,400400,15,13,2,4
12,2000,400400,5,4,1,6
1,2001,400400,9,6,3,11
2,2001,400400,16,14,2,7
3,2001,400400,11,11,0,13
4,2001,400400,14,8,6,11
5,2001,400400,7,4,3,16
6,2001,400400,14,10,4,12
7,2001,400400,15,11,4,10
8,2001,400400,9,6,3,9
9,2001,400400,13,9,4,9
10,2001,400400,16,11,5,12
11,2001,400400,13,10,3,7
12,2001,400400,16,10,6,1
1,2002,400400,4,3,1,5
2,2002,400400,6,3,3,14
3,2002,400400,9,8,1,11
4,2002,400400,9,6,3,9
5,2002,400400,10,8,2,5
6,2002,400400,13,9,4,4
7,2002,400400,24,22,2,5
8,2002,400400,23,18,5,3
9,2002,400400,7,7,0,3
10,2002,400400,17,16,1,4
11,2002,400400,6,5,1,0
12,2002,400400,9,8,1,3
1,2003,400400,4,4,0,14
2,2003,400400,7,5,2,8
3,2003,400400,13,11,2,5
4,2003,400400,12,8,4,3
5,2003,400400,15,11,4,4
6,2003,400400,11,9,2,1
7,2003,400400,15,10,5,2
8,2003,400400,18,18,0,8
9,2003,400400,14,11,3,5
10,2003,400400,10,7,3,8
11,2003,400400,11,10,1,2
12,2003,400400,7,6,1,3
1,2004,400400,9,7,2,3
2,2004,400400,6,3,3,18
3,2004,400400,11,9,2,0
4,2004,400400,12,12,0,0
5,2004,400400,10,9,1,2
6,2004,400400,10,7,3,4
7,2004,400400,16,13,3,5
8,2004,400400,8,7,1,3
9,2004,400400,11,9,2,3
10,2004,400400,6,5,1,7
11,2004,400400,9,6,3,4
12,2004,400400,13,10,3,7
1,2005,400400,6,3,3,3
2,2005,400400,5,5,0,2
3,2005,400400,12,9,3,5
4,2005,400400,10,7,3,1
5,2005,400400,9,8,1,8
6,2005,400400,12,10,2,2
7,2005,400400,19,15,4,5
8,2005,400400,13,9,4,5
9,2005,400400,12,11,1,3
10,2005,400400,7,5,2,8
11,2005,400400,7,7,0,2
12,2005,400400,11,10,1,6
1,2006,400400,8,6,2,1
2,2006,400400,10,9,1,3
3,2006,400400,7,4,3,2
4,2006,400400,12,11,1,1
5,2006,400400,15,13,2,2
6,2006,400400,17,14,3,2
7,2006,400400,14,11,3,1
8,2006,400400,17,13,4,4
9,2006,400400,21,21,0,5
10,2006,400400,13,9,4,6
11,2006,400400,18,17,1,5
12,2006,400400,18,18,0,2
1,2007,400400,14,14,0,3
2,2007,400400,5,5,0,4
3,2007,400400,14,11,3,7
4,2007,400400,16,15,1,2
5,2007,400400,21,17,4,1
6,2007,400400,17,17,0,3
7,2007,400400,18,16,2,2
8,2007,400400,14,14,0,3
9,2007,400400,14,11,3,10
10,2007,400400,11,6,5,11
11,2007,400400,12,10,2,4
12,2007,400400,17,14,3,2
1,2008,400400,11,9,2,8
2,2008,400400,11,8,3,4
3,2008,400400,8,6,2,3
4,2008,400400,6,5,1,7
5,2008,400400,11,7,4,1
6,2008,400400,7,4,3,4
7,2008,400400,12,10,2,4
8,2008,400400,11,6,5,4
9,2008,400400,12,11,1,7
10,2008,400400,14,12,2,5
11,2008,400400,10,10,0,6
12,2008,400400,9,9,0,2
1,2009,400400,6,5,1,9
2,2009,400400,9,9,0,2
3,2009,400400,5,3,2,6
4,2009,400400,12,11,1,5
5,2009,400400,15,10,5,3
6,2009,400400,6,4,2,5
7,2009,400400,20,15,5,5
8,2009,400400,16,12,4,9
9,2009,400400,16,13,3,1
10,2009,400400,11,9,2,10
11,2009,400400,14,10,4,6
12,2009,400400,10,9,1,10
1,2010,400400,10,9,1,6
2,2010,400400,6,6,0,5
3,2010,400400,5,4,1,6
4,2010,400400,8,8,0,4
5,2010,400400,16,14,2,5
6,2010,400400,11,10,1,3
7,2010,400400,6,5,1,4
8,2010,400400,13,11,2,7
9,2010,400400,12,11,1,2
10,2010,400400,14,14,0,3
11,2010,400400,10,9,1,2
12,2010,400400,12,12,0,5
1,2011,400400,16,16,0,5
2,2011,400400,9,9,0,1
1,1999,560900,11,11,0,0
2,1999,560900,7,5,2,0
3,1999,560900,12,12,0,0
4,1999,560900,18,18,0,0
5,1999,560900,6,5,1,0
6,1999,560900,15,15,0,0
7,1999,560900,9,8,1,0
8,1999,560900,15,15,0,0
9,1999,560900,9,9,0,1
10,1999,560900,11,9,2,0
11,1999,560900,7,7,0,0
12,1999,560900,8,7,1,0
1,2000,560900,7,7,0,0
2,2000,560900,5,5,0,0
3,2000,560900,10,10,0,0
4,2000,560900,10,9,1,0
5,2000,560900,15,13,2,0
6,2000,560900,10,10,0,0
7,2000,560900,11,11,0,1
8,2000,560900,14,14,0,1
9,2000,560900,10,10,0,0
10,2000,560900,6,6,0,0
11,2000,560900,8,8,0,0
12,2000,560900,8,8,0,0
1,2001,560900,14,13,1,0
2,2001,560900,8,8,0,0
3,2001,560900,11,11,0,1
4,2001,560900,10,10,0,0
5,2001,560900,13,13,0,0
6,2001,560900,10,9,1,0
7,2001,560900,9,7,2,0
8,2001,560900,13,13,0,1
9,2001,560900,7,7,0,1
10,2001,560900,12,11,1,0
11,2001,560900,10,10,0,0
12,2001,560900,12,11,1,1
1,2002,560900,17,16,1,0
2,2002,560900,5,3,2,0
3,2002,560900,16,15,1,0
4,2002,560900,14,14,0,0
5,2002,560900,23,22,1,0
6,2002,560900,20,18,2,1
7,2002,560900,14,14,0,0
8,2002,560900,18,16,2,1
9,2002,560900,17,16,1,0
10,2002,560900,15,14,1,0
11,2002,560900,14,12,2,0
12,2002,560900,19,19,0,0
1,2003,560900,14,14,0,1
2,2003,560900,5,5,0,0
3,2003,560900,6,6,0,5
4,2003,560900,9,9,0,0
5,2003,560900,8,8,0,3
6,2003,560900,14,14,0,0
7,2003,560900,18,16,2,1
8,2003,560900,22,20,2,0
9,2003,560900,13,12,1,0
10,2003,560900,9,9,0,0
11,2003,560900,20,18,2,1
12,2003,560900,10,8,2,0
1,2004,560900,10,10,0,0
2,2004,560900,10,10,0,1
3,2004,560900,11,11,0,2
4,2004,560900,6,6,0,0
5,2004,560900,5,5,0,0
6,2004,560900,16,15,1,1
7,2004,560900,12,11,1,0
8,2004,560900,6,6,0,0
9,2004,560900,4,3,1,3
10,2004,560900,11,11,0,0
11,2004,560900,18,17,1,0
12,2004,560900,21,21,0,0
1,2005,560900,17,16,1,0
2,2005,560900,5,5,0,0
3,2005,560900,14,12,2,1
4,2005,560900,18,17,1,0
5,2005,560900,12,11,1,0
6,2005,560900,11,11,0,0
7,2005,560900,8,8,0,1
8,2005,560900,7,7,0,2
9,2005,560900,12,12,0,1
10,2005,560900,3,3,0,2
11,2005,560900,14,14,0,0
12,2005,560900,6,6,0,0
1,2006,560900,8,7,1,3
2,2006,560900,11,11,0,2
3,2006,560900,4,4,0,7
4,2006,560900,6,5,1,0
5,2006,560900,6,6,0,1
6,2006,560900,20,20,0,0
7,2006,560900,20,19,1,5
8,2006,560900,24,21,3,3
9,2006,560900,10,9,1,3
10,2006,560900,14,12,2,1
11,2006,560900,4,4,0,1
12,2006,560900,7,6,1,0
1,2007,560900,10,10,0,3
2,2007,560900,3,3,0,2
3,2007,560900,11,8,3,2
4,2007,560900,12,11,1,0
5,2007,560900,10,9,1,1
6,2007,560900,14,11,3,0
7,2007,560900,5,5,0,2
8,2007,560900,9,7,2,4
9,2007,560900,9,7,2,3
10,2007,560900,12,12,0,1
11,2007,560900,14,13,1,3
12,2007,560900,13,12,1,0
1,2008,560900,16,14,2,0
2,2008,560900,11,11,0,1
3,2008,560900,10,10,0,3
4,2008,560900,9,9,0,1
5,2008,560900,4,3,1,1
6,2008,560900,15,12,3,1
7,2008,560900,10,10,0,0
8,2008,560900,8,8,0,0
9,2008,560900,8,7,1,1
10,2008,560900,13,13,0,1
11,2008,560900,14,13,1,0
12,2008,560900,9,8,1,0
1,2009,560900,5,5,0,1
2,2009,560900,3,3,0,1
3,2009,560900,3,3,0,0
4,2009,560900,11,10,1,4
5,2009,560900,10,9,1,0
6,2009,560900,11,10,1,0
7,2009,560900,7,6,1,1
8,2009,560900,10,9,1,0
9,2009,560900,7,7,0,0
10,2009,560900,7,6,1,1
11,2009,560900,5,5,0,2
12,2009,560900,4,4,0,0
1,2010,560900,4,4,0,0
2,2010,560900,5,5,0,0
3,2010,560900,7,7,0,2
4,2010,560900,6,5,1,1
5,2010,560900,16,14,2,2
6,2010,560900,7,7,0,0
7,2010,560900,12,11,1,0
8,2010,560900,12,11,1,2
9,2010,560900,13,13,0,0
10,2010,560900,9,7,2,3
11,2010,560900,8,7,1,0
12,2010,560900,8,8,0,0
1,2011,560900,4,4,0,0
2,2011,560900,3,3,0,3
1,1999,560800,15,15,0,6
2,1999,560800,9,7,2,4
3,1999,560800,17,15,2,3
4,1999,560800,11,10,1,0
5,1999,560800,18,16,2,1
6,1999,560800,13,12,1,0
7,1999,560800,16,15,1,0
8,1999,560800,13,13,0,1
9,1999,560800,21,21,0,2
10,1999,560800,12,11,1,1
11,1999,560800,16,12,4,6
12,1999,560800,12,12,0,0
1,2000,560800,12,9,3,0
2,2000,560800,11,9,2,2
3,2000,560800,16,15,1,1
4,2000,560800,11,11,0,2
5,2000,560800,14,11,3,1
6,2000,560800,11,9,2,0
7,2000,560800,11,11,0,0
8,2000,560800,18,17,1,1
9,2000,560800,18,17,1,1
10,2000,560800,17,16,1,1
11,2000,560800,20,19,1,0
12,2000,560800,18,18,0,0
1,2001,560800,19,14,5,0
2,2001,560800,6,6,0,1
3,2001,560800,21,19,2,1
4,2001,560800,13,11,2,0
5,2001,560800,21,19,2,0
6,2001,560800,17,17,0,1
7,2001,560800,13,13,0,2
8,2001,560800,24,23,1,2
9,2001,560800,13,12,1,1
10,2001,560800,28,28,0,0
11,2001,560800,22,21,1,0
12,2001,560800,17,17,0,1
1,2002,560800,19,19,0,1
2,2002,560800,13,13,0,1
3,2002,560800,21,20,1,1
4,2002,560800,15,14,1,1
5,2002,560800,24,22,2,2
6,2002,560800,18,16,2,0
7,2002,560800,16,16,0,1
8,2002,560800,23,21,2,4
9,2002,560800,14,14,0,2
10,2002,560800,16,14,2,1
11,2002,560800,12,11,1,0
12,2002,560800,17,15,2,1
1,2003,560800,20,18,2,4
2,2003,560800,16,15,1,3
3,2003,560800,18,18,0,1
4,2003,560800,18,17,1,1
5,2003,560800,21,19,2,2
6,2003,560800,16,14,2,1
7,2003,560800,18,18,0,0
8,2003,560800,19,17,2,1
9,2003,560800,12,12,0,2
10,2003,560800,14,14,0,1
11,2003,560800,14,14,0,0
12,2003,560800,15,15,0,0
1,2004,560800,15,15,0,0
2,2004,560800,8,7,1,1
3,2004,560800,17,15,2,2
4,2004,560800,12,12,0,4
5,2004,560800,16,13,3,1
6,2004,560800,17,17,0,3
7,2004,560800,23,21,2,2
8,2004,560800,12,10,2,5
9,2004,560800,15,13,2,0
10,2004,560800,9,8,1,0
11,2004,560800,22,21,1,1
12,2004,560800,18,18,0,0
1,2005,560800,12,12,0,1
2,2005,560800,18,17,1,0
3,2005,560800,15,13,2,1
4,2005,560800,15,14,1,0
5,2005,560800,18,15,3,0
6,2005,560800,11,8,3,0
7,2005,560800,13,9,4,2
8,2005,560800,12,10,2,3
9,2005,560800,15,15,0,0
10,2005,560800,15,12,3,0
11,2005,560800,15,15,0,1
12,2005,560800,17,16,1,0
1,2006,560800,10,9,1,1
2,2006,560800,10,10,0,2
3,2006,560800,16,12,4,7
4,2006,560800,14,13,1,2
5,2006,560800,16,15,1,3
6,2006,560800,10,10,0,1
7,2006,560800,16,15,1,3
8,2006,560800,12,12,0,3
9,2006,560800,17,17,0,1
10,2006,560800,15,10,5,2
11,2006,560800,14,13,1,0
12,2006,560800,18,17,1,6
1,2007,560800,16,16,0,15
2,2007,560800,5,5,0,1
3,2007,560800,18,18,0,1
4,2007,560800,10,10,0,3
5,2007,560800,11,11,0,2
6,2007,560800,9,9,0,2
7,2007,560800,13,12,1,3
8,2007,560800,16,16,0,0
9,2007,560800,15,15,0,0
10,2007,560800,15,14,1,3
11,2007,560800,17,17,0,3
12,2007,560800,21,20,1,0
1,2008,560800,15,15,0,1
2,2008,560800,16,16,0,1
3,2008,560800,6,5,1,1
4,2008,560800,6,5,1,0
5,2008,560800,13,12,1,0
6,2008,560800,13,13,0,1
7,2008,560800,16,14,2,0
8,2008,560800,14,13,1,1
9,2008,560800,19,18,1,5
10,2008,560800,10,10,0,0
11,2008,560800,14,14,0,2
12,2008,560800,14,14,0,1
1,2009,560800,11,10,1,1
2,2009,560800,14,13,1,2
3,2009,560800,12,12,0,1
4,2009,560800,16,15,1,2
5,2009,560800,18,16,2,0
6,2009,560800,18,16,2,2
7,2009,560800,10,10,0,1
8,2009,560800,14,10,4,2
9,2009,560800,9,6,3,5
10,2009,560800,15,15,0,2
11,2009,560800,16,14,2,3
12,2009,560800,8,7,1,1
1,2010,560800,4,4,0,1
2,2010,560800,7,7,0,0
3,2010,560800,7,7,0,6
4,2010,560800,8,7,1,5
5,2010,560800,12,10,2,3
6,2010,560800,10,10,0,3
7,2010,560800,9,9,0,3
8,2010,560800,12,11,1,6
9,2010,560800,18,16,2,0
10,2010,560800,18,17,1,0
11,2010,560800,12,11,1,1
12,2010,560800,7,7,0,1
1,2011,560800,11,10,1,2
2,2011,560800,10,10,0,0
1,1999,560700,13,13,0,0
2,1999,560700,16,15,1,0
3,1999,560700,10,9,1,0
4,1999,560700,20,19,1,0
5,1999,560700,19,18,1,0
6,1999,560700,14,14,0,1
7,1999,560700,24,23,1,1
8,1999,560700,16,16,0,0
9,1999,560700,16,16,0,3
10,1999,560700,12,11,1,1
11,1999,560700,12,12,0,0
12,1999,560700,19,18,1,0
1,2000,560700,13,13,0,0
2,2000,560700,21,21,0,1
3,2000,560700,11,11,0,0
4,2000,560700,24,23,1,0
5,2000,560700,16,16,0,0
6,2000,560700,10,10,0,0
7,2000,560700,10,10,0,0
8,2000,560700,13,13,0,1
9,2000,560700,21,21,0,0
10,2000,560700,19,19,0,1
11,2000,560700,10,9,1,0
12,2000,560700,23,22,1,0
1,2001,560700,20,19,1,1
2,2001,560700,12,11,1,1
3,2001,560700,21,20,1,0
4,2001,560700,17,15,2,0
5,2001,560700,16,14,2,2
6,2001,560700,9,8,1,0
7,2001,560700,21,21,0,0
8,2001,560700,21,20,1,0
9,2001,560700,21,20,1,0
10,2001,560700,22,19,3,0
11,2001,560700,20,20,0,2
12,2001,560700,13,13,0,0
1,2002,560700,9,8,1,1
2,2002,560700,14,14,0,1
3,2002,560700,11,11,0,0
4,2002,560700,11,10,1,1
5,2002,560700,25,24,1,1
6,2002,560700,22,21,1,1
7,2002,560700,18,18,0,0
8,2002,560700,15,15,0,0
9,2002,560700,14,13,1,0
10,2002,560700,20,20,0,0
11,2002,560700,11,11,0,0
12,2002,560700,15,14,1,3
1,2003,560700,8,7,1,2
2,2003,560700,13,13,0,0
3,2003,560700,13,12,1,0
4,2003,560700,12,12,0,0
5,2003,560700,23,21,2,0
6,2003,560700,13,12,1,1
7,2003,560700,14,14,0,0
8,2003,560700,11,10,1,1
9,2003,560700,12,10,2,0
10,2003,560700,13,13,0,0
11,2003,560700,22,22,0,0
12,2003,560700,14,12,2,0
1,2004,560700,10,10,0,0
2,2004,560700,11,11,0,0
3,2004,560700,14,14,0,0
4,2004,560700,14,14,0,0
5,2004,560700,13,12,1,0
6,2004,560700,11,10,1,0
7,2004,560700,12,11,1,2
8,2004,560700,10,9,1,0
9,2004,560700,9,8,1,1
10,2004,560700,18,14,4,0
11,2004,560700,14,13,1,2
12,2004,560700,12,11,1,2
1,2005,560700,9,9,0,0
2,2005,560700,4,3,1,3
3,2005,560700,15,13,2,1
4,2005,560700,8,4,4,0
5,2005,560700,8,7,1,0
6,2005,560700,9,9,0,1
7,2005,560700,13,11,2,1
8,2005,560700,13,12,1,0
9,2005,560700,12,8,4,0
10,2005,560700,18,18,0,0
11,2005,560700,15,14,1,1
12,2005,560700,7,7,0,1
1,2006,560700,10,8,2,1
2,2006,560700,6,5,1,0
3,2006,560700,8,6,2,0
4,2006,560700,3,3,0,1
5,2006,560700,11,10,1,1
6,2006,560700,10,8,2,3
7,2006,560700,12,12,0,3
8,2006,560700,24,24,0,1
9,2006,560700,22,22,0,3
10,2006,560700,16,15,1,2
11,2006,560700,22,17,5,0
12,2006,560700,11,11,0,1
1,2007,560700,10,10,0,3
2,2007,560700,7,7,0,0
3,2007,560700,8,5,3,0
4,2007,560700,10,10,0,2
5,2007,560700,10,10,0,0
6,2007,560700,6,6,0,2
7,2007,560700,7,6,1,1
8,2007,560700,12,12,0,2
9,2007,560700,10,8,2,0
10,2007,560700,7,6,1,0
11,2007,560700,5,5,0,2
12,2007,560700,12,12,0,0
1,2008,560700,9,8,1,1
2,2008,560700,5,5,0,0
3,2008,560700,4,4,0,2
4,2008,560700,7,7,0,2
5,2008,560700,6,5,1,1
6,2008,560700,7,6,1,0
7,2008,560700,5,4,1,0
8,2008,560700,13,13,0,1
9,2008,560700,15,14,1,1
10,2008,560700,12,10,2,1
11,2008,560700,7,6,1,2
12,2008,560700,10,9,1,0
1,2009,560700,8,6,2,0
2,2009,560700,6,6,0,0
3,2009,560700,11,10,1,0
4,2009,560700,15,11,4,1
5,2009,560700,5,4,1,3
6,2009,560700,9,7,2,1
7,2009,560700,2,2,0,0
8,2009,560700,8,5,3,1
9,2009,560700,19,17,2,1
10,2009,560700,11,10,1,0
11,2009,560700,9,9,0,1
12,2009,560700,11,11,0,1
1,2010,560700,7,7,0,2
2,2010,560700,5,5,0,1
3,2010,560700,8,8,0,1
4,2010,560700,9,6,3,1
5,2010,560700,7,7,0,5
6,2010,560700,6,3,3,0
7,2010,560700,4,4,0,1
8,2010,560700,3,3,0,1
9,2010,560700,3,3,0,0
10,2010,560700,3,1,2,2
11,2010,560700,7,7,0,0
12,2010,560700,8,8,0,0
1,2011,560700,3,2,1,0
2,2011,560700,3,3,0,1
1,1999,835200,6,6,0,0
2,1999,835200,3,3,0,3
3,1999,835200,6,5,1,0
4,1999,835200,11,9,2,1
5,1999,835200,9,9,0,0
6,1999,835200,11,10,1,0
7,1999,835200,9,9,0,1
8,1999,835200,4,4,0,0
9,1999,835200,10,8,2,0
10,1999,835200,9,8,1,1
11,1999,835200,5,5,0,0
12,1999,835200,2,2,0,0
1,2000,835200,3,2,1,1
2,2000,835200,5,5,0,2
3,2000,835200,5,4,1,0
4,2000,835200,5,5,0,1
5,2000,835200,8,7,1,0
6,2000,835200,10,9,1,0
7,2000,835200,6,5,1,1
8,2000,835200,11,9,2,0
9,2000,835200,6,4,2,0
10,2000,835200,8,7,1,1
11,2000,835200,7,7,0,3
12,2000,835200,7,7,0,0
1,2001,835200,6,6,0,0
2,2001,835200,7,6,1,0
3,2001,835200,8,8,0,2
4,2001,835200,4,4,0,1
5,2001,835200,7,7,0,2
6,2001,835200,5,5,0,0
7,2001,835200,7,7,0,0
8,2001,835200,12,12,0,1
9,2001,835200,6,6,0,0
10,2001,835200,12,11,1,0
11,2001,835200,7,7,0,0
12,2001,835200,12,12,0,1
1,2002,835200,4,3,1,0
2,2002,835200,3,3,0,0
3,2002,835200,8,8,0,0
4,2002,835200,8,6,2,0
5,2002,835200,9,8,1,1
6,2002,835200,14,14,0,2
7,2002,835200,13,10,3,0
8,2002,835200,13,11,2,0
9,2002,835200,9,9,0,1
10,2002,835200,6,6,0,0
11,2002,835200,7,6,1,0
12,2002,835200,16,16,0,2
1,2003,835200,13,13,0,3
2,2003,835200,7,7,0,4
3,2003,835200,9,9,0,0
4,2003,835200,4,3,1,4
5,2003,835200,6,5,1,1
6,2003,835200,7,6,1,0
7,2003,835200,7,6,1,1
8,2003,835200,10,9,1,0
9,2003,835200,7,7,0,1
10,2003,835200,4,4,0,0
11,2003,835200,8,7,1,0
12,2003,835200,8,8,0,0
1,2004,835200,9,5,4,1
2,2004,835200,6,5,1,3
3,2004,835200,11,10,1,1
4,2004,835200,6,5,1,0
5,2004,835200,7,6,1,1
6,2004,835200,3,3,0,0
7,2004,835200,10,9,1,0
8,2004,835200,6,6,0,0
9,2004,835200,10,10,0,0
10,2004,835200,9,8,1,0
11,2004,835200,7,6,1,0
12,2004,835200,9,8,1,2
1,2005,835200,5,4,1,0
2,2005,835200,5,3,2,1
3,2005,835200,2,2,0,1
4,2005,835200,5,5,0,1
5,2005,835200,5,5,0,1
6,2005,835200,4,3,1,0
7,2005,835200,4,3,1,0
8,2005,835200,6,5,1,0
9,2005,835200,6,5,1,1
10,2005,835200,8,8,0,0
11,2005,835200,3,3,0,0
12,2005,835200,4,4,0,2
1,2006,835200,6,5,1,0
2,2006,835200,3,3,0,0
3,2006,835200,3,3,0,0
4,2006,835200,8,7,1,0
5,2006,835200,5,2,3,0
6,2006,835200,3,3,0,0
7,2006,835200,7,6,1,1
8,2006,835200,6,6,0,0
9,2006,835200,4,4,0,1
10,2006,835200,6,6,0,2
11,2006,835200,4,3,1,1
12,2006,835200,4,4,0,0
1,2007,835200,7,6,1,1
2,2007,835200,4,4,0,0
3,2007,835200,6,6,0,0
4,2007,835200,5,3,2,0
5,2007,835200,8,8,0,1
6,2007,835200,6,6,0,1
7,2007,835200,5,5,0,1
8,2007,835200,8,7,1,1
9,2007,835200,5,3,2,0
10,2007,835200,6,4,2,2
11,2007,835200,3,3,0,1
12,2007,835200,4,4,0,2
1,2008,835200,4,4,0,1
2,2008,835200,4,4,0,1
3,2008,835200,7,7,0,0
4,2008,835200,6,5,1,0
5,2008,835200,8,7,1,2
6,2008,835200,5,5,0,4
7,2008,835200,9,7,2,0
8,2008,835200,7,7,0,2
9,2008,835200,4,4,0,0
10,2008,835200,10,8,2,0
11,2008,835200,3,3,0,0
12,2008,835200,6,5,1,0
1,2009,835200,3,3,0,4
2,2009,835200,4,4,0,0
3,2009,835200,2,2,0,1
4,2009,835200,7,7,0,0
5,2009,835200,5,5,0,1
6,2009,835200,5,5,0,2
7,2009,835200,2,2,0,2
8,2009,835200,2,2,0,0
9,2009,835200,2,1,1,0
10,2009,835200,6,5,1,0
11,2009,835200,2,2,0,0
12,2009,835200,5,5,0,0
1,2010,835200,2,2,0,0
2,2010,835200,2,2,0,0
3,2010,835200,5,4,1,0
4,2010,835200,3,3,0,0
5,2010,835200,9,7,2,0
6,2010,835200,3,3,0,1
7,2010,835200,1,1,0,4
8,2010,835200,3,2,1,0
9,2010,835200,7,6,1,1
10,2010,835200,7,6,1,0
11,2010,835200,1,1,0,0
12,2010,835200,3,3,0,0
1,2011,835200,2,2,0,0
2,2011,835200,3,3,0,0
1,1999,620200,7,6,1,1
2,1999,620200,7,7,0,1
3,1999,620200,10,10,0,0
4,1999,620200,12,12,0,2
5,1999,620200,9,8,1,2
6,1999,620200,9,8,1,1
7,1999,620200,9,8,1,1
8,1999,620200,9,9,0,2
9,1999,620200,11,10,1,1
10,1999,620200,9,9,0,3
11,1999,620200,13,11,2,2
12,1999,620200,10,10,0,3
1,2000,620200,8,8,0,1
2,2000,620200,8,8,0,2
3,2000,620200,9,8,1,5
4,2000,620200,6,6,0,5
5,2000,620200,6,6,0,3
6,2000,620200,11,11,0,5
7,2000,620200,14,13,1,11
8,2000,620200,18,16,2,1
9,2000,620200,17,16,1,6
10,2000,620200,11,10,1,1
11,2000,620200,18,18,0,4
12,2000,620200,20,19,1,1
1,2001,620200,21,20,1,2
2,2001,620200,8,8,0,5
3,2001,620200,9,8,1,4
4,2001,620200,7,5,2,2
5,2001,620200,14,12,2,9
6,2001,620200,6,4,2,5
7,2001,620200,5,4,1,10
8,2001,620200,13,13,0,5
9,2001,620200,9,8,1,4
10,2001,620200,14,14,0,4
11,2001,620200,7,6,1,10
12,2001,620200,10,9,1,3
1,2002,620200,9,7,2,2
2,2002,620200,10,10,0,2
3,2002,620200,3,3,0,2
4,2002,620200,11,10,1,1
5,2002,620200,13,11,2,1
6,2002,620200,9,9,0,0
7,2002,620200,20,19,1,4
8,2002,620200,15,14,1,1
9,2002,620200,12,12,0,2
10,2002,620200,5,5,0,2
11,2002,620200,11,11,0,2
12,2002,620200,13,11,2,1
1,2003,620200,15,15,0,1
2,2003,620200,8,6,2,3
3,2003,620200,15,15,0,0
4,2003,620200,16,15,1,3
5,2003,620200,9,9,0,3
6,2003,620200,12,12,0,3
7,2003,620200,7,6,1,7
8,2003,620200,8,8,0,1
9,2003,620200,11,10,1,1
10,2003,620200,9,8,1,2
11,2003,620200,8,8,0,1
12,2003,620200,17,16,1,0
1,2004,620200,14,13,1,1
2,2004,620200,6,6,0,1
3,2004,620200,7,6,1,0
4,2004,620200,10,10,0,2
5,2004,620200,10,10,0,2
6,2004,620200,11,11,0,1
7,2004,620200,13,13,0,0
8,2004,620200,10,10,0,0
9,2004,620200,15,13,2,1
10,2004,620200,18,17,1,0
11,2004,620200,17,15,2,0
12,2004,620200,16,15,1,3
1,2005,620200,4,3,1,0
2,2005,620200,5,5,0,3
3,2005,620200,14,12,2,1
4,2005,620200,8,6,2,0
5,2005,620200,12,11,1,2
6,2005,620200,16,12,4,1
7,2005,620200,15,9,6,2
8,2005,620200,9,9,0,1
9,2005,620200,11,11,0,2
10,2005,620200,9,9,0,0
11,2005,620200,13,13,0,0
12,2005,620200,11,11,0,1
1,2006,620200,11,9,2,0
2,2006,620200,5,3,2,0
3,2006,620200,7,7,0,2
4,2006,620200,17,17,0,0
5,2006,620200,15,14,1,2
6,2006,620200,8,8,0,8
7,2006,620200,12,11,1,3
8,2006,620200,3,3,0,4
9,2006,620200,13,11,2,0
10,2006,620200,17,12,5,0
11,2006,620200,13,12,1,1
12,2006,620200,1,1,0,4
1,2007,620200,12,11,1,2
2,2007,620200,8,6,2,1
3,2007,620200,7,6,1,2
4,2007,620200,4,4,0,2
5,2007,620200,12,11,1,7
6,2007,620200,17,11,6,3
7,2007,620200,13,12,1,2
8,2007,620200,12,11,1,7
9,2007,620200,10,10,0,7
10,2007,620200,10,10,0,2
11,2007,620200,5,5,0,5
12,2007,620200,7,5,2,3
1,2008,620200,6,6,0,3
2,2008,620200,7,6,1,1
3,2008,620200,8,7,1,1
4,2008,620200,10,8,2,4
5,2008,620200,5,4,1,2
6,2008,620200,10,9,1,1
7,2008,620200,16,14,2,4
8,2008,620200,22,21,1,1
9,2008,620200,12,10,2,4
10,2008,620200,14,13,1,3
11,2008,620200,13,13,0,4
12,2008,620200,15,13,2,7
1,2009,620200,11,11,0,4
2,2009,620200,10,8,2,2
3,2009,620200,8,8,0,5
4,2009,620200,10,10,0,2
5,2009,620200,11,11,0,5
6,2009,620200,11,10,1,4
7,2009,620200,13,13,0,5
8,2009,620200,8,7,1,5
9,2009,620200,6,6,0,2
10,2009,620200,5,4,1,0
11,2009,620200,13,12,1,2
12,2009,620200,9,9,0,2
1,2010,620200,11,11,0,5
2,2010,620200,7,6,1,3
3,2010,620200,10,9,1,4
4,2010,620200,11,11,0,2
5,2010,620200,14,10,4,2
6,2010,620200,10,7,3,1
7,2010,620200,8,6,2,3
8,2010,620200,12,10,2,1
9,2010,620200,11,10,1,0
10,2010,620200,11,9,2,1
11,2010,620200,9,8,1,0
12,2010,620200,8,8,0,5
1,2011,620200,8,8,0,1
2,2011,620200,2,2,0,0
1,1999,620100,21,19,2,0
2,1999,620100,20,19,1,1
3,1999,620100,31,29,2,2
4,1999,620100,38,36,2,3
5,1999,620100,25,24,1,1
6,1999,620100,26,24,2,2
7,1999,620100,34,31,3,1
8,1999,620100,34,31,3,0
9,1999,620100,41,37,4,5
10,1999,620100,42,42,0,2
11,1999,620100,41,40,1,1
12,1999,620100,36,33,3,5
1,2000,620100,42,38,4,3
2,2000,620100,31,30,1,3
3,2000,620100,28,25,3,1
4,2000,620100,23,19,4,3
5,2000,620100,25,24,1,7
6,2000,620100,30,29,1,1
7,2000,620100,26,26,0,5
8,2000,620100,25,22,3,4
9,2000,620100,26,24,2,8
10,2000,620100,27,24,3,8
11,2000,620100,41,39,2,8
12,2000,620100,21,21,0,0
1,2001,620100,16,13,3,6
2,2001,620100,29,25,4,1
3,2001,620100,37,34,3,0
4,2001,620100,22,21,1,2
5,2001,620100,33,32,1,1
6,2001,620100,31,28,3,4
7,2001,620100,21,19,2,1
8,2001,620100,33,32,1,4
9,2001,620100,34,30,4,4
10,2001,620100,52,48,4,3
11,2001,620100,28,27,1,2
12,2001,620100,23,21,2,0
1,2002,620100,22,20,2,8
2,2002,620100,20,16,4,1
3,2002,620100,28,28,0,0
4,2002,620100,36,35,1,2
5,2002,620100,36,33,3,2
6,2002,620100,30,29,1,4
7,2002,620100,54,51,3,2
8,2002,620100,40,39,1,3
9,2002,620100,36,30,6,2
10,2002,620100,29,27,2,2
11,2002,620100,44,42,2,5
12,2002,620100,46,43,3,2
1,2003,620100,35,33,2,6
2,2003,620100,28,27,1,4
3,2003,620100,28,25,3,10
4,2003,620100,43,41,2,4
5,2003,620100,41,35,6,8
6,2003,620100,24,23,1,5
7,2003,620100,32,28,4,3
8,2003,620100,36,35,1,9
9,2003,620100,29,28,1,11
10,2003,620100,30,30,0,9
11,2003,620100,29,26,3,1
12,2003,620100,29,26,3,3
1,2004,620100,33,30,3,1
2,2004,620100,28,25,3,7
3,2004,620100,25,23,2,5
4,2004,620100,26,24,2,9
5,2004,620100,35,32,3,3
6,2004,620100,32,32,0,7
7,2004,620100,29,27,2,1
8,2004,620100,20,19,1,5
9,2004,620100,30,27,3,1
10,2004,620100,38,34,4,0
11,2004,620100,34,34,0,3
12,2004,620100,26,24,2,0
1,2005,620100,19,17,2,2
2,2005,620100,24,24,0,3
3,2005,620100,24,22,2,3
4,2005,620100,21,18,3,1
5,2005,620100,28,27,1,3
6,2005,620100,19,18,1,1
7,2005,620100,33,31,2,3
8,2005,620100,30,29,1,4
9,2005,620100,32,27,5,2
10,2005,620100,34,32,2,0
11,2005,620100,28,27,1,0
12,2005,620100,29,26,3,4
1,2006,620100,28,25,3,3
2,2006,620100,18,16,2,2
3,2006,620100,32,30,2,2
4,2006,620100,33,32,1,5
5,2006,620100,30,29,1,0
6,2006,620100,24,20,4,5
7,2006,620100,29,26,3,4
8,2006,620100,31,30,1,2
9,2006,620100,34,27,7,7
10,2006,620100,32,28,4,1
11,2006,620100,24,23,1,1
12,2006,620100,25,21,4,3
1,2007,620100,22,20,2,3
2,2007,620100,19,18,1,3
3,2007,620100,13,11,2,2
4,2007,620100,27,21,6,6
5,2007,620100,18,16,2,7
6,2007,620100,11,9,2,3
7,2007,620100,27,24,3,2
8,2007,620100,35,35,0,5
9,2007,620100,44,43,1,2
10,2007,620100,35,31,4,7
11,2007,620100,12,10,2,2
12,2007,620100,29,21,8,7
1,2008,620100,13,13,0,8
2,2008,620100,14,13,1,1
3,2008,620100,24,22,2,3
4,2008,620100,28,27,1,3
5,2008,620100,18,17,1,1
6,2008,620100,21,18,3,2
7,2008,620100,23,21,2,2
8,2008,620100,28,26,2,2
9,2008,620100,23,21,2,5
10,2008,620100,20,19,1,3
11,2008,620100,26,25,1,2
12,2008,620100,25,23,2,2
1,2009,620100,27,24,3,2
2,2009,620100,16,16,0,6
3,2009,620100,19,17,2,0
4,2009,620100,23,22,1,1
5,2009,620100,27,25,2,1
6,2009,620100,22,21,1,1
7,2009,620100,31,30,1,5
8,2009,620100,20,16,4,0
9,2009,620100,25,23,2,5
10,2009,620100,25,23,2,2
11,2009,620100,34,31,3,2
12,2009,620100,29,29,0,0
1,2010,620100,8,8,0,3
2,2010,620100,21,21,0,3
3,2010,620100,21,20,1,3
4,2010,620100,17,16,1,7
5,2010,620100,23,22,1,4
6,2010,620100,13,11,2,2
7,2010,620100,28,26,2,2
8,2010,620100,30,29,1,2
9,2010,620100,19,19,0,1
10,2010,620100,25,24,1,3
11,2010,620100,27,25,2,5
12,2010,620100,19,18,1,2
1,2011,620100,23,20,3,1
2,2011,620100,14,14,0,1
1,1999,630300,42,41,1,2
2,1999,630300,37,37,0,3
3,1999,630300,37,33,4,5
4,1999,630300,51,49,2,4
5,1999,630300,43,37,6,3
6,1999,630300,38,38,0,7
7,1999,630300,47,46,1,4
8,1999,630300,65,58,7,8
9,1999,630300,53,46,7,6
10,1999,630300,60,56,4,5
11,1999,630300,40,37,3,3
12,1999,630300,57,52,5,3
1,2000,630300,40,38,2,2
2,2000,630300,31,31,0,7
3,2000,630300,41,40,1,5
4,2000,630300,27,26,1,3
5,2000,630300,45,42,3,3
6,2000,630300,33,29,4,8
7,2000,630300,35,31,4,6
8,2000,630300,35,33,2,16
9,2000,630300,38,36,2,5
10,2000,630300,52,44,8,5
11,2000,630300,36,34,2,2
12,2000,630300,43,40,3,5
1,2001,630300,49,43,6,7
2,2001,630300,52,51,1,5
3,2001,630300,59,55,4,3
4,2001,630300,43,36,7,7
5,2001,630300,49,46,3,2
6,2001,630300,55,48,7,8
7,2001,630300,58,55,3,10
8,2001,630300,49,40,9,7
9,2001,630300,46,41,5,10
10,2001,630300,40,39,1,8
11,2001,630300,39,39,0,1
12,2001,630300,36,33,3,3
1,2002,630300,30,28,2,5
2,2002,630300,28,26,2,4
3,2002,630300,21,19,2,2
4,2002,630300,29,29,0,3
5,2002,630300,35,29,6,6
6,2002,630300,33,30,3,3
7,2002,630300,52,49,3,4
8,2002,630300,42,36,6,4
9,2002,630300,33,29,4,1
10,2002,630300,29,26,3,2
11,2002,630300,37,33,4,6
12,2002,630300,35,32,3,2
1,2003,630300,35,34,1,1
2,2003,630300,30,29,1,5
3,2003,630300,29,26,3,3
4,2003,630300,28,24,4,4
5,2003,630300,31,27,4,5
6,2003,630300,30,25,5,10
7,2003,630300,34,31,3,7
8,2003,630300,35,29,6,11
9,2003,630300,22,22,0,3
10,2003,630300,37,36,1,1
11,2003,630300,30,28,2,6
12,2003,630300,31,27,4,3
1,2004,630300,20,17,3,7
2,2004,630300,23,22,1,10
3,2004,630300,27,24,3,13
4,2004,630300,24,19,5,5
5,2004,630300,26,23,3,15
6,2004,630300,30,28,2,6
7,2004,630300,25,21,4,5
8,2004,630300,23,19,4,6
9,2004,630300,21,17,4,6
10,2004,630300,30,27,3,9
11,2004,630300,23,22,1,16
12,2004,630300,26,24,2,2
1,2005,630300,25,22,3,6
2,2005,630300,21,16,5,9
3,2005,630300,32,29,3,3
4,2005,630300,17,13,4,8
5,2005,630300,31,21,10,1
6,2005,630300,35,28,7,6
7,2005,630300,33,28,5,10
8,2005,630300,29,23,6,10
9,2005,630300,30,25,5,9
10,2005,630300,34,26,8,5
11,2005,630300,30,27,3,12
12,2005,630300,25,22,3,6
1,2006,630300,26,23,3,6
2,2006,630300,31,27,4,14
3,2006,630300,24,23,1,9
4,2006,630300,29,24,5,13
5,2006,630300,26,24,2,12
6,2006,630300,26,18,8,23
7,2006,630300,39,32,7,8
8,2006,630300,22,21,1,2
9,2006,630300,23,21,2,4
10,2006,630300,20,20,0,11
11,2006,630300,29,24,5,8
12,2006,630300,21,19,2,11
1,2007,630300,15,14,1,15
2,2007,630300,16,11,5,16
3,2007,630300,28,24,4,20
4,2007,630300,19,18,1,14
5,2007,630300,15,14,1,11
6,2007,630300,17,17,0,5
7,2007,630300,22,17,5,8
8,2007,630300,24,21,3,5
9,2007,630300,23,21,2,8
10,2007,630300,16,12,4,7
11,2007,630300,16,13,3,2
12,2007,630300,16,12,4,6
1,2008,630300,26,24,2,5
2,2008,630300,13,12,1,8
3,2008,630300,27,23,4,5
4,2008,630300,28,24,4,6
5,2008,630300,25,22,3,8
6,2008,630300,26,22,4,5
7,2008,630300,27,24,3,16
8,2008,630300,28,25,3,5
9,2008,630300,30,28,2,3
10,2008,630300,37,34,3,5
11,2008,630300,23,18,5,5
12,2008,630300,37,34,3,7
1,2009,630300,31,30,1,10
2,2009,630300,32,29,3,5
3,2009,630300,20,17,3,11
4,2009,630300,24,24,0,6
5,2009,630300,18,13,5,5
6,2009,630300,19,19,0,8
7,2009,630300,21,18,3,8
8,2009,630300,26,25,1,7
9,2009,630300,24,23,1,9
10,2009,630300,18,15,3,5
11,2009,630300,24,23,1,8
12,2009,630300,16,14,2,7
1,2010,630300,19,15,4,8
2,2010,630300,17,15,2,7
3,2010,630300,33,30,3,8
4,2010,630300,30,27,3,9
5,2010,630300,21,16,5,4
6,2010,630300,30,27,3,11
7,2010,630300,26,22,4,7
8,2010,630300,38,35,3,8
9,2010,630300,34,32,2,7
10,2010,630300,31,28,3,7
11,2010,630300,32,32,0,6
12,2010,630300,33,33,0,6
1,2011,630300,34,32,2,1
2,2011,630300,14,14,0,5
1,1999,630400,17,15,2,1
2,1999,630400,12,10,2,5
3,1999,630400,17,15,2,2
4,1999,630400,26,24,2,5
5,1999,630400,17,13,4,2
6,1999,630400,20,18,2,0
7,1999,630400,11,11,0,7
8,1999,630400,17,15,2,1
9,1999,630400,16,15,1,2
10,1999,630400,13,11,2,1
11,1999,630400,21,19,2,1
12,1999,630400,13,12,1,0
1,2000,630400,11,10,1,2
2,2000,630400,14,12,2,2
3,2000,630400,12,10,2,1
4,2000,630400,11,9,2,1
5,2000,630400,20,18,2,1
6,2000,630400,13,12,1,1
7,2000,630400,15,11,4,0
8,2000,630400,17,14,3,1
9,2000,630400,22,18,4,1
10,2000,630400,23,21,2,3
11,2000,630400,18,12,6,2
12,2000,630400,17,14,3,4
1,2001,630400,17,16,1,2
2,2001,630400,10,9,1,1
3,2001,630400,13,11,2,4
4,2001,630400,14,14,0,3
5,2001,630400,9,6,3,1
6,2001,630400,19,18,1,3
7,2001,630400,22,13,9,9
8,2001,630400,19,15,4,0
9,2001,630400,12,9,3,3
10,2001,630400,16,15,1,0
11,2001,630400,14,11,3,1
12,2001,630400,14,12,2,8
1,2002,630400,30,30,0,2
2,2002,630400,16,12,4,2
3,2002,630400,11,8,3,3
4,2002,630400,10,9,1,0
5,2002,630400,12,11,1,1
6,2002,630400,11,8,3,1
7,2002,630400,15,14,1,2
8,2002,630400,17,12,5,3
9,2002,630400,19,16,3,1
10,2002,630400,23,20,3,4
11,2002,630400,13,13,0,1
12,2002,630400,25,23,2,7
1,2003,630400,18,17,1,2
2,2003,630400,13,12,1,1
3,2003,630400,26,24,2,1
4,2003,630400,35,31,4,1
5,2003,630400,19,17,2,2
6,2003,630400,10,8,2,4
7,2003,630400,15,13,2,2
8,2003,630400,24,21,3,4
9,2003,630400,12,11,1,3
10,2003,630400,18,17,1,3
11,2003,630400,18,17,1,0
12,2003,630400,18,15,3,1
1,2004,630400,10,10,0,2
2,2004,630400,13,9,4,5
3,2004,630400,12,11,1,2
4,2004,630400,9,5,4,2
5,2004,630400,16,14,2,4
6,2004,630400,17,16,1,2
7,2004,630400,25,21,4,2
8,2004,630400,13,12,1,7
9,2004,630400,13,10,3,0
10,2004,630400,22,20,2,2
11,2004,630400,9,7,2,3
12,2004,630400,14,14,0,2
1,2005,630400,19,16,3,2
2,2005,630400,15,13,2,2
3,2005,630400,22,19,3,0
4,2005,630400,14,12,2,5
5,2005,630400,12,11,1,2
6,2005,630400,25,19,6,2
7,2005,630400,21,19,2,5
8,2005,630400,13,8,5,7
9,2005,630400,15,14,1,1
10,2005,630400,13,12,1,0
11,2005,630400,16,11,5,9
12,2005,630400,12,11,1,3
1,2006,630400,21,21,0,3
2,2006,630400,13,12,1,1
3,2006,630400,20,18,2,1
4,2006,630400,12,12,0,6
5,2006,630400,12,8,4,3
6,2006,630400,5,3,2,9
7,2006,630400,8,6,2,4
8,2006,630400,12,12,0,3
9,2006,630400,13,10,3,3
10,2006,630400,13,12,1,2
11,2006,630400,15,11,4,9
12,2006,630400,16,13,3,9
1,2007,630400,10,6,4,3
2,2007,630400,15,13,2,3
3,2007,630400,13,10,3,8
4,2007,630400,13,12,1,9
5,2007,630400,6,5,1,8
6,2007,630400,14,12,2,11
7,2007,630400,23,21,2,2
8,2007,630400,13,12,1,1
9,2007,630400,11,10,1,2
10,2007,630400,15,14,1,6
11,2007,630400,12,11,1,3
12,2007,630400,13,10,3,2
1,2008,630400,14,14,0,4
2,2008,630400,4,4,0,5
3,2008,630400,8,7,1,3
4,2008,630400,9,7,2,0
5,2008,630400,10,9,1,3
6,2008,630400,13,12,1,1
7,2008,630400,14,11,3,4
8,2008,630400,13,11,2,3
9,2008,630400,16,13,3,4
10,2008,630400,18,15,3,5
11,2008,630400,25,24,1,1
12,2008,630400,11,11,0,2
1,2009,630400,15,12,3,4
2,2009,630400,20,19,1,6
3,2009,630400,19,18,1,5
4,2009,630400,10,7,3,5
5,2009,630400,7,6,1,5
6,2009,630400,8,6,2,2
7,2009,630400,14,10,4,4
8,2009,630400,10,9,1,3
9,2009,630400,14,13,1,10
10,2009,630400,12,11,1,9
11,2009,630400,12,10,2,7
12,2009,630400,15,13,2,4
1,2010,630400,5,5,0,4
2,2010,630400,5,5,0,6
3,2010,630400,16,15,1,5
4,2010,630400,14,11,3,5
5,2010,630400,18,17,1,2
6,2010,630400,14,13,1,12
7,2010,630400,18,15,3,7
8,2010,630400,21,16,5,6
9,2010,630400,19,16,3,5
10,2010,630400,10,7,3,5
11,2010,630400,15,15,0,3
12,2010,630400,21,19,2,3
1,2011,630400,17,15,2,6
2,2011,630400,8,6,2,1
1,1999,630500,24,19,5,5
2,1999,630500,14,11,3,2
3,1999,630500,10,7,3,3
4,1999,630500,29,25,4,10
5,1999,630500,27,21,6,3
6,1999,630500,26,24,2,2
7,1999,630500,28,25,3,5
8,1999,630500,19,13,6,2
9,1999,630500,22,20,2,4
10,1999,630500,25,23,2,8
11,1999,630500,13,13,0,3
12,1999,630500,20,19,1,1
1,2000,630500,18,15,3,2
2,2000,630500,14,12,2,2
3,2000,630500,21,14,7,3
4,2000,630500,17,12,5,3
5,2000,630500,19,13,6,1
6,2000,630500,18,15,3,3
7,2000,630500,24,22,2,6
8,2000,630500,25,18,7,6
9,2000,630500,22,16,6,3
10,2000,630500,27,21,6,6
11,2000,630500,19,17,2,4
12,2000,630500,23,19,4,3
1,2001,630500,27,19,8,4
2,2001,630500,19,19,0,3
3,2001,630500,24,21,3,8
4,2001,630500,20,17,3,4
5,2001,630500,21,18,3,10
6,2001,630500,13,10,3,15
7,2001,630500,25,19,6,18
8,2001,630500,19,15,4,9
9,2001,630500,23,21,2,19
10,2001,630500,34,30,4,16
11,2001,630500,24,16,8,20
12,2001,630500,21,20,1,5
1,2002,630500,17,13,4,9
2,2002,630500,10,9,1,4
3,2002,630500,10,8,2,8
4,2002,630500,15,11,4,3
5,2002,630500,19,14,5,8
6,2002,630500,16,14,2,1
7,2002,630500,18,14,4,5
8,2002,630500,25,18,7,2
9,2002,630500,17,15,2,7
10,2002,630500,28,24,4,6
11,2002,630500,21,19,2,3
12,2002,630500,15,10,5,7
1,2003,630500,19,17,2,4
2,2003,630500,21,17,4,4
3,2003,630500,16,14,2,4
4,2003,630500,24,20,4,8
5,2003,630500,13,10,3,5
6,2003,630500,12,11,1,3
7,2003,630500,22,20,2,7
8,2003,630500,23,17,6,17
9,2003,630500,17,12,5,368
10,2003,630500,15,12,3,8
11,2003,630500,19,13,6,5
12,2003,630500,23,21,2,5
1,2004,630500,12,11,1,3
2,2004,630500,19,13,6,2
3,2004,630500,12,11,1,5
4,2004,630500,13,9,4,3
5,2004,630500,8,8,0,7
6,2004,630500,24,21,3,2
7,2004,630500,17,13,4,7
8,2004,630500,28,18,10,8
9,2004,630500,21,15,6,13
10,2004,630500,16,14,2,5
11,2004,630500,8,5,3,0
12,2004,630500,13,12,1,0
1,2005,630500,13,13,0,2
2,2005,630500,6,4,2,4
3,2005,630500,10,9,1,2
4,2005,630500,10,5,5,5
5,2005,630500,4,4,0,2
6,2005,630500,13,8,5,3
7,2005,630500,11,9,2,9
8,2005,630500,13,12,1,9
9,2005,630500,17,17,0,4
10,2005,630500,11,10,1,7
11,2005,630500,9,8,1,6
12,2005,630500,16,15,1,2
1,2006,630500,18,16,2,5
2,2006,630500,10,9,1,5
3,2006,630500,11,11,0,6
4,2006,630500,12,12,0,7
5,2006,630500,22,19,3,3
6,2006,630500,8,6,2,8
7,2006,630500,19,14,5,5
8,2006,630500,16,14,2,4
9,2006,630500,19,15,4,4
10,2006,630500,20,18,2,3
11,2006,630500,28,27,1,5
12,2006,630500,23,22,1,2
1,2007,630500,10,10,0,6
2,2007,630500,12,10,2,7
3,2007,630500,11,8,3,4
4,2007,630500,15,14,1,3
5,2007,630500,22,21,1,8
6,2007,630500,9,8,1,3
7,2007,630500,22,18,4,1
8,2007,630500,13,11,2,7
9,2007,630500,12,8,4,6
10,2007,630500,12,9,3,4
11,2007,630500,9,7,2,1
12,2007,630500,8,8,0,2
1,2008,630500,14,12,2,2
2,2008,630500,12,12,0,3
3,2008,630500,8,5,3,2
4,2008,630500,11,9,2,4
5,2008,630500,12,10,2,2
6,2008,630500,11,10,1,4
7,2008,630500,12,10,2,3
8,2008,630500,18,16,2,1
9,2008,630500,20,17,3,3
10,2008,630500,10,8,2,2
11,2008,630500,16,15,1,5
12,2008,630500,19,16,3,1
1,2009,630500,9,8,1,8
2,2009,630500,15,12,3,4
3,2009,630500,12,11,1,7
4,2009,630500,12,11,1,6
5,2009,630500,8,8,0,4
6,2009,630500,10,7,3,5
7,2009,630500,20,15,5,7
8,2009,630500,10,9,1,6
9,2009,630500,11,10,1,2
10,2009,630500,6,5,1,5
11,2009,630500,20,17,3,2
12,2009,630500,9,9,0,1
1,2010,630500,15,13,2,4
2,2010,630500,11,11,0,2
3,2010,630500,16,13,3,7
4,2010,630500,10,9,1,3
5,2010,630500,19,14,5,5
6,2010,630500,8,6,2,9
7,2010,630500,5,5,0,5
8,2010,630500,16,15,1,2
9,2010,630500,16,10,6,3
10,2010,630500,10,10,0,2
11,2010,630500,15,15,0,3
12,2010,630500,15,13,2,3
1,2011,630500,13,11,2,5
2,2011,630500,10,8,2,0
1,1999,630100,3,3,0,1
2,1999,630100,0,0,0,6
3,1999,630100,2,2,0,0
4,1999,630100,6,5,1,1
5,1999,630100,7,3,4,3
6,1999,630100,7,6,1,2
7,1999,630100,8,7,1,3
8,1999,630100,3,3,0,1
9,1999,630100,3,3,0,3
10,1999,630100,5,4,1,1
11,1999,630100,9,7,2,0
12,1999,630100,4,4,0,0
1,2000,630100,12,10,2,2
2,2000,630100,5,4,1,3
3,2000,630100,8,7,1,4
4,2000,630100,12,12,0,5
5,2000,630100,4,4,0,6
6,2000,630100,6,5,1,5
7,2000,630100,9,8,1,3
8,2000,630100,4,3,1,3
9,2000,630100,9,7,2,2
10,2000,630100,8,7,1,1
11,2000,630100,4,4,0,5
12,2000,630100,3,3,0,1
1,2001,630100,6,5,1,2
2,2001,630100,3,2,1,0
3,2001,630100,5,5,0,2
4,2001,630100,7,5,2,6
5,2001,630100,9,5,4,7
6,2001,630100,3,3,0,2
7,2001,630100,6,5,1,0
8,2001,630100,13,13,0,3
9,2001,630100,11,9,2,4
10,2001,630100,6,4,2,0
11,2001,630100,3,3,0,1
12,2001,630100,4,4,0,1
1,2002,630100,1,1,0,1
2,2002,630100,6,6,0,0
3,2002,630100,4,3,1,1
4,2002,630100,8,6,2,0
5,2002,630100,7,7,0,3
6,2002,630100,7,7,0,5
7,2002,630100,11,11,0,5
8,2002,630100,7,5,2,3
9,2002,630100,8,8,0,3
10,2002,630100,8,6,2,0
11,2002,630100,5,4,1,3
12,2002,630100,6,3,3,1
1,2003,630100,5,4,1,2
2,2003,630100,9,8,1,1
3,2003,630100,7,5,2,4
4,2003,630100,6,5,1,2
5,2003,630100,5,4,1,3
6,2003,630100,6,4,2,4
7,2003,630100,3,3,0,1
8,2003,630100,6,5,1,3
9,2003,630100,4,3,1,2
10,2003,630100,8,7,1,1
11,2003,630100,4,3,1,0
12,2003,630100,5,5,0,1
1,2004,630100,1,1,0,0
2,2004,630100,3,3,0,1
3,2004,630100,8,7,1,0
4,2004,630100,5,3,2,1
5,2004,630100,4,4,0,1
6,2004,630100,13,10,3,5
7,2004,630100,7,5,2,3
8,2004,630100,7,6,1,2
9,2004,630100,7,5,2,1
10,2004,630100,10,10,0,1
11,2004,630100,8,7,1,0
12,2004,630100,1,1,0,0
1,2005,630100,4,4,0,0
2,2005,630100,5,4,1,3
3,2005,630100,6,5,1,4
4,2005,630100,5,5,0,0
5,2005,630100,4,3,1,5
6,2005,630100,4,4,0,1
7,2005,630100,5,3,2,1
8,2005,630100,3,2,1,0
9,2005,630100,4,3,1,2
10,2005,630100,6,3,3,1
11,2005,630100,1,1,0,1
12,2005,630100,5,5,0,1
1,2006,630100,7,7,0,2
2,2006,630100,3,2,1,0
3,2006,630100,9,8,1,0
4,2006,630100,8,7,1,3
5,2006,630100,7,6,1,3
6,2006,630100,6,6,0,1
7,2006,630100,6,4,2,0
8,2006,630100,10,6,4,8
9,2006,630100,7,6,1,3
10,2006,630100,8,8,0,3
11,2006,630100,3,3,0,1
12,2006,630100,6,5,1,1
1,2007,630100,10,8,2,0
2,2007,630100,4,4,0,4
3,2007,630100,2,2,0,0
4,2007,630100,7,4,3,3
5,2007,630100,5,4,1,6
6,2007,630100,7,7,0,0
7,2007,630100,6,2,4,2
8,2007,630100,6,4,2,2
9,2007,630100,7,3,4,3
10,2007,630100,3,3,0,1
11,2007,630100,9,8,1,2
12,2007,630100,7,5,2,2
1,2008,630100,3,3,0,1
2,2008,630100,5,5,0,0
3,2008,630100,6,4,2,1
4,2008,630100,8,7,1,0
5,2008,630100,6,5,1,3
6,2008,630100,8,7,1,2
7,2008,630100,8,8,0,1
8,2008,630100,10,7,3,7
9,2008,630100,11,10,1,1
10,2008,630100,5,4,1,6
11,2008,630100,8,7,1,0
12,2008,630100,1,1,0,3
1,2009,630100,3,3,0,2
2,2009,630100,3,1,2,2
3,2009,630100,9,4,5,3
4,2009,630100,5,2,3,2
5,2009,630100,5,0,5,0
6,2009,630100,9,7,2,0
7,2009,630100,7,5,2,1
8,2009,630100,4,3,1,1
9,2009,630100,6,6,0,1
10,2009,630100,6,4,2,1
11,2009,630100,7,7,0,2
12,2009,630100,6,4,2,2
1,2010,630100,6,4,2,0
2,2010,630100,3,3,0,1
3,2010,630100,6,6,0,1
4,2010,630100,2,2,0,1
5,2010,630100,1,1,0,1
6,2010,630100,5,4,1,0
7,2010,630100,8,7,1,2
8,2010,630100,6,5,1,1
9,2010,630100,4,4,0,4
10,2010,630100,3,2,1,3
11,2010,630100,3,2,1,2
12,2010,630100,6,5,1,2
1,2011,630100,6,5,1,0
2,2011,630100,1,1,0,0
1,1999,611600,14,12,2,7
2,1999,611600,7,7,0,15
3,1999,611600,14,10,4,9
4,1999,611600,13,13,0,9
5,1999,611600,20,15,5,5
6,1999,611600,17,14,3,10
7,1999,611600,23,18,5,14
8,1999,611600,23,19,4,1
9,1999,611600,20,15,5,8
10,1999,611600,19,15,4,11
11,1999,611600,15,9,6,5
12,1999,611600,18,15,3,6
1,2000,611600,20,18,2,8
2,2000,611600,17,16,1,16
3,2000,611600,13,12,1,9
4,2000,611600,25,18,7,5
5,2000,611600,22,18,4,6
6,2000,611600,16,9,7,4
7,2000,611600,24,15,9,6
8,2000,611600,33,25,8,10
9,2000,611600,18,14,4,5
10,2000,611600,15,12,3,4
11,2000,611600,14,11,3,14
12,2000,611600,16,16,0,7
1,2001,611600,17,13,4,17
2,2001,611600,13,12,1,9
3,2001,611600,18,11,7,11
4,2001,611600,21,14,7,16
5,2001,611600,21,12,9,6
6,2001,611600,16,8,8,5
7,2001,611600,26,19,7,8
8,2001,611600,21,15,6,7
9,2001,611600,30,20,10,9
10,2001,611600,23,19,4,16
11,2001,611600,13,11,2,10
12,2001,611600,17,15,2,14
1,2002,611600,14,11,3,9
2,2002,611600,17,12,5,5
3,2002,611600,17,12,5,19
4,2002,611600,17,13,4,14
5,2002,611600,24,14,10,5
6,2002,611600,15,11,4,4
7,2002,611600,17,12,5,7
8,2002,611600,25,22,3,11
9,2002,611600,25,17,8,18
10,2002,611600,23,20,3,16
11,2002,611600,15,13,2,5
12,2002,611600,29,26,3,5
1,2003,611600,16,14,2,18
2,2003,611600,11,8,3,23
3,2003,611600,22,18,4,15
4,2003,611600,20,18,2,8
5,2003,611600,18,17,1,10
6,2003,611600,18,16,2,5
7,2003,611600,22,20,2,11
8,2003,611600,16,9,7,6
9,2003,611600,20,16,4,6
10,2003,611600,10,6,4,7
11,2003,611600,17,14,3,8
12,2003,611600,16,14,2,4
1,2004,611600,10,8,2,4
2,2004,611600,13,12,1,2
3,2004,611600,13,11,2,4
4,2004,611600,12,11,1,2
5,2004,611600,24,22,2,12
6,2004,611600,18,16,2,19
7,2004,611600,18,16,2,3
8,2004,611600,28,27,1,7
9,2004,611600,17,14,3,3
10,2004,611600,19,14,5,6
11,2004,611600,24,18,6,6
12,2004,611600,11,8,3,1
1,2005,611600,8,7,1,7
2,2005,611600,5,4,1,3
3,2005,611600,10,8,2,9
4,2005,611600,15,12,3,10
5,2005,611600,12,11,1,4
6,2005,611600,13,10,3,9
7,2005,611600,25,18,7,9
8,2005,611600,20,16,4,6
9,2005,611600,26,22,4,8
10,2005,611600,16,14,2,7
11,2005,611600,11,10,1,8
12,2005,611600,10,9,1,2
1,2006,611600,14,11,3,5
2,2006,611600,13,12,1,1
3,2006,611600,15,10,5,7
4,2006,611600,19,13,6,7
5,2006,611600,19,12,7,14
6,2006,611600,21,17,4,2
7,2006,611600,36,27,9,7
8,2006,611600,27,17,10,4
9,2006,611600,16,11,5,5
10,2006,611600,12,12,0,8
11,2006,611600,20,19,1,6
12,2006,611600,12,9,3,4
1,2007,611600,11,9,2,6
2,2007,611600,7,5,2,8
3,2007,611600,8,5,3,5
4,2007,611600,6,6,0,7
5,2007,611600,15,11,4,5
6,2007,611600,12,9,3,5
7,2007,611600,16,15,1,3
8,2007,611600,22,18,4,6
9,2007,611600,14,9,5,9
10,2007,611600,16,11,5,7
11,2007,611600,12,11,1,8
12,2007,611600,19,13,6,4
1,2008,611600,12,11,1,5
2,2008,611600,8,6,2,2
3,2008,611600,12,9,3,6
4,2008,611600,15,11,4,1
5,2008,611600,17,15,2,3
6,2008,611600,16,15,1,1
7,2008,611600,26,21,5,5
8,2008,611600,19,18,1,6
9,2008,611600,23,18,5,4
10,2008,611600,16,12,4,7
11,2008,611600,15,14,1,3
12,2008,611600,14,14,0,2
1,2009,611600,16,14,2,7
2,2009,611600,9,9,0,7
3,2009,611600,15,12,3,5
4,2009,611600,11,9,2,5
5,2009,611600,10,5,5,4
6,2009,611600,22,18,4,6
7,2009,611600,15,12,3,3
8,2009,611600,14,12,2,6
9,2009,611600,17,13,4,4
10,2009,611600,12,7,5,4
11,2009,611600,11,9,2,4
12,2009,611600,17,12,5,4
1,2010,611600,11,8,3,8
2,2010,611600,12,10,2,3
3,2010,611600,9,7,2,5
4,2010,611600,7,5,2,4
5,2010,611600,13,8,5,5
6,2010,611600,14,11,3,6
7,2010,611600,13,11,2,2
8,2010,611600,17,14,3,3
9,2010,611600,15,13,2,6
10,2010,611600,7,5,2,4
11,2010,611600,13,12,1,4
12,2010,611600,7,5,2,2
1,2011,611600,12,8,4,8
2,2011,611600,3,3,0,2
1,1999,611700,32,23,9,8
2,1999,611700,19,12,7,25
3,1999,611700,14,10,4,17
4,1999,611700,24,17,7,15
5,1999,611700,15,6,9,12
6,1999,611700,31,22,9,11
7,1999,611700,27,17,10,20
8,1999,611700,25,18,7,11
9,1999,611700,29,19,10,16
10,1999,611700,19,14,5,16
11,1999,611700,19,16,3,8
12,1999,611700,17,12,5,13
1,2000,611700,24,18,6,11
2,2000,611700,20,11,9,13
3,2000,611700,27,21,6,8
4,2000,611700,36,29,7,23
5,2000,611700,32,21,11,5
6,2000,611700,24,19,5,18
7,2000,611700,36,28,8,12
8,2000,611700,33,25,8,7
9,2000,611700,31,27,4,9
10,2000,611700,25,20,5,20
11,2000,611700,25,18,7,40
12,2000,611700,16,11,5,24
1,2001,611700,25,20,5,19
2,2001,611700,21,16,5,7
3,2001,611700,18,10,8,14
4,2001,611700,18,13,5,13
5,2001,611700,24,18,6,10
6,2001,611700,25,13,12,28
7,2001,611700,42,33,9,20
8,2001,611700,25,16,9,12
9,2001,611700,19,15,4,21
10,2001,611700,25,23,2,17
11,2001,611700,31,20,11,21
12,2001,611700,25,21,4,38
1,2002,611700,21,16,5,18
2,2002,611700,16,14,2,21
3,2002,611700,20,18,2,28
4,2002,611700,21,16,5,14
5,2002,611700,27,17,10,7
6,2002,611700,24,16,8,4
7,2002,611700,31,21,10,8
8,2002,611700,28,24,4,14
9,2002,611700,25,15,10,10
10,2002,611700,27,19,8,13
11,2002,611700,23,14,9,9
12,2002,611700,15,8,7,17
1,2003,611700,14,11,3,10
2,2003,611700,20,16,4,13
3,2003,611700,28,20,8,17
4,2003,611700,23,18,5,15
5,2003,611700,22,14,8,31
6,2003,611700,13,8,5,14
7,2003,611700,28,18,10,25
8,2003,611700,22,14,8,15
9,2003,611700,27,20,7,11
10,2003,611700,25,21,4,11
11,2003,611700,13,11,2,15
12,2003,611700,13,10,3,14
1,2004,611700,15,14,1,19
2,2004,611700,27,23,4,8
3,2004,611700,29,18,11,10
4,2004,611700,17,12,5,21
5,2004,611700,22,18,4,14
6,2004,611700,35,19,16,26
7,2004,611700,27,19,8,9
8,2004,611700,28,23,5,13
9,2004,611700,24,18,6,15
10,2004,611700,20,13,7,8
11,2004,611700,16,12,4,6
12,2004,611700,16,12,4,8
1,2005,611700,14,13,1,6
2,2005,611700,8,6,2,8
3,2005,611700,12,12,0,13
4,2005,611700,18,13,5,28
5,2005,611700,16,12,4,11
6,2005,611700,12,5,7,12
7,2005,611700,27,19,8,11
8,2005,611700,21,11,10,7
9,2005,611700,9,6,3,11
10,2005,611700,19,16,3,9
11,2005,611700,16,14,2,18
12,2005,611700,19,12,7,31
1,2006,611700,11,7,4,7
2,2006,611700,16,13,3,9
3,2006,611700,23,18,5,9
4,2006,611700,22,9,13,32
5,2006,611700,18,14,4,28
6,2006,611700,24,14,10,17
7,2006,611700,25,15,10,24
8,2006,611700,12,7,5,18
9,2006,611700,16,9,7,45
10,2006,611700,20,11,9,21
11,2006,611700,16,14,2,26
12,2006,611700,13,11,2,25
1,2007,611700,14,11,3,7
2,2007,611700,11,8,3,11
3,2007,611700,11,7,4,8
4,2007,611700,16,11,5,7
5,2007,611700,24,17,7,6
6,2007,611700,28,23,5,4
7,2007,611700,26,24,2,8
8,2007,611700,10,8,2,9
9,2007,611700,12,7,5,13
10,2007,611700,17,14,3,11
11,2007,611700,11,9,2,8
12,2007,611700,17,16,1,21
1,2008,611700,15,9,6,8
2,2008,611700,9,8,1,9
3,2008,611700,21,17,4,10
4,2008,611700,19,10,9,6
5,2008,611700,19,10,9,3
6,2008,611700,15,10,5,5
7,2008,611700,14,10,4,6
8,2008,611700,16,10,6,5
9,2008,611700,16,11,5,9
10,2008,611700,20,17,3,7
11,2008,611700,18,11,7,7
12,2008,611700,14,12,2,9
1,2009,611700,19,15,4,5
2,2009,611700,16,13,3,5
3,2009,611700,23,17,6,4
4,2009,611700,18,14,4,9
5,2009,611700,18,11,7,5
6,2009,611700,17,11,6,5
7,2009,611700,14,10,4,8
8,2009,611700,26,21,5,6
9,2009,611700,15,9,6,7
10,2009,611700,16,11,5,9
11,2009,611700,10,8,2,5
12,2009,611700,17,16,1,6
1,2010,611700,18,17,1,6
2,2010,611700,18,15,3,4
3,2010,611700,13,12,1,10
4,2010,611700,15,11,4,8
5,2010,611700,15,13,2,7
6,2010,611700,17,15,2,6
7,2010,611700,20,17,3,3
8,2010,611700,13,10,3,8
9,2010,611700,18,16,2,9
10,2010,611700,13,9,4,4
11,2010,611700,11,8,3,6
12,2010,611700,13,12,1,7
1,2011,611700,19,17,2,6
2,2011,611700,10,9,1,4
1,1999,611800,15,11,4,8
2,1999,611800,17,14,3,10
3,1999,611800,13,11,2,8
4,1999,611800,23,19,4,1
5,1999,611800,28,26,2,4
6,1999,611800,19,15,4,3
7,1999,611800,22,15,7,5
8,1999,611800,21,16,5,8
9,1999,611800,25,22,3,1
10,1999,611800,24,20,4,2
11,1999,611800,20,18,2,3
12,1999,611800,22,20,2,1
1,2000,611800,21,20,1,5
2,2000,611800,18,14,4,6
3,2000,611800,30,27,3,6
4,2000,611800,20,18,2,6
5,2000,611800,19,15,4,5
6,2000,611800,23,20,3,2
7,2000,611800,27,24,3,3
8,2000,611800,27,22,5,3
9,2000,611800,34,28,6,1
10,2000,611800,33,24,9,5
11,2000,611800,25,21,4,3
12,2000,611800,17,15,2,4
1,2001,611800,10,9,1,1
2,2001,611800,11,8,3,10
3,2001,611800,19,14,5,13
4,2001,611800,14,13,1,10
5,2001,611800,22,16,6,2
6,2001,611800,12,10,2,4
7,2001,611800,22,19,3,8
8,2001,611800,16,12,4,3
9,2001,611800,15,12,3,1
10,2001,611800,24,17,7,4
11,2001,611800,22,13,9,3
12,2001,611800,21,14,7,3
1,2002,611800,20,17,3,5
2,2002,611800,13,12,1,4
3,2002,611800,12,6,6,15
4,2002,611800,15,6,9,19
5,2002,611800,15,10,5,9
6,2002,611800,22,17,5,4
7,2002,611800,21,15,6,9
8,2002,611800,28,18,10,2
9,2002,611800,19,6,13,5
10,2002,611800,24,22,2,4
11,2002,611800,18,16,2,7
12,2002,611800,17,13,4,11
1,2003,611800,15,13,2,13
2,2003,611800,16,14,2,5
3,2003,611800,29,27,2,14
4,2003,611800,22,16,6,8
5,2003,611800,17,13,4,8
6,2003,611800,19,18,1,5
7,2003,611800,24,19,5,7
8,2003,611800,19,15,4,12
9,2003,611800,16,12,4,4
10,2003,611800,18,16,2,1
11,2003,611800,16,11,5,4
12,2003,611800,10,9,1,7
1,2004,611800,15,12,3,7
2,2004,611800,14,12,2,2
3,2004,611800,19,16,3,9
4,2004,611800,11,7,4,7
5,2004,611800,20,12,8,6
6,2004,611800,15,13,2,15
7,2004,611800,17,16,1,9
8,2004,611800,20,17,3,7
9,2004,611800,14,13,1,6
10,2004,611800,14,10,4,6
11,2004,611800,16,13,3,5
12,2004,611800,16,13,3,7
1,2005,611800,13,11,2,6
2,2005,611800,12,10,2,11
3,2005,611800,13,11,2,8
4,2005,611800,11,9,2,3
5,2005,611800,25,19,6,7
6,2005,611800,19,16,3,7
7,2005,611800,24,22,2,9
8,2005,611800,20,15,5,7
9,2005,611800,26,24,2,2
10,2005,611800,17,14,3,8
11,2005,611800,23,18,5,4
12,2005,611800,13,11,2,9
1,2006,611800,14,13,1,12
2,2006,611800,21,19,2,14
3,2006,611800,9,7,2,5
4,2006,611800,14,6,8,8
5,2006,611800,12,9,3,21
6,2006,611800,22,16,6,11
7,2006,611800,12,10,2,13
8,2006,611800,17,13,4,12
9,2006,611800,20,15,5,11
10,2006,611800,18,14,4,21
11,2006,611800,8,8,0,16
12,2006,611800,13,9,4,15
1,2007,611800,8,7,1,11
2,2007,611800,11,9,2,6
3,2007,611800,14,9,5,9
4,2007,611800,12,9,3,13
5,2007,611800,17,13,4,9
6,2007,611800,22,15,7,8
7,2007,611800,23,18,5,12
8,2007,611800,18,16,2,20
9,2007,611800,13,12,1,2
10,2007,611800,21,18,3,14
11,2007,611800,28,20,8,9
12,2007,611800,16,12,4,22
1,2008,611800,11,8,3,22
2,2008,611800,10,7,3,20
3,2008,611800,24,20,4,10
4,2008,611800,14,12,2,8
5,2008,611800,14,12,2,4
6,2008,611800,17,11,6,8
7,2008,611800,10,8,2,7
8,2008,611800,14,12,2,3
9,2008,611800,16,13,3,6
10,2008,611800,20,17,3,6
11,2008,611800,13,10,3,12
12,2008,611800,6,5,1,10
1,2009,611800,10,8,2,5
2,2009,611800,15,12,3,4
3,2009,611800,10,9,1,10
4,2009,611800,7,4,3,4
5,2009,611800,13,11,2,7
6,2009,611800,12,8,4,5
7,2009,611800,20,16,4,4
8,2009,611800,11,9,2,9
9,2009,611800,11,7,4,9
10,2009,611800,10,10,0,6
11,2009,611800,9,8,1,7
12,2009,611800,8,5,3,8
1,2010,611800,21,18,3,10
2,2010,611800,9,9,0,13
3,2010,611800,14,12,2,5
4,2010,611800,14,12,2,8
5,2010,611800,15,13,2,6
6,2010,611800,12,9,3,5
7,2010,611800,11,10,1,10
8,2010,611800,23,17,6,15
9,2010,611800,11,10,1,13
10,2010,611800,9,4,5,9
11,2010,611800,16,14,2,8
12,2010,611800,8,7,1,5
1,2011,611800,10,10,0,8
2,2011,611800,8,7,1,4
1,1999,611900,6,6,0,13
2,1999,611900,13,9,4,21
3,1999,611900,11,7,4,12
4,1999,611900,13,8,5,9
5,1999,611900,13,10,3,14
6,1999,611900,18,10,8,12
7,1999,611900,14,11,3,20
8,1999,611900,11,8,3,15
9,1999,611900,13,9,4,10
10,1999,611900,11,8,3,13
11,1999,611900,10,9,1,9
12,1999,611900,12,8,4,14
1,2000,611900,16,13,3,16
2,2000,611900,10,7,3,24
3,2000,611900,9,4,5,15
4,2000,611900,14,10,4,9
5,2000,611900,14,11,3,8
6,2000,611900,24,18,6,10
7,2000,611900,17,13,4,11
8,2000,611900,20,15,5,10
9,2000,611900,25,16,9,9
10,2000,611900,23,17,6,10
11,2000,611900,21,17,4,18
12,2000,611900,16,13,3,10
1,2001,611900,12,12,0,13
2,2001,611900,8,5,3,11
3,2001,611900,11,9,2,9
4,2001,611900,17,12,5,21
5,2001,611900,24,17,7,13
6,2001,611900,21,17,4,11
7,2001,611900,22,16,6,10
8,2001,611900,18,10,8,5
9,2001,611900,25,18,7,10
10,2001,611900,29,15,14,13
11,2001,611900,15,12,3,11
12,2001,611900,16,13,3,6
1,2002,611900,20,12,8,36
2,2002,611900,12,6,6,12
3,2002,611900,25,16,9,10
4,2002,611900,17,8,9,26
5,2002,611900,22,18,4,10
6,2002,611900,27,21,6,7
7,2002,611900,32,24,8,15
8,2002,611900,34,28,6,24
9,2002,611900,17,12,5,12
10,2002,611900,16,13,3,12
11,2002,611900,17,13,4,15
12,2002,611900,22,20,2,23
1,2003,611900,26,22,4,12
2,2003,611900,15,9,6,14
3,2003,611900,23,20,3,21
4,2003,611900,35,26,9,21
5,2003,611900,28,21,7,18
6,2003,611900,24,13,11,18
7,2003,611900,18,16,2,20
8,2003,611900,20,17,3,20
9,2003,611900,20,16,4,15
10,2003,611900,13,13,0,24
11,2003,611900,15,13,2,8
12,2003,611900,17,14,3,14
1,2004,611900,16,13,3,8
2,2004,611900,13,9,4,22
3,2004,611900,20,17,3,18
4,2004,611900,16,11,5,13
5,2004,611900,15,13,2,17
6,2004,611900,11,10,1,23
7,2004,611900,26,20,6,16
8,2004,611900,28,23,5,13
9,2004,611900,18,10,8,20
10,2004,611900,26,15,11,23
11,2004,611900,14,10,4,19
12,2004,611900,14,14,0,17
1,2005,611900,17,13,4,30
2,2005,611900,12,10,2,10
3,2005,611900,16,13,3,17
4,2005,611900,16,12,4,7
5,2005,611900,32,21,11,9
6,2005,611900,32,29,3,14
7,2005,611900,26,17,9,14
8,2005,611900,25,21,4,7
9,2005,611900,35,28,7,8
10,2005,611900,34,24,10,18
11,2005,611900,25,22,3,11
12,2005,611900,19,17,2,36
1,2006,611900,16,9,7,19
2,2006,611900,10,9,1,17
3,2006,611900,20,18,2,19
4,2006,611900,15,9,6,22
5,2006,611900,18,15,3,24
6,2006,611900,19,15,4,17
7,2006,611900,22,15,7,18
8,2006,611900,34,31,3,28
9,2006,611900,23,16,7,12
10,2006,611900,18,17,1,19
11,2006,611900,13,11,2,15
12,2006,611900,20,16,4,22
1,2007,611900,21,18,3,26
2,2007,611900,15,13,2,16
3,2007,611900,24,16,8,17
4,2007,611900,22,19,3,17
5,2007,611900,28,21,7,19
6,2007,611900,29,20,9,14
7,2007,611900,41,34,7,7
8,2007,611900,22,15,7,20
9,2007,611900,27,25,2,16
10,2007,611900,25,20,5,18
11,2007,611900,19,14,5,9
12,2007,611900,18,13,5,15
1,2008,611900,23,19,4,10
2,2008,611900,12,11,1,9
3,2008,611900,18,10,8,15
4,2008,611900,16,8,8,19
5,2008,611900,17,15,2,9
6,2008,611900,25,21,4,8
7,2008,611900,17,15,2,8
8,2008,611900,22,17,5,13
9,2008,611900,17,13,4,10
10,2008,611900,18,14,4,15
11,2008,611900,10,7,3,14
12,2008,611900,13,11,2,4
1,2009,611900,5,5,0,7
2,2009,611900,6,6,0,10
3,2009,611900,9,7,2,9
4,2009,611900,9,4,5,10
5,2009,611900,11,11,0,12
6,2009,611900,16,7,9,23
7,2009,611900,18,11,7,7
8,2009,611900,15,11,4,13
9,2009,611900,23,19,4,5
10,2009,611900,14,11,3,9
11,2009,611900,21,14,7,14
12,2009,611900,16,12,4,10
1,2010,611900,20,17,3,15
2,2010,611900,12,7,5,13
3,2010,611900,16,11,5,16
4,2010,611900,16,11,5,10
5,2010,611900,22,16,6,5
6,2010,611900,26,16,10,10
7,2010,611900,20,18,2,9
8,2010,611900,20,15,5,7
9,2010,611900,13,12,1,22
10,2010,611900,19,18,1,15
11,2010,611900,15,14,1,21
12,2010,611900,13,11,2,9
1,2011,611900,6,6,0,12
2,2011,611900,13,12,1,8
1,1999,612000,13,8,5,2
2,1999,612000,8,4,4,8
3,1999,612000,9,6,3,6
4,1999,612000,8,6,2,5
5,1999,612000,12,7,5,12
6,1999,612000,11,5,6,5
7,1999,612000,8,6,2,4
8,1999,612000,16,7,9,3
9,1999,612000,16,10,6,3
10,1999,612000,12,10,2,8
11,1999,612000,9,5,4,10
12,1999,612000,14,12,2,4
1,2000,612000,16,8,8,7
2,2000,612000,14,9,5,6
3,2000,612000,9,5,4,7
4,2000,612000,8,8,0,3
5,2000,612000,18,15,3,6
6,2000,612000,24,19,5,5
7,2000,612000,15,10,5,3
8,2000,612000,12,6,6,1
9,2000,612000,13,10,3,12
10,2000,612000,16,12,4,7
11,2000,612000,15,11,4,5
12,2000,612000,10,7,3,5
1,2001,612000,9,7,2,15
2,2001,612000,11,10,1,9
3,2001,612000,10,8,2,10
4,2001,612000,18,11,7,13
5,2001,612000,21,13,8,19
6,2001,612000,15,11,4,8
7,2001,612000,13,10,3,5
8,2001,612000,12,10,2,5
9,2001,612000,21,10,11,4
10,2001,612000,8,6,2,7
11,2001,612000,8,5,3,7
12,2001,612000,4,3,1,5
1,2002,612000,12,8,4,13
2,2002,612000,10,8,2,16
3,2002,612000,6,4,2,8
4,2002,612000,11,8,3,8
5,2002,612000,14,12,2,10
6,2002,612000,12,7,5,2
7,2002,612000,10,9,1,8
8,2002,612000,14,11,3,6
9,2002,612000,14,10,4,3
10,2002,612000,16,12,4,9
11,2002,612000,15,12,3,4
12,2002,612000,13,12,1,5
1,2003,612000,15,11,4,5
2,2003,612000,11,7,4,8
3,2003,612000,9,8,1,13
4,2003,612000,15,9,6,19
5,2003,612000,15,10,5,15
6,2003,612000,13,10,3,17
7,2003,612000,14,7,7,11
8,2003,612000,18,12,6,16
9,2003,612000,13,7,6,9
10,2003,612000,13,6,7,21
11,2003,612000,17,13,4,4
12,2003,612000,14,10,4,13
1,2004,612000,14,10,4,14
2,2004,612000,10,8,2,12
3,2004,612000,16,10,6,12
4,2004,612000,12,11,1,6
5,2004,612000,10,9,1,4
6,2004,612000,16,16,0,5
7,2004,612000,11,8,3,21
8,2004,612000,21,18,3,10
9,2004,612000,12,11,1,12
10,2004,612000,18,15,3,8
11,2004,612000,14,9,5,24
12,2004,612000,17,14,3,9
1,2005,612000,15,10,5,5
2,2005,612000,11,9,2,20
3,2005,612000,6,6,0,12
4,2005,612000,6,6,0,10
5,2005,612000,10,10,0,20
6,2005,612000,9,7,2,20
7,2005,612000,16,12,4,8
8,2005,612000,17,15,2,12
9,2005,612000,10,7,3,5
10,2005,612000,9,8,1,11
11,2005,612000,8,6,2,5
12,2005,612000,18,16,2,4
1,2006,612000,15,12,3,7
2,2006,612000,9,8,1,4
3,2006,612000,12,9,3,2
4,2006,612000,15,12,3,5
5,2006,612000,13,12,1,7
6,2006,612000,19,15,4,2
7,2006,612000,17,9,8,5
8,2006,612000,11,10,1,9
9,2006,612000,11,7,4,3
10,2006,612000,18,13,5,9
11,2006,612000,16,11,5,15
12,2006,612000,7,4,3,7
1,2007,612000,10,7,3,8
2,2007,612000,3,2,1,4
3,2007,612000,11,8,3,10
4,2007,612000,13,7,6,5
5,2007,612000,17,12,5,9
6,2007,612000,14,11,3,3
7,2007,612000,13,11,2,5
8,2007,612000,23,17,6,6
9,2007,612000,21,16,5,9
10,2007,612000,23,18,5,13
11,2007,612000,13,7,6,5
12,2007,612000,10,9,1,3
1,2008,612000,9,8,1,10
2,2008,612000,7,4,3,8
3,2008,612000,14,11,3,3
4,2008,612000,10,7,3,8
5,2008,612000,13,9,4,7
6,2008,612000,12,9,3,4
7,2008,612000,15,13,2,5
8,2008,612000,16,12,4,5
9,2008,612000,14,7,7,7
10,2008,612000,12,9,3,5
11,2008,612000,12,11,1,3
12,2008,612000,4,4,0,8
1,2009,612000,10,8,2,6
2,2009,612000,8,7,1,17
3,2009,612000,6,6,0,9
4,2009,612000,12,9,3,10
5,2009,612000,14,11,3,8
6,2009,612000,16,13,3,4
7,2009,612000,19,17,2,3
8,2009,612000,21,16,5,5
9,2009,612000,10,6,4,9
10,2009,612000,17,14,3,7
11,2009,612000,12,10,2,3
12,2009,612000,9,9,0,10
1,2010,612000,19,17,2,9
2,2010,612000,5,5,0,10
3,2010,612000,10,6,4,9
4,2010,612000,11,7,4,11
5,2010,612000,7,5,2,11
6,2010,612000,9,9,0,4
7,2010,612000,16,11,5,13
8,2010,612000,10,8,2,12
9,2010,612000,10,8,2,6
10,2010,612000,11,10,1,7
11,2010,612000,11,10,1,3
12,2010,612000,9,9,0,8
1,2011,612000,10,9,1,15
2,2011,612000,4,4,0,40
1,1999,836100,54,37,17,17
2,1999,836100,70,52,18,13
3,1999,836100,62,40,22,7
4,1999,836100,79,65,14,10
5,1999,836100,72,57,15,12
6,1999,836100,78,56,22,14
7,1999,836100,99,70,29,5
8,1999,836100,71,59,12,9
9,1999,836100,68,48,20,21
10,1999,836100,62,41,21,21
11,1999,836100,46,38,8,13
12,1999,836100,55,49,6,16
1,2000,836100,50,40,10,16
2,2000,836100,52,37,15,17
3,2000,836100,59,47,12,15
4,2000,836100,40,24,16,17
5,2000,836100,50,34,16,15
6,2000,836100,43,32,11,13
7,2000,836100,48,31,17,15
8,2000,836100,53,41,12,15
9,2000,836100,46,36,10,18
10,2000,836100,64,52,12,11
11,2000,836100,37,29,8,9
12,2000,836100,36,31,5,12
1,2001,836100,45,35,10,21
2,2001,836100,34,23,11,15
3,2001,836100,43,33,10,15
4,2001,836100,42,27,15,15
5,2001,836100,49,42,7,13
6,2001,836100,46,34,12,19
7,2001,836100,49,43,6,10
8,2001,836100,45,34,11,4
9,2001,836100,43,29,14,6
10,2001,836100,53,40,13,6
11,2001,836100,52,45,7,12
12,2001,836100,39,31,8,7
1,2002,836100,48,38,10,7
2,2002,836100,30,29,1,12
3,2002,836100,47,29,18,12
4,2002,836100,36,26,10,3
5,2002,836100,42,31,11,11
6,2002,836100,41,31,10,8
7,2002,836100,46,35,11,2
8,2002,836100,39,31,8,6
9,2002,836100,48,39,9,7
10,2002,836100,45,44,1,6
11,2002,836100,40,34,6,11
12,2002,836100,39,30,9,13
1,2003,836100,42,30,12,8
2,2003,836100,30,20,10,9
3,2003,836100,26,21,5,3
4,2003,836100,32,25,7,12
5,2003,836100,27,20,7,2
6,2003,836100,41,27,14,7
7,2003,836100,48,39,9,7
8,2003,836100,47,41,6,6
9,2003,836100,27,22,5,10
10,2003,836100,47,35,12,11
11,2003,836100,43,34,9,12
12,2003,836100,30,22,8,7
1,2004,836100,41,35,6,16
2,2004,836100,41,31,10,17
3,2004,836100,45,38,7,9
4,2004,836100,36,29,7,17
5,2004,836100,41,31,10,14
6,2004,836100,39,33,6,11
7,2004,836100,43,33,10,3
8,2004,836100,46,37,9,3
9,2004,836100,45,35,10,10
10,2004,836100,45,34,11,7
11,2004,836100,32,28,4,3
12,2004,836100,32,27,5,16
1,2005,836100,26,22,4,16
2,2005,836100,23,17,6,13
3,2005,836100,32,27,5,16
4,2005,836100,30,19,11,12
5,2005,836100,50,37,13,23
6,2005,836100,43,31,12,11
7,2005,836100,53,41,12,7
8,2005,836100,47,36,11,14
9,2005,836100,33,23,10,13
10,2005,836100,50,40,10,10
11,2005,836100,33,28,5,4
12,2005,836100,37,30,7,6
1,2006,836100,37,28,9,9
2,2006,836100,31,29,2,5
3,2006,836100,22,19,3,6
4,2006,836100,39,32,7,12
5,2006,836100,41,37,4,9
6,2006,836100,49,38,11,5
7,2006,836100,53,40,13,14
8,2006,836100,48,41,7,15
9,2006,836100,43,35,8,9
10,2006,836100,43,33,10,20
11,2006,836100,30,25,5,11
12,2006,836100,24,22,2,2
1,2007,836100,32,24,8,10
2,2007,836100,12,8,4,14
3,2007,836100,36,29,7,11
4,2007,836100,25,22,3,9
5,2007,836100,47,35,12,8
6,2007,836100,32,24,8,8
7,2007,836100,47,41,6,5
8,2007,836100,41,33,8,12
9,2007,836100,37,29,8,25
10,2007,836100,39,36,3,5
11,2007,836100,31,25,6,13
12,2007,836100,29,20,9,12
1,2008,836100,27,24,3,22
2,2008,836100,23,19,4,7
3,2008,836100,29,24,5,6
4,2008,836100,31,25,6,3
5,2008,836100,33,26,7,2
6,2008,836100,25,21,4,5
7,2008,836100,26,24,2,3
8,2008,836100,42,36,6,15
9,2008,836100,30,26,4,3
10,2008,836100,26,21,5,10
11,2008,836100,24,18,6,10
12,2008,836100,21,20,1,9
1,2009,836100,22,19,3,3
2,2009,836100,24,19,5,6
3,2009,836100,31,24,7,8
4,2009,836100,33,29,4,5
5,2009,836100,37,28,9,12
6,2009,836100,32,23,9,10
7,2009,836100,33,25,8,11
8,2009,836100,40,33,7,9
9,2009,836100,37,30,7,11
10,2009,836100,29,24,5,13
11,2009,836100,31,22,9,13
12,2009,836100,23,22,1,6
1,2010,836100,25,20,5,20
2,2010,836100,20,16,4,12
3,2010,836100,28,21,7,11
4,2010,836100,39,27,12,7
5,2010,836100,28,23,5,11
6,2010,836100,25,10,15,4
7,2010,836100,26,22,4,7
8,2010,836100,37,26,11,7
9,2010,836100,28,18,10,9
10,2010,836100,31,28,3,6
11,2010,836100,35,30,5,14
12,2010,836100,20,18,2,7
1,2011,836100,26,21,5,6
2,2011,836100,21,18,3,8
1,1999,612100,6,3,3,2
2,1999,612100,9,8,1,7
3,1999,612100,11,8,3,1
4,1999,612100,8,8,0,3
5,1999,612100,14,9,5,3
6,1999,612100,9,8,1,2
7,1999,612100,12,8,4,9
8,1999,612100,9,7,2,2
9,1999,612100,10,7,3,5
10,1999,612100,19,16,3,2
11,1999,612100,24,20,4,6
12,1999,612100,12,11,1,3
1,2000,612100,11,9,2,4
2,2000,612100,15,11,4,8
3,2000,612100,14,11,3,10
4,2000,612100,11,10,1,5
5,2000,612100,9,6,3,6
6,2000,612100,7,3,4,7
7,2000,612100,16,11,5,11
8,2000,612100,10,7,3,10
9,2000,612100,10,6,4,0
10,2000,612100,14,11,3,3
11,2000,612100,10,9,1,6
12,2000,612100,7,6,1,6
1,2001,612100,7,7,0,2
2,2001,612100,6,3,3,2
3,2001,612100,5,4,1,5
4,2001,612100,8,8,0,3
5,2001,612100,8,4,4,2
6,2001,612100,7,5,2,5
7,2001,612100,18,12,6,2
8,2001,612100,15,11,4,10
9,2001,612100,14,12,2,6
10,2001,612100,6,2,4,13
11,2001,612100,9,6,3,9
12,2001,612100,5,3,2,8
1,2002,612100,5,3,2,9
2,2002,612100,5,2,3,7
3,2002,612100,7,5,2,5
4,2002,612100,11,10,1,5
5,2002,612100,8,6,2,4
6,2002,612100,8,5,3,2
7,2002,612100,12,9,3,4
8,2002,612100,13,11,2,3
9,2002,612100,15,9,6,3
10,2002,612100,13,11,2,6
11,2002,612100,6,5,1,6
12,2002,612100,9,8,1,5
1,2003,612100,12,10,2,6
2,2003,612100,8,6,2,17
3,2003,612100,14,11,3,14
4,2003,612100,12,8,4,8
5,2003,612100,14,9,5,10
6,2003,612100,10,10,0,9
7,2003,612100,11,9,2,10
8,2003,612100,11,10,1,8
9,2003,612100,19,15,4,4
10,2003,612100,10,9,1,9
11,2003,612100,11,9,2,4
12,2003,612100,19,17,2,9
1,2004,612100,7,6,1,11
2,2004,612100,10,8,2,5
3,2004,612100,13,12,1,5
4,2004,612100,9,7,2,8
5,2004,612100,14,10,4,14
6,2004,612100,10,8,2,4
7,2004,612100,12,8,4,8
8,2004,612100,19,14,5,9
9,2004,612100,9,7,2,8
10,2004,612100,14,13,1,6
11,2004,612100,8,8,0,10
12,2004,612100,10,9,1,7
1,2005,612100,7,6,1,11
2,2005,612100,8,5,3,4
3,2005,612100,11,9,2,8
4,2005,612100,6,4,2,8
5,2005,612100,10,4,6,3
6,2005,612100,13,9,4,3
7,2005,612100,15,9,6,4
8,2005,612100,9,6,3,5
9,2005,612100,9,8,1,4
10,2005,612100,9,8,1,5
11,2005,612100,13,10,3,5
12,2005,612100,9,8,1,2
1,2006,612100,17,13,4,7
2,2006,612100,10,9,1,2
3,2006,612100,10,10,0,2
4,2006,612100,13,7,6,2
5,2006,612100,19,16,3,2
6,2006,612100,12,10,2,5
7,2006,612100,10,7,3,3
8,2006,612100,13,7,6,10
9,2006,612100,12,7,5,9
10,2006,612100,11,8,3,5
11,2006,612100,9,7,2,21
12,2006,612100,10,8,2,3
1,2007,612100,9,6,3,15
2,2007,612100,6,6,0,13
3,2007,612100,10,10,0,14
4,2007,612100,4,3,1,8
5,2007,612100,11,3,8,8
6,2007,612100,12,6,6,9
7,2007,612100,17,13,4,9
8,2007,612100,15,10,5,12
9,2007,612100,9,6,3,9
10,2007,612100,8,6,2,12
11,2007,612100,7,5,2,6
12,2007,612100,6,5,1,4
1,2008,612100,6,5,1,13
2,2008,612100,2,2,0,1
3,2008,612100,7,5,2,8
4,2008,612100,6,5,1,5
5,2008,612100,10,8,2,5
6,2008,612100,7,6,1,2
7,2008,612100,9,4,5,5
8,2008,612100,8,5,3,5
9,2008,612100,8,5,3,8
10,2008,612100,22,18,4,10
11,2008,612100,12,12,0,5
12,2008,612100,11,9,2,6
1,2009,612100,10,8,2,6
2,2009,612100,6,5,1,7
3,2009,612100,9,8,1,7
4,2009,612100,9,7,2,4
5,2009,612100,17,13,4,8
6,2009,612100,13,6,7,8
7,2009,612100,16,11,5,8
8,2009,612100,10,8,2,13
9,2009,612100,12,7,5,10
10,2009,612100,14,12,2,9
11,2009,612100,7,6,1,7
12,2009,612100,5,5,0,6
1,2010,612100,3,2,1,5
2,2010,612100,3,2,1,7
3,2010,612100,6,4,2,5
4,2010,612100,10,8,2,9
5,2010,612100,7,5,2,9
6,2010,612100,11,10,1,8
7,2010,612100,9,8,1,5
8,2010,612100,9,5,4,12
9,2010,612100,14,10,4,13
10,2010,612100,11,11,0,7
11,2010,612100,8,7,1,5
12,2010,612100,7,7,0,11
1,2011,612100,4,4,0,9
2,2011,612100,4,4,0,5
1,1999,843800,19,15,4,6
2,1999,843800,15,11,4,19
3,1999,843800,12,10,2,2
4,1999,843800,25,17,8,4
5,1999,843800,21,19,2,4
6,1999,843800,16,14,2,6
7,1999,843800,24,20,4,8
8,1999,843800,24,15,9,5
9,1999,843800,14,8,6,11
10,1999,843800,17,12,5,7
11,1999,843800,20,16,4,7
12,1999,843800,10,9,1,11
1,2000,843800,14,14,0,6
2,2000,843800,15,12,3,7
3,2000,843800,13,8,5,7
4,2000,843800,23,19,4,13
5,2000,843800,18,15,3,9
6,2000,843800,13,10,3,6
7,2000,843800,12,9,3,9
8,2000,843800,29,24,5,13
9,2000,843800,26,20,6,10
10,2000,843800,20,16,4,23
11,2000,843800,23,20,3,16
12,2000,843800,22,17,5,8
1,2001,843800,19,13,6,9
2,2001,843800,15,14,1,9
3,2001,843800,20,18,2,15
4,2001,843800,16,9,7,15
5,2001,843800,12,6,6,7
6,2001,843800,19,13,6,14
7,2001,843800,23,20,3,19
8,2001,843800,30,24,6,10
9,2001,843800,17,15,2,9
10,2001,843800,18,12,6,11
11,2001,843800,19,11,8,10
12,2001,843800,18,13,5,13
1,2002,843800,17,12,5,16
2,2002,843800,13,8,5,16
3,2002,843800,14,11,3,3
4,2002,843800,20,14,6,12
5,2002,843800,21,11,10,6
6,2002,843800,24,18,6,14
7,2002,843800,20,11,9,7
8,2002,843800,24,21,3,15
9,2002,843800,21,17,4,20
10,2002,843800,21,18,3,11
11,2002,843800,7,5,2,16
12,2002,843800,15,12,3,9
1,2003,843800,12,8,4,10
2,2003,843800,15,12,3,16
3,2003,843800,20,16,4,12
4,2003,843800,14,11,3,5
5,2003,843800,15,14,1,15
6,2003,843800,26,19,7,19
7,2003,843800,14,9,5,13
8,2003,843800,19,14,5,9
9,2003,843800,21,18,3,16
10,2003,843800,21,19,2,29
11,2003,843800,17,13,4,6
12,2003,843800,18,15,3,8
1,2004,843800,22,20,2,16
2,2004,843800,22,14,8,8
3,2004,843800,24,17,7,13
4,2004,843800,19,12,7,5
5,2004,843800,16,11,5,11
6,2004,843800,24,18,6,8
7,2004,843800,10,7,3,8
8,2004,843800,15,14,1,12
9,2004,843800,23,21,2,5
10,2004,843800,25,22,3,3
11,2004,843800,15,13,2,7
12,2004,843800,7,5,2,5
1,2005,843800,17,16,1,3
2,2005,843800,10,9,1,6
3,2005,843800,21,15,6,6
4,2005,843800,18,15,3,3
5,2005,843800,15,14,1,10
6,2005,843800,7,4,3,7
7,2005,843800,10,8,2,5
8,2005,843800,14,10,4,3
9,2005,843800,34,31,3,1
10,2005,843800,20,17,3,8
11,2005,843800,21,19,2,7
12,2005,843800,25,18,7,3
1,2006,843800,28,19,9,2
2,2006,843800,20,17,3,3
3,2006,843800,19,12,7,10
4,2006,843800,12,11,1,7
5,2006,843800,26,18,8,4
6,2006,843800,16,10,6,2
7,2006,843800,10,6,4,5
8,2006,843800,17,13,4,1
9,2006,843800,20,15,5,5
10,2006,843800,21,18,3,3
11,2006,843800,24,17,7,1
12,2006,843800,14,9,5,12
1,2007,843800,9,3,6,9
2,2007,843800,9,7,2,11
3,2007,843800,8,6,2,11
4,2007,843800,7,6,1,3
5,2007,843800,22,17,5,1
6,2007,843800,7,4,3,1
7,2007,843800,12,10,2,6
8,2007,843800,12,11,1,7
9,2007,843800,22,13,9,5
10,2007,843800,14,11,3,5
11,2007,843800,12,8,4,6
12,2007,843800,15,11,4,9
1,2008,843800,18,16,2,5
2,2008,843800,14,11,3,5
3,2008,843800,9,8,1,7
4,2008,843800,15,11,4,7
5,2008,843800,14,10,4,4
6,2008,843800,20,15,5,2
7,2008,843800,10,9,1,6
8,2008,843800,10,7,3,4
9,2008,843800,22,20,2,0
10,2008,843800,13,12,1,3
11,2008,843800,10,7,3,7
12,2008,843800,16,12,4,4
1,2009,843800,11,9,2,10
2,2009,843800,7,5,2,6
3,2009,843800,7,6,1,10
4,2009,843800,9,6,3,5
5,2009,843800,13,11,2,7
6,2009,843800,15,13,2,4
7,2009,843800,8,5,3,5
8,2009,843800,9,5,4,4
9,2009,843800,22,15,7,2
10,2009,843800,11,8,3,14
11,2009,843800,14,9,5,12
12,2009,843800,7,5,2,4
1,2010,843800,14,8,6,4
2,2010,843800,11,7,4,10
3,2010,843800,11,8,3,3
4,2010,843800,6,4,2,5
5,2010,843800,21,18,3,4
6,2010,843800,7,5,2,1
7,2010,843800,17,11,6,5
8,2010,843800,9,8,1,5
9,2010,843800,12,9,3,5
10,2010,843800,6,4,2,4
11,2010,843800,10,9,1,3
12,2010,843800,11,9,2,4
1,2011,843800,8,7,1,1
2,2011,843800,12,9,3,2
1,1999,410900,12,11,1,0
2,1999,410900,10,10,0,0
3,1999,410900,7,7,0,2
4,1999,410900,10,8,2,0
5,1999,410900,9,9,0,1
6,1999,410900,10,10,0,0
7,1999,410900,20,19,1,0
8,1999,410900,19,17,2,0
9,1999,410900,12,12,0,0
10,1999,410900,12,12,0,0
11,1999,410900,9,9,0,0
12,1999,410900,10,10,0,0
1,2000,410900,11,8,3,0
2,2000,410900,6,6,0,2
3,2000,410900,4,4,0,1
4,2000,410900,12,11,1,0
5,2000,410900,13,12,1,1
6,2000,410900,11,11,0,1
7,2000,410900,11,10,1,0
8,2000,410900,14,14,0,0
9,2000,410900,13,13,0,1
10,2000,410900,6,6,0,1
11,2000,410900,13,11,2,1
12,2000,410900,7,7,0,3
1,2001,410900,10,9,1,0
2,2001,410900,8,8,0,0
3,2001,410900,6,5,1,0
4,2001,410900,5,5,0,0
5,2001,410900,5,4,1,1
6,2001,410900,10,10,0,0
7,2001,410900,13,12,1,0
8,2001,410900,5,4,1,1
9,2001,410900,9,8,1,0
10,2001,410900,8,8,0,0
11,2001,410900,9,8,1,0
12,2001,410900,11,10,1,0
1,2002,410900,11,10,1,0
2,2002,410900,6,6,0,0
3,2002,410900,2,2,0,0
4,2002,410900,9,8,1,0
5,2002,410900,8,8,0,0
6,2002,410900,9,8,1,2
7,2002,410900,13,13,0,0
8,2002,410900,8,8,0,0
9,2002,410900,11,10,1,0
10,2002,410900,12,12,0,0
11,2002,410900,13,12,1,0
12,2002,410900,10,9,1,0
1,2003,410900,17,17,0,0
2,2003,410900,4,3,1,0
3,2003,410900,8,6,2,0
4,2003,410900,9,9,0,0
5,2003,410900,9,9,0,0
6,2003,410900,10,9,1,1
7,2003,410900,9,9,0,0
8,2003,410900,11,11,0,1
9,2003,410900,12,12,0,0
10,2003,410900,4,4,0,0
11,2003,410900,10,9,1,0
12,2003,410900,8,8,0,0
1,2004,410900,6,5,1,0
2,2004,410900,5,4,1,0
3,2004,410900,5,5,0,0
4,2004,410900,9,9,0,0
5,2004,410900,9,8,1,0
6,2004,410900,10,10,0,0
7,2004,410900,10,9,1,0
8,2004,410900,12,11,1,0
9,2004,410900,18,17,1,0
10,2004,410900,6,6,0,0
11,2004,410900,7,7,0,0
12,2004,410900,4,4,0,0
1,2005,410900,6,6,0,0
2,2005,410900,3,2,1,0
3,2005,410900,11,10,1,0
4,2005,410900,10,10,0,0
5,2005,410900,7,6,1,0
6,2005,410900,11,9,2,0
7,2005,410900,12,12,0,2
8,2005,410900,10,10,0,0
9,2005,410900,9,9,0,0
10,2005,410900,20,18,2,0
11,2005,410900,11,11,0,0
12,2005,410900,14,14,0,0
1,2006,410900,9,9,0,0
2,2006,410900,6,5,1,0
3,2006,410900,7,7,0,1
4,2006,410900,8,8,0,0
5,2006,410900,3,3,0,0
6,2006,410900,4,4,0,0
7,2006,410900,5,5,0,0
8,2006,410900,6,6,0,0
9,2006,410900,9,9,0,0
10,2006,410900,14,13,1,0
11,2006,410900,10,10,0,0
12,2006,410900,10,10,0,0
1,2007,410900,9,8,1,0
2,2007,410900,3,3,0,0
3,2007,410900,6,6,0,0
4,2007,410900,3,2,1,0
5,2007,410900,7,5,2,0
6,2007,410900,15,13,2,0
7,2007,410900,9,9,0,0
8,2007,410900,8,8,0,0
9,2007,410900,6,6,0,0
10,2007,410900,8,8,0,2
11,2007,410900,3,3,0,0
12,2007,410900,5,5,0,0
1,2008,410900,13,12,1,0
2,2008,410900,4,4,0,0
3,2008,410900,6,5,1,1
4,2008,410900,1,1,0,0
5,2008,410900,2,2,0,0
6,2008,410900,10,9,1,0
7,2008,410900,10,10,0,0
8,2008,410900,7,7,0,0
9,2008,410900,8,7,1,2
10,2008,410900,6,5,1,1
11,2008,410900,3,3,0,1
12,2008,410900,8,6,2,0
1,2009,410900,0,0,0,0
2,2009,410900,3,3,0,0
3,2009,410900,4,4,0,0
4,2009,410900,5,5,0,0
5,2009,410900,6,6,0,0
6,2009,410900,5,5,0,0
7,2009,410900,5,5,0,0
8,2009,410900,13,13,0,0
9,2009,410900,7,7,0,0
10,2009,410900,9,9,0,0
11,2009,410900,8,8,0,0
12,2009,410900,6,5,1,0
1,2010,410900,4,3,1,0
2,2010,410900,1,1,0,0
3,2010,410900,9,9,0,0
4,2010,410900,10,9,1,2
5,2010,410900,12,12,0,2
6,2010,410900,11,11,0,2
7,2010,410900,15,15,0,2
8,2010,410900,11,10,1,1
9,2010,410900,10,10,0,1
10,2010,410900,7,7,0,0
11,2010,410900,8,8,0,1
12,2010,410900,4,4,0,1
1,2011,410900,2,1,1,0
2,2011,410900,3,3,0,0
1,1999,410800,32,32,0,4
2,1999,410800,33,31,2,4
3,1999,410800,47,46,1,2
4,1999,410800,39,34,5,5
5,1999,410800,42,40,2,1
6,1999,410800,28,28,0,1
7,1999,410800,50,48,2,2
8,1999,410800,40,38,2,6
9,1999,410800,48,48,0,1
10,1999,410800,29,29,0,2
11,1999,410800,30,30,0,3
12,1999,410800,26,25,1,3
1,2000,410800,25,25,0,2
2,2000,410800,19,17,2,7
3,2000,410800,43,42,1,2
4,2000,410800,37,35,2,2
5,2000,410800,55,53,2,7
6,2000,410800,39,38,1,8
7,2000,410800,47,47,0,2
8,2000,410800,41,40,1,5
9,2000,410800,36,35,1,3
10,2000,410800,37,36,1,3
11,2000,410800,43,38,5,4
12,2000,410800,35,34,1,3
1,2001,410800,28,27,1,5
2,2001,410800,15,14,1,3
3,2001,410800,26,24,2,1
4,2001,410800,21,21,0,1
5,2001,410800,34,33,1,6
6,2001,410800,27,25,2,3
7,2001,410800,33,33,0,6
8,2001,410800,36,32,4,4
9,2001,410800,36,33,3,4
10,2001,410800,37,37,0,3
11,2001,410800,20,19,1,3
12,2001,410800,22,21,1,13
1,2002,410800,13,12,1,0
2,2002,410800,25,23,2,2
3,2002,410800,18,16,2,0
4,2002,410800,29,28,1,4
5,2002,410800,29,26,3,2
6,2002,410800,39,33,6,4
7,2002,410800,29,26,3,4
8,2002,410800,31,30,1,5
9,2002,410800,36,33,3,0
10,2002,410800,25,25,0,0
11,2002,410800,30,27,3,2
12,2002,410800,27,26,1,0
1,2003,410800,24,23,1,2
2,2003,410800,12,10,2,2
3,2003,410800,18,16,2,1
4,2003,410800,15,14,1,0
5,2003,410800,20,20,0,2
6,2003,410800,15,13,2,0
7,2003,410800,32,29,3,0
8,2003,410800,27,27,0,0
9,2003,410800,32,29,3,0
10,2003,410800,27,26,1,0
11,2003,410800,28,25,3,0
12,2003,410800,27,26,1,0
1,2004,410800,20,19,1,0
2,2004,410800,16,16,0,3
3,2004,410800,13,12,1,1
4,2004,410800,17,16,1,0
5,2004,410800,27,25,2,0
6,2004,410800,22,22,0,0
7,2004,410800,29,28,1,0
8,2004,410800,26,24,2,2
9,2004,410800,18,16,2,1
10,2004,410800,33,32,1,3
11,2004,410800,33,31,2,1
12,2004,410800,19,17,2,0
1,2005,410800,17,16,1,3
2,2005,410800,16,15,1,0
3,2005,410800,13,12,1,1
4,2005,410800,21,20,1,1
5,2005,410800,28,27,1,1
6,2005,410800,20,19,1,3
7,2005,410800,30,30,0,2
8,2005,410800,21,20,1,1
9,2005,410800,19,17,2,2
10,2005,410800,26,23,3,0
11,2005,410800,18,17,1,1
12,2005,410800,20,19,1,0
1,2006,410800,18,16,2,3
2,2006,410800,8,8,0,0
3,2006,410800,19,16,3,1
4,2006,410800,7,7,0,1
5,2006,410800,13,13,0,1
6,2006,410800,15,14,1,1
7,2006,410800,15,12,3,2
8,2006,410800,13,11,2,0
9,2006,410800,10,9,1,0
10,2006,410800,19,16,3,0
11,2006,410800,12,11,1,0
12,2006,410800,20,20,0,1
1,2007,410800,14,11,3,0
2,2007,410800,10,10,0,1
3,2007,410800,17,16,1,2
4,2007,410800,11,11,0,0
5,2007,410800,15,13,2,1
6,2007,410800,15,15,0,0
7,2007,410800,16,16,0,3
8,2007,410800,12,11,1,0
9,2007,410800,21,21,0,1
10,2007,410800,23,23,0,0
11,2007,410800,19,18,1,2
12,2007,410800,18,16,2,1
1,2008,410800,13,13,0,0
2,2008,410800,12,12,0,2
3,2008,410800,11,11,0,1
4,2008,410800,11,11,0,4
5,2008,410800,17,16,1,1
6,2008,410800,25,23,2,1
7,2008,410800,23,22,1,3
8,2008,410800,15,15,0,1
9,2008,410800,15,13,2,2
10,2008,410800,11,10,1,1
11,2008,410800,5,4,1,0
12,2008,410800,11,9,2,0
1,2009,410800,7,6,1,1
2,2009,410800,8,8,0,0
3,2009,410800,16,14,2,1
4,2009,410800,8,8,0,2
5,2009,410800,9,8,1,3
6,2009,410800,16,15,1,3
7,2009,410800,17,16,1,1
8,2009,410800,8,8,0,0
9,2009,410800,10,10,0,1
10,2009,410800,12,12,0,1
11,2009,410800,6,6,0,3
12,2009,410800,10,10,0,2
1,2010,410800,9,9,0,1
2,2010,410800,14,14,0,3
3,2010,410800,8,8,0,6
4,2010,410800,13,13,0,1
5,2010,410800,7,7,0,3
6,2010,410800,13,13,0,1
7,2010,410800,13,13,0,1
8,2010,410800,13,13,0,1
9,2010,410800,10,8,2,0
10,2010,410800,11,11,0,2
11,2010,410800,10,10,0,2
12,2010,410800,11,10,1,1
1,2011,410800,15,14,1,1
2,2011,410800,8,7,1,1
1,1999,835600,47,42,5,16
2,1999,835600,54,50,4,17
3,1999,835600,28,24,4,17
4,1999,835600,41,37,4,13
5,1999,835600,49,43,6,10
6,1999,835600,30,27,3,15
7,1999,835600,40,39,1,15
8,1999,835600,50,42,8,8
9,1999,835600,31,28,3,10
10,1999,835600,42,37,5,15
11,1999,835600,28,23,5,17
12,1999,835600,31,28,3,19
1,2000,835600,35,34,1,35
2,2000,835600,31,29,2,20
3,2000,835600,52,46,6,19
4,2000,835600,38,36,2,15
5,2000,835600,42,34,8,18
6,2000,835600,46,40,6,36
7,2000,835600,22,19,3,12
8,2000,835600,31,28,3,15
9,2000,835600,32,22,10,7
10,2000,835600,24,23,1,16
11,2000,835600,27,23,4,12
12,2000,835600,28,27,1,9
1,2001,835600,28,26,2,19
2,2001,835600,19,17,2,10
3,2001,835600,34,23,11,9
4,2001,835600,26,21,5,16
5,2001,835600,40,36,4,11
6,2001,835600,28,23,5,7
7,2001,835600,28,21,7,19
8,2001,835600,46,39,7,18
9,2001,835600,25,22,3,12
10,2001,835600,30,24,6,22
11,2001,835600,32,28,4,22
12,2001,835600,17,15,2,11
1,2002,835600,33,32,1,15
2,2002,835600,25,22,3,14
3,2002,835600,24,19,5,5
4,2002,835600,18,13,5,21
5,2002,835600,28,23,5,12
6,2002,835600,18,15,3,21
7,2002,835600,30,24,6,8
8,2002,835600,32,24,8,15
9,2002,835600,32,29,3,13
10,2002,835600,28,24,4,9
11,2002,835600,22,18,4,14
12,2002,835600,27,25,2,8
1,2003,835600,16,14,2,17
2,2003,835600,9,8,1,20
3,2003,835600,15,11,4,15
4,2003,835600,27,25,2,15
5,2003,835600,17,16,1,29
6,2003,835600,28,26,2,30
7,2003,835600,26,21,5,35
8,2003,835600,19,18,1,6
9,2003,835600,26,24,2,9
10,2003,835600,31,28,3,10
11,2003,835600,23,19,4,9
12,2003,835600,22,21,1,22
1,2004,835600,29,28,1,31
2,2004,835600,17,16,1,28
3,2004,835600,26,22,4,16
4,2004,835600,21,18,3,10
5,2004,835600,26,23,3,8
6,2004,835600,23,21,2,8
7,2004,835600,29,26,3,18
8,2004,835600,29,28,1,5
9,2004,835600,18,17,1,4
10,2004,835600,30,24,6,11
11,2004,835600,22,21,1,7
12,2004,835600,20,17,3,10
1,2005,835600,11,10,1,6
2,2005,835600,14,10,4,6
3,2005,835600,18,16,2,9
4,2005,835600,22,18,4,4
5,2005,835600,26,22,4,7
6,2005,835600,11,8,3,7
7,2005,835600,19,19,0,2
8,2005,835600,26,22,4,4
9,2005,835600,21,17,4,6
10,2005,835600,32,23,9,10
11,2005,835600,34,29,5,17
12,2005,835600,18,16,2,4
1,2006,835600,19,19,0,11
2,2006,835600,25,23,2,11
3,2006,835600,16,11,5,14
4,2006,835600,17,13,4,3
5,2006,835600,23,18,5,16
6,2006,835600,28,25,3,4
7,2006,835600,24,20,4,3
8,2006,835600,15,13,2,12
9,2006,835600,17,14,3,12
10,2006,835600,20,19,1,12
11,2006,835600,12,11,1,20
12,2006,835600,18,16,2,10
1,2007,835600,17,16,1,17
2,2007,835600,14,12,2,6
3,2007,835600,9,9,0,8
4,2007,835600,12,11,1,12
5,2007,835600,22,20,2,8
6,2007,835600,17,14,3,3
7,2007,835600,20,19,1,4
8,2007,835600,14,13,1,11
9,2007,835600,25,22,3,9
10,2007,835600,25,23,2,10
11,2007,835600,17,16,1,10
12,2007,835600,26,25,1,14
1,2008,835600,18,16,2,7
2,2008,835600,22,19,3,10
3,2008,835600,28,27,1,11
4,2008,835600,20,17,3,10
5,2008,835600,23,20,3,6
6,2008,835600,33,30,3,8
7,2008,835600,25,23,2,7
8,2008,835600,32,24,8,9
9,2008,835600,27,23,4,5
10,2008,835600,36,33,3,4
11,2008,835600,18,18,0,17
12,2008,835600,13,10,3,9
1,2009,835600,18,11,7,10
2,2009,835600,12,11,1,9
3,2009,835600,21,20,1,9
4,2009,835600,22,22,0,5
5,2009,835600,21,18,3,5
6,2009,835600,20,14,6,8
7,2009,835600,14,12,2,7
8,2009,835600,20,18,2,5
9,2009,835600,21,18,3,11
10,2009,835600,11,8,3,11
11,2009,835600,15,10,5,4
12,2009,835600,17,15,2,8
1,2010,835600,15,13,2,21
2,2010,835600,23,21,2,12
3,2010,835600,15,12,3,12
4,2010,835600,20,16,4,8
5,2010,835600,18,16,2,15
6,2010,835600,19,17,2,11
7,2010,835600,18,16,2,7
8,2010,835600,22,20,2,10
9,2010,835600,13,12,1,12
10,2010,835600,21,17,4,9
11,2010,835600,17,16,1,9
12,2010,835600,20,20,0,4
1,2011,835600,15,14,1,9
2,2011,835600,9,7,2,8
1,1999,410700,11,10,1,1
2,1999,410700,15,15,0,1
3,1999,410700,12,9,3,0
4,1999,410700,14,14,0,2
5,1999,410700,17,17,0,0
6,1999,410700,23,22,1,0
7,1999,410700,20,18,2,1
8,1999,410700,25,25,0,2
9,1999,410700,23,23,0,3
10,1999,410700,11,10,1,2
11,1999,410700,15,13,2,4
12,1999,410700,10,9,1,2
1,2000,410700,14,12,2,1
2,2000,410700,10,9,1,1
3,2000,410700,14,13,1,1
4,2000,410700,14,14,0,1
5,2000,410700,14,14,0,0
6,2000,410700,13,11,2,1
7,2000,410700,14,14,0,0
8,2000,410700,12,12,0,3
9,2000,410700,13,11,2,4
10,2000,410700,23,21,2,1
11,2000,410700,18,18,0,1
12,2000,410700,15,14,1,0
1,2001,410700,16,16,0,3
2,2001,410700,8,7,1,0
3,2001,410700,12,12,0,0
4,2001,410700,9,9,0,1
5,2001,410700,13,12,1,1
6,2001,410700,17,17,0,0
7,2001,410700,19,18,1,3
8,2001,410700,12,11,1,3
9,2001,410700,14,13,1,0
10,2001,410700,19,19,0,0
11,2001,410700,19,17,2,1
12,2001,410700,11,10,1,0
1,2002,410700,4,4,0,1
2,2002,410700,9,7,2,2
3,2002,410700,11,10,1,0
4,2002,410700,5,5,0,0
5,2002,410700,10,9,1,1
6,2002,410700,17,17,0,1
7,2002,410700,22,21,1,1
8,2002,410700,23,22,1,1
9,2002,410700,22,21,1,1
10,2002,410700,21,21,0,0
11,2002,410700,15,15,0,0
12,2002,410700,15,14,1,0
1,2003,410700,16,16,0,1
2,2003,410700,24,24,0,0
3,2003,410700,9,9,0,5
4,2003,410700,15,13,2,1
5,2003,410700,13,12,1,0
6,2003,410700,8,8,0,0
7,2003,410700,10,10,0,1
8,2003,410700,20,18,2,0
9,2003,410700,13,13,0,0
10,2003,410700,19,18,1,3
11,2003,410700,11,10,1,1
12,2003,410700,12,12,0,3
1,2004,410700,5,5,0,0
2,2004,410700,11,11,0,0
3,2004,410700,12,12,0,0
4,2004,410700,17,17,0,0
5,2004,410700,11,10,1,1
6,2004,410700,11,10,1,3
7,2004,410700,18,18,0,0
8,2004,410700,12,12,0,0
9,2004,410700,14,13,1,0
10,2004,410700,9,9,0,0
11,2004,410700,11,10,1,0
12,2004,410700,17,16,1,0
1,2005,410700,5,5,0,0
2,2005,410700,12,12,0,0
3,2005,410700,17,16,1,1
4,2005,410700,11,8,3,0
5,2005,410700,16,14,2,0
6,2005,410700,13,13,0,0
7,2005,410700,14,13,1,0
8,2005,410700,26,26,0,0
9,2005,410700,12,12,0,3
10,2005,410700,15,15,0,0
11,2005,410700,15,15,0,0
12,2005,410700,8,7,1,0
1,2006,410700,3,2,1,1
2,2006,410700,6,6,0,0
3,2006,410700,6,6,0,0
4,2006,410700,8,7,1,0
5,2006,410700,22,21,1,0
6,2006,410700,8,8,0,0
7,2006,410700,15,14,1,0
8,2006,410700,13,13,0,1
9,2006,410700,14,13,1,0
10,2006,410700,10,9,1,0
11,2006,410700,15,13,2,0
12,2006,410700,13,12,1,0
1,2007,410700,10,10,0,0
2,2007,410700,9,7,2,0
3,2007,410700,11,10,1,1
4,2007,410700,10,10,0,0
5,2007,410700,6,6,0,0
6,2007,410700,9,9,0,2
7,2007,410700,10,10,0,1
8,2007,410700,14,13,1,0
9,2007,410700,6,6,0,2
10,2007,410700,19,18,1,0
11,2007,410700,9,9,0,0
12,2007,410700,9,9,0,2
1,2008,410700,5,4,1,0
2,2008,410700,9,9,0,1
3,2008,410700,6,5,1,3
4,2008,410700,8,8,0,1
5,2008,410700,12,11,1,0
6,2008,410700,6,6,0,0
7,2008,410700,11,11,0,2
8,2008,410700,14,13,1,1
9,2008,410700,14,14,0,1
10,2008,410700,9,9,0,1
11,2008,410700,7,7,0,3
12,2008,410700,7,7,0,0
1,2009,410700,2,2,0,1
2,2009,410700,7,7,0,0
3,2009,410700,9,8,1,1
4,2009,410700,5,5,0,1
5,2009,410700,7,7,0,2
6,2009,410700,15,14,1,0
7,2009,410700,14,14,0,0
8,2009,410700,7,7,0,0
9,2009,410700,5,5,0,0
10,2009,410700,15,15,0,0
11,2009,410700,11,11,0,0
12,2009,410700,8,8,0,0
1,2010,410700,10,10,0,3
2,2010,410700,1,1,0,0
3,2010,410700,1,1,0,0
4,2010,410700,9,9,0,2
5,2010,410700,7,7,0,1
6,2010,410700,5,5,0,0
7,2010,410700,9,9,0,0
8,2010,410700,13,12,1,2
9,2010,410700,8,8,0,1
10,2010,410700,6,5,1,1
11,2010,410700,10,9,1,0
12,2010,410700,7,7,0,2
1,2011,410700,5,5,0,1
2,2011,410700,3,3,0,0
1,1999,410500,4,4,0,1
2,1999,410500,11,10,1,0
3,1999,410500,16,15,1,1
4,1999,410500,10,10,0,2
5,1999,410500,8,5,3,4
6,1999,410500,17,16,1,2
7,1999,410500,19,14,5,3
8,1999,410500,17,15,2,2
9,1999,410500,17,16,1,2
10,1999,410500,6,6,0,6
11,1999,410500,13,11,2,1
12,1999,410500,11,11,0,4
1,2000,410500,7,6,1,1
2,2000,410500,7,7,0,1
3,2000,410500,17,15,2,2
4,2000,410500,11,10,1,1
5,2000,410500,17,15,2,0
6,2000,410500,21,19,2,3
7,2000,410500,17,15,2,3
8,2000,410500,12,12,0,2
9,2000,410500,14,11,3,0
10,2000,410500,13,10,3,5
11,2000,410500,13,13,0,2
12,2000,410500,11,10,1,0
1,2001,410500,10,9,1,4
2,2001,410500,15,15,0,0
3,2001,410500,13,12,1,4
4,2001,410500,6,6,0,1
5,2001,410500,18,14,4,0
6,2001,410500,11,10,1,5
7,2001,410500,14,12,2,3
8,2001,410500,7,6,1,3
9,2001,410500,15,12,3,0
10,2001,410500,16,15,1,0
11,2001,410500,11,11,0,1
12,2001,410500,9,9,0,1
1,2002,410500,4,4,0,2
2,2002,410500,2,1,1,1
3,2002,410500,8,8,0,2
4,2002,410500,11,7,4,1
5,2002,410500,5,5,0,2
6,2002,410500,9,8,1,3
7,2002,410500,16,16,0,4
8,2002,410500,10,10,0,0
9,2002,410500,15,15,0,0
10,2002,410500,13,12,1,4
11,2002,410500,9,8,1,2
12,2002,410500,11,11,0,2
1,2003,410500,15,15,0,1
2,2003,410500,7,6,1,0
3,2003,410500,4,2,2,0
4,2003,410500,14,11,3,0
5,2003,410500,8,8,0,2
6,2003,410500,13,12,1,1
7,2003,410500,22,20,2,3
8,2003,410500,15,15,0,2
9,2003,410500,19,19,0,0
10,2003,410500,15,15,0,4
11,2003,410500,14,14,0,1
12,2003,410500,19,18,1,0
1,2004,410500,17,16,1,3
2,2004,410500,17,15,2,0
3,2004,410500,14,13,1,2
4,2004,410500,7,7,0,0
5,2004,410500,18,17,1,1
6,2004,410500,13,12,1,0
7,2004,410500,20,18,2,0
8,2004,410500,10,8,2,0
9,2004,410500,12,11,1,0
10,2004,410500,10,9,1,1
11,2004,410500,4,4,0,0
12,2004,410500,7,5,2,0
1,2005,410500,9,7,2,0
2,2005,410500,8,8,0,0
3,2005,410500,8,8,0,0
4,2005,410500,12,11,1,1
5,2005,410500,17,14,3,0
6,2005,410500,18,15,3,0
7,2005,410500,14,12,2,2
8,2005,410500,17,17,0,2
9,2005,410500,19,17,2,2
10,2005,410500,27,24,3,1
11,2005,410500,22,20,2,1
12,2005,410500,14,14,0,1
1,2006,410500,14,12,2,0
2,2006,410500,12,10,2,1
3,2006,410500,4,3,1,3
4,2006,410500,6,6,0,2
5,2006,410500,7,6,1,3
6,2006,410500,8,5,3,1
7,2006,410500,11,10,1,3
8,2006,410500,12,12,0,1
9,2006,410500,18,16,2,2
10,2006,410500,6,6,0,1
11,2006,410500,9,9,0,1
12,2006,410500,18,18,0,0
1,2007,410500,12,11,1,1
2,2007,410500,12,11,1,0
3,2007,410500,5,2,3,1
4,2007,410500,10,9,1,1
5,2007,410500,10,10,0,0
6,2007,410500,11,10,1,0
7,2007,410500,6,6,0,0
8,2007,410500,10,8,2,3
9,2007,410500,9,7,2,2
10,2007,410500,14,12,2,0
11,2007,410500,9,8,1,0
12,2007,410500,9,7,2,1
1,2008,410500,4,4,0,1
2,2008,410500,7,7,0,0
3,2008,410500,8,8,0,1
4,2008,410500,14,11,3,1
5,2008,410500,10,10,0,0
6,2008,410500,8,7,1,3
7,2008,410500,15,15,0,0
8,2008,410500,9,9,0,0
9,2008,410500,13,13,0,2
10,2008,410500,7,6,1,0
11,2008,410500,9,8,1,1
12,2008,410500,3,2,1,0
1,2009,410500,5,5,0,0
2,2009,410500,6,6,0,0
3,2009,410500,7,6,1,0
4,2009,410500,9,9,0,0
5,2009,410500,7,6,1,2
6,2009,410500,10,8,2,1
7,2009,410500,11,10,1,2
8,2009,410500,12,11,1,4
9,2009,410500,13,13,0,2
10,2009,410500,15,15,0,0
11,2009,410500,15,15,0,1
12,2009,410500,9,8,1,1
1,2010,410500,10,8,2,0
2,2010,410500,5,5,0,1
3,2010,410500,3,2,1,0
4,2010,410500,5,3,2,1
5,2010,410500,10,9,1,0
6,2010,410500,14,13,1,0
7,2010,410500,8,6,2,0
8,2010,410500,16,15,1,0
9,2010,410500,14,14,0,0
10,2010,410500,13,13,0,1
11,2010,410500,20,18,2,0
12,2010,410500,11,11,0,1
1,2011,410500,7,7,0,1
2,2011,410500,6,5,1,0
1,1999,410600,7,7,0,0
2,1999,410600,12,12,0,0
3,1999,410600,12,11,1,0
4,1999,410600,20,19,1,0
5,1999,410600,19,19,0,0
6,1999,410600,14,14,0,0
7,1999,410600,21,20,1,1
8,1999,410600,23,23,0,0
9,1999,410600,21,20,1,1
10,1999,410600,7,7,0,1
11,1999,410600,16,16,0,0
12,1999,410600,10,10,0,0
1,2000,410600,9,9,0,0
2,2000,410600,10,10,0,0
3,2000,410600,17,17,0,1
4,2000,410600,16,16,0,0
5,2000,410600,18,18,0,1
6,2000,410600,19,18,1,0
7,2000,410600,12,12,0,0
8,2000,410600,9,9,0,0
9,2000,410600,12,11,1,0
10,2000,410600,19,19,0,0
11,2000,410600,18,18,0,0
12,2000,410600,11,10,1,1
1,2001,410600,18,18,0,0
2,2001,410600,10,10,0,0
3,2001,410600,11,10,1,1
4,2001,410600,9,9,0,0
5,2001,410600,7,7,0,0
6,2001,410600,7,7,0,2
7,2001,410600,9,9,0,1
8,2001,410600,8,8,0,0
9,2001,410600,7,7,0,1
10,2001,410600,10,8,2,1
11,2001,410600,12,11,1,0
12,2001,410600,6,5,1,0
1,2002,410600,10,10,0,2
2,2002,410600,8,6,2,0
3,2002,410600,11,10,1,0
4,2002,410600,9,9,0,0
5,2002,410600,14,13,1,1
6,2002,410600,11,10,1,0
7,2002,410600,13,12,1,0
8,2002,410600,19,19,0,0
9,2002,410600,14,13,1,0
10,2002,410600,23,22,1,1
11,2002,410600,9,8,1,0
12,2002,410600,10,9,1,1
1,2003,410600,12,12,0,0
2,2003,410600,13,12,1,0
3,2003,410600,8,8,0,1
4,2003,410600,11,11,0,0
5,2003,410600,9,8,1,0
6,2003,410600,11,11,0,0
7,2003,410600,10,8,2,0
8,2003,410600,20,19,1,0
9,2003,410600,14,14,0,0
10,2003,410600,17,15,2,1
11,2003,410600,9,9,0,0
12,2003,410600,11,11,0,2
1,2004,410600,8,8,0,0
2,2004,410600,4,3,1,0
3,2004,410600,8,8,0,1
4,2004,410600,14,13,1,0
5,2004,410600,20,20,0,0
6,2004,410600,14,14,0,0
7,2004,410600,17,17,0,0
8,2004,410600,11,10,1,0
9,2004,410600,7,7,0,0
10,2004,410600,20,19,1,0
11,2004,410600,5,5,0,0
12,2004,410600,13,11,2,0
1,2005,410600,7,5,2,0
2,2005,410600,15,14,1,0
3,2005,410600,14,13,1,1
4,2005,410600,7,7,0,0
5,2005,410600,18,17,1,0
6,2005,410600,13,12,1,0
7,2005,410600,10,10,0,1
8,2005,410600,18,17,1,0
9,2005,410600,14,14,0,0
10,2005,410600,10,10,0,0
11,2005,410600,19,19,0,0
12,2005,410600,10,10,0,0
1,2006,410600,10,10,0,0
2,2006,410600,7,7,0,0
3,2006,410600,6,6,0,1
4,2006,410600,11,10,1,0
5,2006,410600,10,9,1,0
6,2006,410600,6,5,1,0
7,2006,410600,6,6,0,0
8,2006,410600,12,12,0,0
9,2006,410600,13,13,0,0
10,2006,410600,21,21,0,0
11,2006,410600,14,14,0,0
12,2006,410600,14,14,0,1
1,2007,410600,15,14,1,0
2,2007,410600,4,4,0,0
3,2007,410600,6,6,0,0
4,2007,410600,5,5,0,1
5,2007,410600,4,4,0,0
6,2007,410600,7,7,0,0
7,2007,410600,12,12,0,0
8,2007,410600,9,8,1,0
9,2007,410600,5,5,0,0
10,2007,410600,15,15,0,0
11,2007,410600,5,5,0,0
12,2007,410600,3,3,0,0
1,2008,410600,3,3,0,0
2,2008,410600,5,5,0,0
3,2008,410600,4,4,0,0
4,2008,410600,2,2,0,0
5,2008,410600,7,6,1,1
6,2008,410600,12,12,0,0
7,2008,410600,14,14,0,1
8,2008,410600,7,6,1,0
9,2008,410600,8,8,0,0
10,2008,410600,9,9,0,0
11,2008,410600,8,7,1,0
12,2008,410600,4,4,0,0
1,2009,410600,5,5,0,0
2,2009,410600,4,4,0,0
3,2009,410600,0,0,0,1
4,2009,410600,5,4,1,0
5,2009,410600,6,6,0,1
6,2009,410600,8,8,0,0
7,2009,410600,17,17,0,0
8,2009,410600,3,3,0,0
9,2009,410600,4,4,0,0
10,2009,410600,11,11,0,0
11,2009,410600,10,10,0,1
12,2009,410600,5,5,0,0
1,2010,410600,11,10,1,0
2,2010,410600,6,5,1,1
3,2010,410600,3,3,0,0
4,2010,410600,6,6,0,1
5,2010,410600,6,6,0,0
6,2010,410600,14,14,0,1
7,2010,410600,15,14,1,0
8,2010,410600,10,10,0,0
9,2010,410600,13,13,0,0
10,2010,410600,9,9,0,0
11,2010,410600,12,12,0,0
12,2010,410600,6,6,0,1
1,2011,410600,12,12,0,0
2,2011,410600,1,1,0,0
1,1999,570500,2,2,0,0
2,1999,570500,5,4,1,0
3,1999,570500,5,5,0,0
4,1999,570500,8,8,0,0
5,1999,570500,5,4,1,0
6,1999,570500,7,7,0,3
7,1999,570500,3,3,0,1
8,1999,570500,6,6,0,0
9,1999,570500,7,6,1,0
10,1999,570500,6,5,1,0
11,1999,570500,4,4,0,0
12,1999,570500,9,7,2,1
1,2000,570500,3,3,0,0
2,2000,570500,7,5,2,0
3,2000,570500,8,6,2,0
4,2000,570500,8,7,1,0
5,2000,570500,4,4,0,0
6,2000,570500,5,5,0,0
7,2000,570500,4,4,0,0
8,2000,570500,10,9,1,0
9,2000,570500,3,2,1,0
10,2000,570500,3,3,0,0
11,2000,570500,10,9,1,1
12,2000,570500,11,11,0,0
1,2001,570500,5,5,0,2
2,2001,570500,5,5,0,1
3,2001,570500,4,4,0,0
4,2001,570500,4,4,0,1
5,2001,570500,2,2,0,0
6,2001,570500,6,6,0,0
7,2001,570500,6,6,0,0
8,2001,570500,7,7,0,0
9,2001,570500,7,7,0,1
10,2001,570500,9,8,1,2
11,2001,570500,3,3,0,0
12,2001,570500,2,2,0,0
1,2002,570500,4,4,0,0
2,2002,570500,5,5,0,1
3,2002,570500,6,5,1,0
4,2002,570500,9,8,1,1
5,2002,570500,6,6,0,2
6,2002,570500,5,3,2,0
7,2002,570500,4,4,0,0
8,2002,570500,13,12,1,0
9,2002,570500,14,13,1,0
10,2002,570500,7,7,0,0
11,2002,570500,10,10,0,0
12,2002,570500,7,7,0,0
1,2003,570500,7,6,1,0
2,2003,570500,5,5,0,0
3,2003,570500,4,4,0,0
4,2003,570500,7,7,0,1
5,2003,570500,8,8,0,0
6,2003,570500,8,7,1,1
7,2003,570500,8,8,0,1
8,2003,570500,10,10,0,0
9,2003,570500,5,5,0,0
10,2003,570500,5,5,0,0
11,2003,570500,11,9,2,1
12,2003,570500,6,5,1,0
1,2004,570500,5,5,0,0
2,2004,570500,6,6,0,0
3,2004,570500,5,4,1,1
4,2004,570500,7,7,0,0
5,2004,570500,7,7,0,0
6,2004,570500,4,4,0,0
7,2004,570500,7,7,0,0
8,2004,570500,9,9,0,0
9,2004,570500,9,8,1,2
10,2004,570500,5,5,0,1
11,2004,570500,5,5,0,0
12,2004,570500,6,5,1,0
1,2005,570500,10,9,1,0
2,2005,570500,5,4,1,0
3,2005,570500,9,7,2,0
4,2005,570500,10,9,1,0
5,2005,570500,8,7,1,0
6,2005,570500,8,8,0,0
7,2005,570500,8,7,1,0
8,2005,570500,5,4,1,0
9,2005,570500,9,9,0,0
10,2005,570500,4,4,0,0
11,2005,570500,6,6,0,1
12,2005,570500,4,4,0,0
1,2006,570500,6,6,0,1
2,2006,570500,7,7,0,0
3,2006,570500,10,9,1,0
4,2006,570500,0,0,0,1
5,2006,570500,2,2,0,2
6,2006,570500,2,2,0,2
7,2006,570500,7,7,0,0
8,2006,570500,6,5,1,3
9,2006,570500,7,7,0,2
10,2006,570500,6,6,0,3
11,2006,570500,9,7,2,0
12,2006,570500,4,4,0,0
1,2007,570500,3,3,0,0
2,2007,570500,6,5,1,0
3,2007,570500,7,6,1,1
4,2007,570500,5,4,1,2
5,2007,570500,10,9,1,0
6,2007,570500,8,7,1,5
7,2007,570500,10,9,1,0
8,2007,570500,5,5,0,0
9,2007,570500,4,4,0,0
10,2007,570500,6,6,0,1
11,2007,570500,7,7,0,0
12,2007,570500,12,12,0,0
1,2008,570500,9,9,0,0
2,2008,570500,2,2,0,1
3,2008,570500,4,4,0,0
4,2008,570500,7,6,1,1
5,2008,570500,7,7,0,0
6,2008,570500,6,6,0,1
7,2008,570500,7,7,0,0
8,2008,570500,8,8,0,0
9,2008,570500,3,3,0,0
10,2008,570500,5,4,1,1
11,2008,570500,9,9,0,0
12,2008,570500,7,7,0,0
1,2009,570500,4,4,0,0
2,2009,570500,6,6,0,2
3,2009,570500,7,4,3,0
4,2009,570500,5,5,0,0
5,2009,570500,4,3,1,0
6,2009,570500,5,5,0,2
7,2009,570500,7,6,1,1
8,2009,570500,2,2,0,2
9,2009,570500,5,5,0,0
10,2009,570500,4,4,0,0
11,2009,570500,6,6,0,2
12,2009,570500,15,14,1,0
1,2010,570500,4,4,0,0
2,2010,570500,2,2,0,2
3,2010,570500,3,3,0,2
4,2010,570500,4,4,0,0
5,2010,570500,6,5,1,0
6,2010,570500,5,5,0,0
7,2010,570500,2,2,0,2
8,2010,570500,4,4,0,0
9,2010,570500,6,5,1,0
10,2010,570500,6,6,0,2
11,2010,570500,5,5,0,0
12,2010,570500,8,8,0,0
1,2011,570500,6,6,0,0
2,2011,570500,0,0,0,0
1,1999,410100,6,3,3,0
2,1999,410100,12,10,2,0
3,1999,410100,8,8,0,0
4,1999,410100,14,12,2,1
5,1999,410100,17,16,1,3
6,1999,410100,23,21,2,2
7,1999,410100,26,23,3,1
8,1999,410100,18,17,1,0
9,1999,410100,23,22,1,4
10,1999,410100,28,25,3,1
11,1999,410100,15,13,2,0
12,1999,410100,16,12,4,0
1,2000,410100,6,6,0,1
2,2000,410100,11,10,1,0
3,2000,410100,7,5,2,2
4,2000,410100,12,10,2,1
5,2000,410100,8,7,1,0
6,2000,410100,15,14,1,0
7,2000,410100,14,14,0,0
8,2000,410100,15,13,2,2
9,2000,410100,7,7,0,2
10,2000,410100,15,14,1,0
11,2000,410100,15,15,0,1
12,2000,410100,18,18,0,2
1,2001,410100,14,13,1,1
2,2001,410100,16,16,0,1
3,2001,410100,9,6,3,1
4,2001,410100,11,9,2,1
5,2001,410100,14,13,1,0
6,2001,410100,9,9,0,1
7,2001,410100,25,22,3,0
8,2001,410100,12,11,1,1
9,2001,410100,16,16,0,0
10,2001,410100,13,13,0,0
11,2001,410100,9,8,1,1
12,2001,410100,15,13,2,2
1,2002,410100,14,14,0,1
2,2002,410100,6,6,0,0
3,2002,410100,10,7,3,0
4,2002,410100,14,14,0,0
5,2002,410100,7,7,0,1
6,2002,410100,14,13,1,3
7,2002,410100,19,16,3,0
8,2002,410100,22,19,3,1
9,2002,410100,13,13,0,1
10,2002,410100,15,15,0,0
11,2002,410100,15,13,2,1
12,2002,410100,14,12,2,2
1,2003,410100,16,15,1,0
2,2003,410100,3,3,0,1
3,2003,410100,20,18,2,0
4,2003,410100,9,9,0,0
5,2003,410100,10,7,3,0
6,2003,410100,16,16,0,2
7,2003,410100,12,12,0,0
8,2003,410100,14,13,1,1
9,2003,410100,21,19,2,0
10,2003,410100,15,14,1,0
11,2003,410100,13,7,6,0
12,2003,410100,15,12,3,0
1,2004,410100,8,6,2,1
2,2004,410100,12,11,1,0
3,2004,410100,12,12,0,0
4,2004,410100,13,10,3,0
5,2004,410100,7,6,1,0
6,2004,410100,9,9,0,1
7,2004,410100,26,26,0,1
8,2004,410100,14,14,0,0
9,2004,410100,12,9,3,1
10,2004,410100,10,10,0,1
11,2004,410100,8,8,0,0
12,2004,410100,11,11,0,0
1,2005,410100,17,17,0,0
2,2005,410100,15,14,1,0
3,2005,410100,11,9,2,0
4,2005,410100,14,14,0,0
5,2005,410100,9,8,1,1
6,2005,410100,12,10,2,0
7,2005,410100,12,12,0,0
8,2005,410100,19,18,1,0
9,2005,410100,16,16,0,1
10,2005,410100,8,7,1,0
11,2005,410100,15,13,2,0
12,2005,410100,6,6,0,0
1,2006,410100,10,9,1,0
2,2006,410100,10,8,2,0
3,2006,410100,15,11,4,1
4,2006,410100,4,4,0,3
5,2006,410100,7,7,0,1
6,2006,410100,11,11,0,1
7,2006,410100,15,14,1,1
8,2006,410100,13,12,1,2
9,2006,410100,13,13,0,0
10,2006,410100,10,8,2,1
11,2006,410100,14,13,1,2
12,2006,410100,11,11,0,1
1,2007,410100,13,12,1,1
2,2007,410100,4,4,0,0
3,2007,410100,7,7,0,0
4,2007,410100,7,7,0,0
5,2007,410100,10,9,1,1
6,2007,410100,14,11,3,0
7,2007,410100,11,10,1,0
8,2007,410100,13,11,2,1
9,2007,410100,11,11,0,0
10,2007,410100,10,9,1,0
11,2007,410100,8,8,0,1
12,2007,410100,4,4,0,0
1,2008,410100,8,7,1,0
2,2008,410100,3,2,1,0
3,2008,410100,9,9,0,1
4,2008,410100,10,6,4,1
5,2008,410100,6,5,1,0
6,2008,410100,8,8,0,0
7,2008,410100,9,8,1,4
8,2008,410100,9,9,0,1
9,2008,410100,5,5,0,1
10,2008,410100,6,3,3,1
11,2008,410100,2,2,0,2
12,2008,410100,9,8,1,1
1,2009,410100,6,5,1,0
2,2009,410100,3,3,0,2
3,2009,410100,4,4,0,1
4,2009,410100,10,9,1,0
5,2009,410100,2,2,0,1
6,2009,410100,4,4,0,4
7,2009,410100,10,10,0,1
8,2009,410100,7,7,0,0
9,2009,410100,7,5,2,4
10,2009,410100,10,8,2,1
11,2009,410100,6,6,0,1
12,2009,410100,8,8,0,0
1,2010,410100,4,4,0,2
2,2010,410100,6,6,0,0
3,2010,410100,12,12,0,3
4,2010,410100,5,5,0,1
5,2010,410100,10,9,1,3
6,2010,410100,7,7,0,0
7,2010,410100,12,12,0,2
8,2010,410100,5,3,2,0
9,2010,410100,7,7,0,0
10,2010,410100,5,5,0,0
11,2010,410100,6,6,0,0
12,2010,410100,7,6,1,0
1,2011,410100,4,3,1,1
2,2011,410100,3,3,0,0
1,1999,560300,5,4,1,4
2,1999,560300,3,2,1,0
3,1999,560300,6,6,0,1
4,1999,560300,5,4,1,0
5,1999,560300,5,4,1,1
6,1999,560300,5,5,0,0
7,1999,560300,7,7,0,0
8,1999,560300,11,10,1,0
9,1999,560300,11,11,0,0
10,1999,560300,9,9,0,0
11,1999,560300,4,4,0,3
12,1999,560300,9,9,0,0
1,2000,560300,6,6,0,0
2,2000,560300,4,2,2,2
3,2000,560300,4,3,1,1
4,2000,560300,10,9,1,0
5,2000,560300,4,4,0,1
6,2000,560300,10,10,0,0
7,2000,560300,12,11,1,1
8,2000,560300,11,11,0,1
9,2000,560300,10,9,1,1
10,2000,560300,4,4,0,0
11,2000,560300,6,4,2,0
12,2000,560300,3,3,0,0
1,2001,560300,3,3,0,1
2,2001,560300,6,6,0,0
3,2001,560300,7,7,0,0
4,2001,560300,5,3,2,1
5,2001,560300,2,2,0,0
6,2001,560300,3,2,1,0
7,2001,560300,2,2,0,0
8,2001,560300,11,10,1,4
9,2001,560300,2,2,0,1
10,2001,560300,10,10,0,1
11,2001,560300,7,7,0,0
12,2001,560300,11,11,0,0
1,2002,560300,2,1,1,1
2,2002,560300,6,6,0,1
3,2002,560300,8,7,1,1
4,2002,560300,5,4,1,1
5,2002,560300,17,14,3,1
6,2002,560300,9,8,1,0
7,2002,560300,9,8,1,1
8,2002,560300,11,10,1,0
9,2002,560300,8,8,0,0
10,2002,560300,8,8,0,0
11,2002,560300,9,8,1,1
12,2002,560300,14,14,0,0
1,2003,560300,4,3,1,1
2,2003,560300,3,3,0,1
3,2003,560300,9,8,1,0
4,2003,560300,8,8,0,0
5,2003,560300,5,5,0,1
6,2003,560300,9,8,1,0
7,2003,560300,4,4,0,1
8,2003,560300,8,8,0,2
9,2003,560300,5,4,1,1
10,2003,560300,13,13,0,0
11,2003,560300,15,13,2,1
12,2003,560300,1,1,0,0
1,2004,560300,6,6,0,1
2,2004,560300,7,7,0,1
3,2004,560300,6,6,0,0
4,2004,560300,5,5,0,3
5,2004,560300,7,6,1,0
6,2004,560300,9,8,1,0
7,2004,560300,8,7,1,0
8,2004,560300,3,3,0,0
9,2004,560300,7,7,0,0
10,2004,560300,4,4,0,1
11,2004,560300,3,3,0,0
12,2004,560300,8,8,0,0
1,2005,560300,2,1,1,3
2,2005,560300,1,1,0,1
3,2005,560300,11,11,0,0
4,2005,560300,7,6,1,0
5,2005,560300,10,10,0,0
6,2005,560300,7,6,1,0
7,2005,560300,10,10,0,0
8,2005,560300,4,4,0,0
9,2005,560300,5,5,0,0
10,2005,560300,6,6,0,0
11,2005,560300,4,4,0,1
12,2005,560300,4,4,0,0
1,2006,560300,2,2,0,1
2,2006,560300,4,4,0,0
3,2006,560300,4,3,1,0
4,2006,560300,3,3,0,0
5,2006,560300,1,1,0,1
6,2006,560300,4,2,2,5
7,2006,560300,2,2,0,0
8,2006,560300,10,10,0,1
9,2006,560300,2,2,0,0
10,2006,560300,2,2,0,0
11,2006,560300,9,9,0,1
12,2006,560300,7,7,0,3
1,2007,560300,3,3,0,4
2,2007,560300,4,3,1,1
3,2007,560300,4,4,0,1
4,2007,560300,5,4,1,0
5,2007,560300,2,2,0,1
6,2007,560300,6,5,1,0
7,2007,560300,8,7,1,0
8,2007,560300,3,3,0,0
9,2007,560300,4,4,0,3
10,2007,560300,4,4,0,0
11,2007,560300,4,4,0,1
12,2007,560300,3,3,0,0
1,2008,560300,1,1,0,1
2,2008,560300,1,1,0,0
3,2008,560300,3,3,0,1
4,2008,560300,2,2,0,1
5,2008,560300,4,2,2,2
6,2008,560300,6,6,0,2
7,2008,560300,4,4,0,2
8,2008,560300,2,2,0,0
9,2008,560300,2,1,1,1
10,2008,560300,4,4,0,2
11,2008,560300,6,6,0,0
12,2008,560300,6,6,0,0
1,2009,560300,6,4,2,0
2,2009,560300,3,3,0,0
3,2009,560300,3,2,1,1
4,2009,560300,5,5,0,1
5,2009,560300,6,5,1,0
6,2009,560300,2,2,0,0
7,2009,560300,4,4,0,0
8,2009,560300,4,4,0,0
9,2009,560300,9,7,2,0
10,2009,560300,4,4,0,0
11,2009,560300,0,0,0,1
12,2009,560300,2,2,0,0
1,2010,560300,3,2,1,0
2,2010,560300,2,2,0,1
3,2010,560300,3,3,0,0
4,2010,560300,4,3,1,1
5,2010,560300,8,8,0,2
6,2010,560300,7,7,0,0
7,2010,560300,7,5,2,0
8,2010,560300,7,4,3,2
9,2010,560300,2,2,0,0
10,2010,560300,5,4,1,0
11,2010,560300,8,8,0,2
12,2010,560300,7,7,0,0
1,2011,560300,4,4,0,0
2,2011,560300,3,3,0,0
1,1999,560400,10,10,0,2
2,1999,560400,2,2,0,0
3,1999,560400,6,6,0,0
4,1999,560400,5,5,0,0
5,1999,560400,2,1,1,0
6,1999,560400,2,2,0,0
7,1999,560400,4,4,0,0
8,1999,560400,5,5,0,1
9,1999,560400,3,3,0,0
10,1999,560400,2,2,0,0
11,1999,560400,1,1,0,1
12,1999,560400,7,7,0,2
1,2000,560400,9,7,2,1
2,2000,560400,1,1,0,0
3,2000,560400,2,2,0,0
4,2000,560400,1,1,0,0
5,2000,560400,3,2,1,0
6,2000,560400,1,0,1,0
7,2000,560400,7,5,2,0
8,2000,560400,3,3,0,0
9,2000,560400,4,4,0,5
10,2000,560400,7,7,0,0
11,2000,560400,7,6,1,0
12,2000,560400,5,5,0,0
1,2001,560400,2,2,0,0
2,2001,560400,3,3,0,2
3,2001,560400,9,8,1,1
4,2001,560400,2,1,1,0
5,2001,560400,4,2,2,0
6,2001,560400,4,4,0,2
7,2001,560400,8,7,1,0
8,2001,560400,3,3,0,0
9,2001,560400,2,2,0,0
10,2001,560400,4,3,1,0
11,2001,560400,3,2,1,0
12,2001,560400,3,3,0,0
1,2002,560400,4,4,0,0
2,2002,560400,5,5,0,1
3,2002,560400,1,1,0,1
4,2002,560400,6,5,1,1
5,2002,560400,6,5,1,0
6,2002,560400,8,7,1,0
7,2002,560400,4,4,0,2
8,2002,560400,1,1,0,0
9,2002,560400,11,11,0,0
10,2002,560400,2,2,0,1
11,2002,560400,5,5,0,0
12,2002,560400,8,8,0,0
1,2003,560400,4,4,0,0
2,2003,560400,2,2,0,1
3,2003,560400,2,2,0,0
4,2003,560400,2,2,0,0
5,2003,560400,8,8,0,0
6,2003,560400,1,1,0,1
7,2003,560400,2,2,0,0
8,2003,560400,6,6,0,1
9,2003,560400,1,0,1,0
10,2003,560400,4,4,0,0
11,2003,560400,5,5,0,0
12,2003,560400,2,2,0,0
1,2004,560400,1,1,0,0
2,2004,560400,5,5,0,0
3,2004,560400,4,4,0,0
4,2004,560400,4,4,0,0
5,2004,560400,2,2,0,0
6,2004,560400,2,1,1,0
7,2004,560400,2,2,0,0
8,2004,560400,6,6,0,0
9,2004,560400,7,7,0,0
10,2004,560400,5,5,0,1
11,2004,560400,5,5,0,0
12,2004,560400,8,8,0,0
1,2005,560400,1,1,0,1
2,2005,560400,0,0,0,1
3,2005,560400,4,4,0,0
4,2005,560400,6,6,0,0
5,2005,560400,3,3,0,2
6,2005,560400,5,5,0,0
7,2005,560400,1,1,0,0
8,2005,560400,8,8,0,0
9,2005,560400,5,4,1,0
10,2005,560400,6,6,0,0
11,2005,560400,2,2,0,1
12,2005,560400,3,3,0,1
1,2006,560400,6,6,0,0
2,2006,560400,4,4,0,2
3,2006,560400,5,4,1,0
4,2006,560400,1,1,0,0
5,2006,560400,3,3,0,0
6,2006,560400,5,3,2,2
7,2006,560400,4,2,2,0
8,2006,560400,7,7,0,0
9,2006,560400,4,3,1,0
10,2006,560400,4,4,0,0
11,2006,560400,6,6,0,0
12,2006,560400,7,7,0,1
1,2007,560400,2,2,0,0
2,2007,560400,3,3,0,2
3,2007,560400,6,5,1,0
4,2007,560400,8,8,0,0
5,2007,560400,4,4,0,0
6,2007,560400,1,1,0,0
7,2007,560400,1,1,0,0
8,2007,560400,2,2,0,0
9,2007,560400,3,3,0,0
10,2007,560400,1,1,0,0
11,2007,560400,2,2,0,0
12,2007,560400,3,3,0,0
1,2008,560400,4,4,0,0
2,2008,560400,4,3,1,0
3,2008,560400,3,2,1,0
4,2008,560400,7,7,0,1
5,2008,560400,3,3,0,0
6,2008,560400,3,3,0,0
7,2008,560400,8,8,0,0
8,2008,560400,3,3,0,0
9,2008,560400,2,2,0,0
10,2008,560400,4,4,0,0
11,2008,560400,7,6,1,0
12,2008,560400,6,6,0,0
1,2009,560400,5,5,0,0
2,2009,560400,3,3,0,0
3,2009,560400,1,1,0,0
4,2009,560400,5,5,0,1
5,2009,560400,2,2,0,0
6,2009,560400,6,6,0,0
7,2009,560400,9,7,2,1
8,2009,560400,4,2,2,1
9,2009,560400,4,4,0,0
10,2009,560400,4,4,0,0
11,2009,560400,1,1,0,0
12,2009,560400,4,4,0,0
1,2010,560400,3,3,0,1
2,2010,560400,2,2,0,0
3,2010,560400,2,2,0,0
4,2010,560400,3,3,0,0
5,2010,560400,2,2,0,0
6,2010,560400,4,3,1,1
7,2010,560400,2,2,0,0
8,2010,560400,1,0,1,0
9,2010,560400,2,2,0,0
10,2010,560400,2,2,0,1
11,2010,560400,2,2,0,1
12,2010,560400,3,3,0,0
1,2011,560400,4,4,0,0
2,2011,560400,0,0,0,0
1,1999,570300,15,13,2,1
2,1999,570300,15,13,2,0
3,1999,570300,21,21,0,1
4,1999,570300,13,12,1,0
5,1999,570300,18,18,0,1
6,1999,570300,16,16,0,0
7,1999,570300,15,10,5,0
8,1999,570300,15,14,1,0
9,1999,570300,27,25,2,0
10,1999,570300,25,21,4,0
11,1999,570300,23,19,4,0
12,1999,570300,24,24,0,3
1,2000,570300,22,20,2,1
2,2000,570300,12,11,1,0
3,2000,570300,20,19,1,0
4,2000,570300,12,10,2,2
5,2000,570300,18,17,1,0
6,2000,570300,12,12,0,2
7,2000,570300,14,14,0,0
8,2000,570300,17,17,0,4
9,2000,570300,17,16,1,0
10,2000,570300,22,21,1,2
11,2000,570300,19,18,1,2
12,2000,570300,25,22,3,0
1,2001,570300,13,12,1,3
2,2001,570300,30,27,3,0
3,2001,570300,22,19,3,2
4,2001,570300,15,15,0,0
5,2001,570300,18,18,0,0
6,2001,570300,19,18,1,2
7,2001,570300,17,17,0,2
8,2001,570300,16,14,2,1
9,2001,570300,17,15,2,0
10,2001,570300,25,25,0,0
11,2001,570300,28,27,1,1
12,2001,570300,20,15,5,0
1,2002,570300,13,11,2,1
2,2002,570300,16,15,1,1
3,2002,570300,15,15,0,1
4,2002,570300,17,17,0,2
5,2002,570300,30,25,5,1
6,2002,570300,28,27,1,1
7,2002,570300,30,30,0,0
8,2002,570300,32,31,1,0
9,2002,570300,28,27,1,2
10,2002,570300,23,21,2,0
11,2002,570300,22,21,1,0
12,2002,570300,16,16,0,0
1,2003,570300,21,19,2,0
2,2003,570300,20,18,2,0
3,2003,570300,23,22,1,2
4,2003,570300,16,15,1,3
5,2003,570300,38,36,2,2
6,2003,570300,22,20,2,3
7,2003,570300,25,24,1,1
8,2003,570300,18,14,4,0
9,2003,570300,25,22,3,3
10,2003,570300,28,26,2,1
11,2003,570300,26,25,1,2
12,2003,570300,31,29,2,0
1,2004,570300,16,16,0,0
2,2004,570300,18,16,2,0
3,2004,570300,16,14,2,0
4,2004,570300,23,22,1,2
5,2004,570300,24,21,3,2
6,2004,570300,25,22,3,2
7,2004,570300,24,23,1,2
8,2004,570300,18,17,1,2
9,2004,570300,19,19,0,4
10,2004,570300,24,21,3,1
11,2004,570300,25,24,1,0
12,2004,570300,18,18,0,0
1,2005,570300,15,14,1,0
2,2005,570300,10,9,1,0
3,2005,570300,10,9,1,1
4,2005,570300,11,8,3,0
5,2005,570300,12,11,1,2
6,2005,570300,21,20,1,1
7,2005,570300,21,20,1,0
8,2005,570300,22,19,3,2
9,2005,570300,19,17,2,2
10,2005,570300,21,20,1,0
11,2005,570300,9,9,0,0
12,2005,570300,22,20,2,0
1,2006,570300,19,19,0,3
2,2006,570300,8,6,2,0
3,2006,570300,10,9,1,1
4,2006,570300,22,19,3,3
5,2006,570300,13,11,2,4
6,2006,570300,18,16,2,2
7,2006,570300,17,16,1,1
8,2006,570300,14,14,0,0
9,2006,570300,20,20,0,1
10,2006,570300,13,11,2,5
11,2006,570300,21,19,2,1
12,2006,570300,16,12,4,1
1,2007,570300,9,9,0,1
2,2007,570300,13,11,2,2
3,2007,570300,16,15,1,6
4,2007,570300,26,24,2,2
5,2007,570300,16,13,3,0
6,2007,570300,12,10,2,2
7,2007,570300,18,17,1,2
8,2007,570300,14,11,3,2
9,2007,570300,17,12,5,1
10,2007,570300,23,23,0,2
11,2007,570300,18,17,1,0
12,2007,570300,20,19,1,2
1,2008,570300,13,12,1,3
2,2008,570300,16,14,2,1
3,2008,570300,21,17,4,0
4,2008,570300,15,13,2,2
5,2008,570300,24,20,4,1
6,2008,570300,12,9,3,2
7,2008,570300,18,13,5,1
8,2008,570300,13,9,4,1
9,2008,570300,13,12,1,0
10,2008,570300,17,13,4,1
11,2008,570300,14,13,1,0
12,2008,570300,14,11,3,2
1,2009,570300,18,12,6,3
2,2009,570300,16,16,0,2
3,2009,570300,10,10,0,4
4,2009,570300,22,20,2,0
5,2009,570300,16,12,4,3
6,2009,570300,19,15,4,5
7,2009,570300,17,15,2,1
8,2009,570300,22,18,4,4
9,2009,570300,12,10,2,9
10,2009,570300,20,18,2,2
11,2009,570300,12,11,1,0
12,2009,570300,17,16,1,3
1,2010,570300,10,8,2,1
2,2010,570300,8,8,0,1
3,2010,570300,12,11,1,0
4,2010,570300,12,10,2,0
5,2010,570300,23,22,1,1
6,2010,570300,16,15,1,0
7,2010,570300,17,17,0,1
8,2010,570300,18,15,3,2
9,2010,570300,10,10,0,0
10,2010,570300,18,18,0,3
11,2010,570300,17,17,0,1
12,2010,570300,7,6,1,3
1,2011,570300,13,10,3,0
2,2011,570300,6,6,0,0
1,1999,570400,5,5,0,2
2,1999,570400,9,9,0,4
3,1999,570400,7,6,1,5
4,1999,570400,4,3,1,1
5,1999,570400,11,10,1,2
6,1999,570400,13,13,0,1
7,1999,570400,12,12,0,1
8,1999,570400,6,6,0,0
9,1999,570400,16,16,0,0
10,1999,570400,10,10,0,1
11,1999,570400,8,8,0,2
12,1999,570400,11,10,1,3
1,2000,570400,14,13,1,3
2,2000,570400,9,8,1,4
3,2000,570400,12,12,0,4
4,2000,570400,7,7,0,3
5,2000,570400,2,2,0,2
6,2000,570400,5,4,1,1
7,2000,570400,6,4,2,0
8,2000,570400,9,9,0,0
9,2000,570400,8,8,0,1
10,2000,570400,9,9,0,3
11,2000,570400,10,9,1,2
12,2000,570400,5,4,1,2
1,2001,570400,6,6,0,0
2,2001,570400,7,7,0,3
3,2001,570400,9,8,1,1
4,2001,570400,3,3,0,1
5,2001,570400,2,2,0,2
6,2001,570400,4,1,3,1
7,2001,570400,4,4,0,0
8,2001,570400,2,1,1,1
9,2001,570400,9,7,2,0
10,2001,570400,11,10,1,1
11,2001,570400,11,8,3,2
12,2001,570400,10,9,1,0
1,2002,570400,4,4,0,1
2,2002,570400,4,4,0,4
3,2002,570400,10,9,1,0
4,2002,570400,4,3,1,2
5,2002,570400,10,8,2,3
6,2002,570400,3,3,0,0
7,2002,570400,9,8,1,2
8,2002,570400,8,8,0,0
9,2002,570400,7,5,2,1
10,2002,570400,10,9,1,1
11,2002,570400,10,10,0,0
12,2002,570400,11,10,1,2
1,2003,570400,10,9,1,1
2,2003,570400,5,5,0,1
3,2003,570400,6,6,0,1
4,2003,570400,1,1,0,1
5,2003,570400,8,7,1,2
6,2003,570400,7,7,0,2
7,2003,570400,12,10,2,1
8,2003,570400,1,1,0,0
9,2003,570400,10,9,1,0
10,2003,570400,7,7,0,2
11,2003,570400,10,10,0,1
12,2003,570400,7,7,0,3
1,2004,570400,4,4,0,1
2,2004,570400,5,5,0,0
3,2004,570400,7,7,0,4
4,2004,570400,9,9,0,0
5,2004,570400,5,5,0,2
6,2004,570400,4,3,1,4
7,2004,570400,3,3,0,0
8,2004,570400,3,3,0,0
9,2004,570400,5,5,0,2
10,2004,570400,8,5,3,4
11,2004,570400,6,4,2,1
12,2004,570400,7,7,0,0
1,2005,570400,8,8,0,2
2,2005,570400,11,11,0,0
3,2005,570400,5,5,0,4
4,2005,570400,9,8,1,1
5,2005,570400,7,7,0,4
6,2005,570400,4,4,0,1
7,2005,570400,4,4,0,0
8,2005,570400,5,5,0,0
9,2005,570400,7,7,0,1
10,2005,570400,9,8,1,0
11,2005,570400,12,11,1,0
12,2005,570400,8,7,1,2
1,2006,570400,11,10,1,1
2,2006,570400,3,2,1,1
3,2006,570400,6,5,1,5
4,2006,570400,7,7,0,0
5,2006,570400,10,9,1,2
6,2006,570400,4,3,1,1
7,2006,570400,2,1,1,2
8,2006,570400,6,5,1,0
9,2006,570400,12,9,3,1
10,2006,570400,10,10,0,3
11,2006,570400,4,4,0,2
12,2006,570400,6,6,0,2
1,2007,570400,4,4,0,1
2,2007,570400,5,3,2,2
3,2007,570400,10,9,1,0
4,2007,570400,8,8,0,1
5,2007,570400,7,7,0,3
6,2007,570400,3,3,0,2
7,2007,570400,1,1,0,1
8,2007,570400,2,2,0,1
9,2007,570400,7,7,0,1
10,2007,570400,4,4,0,1
11,2007,570400,11,10,1,0
12,2007,570400,6,6,0,0
1,2008,570400,4,4,0,2
2,2008,570400,6,5,1,0
3,2008,570400,7,7,0,2
4,2008,570400,9,9,0,2
5,2008,570400,10,7,3,0
6,2008,570400,8,6,2,3
7,2008,570400,6,6,0,1
8,2008,570400,3,3,0,0
9,2008,570400,5,4,1,2
10,2008,570400,9,8,1,1
11,2008,570400,8,7,1,0
12,2008,570400,5,5,0,0
1,2009,570400,10,9,1,1
2,2009,570400,8,7,1,2
3,2009,570400,13,12,1,4
4,2009,570400,7,6,1,0
5,2009,570400,17,15,2,0
6,2009,570400,5,5,0,0
7,2009,570400,4,4,0,0
8,2009,570400,5,4,1,2
9,2009,570400,8,7,1,3
10,2009,570400,11,8,3,4
11,2009,570400,7,6,1,2
12,2009,570400,6,5,1,3
1,2010,570400,9,9,0,1
2,2010,570400,14,14,0,4
3,2010,570400,6,6,0,2
4,2010,570400,4,4,0,1
5,2010,570400,13,11,2,2
6,2010,570400,9,9,0,3
7,2010,570400,12,12,0,1
8,2010,570400,7,6,1,0
9,2010,570400,10,9,1,0
10,2010,570400,6,6,0,1
11,2010,570400,8,7,1,2
12,2010,570400,2,2,0,3
1,2011,570400,11,9,2,2
2,2011,570400,3,3,0,3
1,1999,836300,35,29,6,2
2,1999,836300,36,34,2,1
3,1999,836300,37,31,6,5
4,1999,836300,42,36,6,7
5,1999,836300,46,42,4,4
6,1999,836300,46,34,12,6
7,1999,836300,55,45,10,8
8,1999,836300,54,45,9,8
9,1999,836300,49,44,5,2
10,1999,836300,36,30,6,5
11,1999,836300,16,12,4,5
12,1999,836300,23,17,6,6
1,2000,836300,22,20,2,3
2,2000,836300,18,17,1,3
3,2000,836300,10,8,2,4
4,2000,836300,13,11,2,5
5,2000,836300,16,14,2,9
6,2000,836300,14,12,2,4
7,2000,836300,10,8,2,1
8,2000,836300,17,15,2,8
9,2000,836300,12,11,1,1
10,2000,836300,17,16,1,1
11,2000,836300,13,13,0,5
12,2000,836300,7,6,1,1
1,2001,836300,10,8,2,1
2,2001,836300,7,7,0,6
3,2001,836300,9,8,1,6
4,2001,836300,7,6,1,3
5,2001,836300,15,13,2,6
6,2001,836300,8,5,3,4
7,2001,836300,7,7,0,0
8,2001,836300,10,9,1,8
9,2001,836300,16,16,0,3
10,2001,836300,12,9,3,7
11,2001,836300,9,6,3,0
12,2001,836300,10,10,0,3
1,2002,836300,7,7,0,3
2,2002,836300,7,3,4,7
3,2002,836300,5,2,3,5
4,2002,836300,9,6,3,3
5,2002,836300,5,5,0,3
6,2002,836300,5,4,1,0
7,2002,836300,6,6,0,0
8,2002,836300,12,11,1,0
9,2002,836300,6,5,1,0
10,2002,836300,7,6,1,3
11,2002,836300,7,6,1,2
12,2002,836300,6,4,2,0
1,2003,836300,9,9,0,0
2,2003,836300,6,5,1,1
3,2003,836300,10,10,0,0
4,2003,836300,7,6,1,1
5,2003,836300,11,10,1,0
6,2003,836300,12,10,2,0
7,2003,836300,3,3,0,0
8,2003,836300,16,16,0,0
9,2003,836300,9,9,0,0
10,2003,836300,13,12,1,0
11,2003,836300,8,7,1,0
12,2003,836300,6,6,0,1
1,2004,836300,8,7,1,1
2,2004,836300,8,7,1,1
3,2004,836300,10,10,0,0
4,2004,836300,7,7,0,0
5,2004,836300,7,6,1,1
6,2004,836300,7,6,1,0
7,2004,836300,10,10,0,2
8,2004,836300,12,12,0,0
9,2004,836300,7,7,0,0
10,2004,836300,15,15,0,0
11,2004,836300,7,6,1,0
12,2004,836300,6,6,0,0
1,2005,836300,13,13,0,0
2,2005,836300,3,2,1,1
3,2005,836300,2,2,0,0
4,2005,836300,3,2,1,1
5,2005,836300,7,6,1,0
6,2005,836300,5,5,0,0
7,2005,836300,5,5,0,0
8,2005,836300,9,8,1,1
9,2005,836300,11,11,0,1
10,2005,836300,10,10,0,0
11,2005,836300,13,13,0,0
12,2005,836300,7,6,1,0
1,2006,836300,11,11,0,0
2,2006,836300,5,5,0,1
3,2006,836300,7,7,0,1
4,2006,836300,7,7,0,0
5,2006,836300,8,8,0,1
6,2006,836300,7,7,0,1
7,2006,836300,9,8,1,0
8,2006,836300,11,10,1,0
9,2006,836300,4,3,1,0
10,2006,836300,8,8,0,0
11,2006,836300,10,9,1,0
12,2006,836300,9,9,0,1
1,2007,836300,4,4,0,0
2,2007,836300,1,1,0,0
3,2007,836300,7,6,1,0
4,2007,836300,4,3,1,1
5,2007,836300,4,3,1,0
6,2007,836300,7,6,1,0
7,2007,836300,7,7,0,1
8,2007,836300,2,2,0,0
9,2007,836300,5,5,0,1
10,2007,836300,5,3,2,1
11,2007,836300,6,5,1,0
12,2007,836300,8,8,0,1
1,2008,836300,3,2,1,0
2,2008,836300,6,6,0,1
3,2008,836300,3,1,2,2
4,2008,836300,4,4,0,0
5,2008,836300,9,8,1,1
6,2008,836300,9,9,0,0
7,2008,836300,9,8,1,1
8,2008,836300,13,13,0,3
9,2008,836300,7,7,0,3
10,2008,836300,4,4,0,2
11,2008,836300,4,4,0,2
12,2008,836300,5,4,1,0
1,2009,836300,2,2,0,0
2,2009,836300,3,3,0,1
3,2009,836300,4,4,0,1
4,2009,836300,2,2,0,1
5,2009,836300,8,8,0,1
6,2009,836300,7,5,2,0
7,2009,836300,4,4,0,0
8,2009,836300,6,6,0,2
9,2009,836300,7,6,1,0
10,2009,836300,6,6,0,1
11,2009,836300,2,1,1,0
12,2009,836300,4,3,1,0
1,2010,836300,8,8,0,2
2,2010,836300,0,0,0,1
3,2010,836300,6,5,1,0
4,2010,836300,1,1,0,5
5,2010,836300,8,7,1,2
6,2010,836300,11,11,0,1
7,2010,836300,8,8,0,0
8,2010,836300,12,12,0,0
9,2010,836300,3,3,0,1
10,2010,836300,10,10,0,4
11,2010,836300,7,7,0,4
12,2010,836300,3,3,0,1
1,2011,836300,5,5,0,2
2,2011,836300,6,5,1,0
1,1999,630200,17,13,4,1
2,1999,630200,25,24,1,4
3,1999,630200,20,19,1,2
4,1999,630200,27,26,1,2
5,1999,630200,24,23,1,1
6,1999,630200,22,20,2,2
7,1999,630200,25,21,4,3
8,1999,630200,33,29,4,3
9,1999,630200,40,32,8,1
10,1999,630200,34,26,8,0
11,1999,630200,27,23,4,2
12,1999,630200,18,17,1,2
1,2000,630200,17,14,3,0
2,2000,630200,13,12,1,6
3,2000,630200,22,21,1,1
4,2000,630200,30,29,1,2
5,2000,630200,17,15,2,2
6,2000,630200,24,19,5,1
7,2000,630200,32,29,3,4
8,2000,630200,27,24,3,0
9,2000,630200,32,32,0,2
10,2000,630200,24,23,1,1
11,2000,630200,22,17,5,0
12,2000,630200,15,15,0,4
1,2001,630200,20,18,2,0
2,2001,630200,25,23,2,1
3,2001,630200,25,22,3,4
4,2001,630200,18,17,1,3
5,2001,630200,16,14,2,0
6,2001,630200,20,19,1,3
7,2001,630200,12,10,2,1
8,2001,630200,19,14,5,2
9,2001,630200,22,18,4,1
10,2001,630200,25,25,0,0
11,2001,630200,14,13,1,4
12,2001,630200,25,23,2,4
1,2002,630200,25,23,2,1
2,2002,630200,19,17,2,3
3,2002,630200,22,22,0,7
4,2002,630200,15,12,3,0
5,2002,630200,19,18,1,4
6,2002,630200,21,19,2,0
7,2002,630200,28,25,3,3
8,2002,630200,22,22,0,2
9,2002,630200,19,19,0,1
10,2002,630200,34,33,1,1
11,2002,630200,25,23,2,3
12,2002,630200,14,12,2,1
1,2003,630200,18,18,0,2
2,2003,630200,11,10,1,0
3,2003,630200,20,19,1,1
4,2003,630200,34,26,8,2
5,2003,630200,13,12,1,4
6,2003,630200,13,9,4,4
7,2003,630200,16,15,1,1
8,2003,630200,26,22,4,1
9,2003,630200,26,24,2,2
10,2003,630200,23,21,2,4
11,2003,630200,19,17,2,2
12,2003,630200,23,23,0,3
1,2004,630200,11,11,0,2
2,2004,630200,11,10,1,5
3,2004,630200,16,15,1,3
4,2004,630200,18,18,0,3
5,2004,630200,16,14,2,3
6,2004,630200,24,23,1,1
7,2004,630200,17,16,1,4
8,2004,630200,16,14,2,1
9,2004,630200,15,13,2,2
10,2004,630200,15,15,0,3
11,2004,630200,15,13,2,1
12,2004,630200,18,17,1,2
1,2005,630200,14,14,0,2
2,2005,630200,10,10,0,2
3,2005,630200,14,14,0,1
4,2005,630200,6,5,1,3
5,2005,630200,13,10,3,4
6,2005,630200,15,13,2,2
7,2005,630200,16,16,0,3
8,2005,630200,14,14,0,5
9,2005,630200,15,11,4,1
10,2005,630200,14,14,0,3
11,2005,630200,18,15,3,1
12,2005,630200,28,27,1,1
1,2006,630200,26,25,1,1
2,2006,630200,22,22,0,2
3,2006,630200,8,5,3,3
4,2006,630200,11,8,3,5
5,2006,630200,17,11,6,2
6,2006,630200,16,13,3,4
7,2006,630200,21,21,0,0
8,2006,630200,14,12,2,2
9,2006,630200,13,11,2,5
10,2006,630200,13,12,1,4
11,2006,630200,7,6,1,3
12,2006,630200,19,18,1,4
1,2007,630200,19,15,4,3
2,2007,630200,11,11,0,3
3,2007,630200,7,6,1,3
4,2007,630200,10,9,1,3
5,2007,630200,23,21,2,6
6,2007,630200,13,12,1,3
7,2007,630200,15,12,3,3
8,2007,630200,13,9,4,3
9,2007,630200,14,11,3,8
10,2007,630200,19,17,2,0
11,2007,630200,14,12,2,5
12,2007,630200,9,8,1,1
1,2008,630200,22,22,0,1
2,2008,630200,11,11,0,5
3,2008,630200,8,5,3,2
4,2008,630200,10,9,1,2
5,2008,630200,15,10,5,2
6,2008,630200,15,12,3,2
7,2008,630200,13,9,4,2
8,2008,630200,10,8,2,3
9,2008,630200,13,12,1,1
10,2008,630200,21,16,5,1
11,2008,630200,17,14,3,1
12,2008,630200,12,12,0,1
1,2009,630200,16,16,0,2
2,2009,630200,7,7,0,2
3,2009,630200,10,9,1,7
4,2009,630200,12,9,3,3
5,2009,630200,10,8,2,1
6,2009,630200,10,8,2,2
7,2009,630200,18,14,4,2
8,2009,630200,22,20,2,2
9,2009,630200,11,10,1,3
10,2009,630200,7,7,0,3
11,2009,630200,17,15,2,0
12,2009,630200,10,10,0,2
1,2010,630200,13,12,1,3
2,2010,630200,8,7,1,0
3,2010,630200,11,11,0,8
4,2010,630200,12,12,0,2
5,2010,630200,10,9,1,6
6,2010,630200,23,21,2,3
7,2010,630200,17,16,1,2
8,2010,630200,15,14,1,2
9,2010,630200,17,15,2,2
10,2010,630200,29,26,3,3
11,2010,630200,14,12,2,3
12,2010,630200,13,12,1,1
1,2011,630200,15,15,0,9
2,2011,630200,12,10,2,3
1,1999,611300,23,20,3,8
2,1999,611300,31,26,5,11
3,1999,611300,27,20,7,8
4,1999,611300,21,16,5,19
5,1999,611300,27,21,6,7
6,1999,611300,30,20,10,6
7,1999,611300,44,28,16,5
8,1999,611300,35,25,10,8
9,1999,611300,40,31,9,10
10,1999,611300,25,19,6,2
11,1999,611300,26,22,4,13
12,1999,611300,43,33,10,12
1,2000,611300,28,20,8,5
2,2000,611300,18,14,4,5
3,2000,611300,34,26,8,7
4,2000,611300,24,14,10,7
5,2000,611300,30,27,3,12
6,2000,611300,21,18,3,9
7,2000,611300,44,33,11,15
8,2000,611300,40,29,11,8
9,2000,611300,42,37,5,14
10,2000,611300,43,35,8,18
11,2000,611300,19,15,4,18
12,2000,611300,27,22,5,7
1,2001,611300,35,31,4,9
2,2001,611300,21,20,1,5
3,2001,611300,31,25,6,8
4,2001,611300,18,13,5,7
5,2001,611300,36,25,11,12
6,2001,611300,27,21,6,12
7,2001,611300,43,35,8,11
8,2001,611300,35,31,4,9
9,2001,611300,31,25,6,11
10,2001,611300,40,36,4,21
11,2001,611300,27,18,9,9
12,2001,611300,18,14,4,25
1,2002,611300,32,21,11,12
2,2002,611300,29,21,8,12
3,2002,611300,27,16,11,35
4,2002,611300,29,21,8,9
5,2002,611300,27,20,7,9
6,2002,611300,28,15,13,9
7,2002,611300,26,13,13,10
8,2002,611300,23,20,3,19
9,2002,611300,37,33,4,7
10,2002,611300,40,33,7,5
11,2002,611300,16,14,2,15
12,2002,611300,25,21,4,12
1,2003,611300,23,17,6,8
2,2003,611300,18,16,2,11
3,2003,611300,22,20,2,19
4,2003,611300,29,21,8,15
5,2003,611300,19,17,2,9
6,2003,611300,36,24,12,14
7,2003,611300,39,30,9,11
8,2003,611300,32,27,5,13
9,2003,611300,43,37,6,4
10,2003,611300,33,29,4,11
11,2003,611300,22,19,3,18
12,2003,611300,18,17,1,16
1,2004,611300,15,14,1,9
2,2004,611300,17,17,0,7
3,2004,611300,28,25,3,13
4,2004,611300,20,17,3,10
5,2004,611300,29,22,7,13
6,2004,611300,25,19,6,21
7,2004,611300,27,26,1,6
8,2004,611300,31,24,7,20
9,2004,611300,36,26,10,9
10,2004,611300,19,18,1,15
11,2004,611300,21,16,5,10
12,2004,611300,15,13,2,7
1,2005,611300,16,10,6,8
2,2005,611300,22,18,4,13
3,2005,611300,19,16,3,18
4,2005,611300,15,12,3,11
5,2005,611300,23,22,1,8
6,2005,611300,24,18,6,4
7,2005,611300,24,22,2,4
8,2005,611300,28,23,5,6
9,2005,611300,30,27,3,8
10,2005,611300,18,14,4,8
11,2005,611300,18,12,6,8
12,2005,611300,13,12,1,12
1,2006,611300,18,15,3,7
2,2006,611300,19,18,1,9
3,2006,611300,23,20,3,6
4,2006,611300,21,12,9,8
5,2006,611300,25,22,3,8
6,2006,611300,32,31,1,17
7,2006,611300,24,20,4,9
8,2006,611300,21,21,0,13
9,2006,611300,24,18,6,7
10,2006,611300,23,19,4,10
11,2006,611300,17,15,2,8
12,2006,611300,20,16,4,5
1,2007,611300,14,10,4,6
2,2007,611300,9,6,3,1
3,2007,611300,17,11,6,4
4,2007,611300,5,5,0,6
5,2007,611300,23,18,5,5
6,2007,611300,25,23,2,5
7,2007,611300,24,16,8,6
8,2007,611300,32,30,2,13
9,2007,611300,27,23,4,4
10,2007,611300,27,20,7,14
11,2007,611300,26,25,1,8
12,2007,611300,17,14,3,8
1,2008,611300,19,16,3,6
2,2008,611300,12,11,1,9
3,2008,611300,13,12,1,14
4,2008,611300,12,9,3,4
5,2008,611300,16,9,7,8
6,2008,611300,19,16,3,9
7,2008,611300,15,11,4,2
8,2008,611300,12,10,2,5
9,2008,611300,26,20,6,3
10,2008,611300,17,14,3,7
11,2008,611300,11,9,2,6
12,2008,611300,14,14,0,5
1,2009,611300,17,15,2,8
2,2009,611300,12,10,2,6
3,2009,611300,31,28,3,12
4,2009,611300,13,10,3,16
5,2009,611300,17,14,3,5
6,2009,611300,12,12,0,9
7,2009,611300,16,14,2,4
8,2009,611300,35,29,6,2
9,2009,611300,19,15,4,6
10,2009,611300,21,21,0,6
11,2009,611300,18,14,4,11
12,2009,611300,14,13,1,6
1,2010,611300,13,11,2,12
2,2010,611300,12,10,2,18
3,2010,611300,17,13,4,8
4,2010,611300,13,11,2,4
5,2010,611300,17,15,2,5
6,2010,611300,13,11,2,7
7,2010,611300,13,10,3,3
8,2010,611300,25,23,2,7
9,2010,611300,16,16,0,0
10,2010,611300,30,23,7,6
11,2010,611300,14,13,1,5
12,2010,611300,16,15,1,9
1,2011,611300,12,8,4,5
2,2011,611300,8,5,3,3
1,1999,611200,20,17,3,5
2,1999,611200,10,8,2,11
3,1999,611200,9,9,0,9
4,1999,611200,16,12,4,9
5,1999,611200,20,14,6,11
6,1999,611200,28,16,12,9
7,1999,611200,16,10,6,7
8,1999,611200,18,9,9,0
9,1999,611200,12,10,2,3
10,1999,611200,15,9,6,6
11,1999,611200,22,12,10,4
12,1999,611200,14,12,2,2
1,2000,611200,22,15,7,6
2,2000,611200,20,15,5,4
3,2000,611200,27,18,9,5
4,2000,611200,26,16,10,1
5,2000,611200,17,11,6,4
6,2000,611200,19,16,3,5
7,2000,611200,28,22,6,5
8,2000,611200,28,19,9,2
9,2000,611200,25,20,5,5
10,2000,611200,21,14,7,3
11,2000,611200,22,16,6,1
12,2000,611200,11,5,6,3
1,2001,611200,15,11,4,7
2,2001,611200,17,14,3,7
3,2001,611200,16,13,3,5
4,2001,611200,17,11,6,7
5,2001,611200,17,10,7,7
6,2001,611200,11,10,1,11
7,2001,611200,23,17,6,6
8,2001,611200,9,6,3,5
9,2001,611200,14,7,7,2
10,2001,611200,7,4,3,4
11,2001,611200,20,16,4,6
12,2001,611200,14,14,0,5
1,2002,611200,9,6,3,14
2,2002,611200,9,6,3,8
3,2002,611200,10,8,2,3
4,2002,611200,24,12,12,7
5,2002,611200,19,13,6,7
6,2002,611200,21,11,10,9
7,2002,611200,18,13,5,7
8,2002,611200,35,20,15,6
9,2002,611200,20,15,5,4
10,2002,611200,32,23,9,11
11,2002,611200,17,12,5,14
12,2002,611200,19,14,5,14
1,2003,611200,23,18,5,5
2,2003,611200,17,13,4,13
3,2003,611200,17,12,5,13
4,2003,611200,11,8,3,6
5,2003,611200,17,13,4,9
6,2003,611200,25,16,9,17
7,2003,611200,22,8,14,11
8,2003,611200,16,10,6,11
9,2003,611200,16,10,6,10
10,2003,611200,14,13,1,23
11,2003,611200,20,13,7,23
12,2003,611200,8,7,1,14
1,2004,611200,15,11,4,9
2,2004,611200,16,12,4,4
3,2004,611200,8,5,3,10
4,2004,611200,7,4,3,10
5,2004,611200,18,14,4,12
6,2004,611200,17,13,4,6
7,2004,611200,18,13,5,20
8,2004,611200,15,10,5,22
9,2004,611200,13,6,7,21
10,2004,611200,18,16,2,34
11,2004,611200,16,10,6,11
12,2004,611200,12,9,3,11
1,2005,611200,12,9,3,17
2,2005,611200,16,9,7,24
3,2005,611200,10,5,5,18
4,2005,611200,9,7,2,25
5,2005,611200,16,12,4,15
6,2005,611200,15,11,4,15
7,2005,611200,21,16,5,7
8,2005,611200,15,10,5,14
9,2005,611200,15,8,7,9
10,2005,611200,15,10,5,8
11,2005,611200,11,10,1,12
12,2005,611200,17,15,2,7
1,2006,611200,14,8,6,9
2,2006,611200,12,10,2,4
3,2006,611200,23,18,5,10
4,2006,611200,7,5,2,9
5,2006,611200,16,11,5,8
6,2006,611200,16,11,5,3
7,2006,611200,14,9,5,10
8,2006,611200,15,9,6,17
9,2006,611200,16,7,9,6
10,2006,611200,15,7,8,12
11,2006,611200,15,14,1,21
12,2006,611200,14,9,5,10
1,2007,611200,17,13,4,22
2,2007,611200,5,4,1,11
3,2007,611200,7,5,2,13
4,2007,611200,15,11,4,7
5,2007,611200,10,5,5,11
6,2007,611200,11,7,4,15
7,2007,611200,20,13,7,9
8,2007,611200,20,13,7,16
9,2007,611200,18,14,4,16
10,2007,611200,19,16,3,17
11,2007,611200,18,16,2,8
12,2007,611200,12,8,4,7
1,2008,611200,12,6,6,18
2,2008,611200,8,7,1,8
3,2008,611200,16,8,8,16
4,2008,611200,17,9,8,8
5,2008,611200,15,7,8,5
6,2008,611200,13,8,5,11
7,2008,611200,11,9,2,15
8,2008,611200,9,9,0,17
9,2008,611200,13,9,4,14
10,2008,611200,18,11,7,18
11,2008,611200,7,6,1,14
12,2008,611200,14,10,4,12
1,2009,611200,8,4,4,8
2,2009,611200,16,10,6,11
3,2009,611200,8,5,3,13
4,2009,611200,14,6,8,19
5,2009,611200,10,7,3,10
6,2009,611200,8,6,2,8
7,2009,611200,16,12,4,8
8,2009,611200,8,5,3,9
9,2009,611200,7,5,2,11
10,2009,611200,14,12,2,7
11,2009,611200,12,9,3,6
12,2009,611200,11,8,3,9
1,2010,611200,10,9,1,9
2,2010,611200,11,8,3,9
3,2010,611200,8,7,1,14
4,2010,611200,19,12,7,18
5,2010,611200,13,6,7,4
6,2010,611200,19,11,8,12
7,2010,611200,15,8,7,8
8,2010,611200,10,4,6,3
9,2010,611200,10,9,1,3
10,2010,611200,9,7,2,9
11,2010,611200,19,16,3,5
12,2010,611200,10,7,3,7
1,2011,611200,18,12,6,6
2,2011,611200,18,12,6,14
1,1999,611100,12,6,6,4
2,1999,611100,14,7,7,7
3,1999,611100,14,12,2,4
4,1999,611100,19,17,2,5
5,1999,611100,8,7,1,6
6,1999,611100,19,11,8,4
7,1999,611100,22,18,4,9
8,1999,611100,15,10,5,12
9,1999,611100,17,13,4,6
10,1999,611100,8,4,4,8
11,1999,611100,13,6,7,13
12,1999,611100,14,8,6,7
1,2000,611100,19,12,7,9
2,2000,611100,7,5,2,11
3,2000,611100,13,8,5,7
4,2000,611100,14,10,4,1
5,2000,611100,16,9,7,10
6,2000,611100,12,5,7,3
7,2000,611100,22,20,2,5
8,2000,611100,24,12,12,1
9,2000,611100,12,11,1,5
10,2000,611100,11,10,1,3
11,2000,611100,10,10,0,7
12,2000,611100,9,5,4,15
1,2001,611100,7,4,3,11
2,2001,611100,8,6,2,7
3,2001,611100,16,10,6,10
4,2001,611100,20,17,3,5
5,2001,611100,14,10,4,12
6,2001,611100,9,6,3,3
7,2001,611100,11,7,4,1
8,2001,611100,15,10,5,4
9,2001,611100,12,8,4,3
10,2001,611100,15,12,3,12
11,2001,611100,13,7,6,9
12,2001,611100,15,12,3,8
1,2002,611100,6,4,2,14
2,2002,611100,9,4,5,15
3,2002,611100,11,7,4,19
4,2002,611100,13,8,5,11
5,2002,611100,16,10,6,8
6,2002,611100,19,11,8,9
7,2002,611100,20,16,4,5
8,2002,611100,16,12,4,10
9,2002,611100,21,9,12,3
10,2002,611100,9,5,4,8
11,2002,611100,13,12,1,7
12,2002,611100,12,7,5,11
1,2003,611100,13,8,5,6
2,2003,611100,16,8,8,3
3,2003,611100,15,9,6,6
4,2003,611100,15,11,4,16
5,2003,611100,20,16,4,7
6,2003,611100,16,12,4,12
7,2003,611100,14,12,2,3
8,2003,611100,14,10,4,8
9,2003,611100,22,18,4,11
10,2003,611100,14,9,5,3
11,2003,611100,9,7,2,5
12,2003,611100,9,7,2,7
1,2004,611100,8,5,3,7
2,2004,611100,13,10,3,6
3,2004,611100,13,8,5,4
4,2004,611100,12,6,6,6
5,2004,611100,8,6,2,15
6,2004,611100,10,7,3,15
7,2004,611100,16,15,1,18
8,2004,611100,15,13,2,16
9,2004,611100,11,9,2,12
10,2004,611100,13,8,5,10
11,2004,611100,12,10,2,9
12,2004,611100,19,15,4,1
1,2005,611100,7,6,1,3
2,2005,611100,4,2,2,8
3,2005,611100,16,14,2,3
4,2005,611100,16,10,6,4
5,2005,611100,13,7,6,12
6,2005,611100,11,6,5,8
7,2005,611100,15,10,5,6
8,2005,611100,16,12,4,12
9,2005,611100,24,21,3,9
10,2005,611100,18,15,3,8
11,2005,611100,12,9,3,10
12,2005,611100,10,10,0,6
1,2006,611100,9,6,3,8
2,2006,611100,8,4,4,6
3,2006,611100,13,10,3,3
4,2006,611100,2,1,1,7
5,2006,611100,14,10,4,10
6,2006,611100,9,5,4,5
7,2006,611100,15,11,4,5
8,2006,611100,16,13,3,14
9,2006,611100,10,8,2,9
10,2006,611100,13,8,5,12
11,2006,611100,5,4,1,9
12,2006,611100,13,10,3,9
1,2007,611100,16,14,2,8
2,2007,611100,6,5,1,11
3,2007,611100,18,11,7,12
4,2007,611100,8,5,3,4
5,2007,611100,10,6,4,12
6,2007,611100,17,11,6,10
7,2007,611100,14,9,5,7
8,2007,611100,15,11,4,6
9,2007,611100,15,10,5,9
10,2007,611100,16,13,3,14
11,2007,611100,12,10,2,3
12,2007,611100,9,9,0,10
1,2008,611100,9,8,1,7
2,2008,611100,10,7,3,6
3,2008,611100,15,9,6,14
4,2008,611100,12,9,3,3
5,2008,611100,4,4,0,2
6,2008,611100,13,7,6,3
7,2008,611100,13,8,5,6
8,2008,611100,19,12,7,8
9,2008,611100,14,14,0,2
10,2008,611100,12,11,1,4
11,2008,611100,11,8,3,1
12,2008,611100,2,1,1,5
1,2009,611100,11,7,4,2
2,2009,611100,9,7,2,2
3,2009,611100,10,7,3,7
4,2009,611100,5,5,0,6
5,2009,611100,7,5,2,5
6,2009,611100,7,6,1,4
7,2009,611100,3,2,1,2
8,2009,611100,15,10,5,5
9,2009,611100,15,10,5,9
10,2009,611100,9,4,5,4
11,2009,611100,5,4,1,6
12,2009,611100,8,8,0,2
1,2010,611100,6,5,1,4
2,2010,611100,10,7,3,8
3,2010,611100,8,7,1,3
4,2010,611100,5,3,2,6
5,2010,611100,14,12,2,8
6,2010,611100,10,7,3,2
7,2010,611100,14,12,2,3
8,2010,611100,6,5,1,3
9,2010,611100,15,13,2,2
10,2010,611100,9,7,2,2
11,2010,611100,9,9,0,3
12,2010,611100,9,7,2,8
1,2011,611100,8,6,2,7
2,2011,611100,2,1,1,4
1,1999,611000,16,12,4,1
2,1999,611000,14,11,3,9
3,1999,611000,16,14,2,5
4,1999,611000,21,19,2,4
5,1999,611000,23,20,3,17
6,1999,611000,36,27,9,9
7,1999,611000,28,21,7,26
8,1999,611000,25,17,8,18
9,1999,611000,27,23,4,13
10,1999,611000,14,10,4,27
11,1999,611000,26,24,2,15
12,1999,611000,18,13,5,13
1,2000,611000,12,10,2,13
2,2000,611000,23,19,4,12
3,2000,611000,12,12,0,12
4,2000,611000,21,17,4,8
5,2000,611000,21,17,4,11
6,2000,611000,26,13,13,13
7,2000,611000,35,28,7,24
8,2000,611000,27,18,9,6
9,2000,611000,29,24,5,13
10,2000,611000,24,21,3,12
11,2000,611000,18,15,3,15
12,2000,611000,22,19,3,7
1,2001,611000,22,18,4,16
2,2001,611000,18,12,6,11
3,2001,611000,18,15,3,15
4,2001,611000,20,19,1,29
5,2001,611000,22,14,8,19
6,2001,611000,27,21,6,9
7,2001,611000,32,24,8,15
8,2001,611000,27,20,7,10
9,2001,611000,22,18,4,16
10,2001,611000,21,14,7,16
11,2001,611000,25,21,4,8
12,2001,611000,14,11,3,6
1,2002,611000,14,9,5,16
2,2002,611000,15,15,0,8
3,2002,611000,24,18,6,9
4,2002,611000,17,7,10,4
5,2002,611000,20,13,7,1
6,2002,611000,19,13,6,6
7,2002,611000,23,16,7,19
8,2002,611000,30,19,11,14
9,2002,611000,24,14,10,5
10,2002,611000,30,22,8,10
11,2002,611000,24,23,1,18
12,2002,611000,19,17,2,6
1,2003,611000,11,10,1,3
2,2003,611000,17,14,3,0
3,2003,611000,15,12,3,10
4,2003,611000,18,11,7,12
5,2003,611000,31,25,6,22
6,2003,611000,13,12,1,15
7,2003,611000,29,20,9,10
8,2003,611000,19,12,7,9
9,2003,611000,26,23,3,13
10,2003,611000,16,13,3,8
11,2003,611000,13,10,3,7
12,2003,611000,17,14,3,9
1,2004,611000,25,22,3,14
2,2004,611000,18,11,7,0
3,2004,611000,13,11,2,8
4,2004,611000,6,4,2,3
5,2004,611000,16,15,1,7
6,2004,611000,20,18,2,4
7,2004,611000,22,13,9,6
8,2004,611000,17,10,7,1
9,2004,611000,22,15,7,6
10,2004,611000,19,17,2,13
11,2004,611000,18,16,2,13
12,2004,611000,12,9,3,1
1,2005,611000,7,6,1,6
2,2005,611000,11,11,0,3
3,2005,611000,10,8,2,4
4,2005,611000,14,12,2,9
5,2005,611000,15,14,1,11
6,2005,611000,13,12,1,5
7,2005,611000,18,17,1,6
8,2005,611000,27,18,9,8
9,2005,611000,12,10,2,6
10,2005,611000,13,10,3,11
11,2005,611000,8,8,0,5
12,2005,611000,20,18,2,4
1,2006,611000,12,9,3,7
2,2006,611000,13,11,2,4
3,2006,611000,11,10,1,5
4,2006,611000,19,11,8,3
5,2006,611000,14,12,2,10
6,2006,611000,14,12,2,3
7,2006,611000,20,16,4,6
8,2006,611000,13,13,0,7
9,2006,611000,23,19,4,6
10,2006,611000,17,13,4,9
11,2006,611000,18,15,3,8
12,2006,611000,15,14,1,3
1,2007,611000,10,8,2,8
2,2007,611000,8,5,3,9
3,2007,611000,15,5,10,5
4,2007,611000,19,17,2,1
5,2007,611000,10,5,5,7
6,2007,611000,17,13,4,11
7,2007,611000,15,14,1,1
8,2007,611000,19,12,7,3
9,2007,611000,12,8,4,4
10,2007,611000,12,8,4,7
11,2007,611000,14,9,5,8
12,2007,611000,21,17,4,4
1,2008,611000,9,7,2,5
2,2008,611000,8,5,3,3
3,2008,611000,8,5,3,3
4,2008,611000,9,6,3,2
5,2008,611000,10,8,2,6
6,2008,611000,15,12,3,2
7,2008,611000,19,13,6,3
8,2008,611000,18,13,5,7
9,2008,611000,18,16,2,1
10,2008,611000,11,6,5,4
11,2008,611000,8,7,1,9
12,2008,611000,26,20,6,3
1,2009,611000,6,4,2,4
2,2009,611000,7,5,2,6
3,2009,611000,21,21,0,3
4,2009,611000,7,6,1,2
5,2009,611000,15,11,4,7
6,2009,611000,16,11,5,4
7,2009,611000,9,6,3,6
8,2009,611000,17,15,2,3
9,2009,611000,15,9,6,3
10,2009,611000,9,6,3,4
11,2009,611000,11,7,4,2
12,2009,611000,11,8,3,9
1,2010,611000,13,9,4,1
2,2010,611000,4,4,0,4
3,2010,611000,12,11,1,3
4,2010,611000,16,10,6,3
5,2010,611000,7,5,2,2
6,2010,611000,9,7,2,4
7,2010,611000,14,12,2,6
8,2010,611000,10,5,5,0
9,2010,611000,14,13,1,4
10,2010,611000,14,13,1,2
11,2010,611000,9,8,1,2
12,2010,611000,15,13,2,1
1,2011,611000,3,3,0,3
2,2011,611000,2,2,0,1
1,1999,381700,37,23,14,11
2,1999,381700,47,33,14,24
3,1999,381700,32,26,6,7
4,1999,381700,40,33,7,8
5,1999,381700,43,31,12,11
6,1999,381700,43,31,12,8
7,1999,381700,36,24,12,3
8,1999,381700,45,30,15,7
9,1999,381700,42,29,13,7
10,1999,381700,34,27,7,15
11,1999,381700,17,10,7,14
12,1999,381700,35,21,14,12
1,2000,381700,26,12,14,19
2,2000,381700,23,16,7,15
3,2000,381700,30,21,9,20
4,2000,381700,22,17,5,20
5,2000,381700,27,11,16,7
6,2000,381700,21,8,13,9
7,2000,381700,26,9,17,15
8,2000,381700,29,17,12,12
9,2000,381700,20,12,8,11
10,2000,381700,15,10,5,11
11,2000,381700,18,13,5,10
12,2000,381700,18,13,5,4
1,2001,381700,20,13,7,12
2,2001,381700,17,9,8,11
3,2001,381700,33,17,16,13
4,2001,381700,32,19,13,20
5,2001,381700,22,11,11,25
6,2001,381700,21,12,9,31
7,2001,381700,33,16,17,19
8,2001,381700,23,10,13,14
9,2001,381700,22,12,10,6
10,2001,381700,25,9,16,12
11,2001,381700,27,13,14,25
12,2001,381700,16,8,8,11
1,2002,381700,16,4,12,4
2,2002,381700,14,9,5,19
3,2002,381700,9,6,3,26
4,2002,381700,16,9,7,14
5,2002,381700,20,11,9,22
6,2002,381700,32,16,16,15
7,2002,381700,23,14,9,15
8,2002,381700,22,13,9,13
9,2002,381700,16,8,8,4
10,2002,381700,24,15,9,7
11,2002,381700,9,4,5,7
12,2002,381700,25,17,8,4
1,2003,381700,10,9,1,10
2,2003,381700,14,9,5,9
3,2003,381700,11,7,4,3
4,2003,381700,11,9,2,1
5,2003,381700,14,9,5,2
6,2003,381700,14,7,7,2
7,2003,381700,19,10,9,1
8,2003,381700,29,13,16,2
9,2003,381700,8,7,1,7
10,2003,381700,11,9,2,3
11,2003,381700,6,3,3,6
12,2003,381700,8,4,4,3
1,2004,381700,7,6,1,3
2,2004,381700,4,1,3,5
3,2004,381700,9,6,3,2
4,2004,381700,9,7,2,5
5,2004,381700,9,9,0,11
6,2004,381700,14,8,6,4
7,2004,381700,8,6,2,2
8,2004,381700,7,5,2,0
9,2004,381700,11,8,3,0
10,2004,381700,9,5,4,21
11,2004,381700,2,2,0,26
12,2004,381700,1,1,0,9
1,2005,381700,4,4,0,5
2,2005,381700,6,4,2,9
3,2005,381700,4,1,3,1
4,2005,381700,2,2,0,0
5,2005,381700,3,1,2,1
6,2005,381700,3,3,0,0
7,2005,381700,1,0,1,0
8,2005,381700,7,4,3,1
9,2005,381700,2,1,1,1
10,2005,381700,3,1,2,0
11,2005,381700,3,3,0,2
12,2005,381700,6,3,3,0
1,2006,381700,5,2,3,3
2,2006,381700,2,1,1,2
3,2006,381700,1,0,1,0
4,2006,381700,2,1,1,8
5,2006,381700,8,7,1,1
6,2006,381700,0,0,0,2
7,2006,381700,2,1,1,1
8,2006,381700,4,4,0,0
9,2006,381700,1,0,1,1
10,2006,381700,0,0,0,0
11,2006,381700,2,1,1,0
12,2006,381700,1,1,0,0
1,2007,381700,1,1,0,0
2,2007,381700,2,1,1,0
3,2007,381700,2,1,1,0
4,2007,381700,1,1,0,0
5,2007,381700,2,2,0,0
6,2007,381700,3,1,2,0
7,2007,381700,1,1,0,0
8,2007,381700,4,4,0,0
9,2007,381700,4,4,0,0
10,2007,381700,1,1,0,0
11,2007,381700,0,0,0,0
12,2007,381700,1,1,0,0
1,2008,381700,1,1,0,0
2,2008,381700,0,0,0,0
3,2008,381700,2,2,0,0
4,2008,381700,0,0,0,0
5,2008,381700,0,0,0,0
6,2008,381700,2,2,0,0
7,2008,381700,1,1,0,0
8,2008,381700,1,1,0,0
9,2008,381700,1,1,0,2
10,2008,381700,2,2,0,1
11,2008,381700,1,1,0,0
12,2008,381700,2,1,1,0
1,2009,381700,2,1,1,0
2,2009,381700,0,0,0,1
3,2009,381700,1,0,1,1
4,2009,381700,1,1,0,0
5,2009,381700,1,1,0,0
6,2009,381700,3,1,2,0
7,2009,381700,1,1,0,0
8,2009,381700,3,3,0,0
9,2009,381700,2,1,1,0
10,2009,381700,2,2,0,1
11,2009,381700,1,1,0,0
12,2009,381700,0,0,0,0
1,2010,381700,1,1,0,0
2,2010,381700,1,1,0,0
3,2010,381700,1,1,0,0
4,2010,381700,4,3,1,0
5,2010,381700,2,2,0,2
6,2010,381700,1,1,0,0
7,2010,381700,2,1,1,0
8,2010,381700,2,2,0,0
9,2010,381700,4,3,1,0
10,2010,381700,2,2,0,0
11,2010,381700,2,2,0,1
12,2010,381700,2,2,0,2
1,2011,381700,0,0,0,1
2,2011,381700,1,1,0,0
1,1999,611500,9,9,0,0
2,1999,611500,12,10,2,0
3,1999,611500,12,10,2,1
4,1999,611500,6,5,1,5
5,1999,611500,16,16,0,3
6,1999,611500,18,15,3,2
7,1999,611500,16,15,1,0
8,1999,611500,15,15,0,1
9,1999,611500,20,16,4,4
10,1999,611500,16,16,0,0
11,1999,611500,15,12,3,1
12,1999,611500,18,16,2,0
1,2000,611500,11,11,0,1
2,2000,611500,13,12,1,0
3,2000,611500,13,12,1,1
4,2000,611500,15,13,2,0
5,2000,611500,11,9,2,2
6,2000,611500,15,12,3,0
7,2000,611500,20,17,3,4
8,2000,611500,27,26,1,0
9,2000,611500,18,15,3,2
10,2000,611500,12,10,2,0
11,2000,611500,11,10,1,2
12,2000,611500,19,19,0,1
1,2001,611500,9,8,1,5
2,2001,611500,13,11,2,5
3,2001,611500,6,4,2,1
4,2001,611500,7,7,0,1
5,2001,611500,11,8,3,3
6,2001,611500,17,15,2,4
7,2001,611500,20,16,4,4
8,2001,611500,11,9,2,0
9,2001,611500,14,8,6,2
10,2001,611500,12,10,2,1
11,2001,611500,6,6,0,2
12,2001,611500,7,5,2,1
1,2002,611500,22,17,5,4
2,2002,611500,11,6,5,1
3,2002,611500,9,7,2,5
4,2002,611500,7,5,2,3
5,2002,611500,11,8,3,3
6,2002,611500,13,10,3,0
7,2002,611500,18,13,5,4
8,2002,611500,17,15,2,0
9,2002,611500,11,7,4,2
10,2002,611500,20,18,2,5
11,2002,611500,15,12,3,2
12,2002,611500,12,8,4,5
1,2003,611500,2,1,1,2
2,2003,611500,6,6,0,1
3,2003,611500,14,14,0,1
4,2003,611500,10,6,4,1
5,2003,611500,17,11,6,2
6,2003,611500,7,6,1,5
7,2003,611500,7,6,1,1
8,2003,611500,14,12,2,0
9,2003,611500,8,6,2,1
10,2003,611500,9,7,2,2
11,2003,611500,17,16,1,2
12,2003,611500,9,9,0,2
1,2004,611500,8,8,0,3
2,2004,611500,12,12,0,3
3,2004,611500,15,15,0,2
4,2004,611500,8,6,2,1
5,2004,611500,7,7,0,0
6,2004,611500,12,11,1,0
7,2004,611500,14,13,1,3
8,2004,611500,13,12,1,3
9,2004,611500,20,19,1,3
10,2004,611500,16,14,2,0
11,2004,611500,11,11,0,2
12,2004,611500,8,7,1,1
1,2005,611500,7,6,1,2
2,2005,611500,9,6,3,7
3,2005,611500,6,5,1,0
4,2005,611500,10,7,3,3
5,2005,611500,12,9,3,6
6,2005,611500,10,8,2,3
7,2005,611500,19,13,6,5
8,2005,611500,10,9,1,2
9,2005,611500,11,9,2,4
10,2005,611500,14,11,3,1
11,2005,611500,6,4,2,3
12,2005,611500,11,10,1,1
1,2006,611500,8,6,2,1
2,2006,611500,7,6,1,6
3,2006,611500,6,5,1,1
4,2006,611500,10,6,4,3
5,2006,611500,11,11,0,6
6,2006,611500,5,4,1,4
7,2006,611500,10,7,3,3
8,2006,611500,7,5,2,6
9,2006,611500,11,8,3,3
10,2006,611500,8,8,0,3
11,2006,611500,9,9,0,5
12,2006,611500,8,5,3,7
1,2007,611500,5,5,0,7
2,2007,611500,5,4,1,4
3,2007,611500,9,9,0,2
4,2007,611500,9,9,0,4
5,2007,611500,11,9,2,6
6,2007,611500,8,7,1,12
7,2007,611500,11,8,3,7
8,2007,611500,14,14,0,3
9,2007,611500,21,19,2,2
10,2007,611500,14,12,2,5
11,2007,611500,9,7,2,3
12,2007,611500,9,8,1,2
1,2008,611500,4,4,0,5
2,2008,611500,4,3,1,2
3,2008,611500,8,5,3,5
4,2008,611500,5,4,1,4
5,2008,611500,13,10,3,0
6,2008,611500,14,13,1,3
7,2008,611500,11,8,3,2
8,2008,611500,8,6,2,1
9,2008,611500,12,8,4,4
10,2008,611500,10,9,1,4
11,2008,611500,7,7,0,3
12,2008,611500,15,13,2,7
1,2009,611500,10,8,2,5
2,2009,611500,4,4,0,3
3,2009,611500,9,8,1,2
4,2009,611500,6,5,1,0
5,2009,611500,8,5,3,3
6,2009,611500,7,3,4,1
7,2009,611500,15,12,3,4
8,2009,611500,7,4,3,6
9,2009,611500,12,10,2,5
10,2009,611500,10,7,3,4
11,2009,611500,14,13,1,2
12,2009,611500,11,10,1,1
1,2010,611500,5,4,1,1
2,2010,611500,8,8,0,3
3,2010,611500,5,5,0,8
4,2010,611500,9,6,3,7
5,2010,611500,14,11,3,5
6,2010,611500,13,11,2,5
7,2010,611500,8,6,2,4
8,2010,611500,12,8,4,3
9,2010,611500,8,8,0,2
10,2010,611500,15,13,2,5
11,2010,611500,10,9,1,3
12,2010,611500,11,10,1,4
1,2011,611500,9,7,2,3
2,2011,611500,10,9,1,0
1,1999,410200,3,3,0,0
2,1999,410200,1,1,0,0
3,1999,410200,0,0,0,0
4,1999,410200,3,3,0,0
5,1999,410200,10,9,1,2
6,1999,410200,4,4,0,0
7,1999,410200,5,4,1,1
8,1999,410200,8,8,0,0
9,1999,410200,6,5,1,0
10,1999,410200,5,5,0,4
11,1999,410200,4,3,1,0
12,1999,410200,2,2,0,0
1,2000,410200,4,4,0,0
2,2000,410200,2,2,0,1
3,2000,410200,4,3,1,0
4,2000,410200,6,6,0,0
5,2000,410200,4,3,1,0
6,2000,410200,4,3,1,0
7,2000,410200,6,6,0,0
8,2000,410200,5,5,0,1
9,2000,410200,4,4,0,0
10,2000,410200,2,2,0,0
11,2000,410200,4,4,0,0
12,2000,410200,4,4,0,0
1,2001,410200,2,2,0,0
2,2001,410200,2,2,0,0
3,2001,410200,3,3,0,0
4,2001,410200,5,4,1,0
5,2001,410200,4,4,0,0
6,2001,410200,2,2,0,0
7,2001,410200,5,4,1,0
8,2001,410200,2,2,0,0
9,2001,410200,4,4,0,0
10,2001,410200,4,4,0,2
11,2001,410200,2,2,0,0
12,2001,410200,3,3,0,0
1,2002,410200,2,2,0,0
2,2002,410200,1,1,0,0
3,2002,410200,3,3,0,0
4,2002,410200,5,3,2,0
5,2002,410200,3,3,0,0
6,2002,410200,1,1,0,0
7,2002,410200,1,1,0,0
8,2002,410200,6,6,0,0
9,2002,410200,5,5,0,0
10,2002,410200,3,3,0,0
11,2002,410200,7,7,0,0
12,2002,410200,4,4,0,0
1,2003,410200,2,2,0,0
2,2003,410200,1,1,0,0
3,2003,410200,2,2,0,0
4,2003,410200,4,4,0,0
5,2003,410200,3,3,0,0
6,2003,410200,5,4,1,0
7,2003,410200,1,1,0,0
8,2003,410200,4,4,0,0
9,2003,410200,9,9,0,0
10,2003,410200,4,4,0,0
11,2003,410200,0,0,0,0
12,2003,410200,2,2,0,0
1,2004,410200,2,2,0,0
2,2004,410200,3,2,1,0
3,2004,410200,2,0,2,0
4,2004,410200,5,5,0,0
5,2004,410200,3,3,0,0
6,2004,410200,2,1,1,0
7,2004,410200,1,1,0,0
8,2004,410200,6,6,0,0
9,2004,410200,5,4,1,0
10,2004,410200,2,2,0,0
11,2004,410200,6,6,0,0
12,2004,410200,2,2,0,0
1,2005,410200,1,1,0,0
2,2005,410200,2,2,0,0
3,2005,410200,3,3,0,0
4,2005,410200,2,2,0,0
5,2005,410200,2,2,0,0
6,2005,410200,5,5,0,0
7,2005,410200,4,4,0,0
8,2005,410200,5,5,0,0
9,2005,410200,6,6,0,0
10,2005,410200,4,3,1,0
11,2005,410200,4,4,0,0
12,2005,410200,4,4,0,0
1,2006,410200,3,3,0,0
2,2006,410200,3,2,1,0
3,2006,410200,3,3,0,0
4,2006,410200,2,2,0,0
5,2006,410200,1,1,0,0
6,2006,410200,3,2,1,0
7,2006,410200,3,3,0,0
8,2006,410200,5,5,0,0
9,2006,410200,4,4,0,1
10,2006,410200,5,5,0,0
11,2006,410200,4,4,0,0
12,2006,410200,2,2,0,0
1,2007,410200,2,2,0,0
2,2007,410200,2,2,0,0
3,2007,410200,3,2,1,0
4,2007,410200,4,4,0,0
5,2007,410200,3,3,0,0
6,2007,410200,5,5,0,0
7,2007,410200,2,2,0,0
8,2007,410200,2,2,0,1
9,2007,410200,2,2,0,0
10,2007,410200,1,1,0,0
11,2007,410200,0,0,0,0
12,2007,410200,3,3,0,0
1,2008,410200,1,1,0,0
2,2008,410200,0,0,0,0
3,2008,410200,3,3,0,0
4,2008,410200,0,0,0,0
5,2008,410200,0,0,0,0
6,2008,410200,2,2,0,0
7,2008,410200,4,4,0,0
8,2008,410200,5,5,0,0
9,2008,410200,5,5,0,0
10,2008,410200,2,1,1,0
11,2008,410200,1,1,0,0
12,2008,410200,1,0,1,2
1,2009,410200,3,2,1,0
2,2009,410200,1,1,0,0
3,2009,410200,1,1,0,0
4,2009,410200,2,2,0,0
5,2009,410200,1,1,0,0
6,2009,410200,1,1,0,0
7,2009,410200,3,3,0,0
8,2009,410200,6,6,0,0
9,2009,410200,1,1,0,0
10,2009,410200,2,2,0,0
11,2009,410200,1,1,0,0
12,2009,410200,2,2,0,0
1,2010,410200,1,1,0,0
2,2010,410200,1,1,0,0
3,2010,410200,3,2,1,0
4,2010,410200,2,2,0,0
5,2010,410200,4,4,0,0
6,2010,410200,4,3,1,0
7,2010,410200,7,6,1,0
8,2010,410200,2,2,0,0
9,2010,410200,6,6,0,0
10,2010,410200,5,5,0,0
11,2010,410200,3,3,0,0
12,2010,410200,2,2,0,0
1,2011,410200,1,1,0,0
2,2011,410200,0,0,0,0
1,1999,390700,16,14,2,1
2,1999,390700,14,14,0,0
3,1999,390700,16,16,0,0
4,1999,390700,24,23,1,1
5,1999,390700,23,21,2,1
6,1999,390700,20,19,1,0
7,1999,390700,13,12,1,0
8,1999,390700,14,12,2,0
9,1999,390700,15,14,1,1
10,1999,390700,7,7,0,0
11,1999,390700,11,10,1,0
12,1999,390700,7,7,0,0
1,2000,390700,14,14,0,0
2,2000,390700,9,8,1,2
3,2000,390700,13,12,1,2
4,2000,390700,12,11,1,0
5,2000,390700,19,16,3,0
6,2000,390700,11,10,1,0
7,2000,390700,19,19,0,0
8,2000,390700,24,24,0,0
9,2000,390700,17,16,1,1
10,2000,390700,20,15,5,2
11,2000,390700,13,12,1,0
12,2000,390700,7,7,0,6
1,2001,390700,8,8,0,0
2,2001,390700,16,15,1,4
3,2001,390700,7,7,0,1
4,2001,390700,3,3,0,1
5,2001,390700,7,7,0,0
6,2001,390700,11,11,0,0
7,2001,390700,11,8,3,1
8,2001,390700,10,8,2,0
9,2001,390700,12,11,1,0
10,2001,390700,23,19,4,3
11,2001,390700,11,11,0,0
12,2001,390700,10,9,1,1
1,2002,390700,11,9,2,0
2,2002,390700,5,5,0,0
3,2002,390700,15,13,2,2
4,2002,390700,13,12,1,1
5,2002,390700,13,13,0,0
6,2002,390700,16,16,0,1
7,2002,390700,14,13,1,0
8,2002,390700,6,5,1,0
9,2002,390700,16,16,0,1
10,2002,390700,21,21,0,0
11,2002,390700,14,13,1,2
12,2002,390700,10,10,0,0
1,2003,390700,16,16,0,0
2,2003,390700,6,5,1,2
3,2003,390700,12,10,2,2
4,2003,390700,13,12,1,0
5,2003,390700,11,11,0,0
6,2003,390700,17,16,1,0
7,2003,390700,16,16,0,0
8,2003,390700,12,11,1,0
9,2003,390700,29,29,0,0
10,2003,390700,22,21,1,0
11,2003,390700,8,8,0,1
12,2003,390700,9,9,0,0
1,2004,390700,10,9,1,0
2,2004,390700,10,10,0,3
3,2004,390700,18,17,1,1
4,2004,390700,9,9,0,3
5,2004,390700,13,10,3,0
6,2004,390700,24,19,5,0
7,2004,390700,18,16,2,0
8,2004,390700,13,13,0,1
9,2004,390700,13,13,0,2
10,2004,390700,14,12,2,1
11,2004,390700,14,12,2,0
12,2004,390700,14,14,0,0
1,2005,390700,19,19,0,4
2,2005,390700,13,13,0,3
3,2005,390700,12,11,1,0
4,2005,390700,10,10,0,1
5,2005,390700,17,16,1,0
6,2005,390700,14,12,2,0
7,2005,390700,11,11,0,0
8,2005,390700,13,13,0,3
9,2005,390700,15,14,1,0
10,2005,390700,14,12,2,2
11,2005,390700,17,16,1,0
12,2005,390700,14,13,1,0
1,2006,390700,7,6,1,0
2,2006,390700,12,9,3,0
3,2006,390700,12,12,0,1
4,2006,390700,5,5,0,2
5,2006,390700,13,11,2,1
6,2006,390700,10,10,0,0
7,2006,390700,8,8,0,0
8,2006,390700,6,6,0,1
9,2006,390700,12,11,1,1
10,2006,390700,10,8,2,0
11,2006,390700,11,9,2,0
12,2006,390700,10,9,1,1
1,2007,390700,6,5,1,0
2,2007,390700,10,10,0,0
3,2007,390700,16,13,3,4
4,2007,390700,11,9,2,1
5,2007,390700,12,12,0,0
6,2007,390700,21,19,2,2
7,2007,390700,19,18,1,0
8,2007,390700,15,13,2,0
9,2007,390700,11,10,1,0
10,2007,390700,12,11,1,2
11,2007,390700,11,10,1,1
12,2007,390700,14,12,2,2
1,2008,390700,14,14,0,0
2,2008,390700,12,12,0,0
3,2008,390700,12,11,1,0
4,2008,390700,11,11,0,0
5,2008,390700,10,10,0,3
6,2008,390700,10,9,1,0
7,2008,390700,16,15,1,0
8,2008,390700,8,8,0,1
9,2008,390700,17,17,0,1
10,2008,390700,9,8,1,0
11,2008,390700,14,14,0,1
12,2008,390700,8,8,0,1
1,2009,390700,10,8,2,0
2,2009,390700,11,11,0,0
3,2009,390700,10,10,0,2
4,2009,390700,18,18,0,0
5,2009,390700,9,9,0,1
6,2009,390700,10,10,0,0
7,2009,390700,6,6,0,0
8,2009,390700,12,12,0,0
9,2009,390700,14,14,0,0
10,2009,390700,9,8,1,2
11,2009,390700,14,14,0,3
12,2009,390700,10,10,0,0
1,2010,390700,12,12,0,0
2,2010,390700,8,7,1,1
3,2010,390700,12,11,1,1
4,2010,390700,14,13,1,1
5,2010,390700,7,7,0,1
6,2010,390700,8,7,1,0
7,2010,390700,13,13,0,0
8,2010,390700,6,6,0,0
9,2010,390700,11,11,0,1
10,2010,390700,10,9,1,2
11,2010,390700,17,15,2,1
12,2010,390700,13,13,0,2
1,2011,390700,8,7,1,3
2,2011,390700,6,6,0,0
1,1999,611400,11,9,2,2
2,1999,611400,10,7,3,7
3,1999,611400,14,13,1,0
4,1999,611400,8,4,4,4
5,1999,611400,22,16,6,4
6,1999,611400,11,8,3,2
7,1999,611400,16,8,8,2
8,1999,611400,22,20,2,3
9,1999,611400,16,9,7,6
10,1999,611400,24,21,3,4
11,1999,611400,13,10,3,1
12,1999,611400,20,18,2,10
1,2000,611400,21,16,5,3
2,2000,611400,16,14,2,3
3,2000,611400,20,18,2,4
4,2000,611400,21,17,4,0
5,2000,611400,15,11,4,3
6,2000,611400,15,12,3,4
7,2000,611400,28,28,0,3
8,2000,611400,35,27,8,0
9,2000,611400,20,19,1,2
10,2000,611400,17,13,4,1
11,2000,611400,14,10,4,6
12,2000,611400,25,24,1,5
1,2001,611400,16,14,2,6
2,2001,611400,19,13,6,5
3,2001,611400,12,9,3,3
4,2001,611400,9,6,3,5
5,2001,611400,15,13,2,1
6,2001,611400,19,15,4,5
7,2001,611400,23,19,4,2
8,2001,611400,19,17,2,3
9,2001,611400,9,7,2,2
10,2001,611400,20,14,6,0
11,2001,611400,10,9,1,2
12,2001,611400,16,12,4,0
1,2002,611400,12,10,2,5
2,2002,611400,15,10,5,8
3,2002,611400,6,4,2,6
4,2002,611400,12,9,3,5
5,2002,611400,14,10,4,3
6,2002,611400,18,11,7,2
7,2002,611400,20,16,4,4
8,2002,611400,28,23,5,4
9,2002,611400,21,18,3,3
10,2002,611400,30,24,6,2
11,2002,611400,13,13,0,2
12,2002,611400,21,18,3,1
1,2003,611400,15,11,4,5
2,2003,611400,3,2,1,7
3,2003,611400,15,13,2,11
4,2003,611400,12,6,6,3
5,2003,611400,22,15,7,5
6,2003,611400,22,18,4,2
7,2003,611400,12,10,2,3
8,2003,611400,20,18,2,1
9,2003,611400,15,12,3,5
10,2003,611400,12,9,3,5
11,2003,611400,12,11,1,2
12,2003,611400,11,9,2,7
1,2004,611400,11,10,1,4
2,2004,611400,16,13,3,1
3,2004,611400,23,21,2,7
4,2004,611400,21,18,3,8
5,2004,611400,10,9,1,5
6,2004,611400,17,13,4,4
7,2004,611400,13,10,3,6
8,2004,611400,13,11,2,3
9,2004,611400,25,23,2,5
10,2004,611400,15,13,2,3
11,2004,611400,7,6,1,1
12,2004,611400,13,11,2,2
1,2005,611400,8,7,1,3
2,2005,611400,7,5,2,7
3,2005,611400,7,5,2,5
4,2005,611400,5,5,0,6
5,2005,611400,13,11,2,4
6,2005,611400,15,9,6,3
7,2005,611400,23,18,5,6
8,2005,611400,15,12,3,2
9,2005,611400,15,10,5,0
10,2005,611400,15,13,2,1
11,2005,611400,17,16,1,3
12,2005,611400,14,12,2,0
1,2006,611400,9,7,2,2
2,2006,611400,14,12,2,1
3,2006,611400,13,10,3,1
4,2006,611400,12,8,4,1
5,2006,611400,15,12,3,3
6,2006,611400,21,17,4,6
7,2006,611400,14,9,5,13
8,2006,611400,26,23,3,6
9,2006,611400,11,10,1,3
10,2006,611400,11,8,3,5
11,2006,611400,20,18,2,3
12,2006,611400,8,8,0,8
1,2007,611400,14,9,5,6
2,2007,611400,13,10,3,1
3,2007,611400,7,4,3,7
4,2007,611400,18,16,2,4
5,2007,611400,13,11,2,8
6,2007,611400,10,7,3,1
7,2007,611400,23,20,3,2
8,2007,611400,17,15,2,7
9,2007,611400,14,12,2,3
10,2007,611400,15,14,1,5
11,2007,611400,17,17,0,7
12,2007,611400,7,6,1,3
1,2008,611400,12,9,3,4
2,2008,611400,10,7,3,4
3,2008,611400,10,8,2,5
4,2008,611400,11,9,2,5
5,2008,611400,7,4,3,2
6,2008,611400,7,4,3,5
7,2008,611400,11,7,4,1
8,2008,611400,20,19,1,7
9,2008,611400,11,9,2,5
10,2008,611400,13,10,3,2
11,2008,611400,20,18,2,2
12,2008,611400,11,10,1,3
1,2009,611400,4,3,1,1
2,2009,611400,8,7,1,2
3,2009,611400,5,4,1,6
4,2009,611400,9,6,3,5
5,2009,611400,10,8,2,8
6,2009,611400,12,10,2,4
7,2009,611400,19,16,3,3
8,2009,611400,16,13,3,6
9,2009,611400,11,10,1,4
10,2009,611400,22,18,4,3
11,2009,611400,11,9,2,1
12,2009,611400,17,17,0,1
1,2010,611400,19,19,0,6
2,2010,611400,12,10,2,7
3,2010,611400,13,13,0,3
4,2010,611400,9,9,0,6
5,2010,611400,13,13,0,9
6,2010,611400,10,8,2,2
7,2010,611400,12,10,2,2
8,2010,611400,15,10,5,1
9,2010,611400,13,13,0,2
10,2010,611400,16,13,3,3
11,2010,611400,23,21,2,2
12,2010,611400,12,10,2,1
1,2011,611400,11,9,2,4
2,2011,611400,2,2,0,3
1,1999,381900,13,9,4,0
2,1999,381900,4,2,2,0
3,1999,381900,11,8,3,2
4,1999,381900,10,7,3,0
5,1999,381900,13,11,2,0
6,1999,381900,12,12,0,0
7,1999,381900,13,11,2,0
8,1999,381900,14,14,0,0
9,1999,381900,15,13,2,1
10,1999,381900,13,13,0,2
11,1999,381900,9,9,0,1
12,1999,381900,13,12,1,0
1,2000,381900,11,8,3,2
2,2000,381900,15,11,4,1
3,2000,381900,7,6,1,1
4,2000,381900,7,5,2,1
5,2000,381900,9,9,0,0
6,2000,381900,9,5,4,1
7,2000,381900,10,9,1,2
8,2000,381900,8,5,3,1
9,2000,381900,13,12,1,1
10,2000,381900,5,4,1,0
11,2000,381900,11,7,4,0
12,2000,381900,7,7,0,2
1,2001,381900,8,6,2,3
2,2001,381900,5,2,3,1
3,2001,381900,6,6,0,3
4,2001,381900,8,7,1,1
5,2001,381900,7,4,3,2
6,2001,381900,17,15,2,1
7,2001,381900,6,6,0,1
8,2001,381900,9,9,0,1
9,2001,381900,12,9,3,1
10,2001,381900,9,7,2,1
11,2001,381900,3,3,0,3
12,2001,381900,5,4,1,2
1,2002,381900,6,4,2,0
2,2002,381900,4,2,2,0
3,2002,381900,9,7,2,0
4,2002,381900,9,8,1,2
5,2002,381900,5,4,1,0
6,2002,381900,7,7,0,0
7,2002,381900,11,8,3,0
8,2002,381900,8,8,0,0
9,2002,381900,5,5,0,1
10,2002,381900,4,4,0,1
11,2002,381900,7,7,0,3
12,2002,381900,5,4,1,2
1,2003,381900,5,5,0,1
2,2003,381900,6,6,0,1
3,2003,381900,6,6,0,0
4,2003,381900,4,4,0,0
5,2003,381900,5,5,0,2
6,2003,381900,9,9,0,0
7,2003,381900,6,5,1,2
8,2003,381900,6,6,0,1
9,2003,381900,7,6,1,0
10,2003,381900,18,18,0,0
11,2003,381900,3,3,0,1
12,2003,381900,4,1,3,0
1,2004,381900,7,6,1,2
2,2004,381900,6,6,0,0
3,2004,381900,9,8,1,0
4,2004,381900,5,3,2,3
5,2004,381900,10,10,0,1
6,2004,381900,6,5,1,0
7,2004,381900,16,12,4,0
8,2004,381900,4,3,1,0
9,2004,381900,9,9,0,2
10,2004,381900,8,6,2,1
11,2004,381900,5,4,1,2
12,2004,381900,5,5,0,0
1,2005,381900,5,5,0,1
2,2005,381900,3,2,1,1
3,2005,381900,6,6,0,2
4,2005,381900,13,9,4,0
5,2005,381900,13,13,0,1
6,2005,381900,9,9,0,2
7,2005,381900,6,6,0,0
8,2005,381900,11,7,4,1
9,2005,381900,9,8,1,0
10,2005,381900,9,9,0,0
11,2005,381900,9,8,1,3
12,2005,381900,3,3,0,0
1,2006,381900,4,4,0,2
2,2006,381900,4,4,0,1
3,2006,381900,6,4,2,0
4,2006,381900,2,2,0,2
5,2006,381900,7,5,2,0
6,2006,381900,6,6,0,1
7,2006,381900,13,12,1,2
8,2006,381900,4,4,0,0
9,2006,381900,7,6,1,0
10,2006,381900,7,6,1,0
11,2006,381900,3,3,0,0
12,2006,381900,5,5,0,0
1,2007,381900,4,4,0,0
2,2007,381900,6,5,1,0
3,2007,381900,5,5,0,0
4,2007,381900,3,3,0,1
5,2007,381900,8,8,0,0
6,2007,381900,10,10,0,1
7,2007,381900,9,8,1,0
8,2007,381900,10,9,1,0
9,2007,381900,9,8,1,0
10,2007,381900,11,11,0,0
11,2007,381900,6,6,0,5
12,2007,381900,6,5,1,0
1,2008,381900,2,2,0,0
2,2008,381900,5,5,0,1
3,2008,381900,4,3,1,1
4,2008,381900,6,6,0,1
5,2008,381900,7,7,0,1
6,2008,381900,9,8,1,0
7,2008,381900,9,8,1,1
8,2008,381900,9,8,1,0
9,2008,381900,7,5,2,0
10,2008,381900,9,8,1,0
11,2008,381900,5,5,0,1
12,2008,381900,8,8,0,0
1,2009,381900,8,8,0,2
2,2009,381900,4,3,1,1
3,2009,381900,8,8,0,0
4,2009,381900,7,6,1,0
5,2009,381900,8,6,2,0
6,2009,381900,9,9,0,0
7,2009,381900,6,6,0,0
8,2009,381900,6,6,0,1
9,2009,381900,6,5,1,3
10,2009,381900,6,5,1,1
11,2009,381900,5,5,0,0
12,2009,381900,8,7,1,0
1,2010,381900,8,8,0,1
2,2010,381900,6,5,1,0
3,2010,381900,4,4,0,0
4,2010,381900,6,5,1,0
5,2010,381900,6,6,0,1
6,2010,381900,4,4,0,0
7,2010,381900,0,0,0,0
8,2010,381900,7,7,0,0
9,2010,381900,6,6,0,0
10,2010,381900,9,9,0,3
11,2010,381900,7,6,1,1
12,2010,381900,10,9,1,1
1,2011,381900,7,7,0,0
2,2011,381900,5,5,0,0
1,1999,843600,20,16,4,14
2,1999,843600,12,8,4,7
3,1999,843600,23,17,6,2
4,1999,843600,28,23,5,3
5,1999,843600,25,16,9,20
6,1999,843600,21,17,4,5
7,1999,843600,17,14,3,1
8,1999,843600,25,22,3,2
9,1999,843600,19,15,4,4
10,1999,843600,16,13,3,4
11,1999,843600,33,26,7,20
12,1999,843600,36,28,8,4
1,2000,843600,14,9,5,6
2,2000,843600,21,18,3,3
3,2000,843600,30,25,5,2
4,2000,843600,21,15,6,5
5,2000,843600,37,32,5,1
6,2000,843600,33,27,6,3
7,2000,843600,33,26,7,2
8,2000,843600,44,38,6,5
9,2000,843600,30,24,6,7
10,2000,843600,39,36,3,5
11,2000,843600,20,17,3,1
12,2000,843600,28,22,6,8
1,2001,843600,33,27,6,7
2,2001,843600,29,26,3,8
3,2001,843600,35,23,12,2
4,2001,843600,18,13,5,4
5,2001,843600,37,28,9,8
6,2001,843600,22,15,7,8
7,2001,843600,28,22,6,5
8,2001,843600,36,30,6,6
9,2001,843600,29,21,8,4
10,2001,843600,37,29,8,7
11,2001,843600,32,30,2,4
12,2001,843600,22,20,2,1
1,2002,843600,39,33,6,1
2,2002,843600,28,27,1,6
3,2002,843600,18,17,1,10
4,2002,843600,18,16,2,7
5,2002,843600,47,35,12,14
6,2002,843600,38,29,9,7
7,2002,843600,44,40,4,11
8,2002,843600,39,36,3,5
9,2002,843600,30,24,6,4
10,2002,843600,35,28,7,7
11,2002,843600,32,28,4,7
12,2002,843600,39,36,3,19
1,2003,843600,17,16,1,14
2,2003,843600,22,18,4,7
3,2003,843600,29,22,7,11
4,2003,843600,30,28,2,2
5,2003,843600,20,19,1,8
6,2003,843600,28,24,4,5
7,2003,843600,35,29,6,7
8,2003,843600,35,34,1,8
9,2003,843600,34,32,2,9
10,2003,843600,40,37,3,11
11,2003,843600,31,27,4,6
12,2003,843600,33,32,1,9
1,2004,843600,38,35,3,9
2,2004,843600,43,40,3,15
3,2004,843600,32,26,6,4
4,2004,843600,32,28,4,12
5,2004,843600,33,31,2,13
6,2004,843600,29,27,2,5
7,2004,843600,36,28,8,7
8,2004,843600,40,34,6,11
9,2004,843600,37,31,6,18
10,2004,843600,28,24,4,17
11,2004,843600,23,20,3,9
12,2004,843600,25,24,1,3
1,2005,843600,12,9,3,8
2,2005,843600,27,21,6,15
3,2005,843600,42,36,6,9
4,2005,843600,27,26,1,4
5,2005,843600,33,32,1,9
6,2005,843600,34,25,9,10
7,2005,843600,28,22,6,9
8,2005,843600,29,23,6,9
9,2005,843600,38,30,8,8
10,2005,843600,32,26,6,8
11,2005,843600,30,23,7,8
12,2005,843600,22,21,1,3
1,2006,843600,25,21,4,11
2,2006,843600,21,17,4,8
3,2006,843600,20,19,1,5
4,2006,843600,21,17,4,4
5,2006,843600,28,25,3,4
6,2006,843600,25,20,5,4
7,2006,843600,27,22,5,6
8,2006,843600,30,27,3,10
9,2006,843600,31,27,4,1
10,2006,843600,25,20,5,3
11,2006,843600,27,23,4,4
12,2006,843600,24,21,3,5
1,2007,843600,13,12,1,8
2,2007,843600,16,13,3,5
3,2007,843600,21,20,1,9
4,2007,843600,23,13,10,10
5,2007,843600,29,24,5,15
6,2007,843600,24,20,4,14
7,2007,843600,30,26,4,9
8,2007,843600,25,23,2,10
9,2007,843600,18,14,4,6
10,2007,843600,17,15,2,7
11,2007,843600,20,17,3,15
12,2007,843600,17,16,1,11
1,2008,843600,20,13,7,12
2,2008,843600,16,15,1,6
3,2008,843600,17,16,1,12
4,2008,843600,22,16,6,7
5,2008,843600,22,16,6,6
6,2008,843600,14,10,4,7
7,2008,843600,26,18,8,5
8,2008,843600,23,20,3,10
9,2008,843600,25,22,3,15
10,2008,843600,25,22,3,9
11,2008,843600,14,10,4,11
12,2008,843600,14,12,2,11
1,2009,843600,28,25,3,8
2,2009,843600,11,11,0,10
3,2009,843600,21,19,2,4
4,2009,843600,20,17,3,7
5,2009,843600,23,22,1,17
6,2009,843600,29,24,5,15
7,2009,843600,20,18,2,13
8,2009,843600,22,17,5,14
9,2009,843600,25,21,4,18
10,2009,843600,27,24,3,10
11,2009,843600,21,17,4,12
12,2009,843600,27,23,4,10
1,2010,843600,7,7,0,23
2,2010,843600,11,10,1,14
3,2010,843600,18,16,2,18
4,2010,843600,15,11,4,13
5,2010,843600,16,15,1,9
6,2010,843600,12,12,0,11
7,2010,843600,27,23,4,13
8,2010,843600,32,24,8,12
9,2010,843600,18,17,1,15
10,2010,843600,18,17,1,8
11,2010,843600,23,18,5,9
12,2010,843600,11,8,3,3
1,2011,843600,19,17,2,6
2,2011,843600,15,13,2,2
1,1999,381800,31,25,6,5
2,1999,381800,15,12,3,10
3,1999,381800,27,21,6,7
4,1999,381800,16,12,4,7
5,1999,381800,37,25,12,5
6,1999,381800,31,24,7,7
7,1999,381800,27,21,6,8
8,1999,381800,41,36,5,5
9,1999,381800,27,17,10,1
10,1999,381800,21,17,4,9
11,1999,381800,24,21,3,13
12,1999,381800,25,17,8,6
1,2000,381800,19,19,0,4
2,2000,381800,16,15,1,9
3,2000,381800,16,15,1,10
4,2000,381800,18,11,7,7
5,2000,381800,17,12,5,9
6,2000,381800,19,16,3,12
7,2000,381800,19,11,8,11
8,2000,381800,26,22,4,10
9,2000,381800,33,23,10,9
10,2000,381800,14,10,4,11
11,2000,381800,16,15,1,12
12,2000,381800,20,15,5,7
1,2001,381800,15,10,5,3
2,2001,381800,23,19,4,11
3,2001,381800,22,17,5,13
4,2001,381800,15,10,5,12
5,2001,381800,18,14,4,5
6,2001,381800,22,20,2,9
7,2001,381800,26,20,6,7
8,2001,381800,26,18,8,6
9,2001,381800,23,16,7,7
10,2001,381800,22,15,7,4
11,2001,381800,20,17,3,10
12,2001,381800,17,12,5,5
1,2002,381800,25,19,6,8
2,2002,381800,17,13,4,11
3,2002,381800,19,16,3,10
4,2002,381800,13,8,5,9
5,2002,381800,23,19,4,18
6,2002,381800,27,16,11,10
7,2002,381800,23,17,6,5
8,2002,381800,24,20,4,11
9,2002,381800,13,10,3,10
10,2002,381800,29,21,8,12
11,2002,381800,31,26,5,9
12,2002,381800,30,25,5,9
1,2003,381800,14,13,1,6
2,2003,381800,11,11,0,7
3,2003,381800,14,12,2,3
4,2003,381800,17,10,7,9
5,2003,381800,10,8,2,7
6,2003,381800,21,19,2,3
7,2003,381800,21,17,4,2
8,2003,381800,13,12,1,3
9,2003,381800,17,15,2,2
10,2003,381800,11,8,3,4
11,2003,381800,14,13,1,2
12,2003,381800,13,9,4,8
1,2004,381800,11,11,0,4
2,2004,381800,8,8,0,4
3,2004,381800,13,10,3,3
4,2004,381800,11,9,2,4
5,2004,381800,10,6,4,13
6,2004,381800,13,11,2,3
7,2004,381800,13,11,2,6
8,2004,381800,15,14,1,3
9,2004,381800,15,10,5,1
10,2004,381800,15,13,2,3
11,2004,381800,12,8,4,6
12,2004,381800,8,8,0,7
1,2005,381800,9,7,2,10
2,2005,381800,9,8,1,1
3,2005,381800,14,14,0,2
4,2005,381800,22,21,1,2
5,2005,381800,16,13,3,2
6,2005,381800,14,10,4,1
7,2005,381800,14,13,1,3
8,2005,381800,12,10,2,4
9,2005,381800,15,13,2,3
10,2005,381800,18,12,6,0
11,2005,381800,22,20,2,1
12,2005,381800,15,13,2,3
1,2006,381800,23,20,3,2
2,2006,381800,22,19,3,2
3,2006,381800,11,7,4,1
4,2006,381800,15,12,3,7
5,2006,381800,24,18,6,1
6,2006,381800,19,17,2,2
7,2006,381800,13,10,3,4
8,2006,381800,17,15,2,3
9,2006,381800,28,27,1,4
10,2006,381800,11,8,3,1
11,2006,381800,21,18,3,0
12,2006,381800,8,6,2,3
1,2007,381800,16,9,7,2
2,2007,381800,13,11,2,3
3,2007,381800,12,10,2,1
4,2007,381800,9,7,2,2
5,2007,381800,18,15,3,4
6,2007,381800,13,9,4,7
7,2007,381800,24,20,4,1
8,2007,381800,12,10,2,1
9,2007,381800,16,13,3,7
10,2007,381800,6,5,1,2
11,2007,381800,14,11,3,3
12,2007,381800,12,11,1,1
1,2008,381800,13,9,4,5
2,2008,381800,13,10,3,5
3,2008,381800,9,7,2,3
4,2008,381800,14,11,3,1
5,2008,381800,9,7,2,1
6,2008,381800,22,20,2,2
7,2008,381800,8,6,2,2
8,2008,381800,8,7,1,2
9,2008,381800,9,8,1,4
10,2008,381800,7,7,0,2
11,2008,381800,12,11,1,5
12,2008,381800,12,11,1,0
1,2009,381800,8,7,1,2
2,2009,381800,10,9,1,4
3,2009,381800,15,10,5,1
4,2009,381800,14,13,1,1
5,2009,381800,12,9,3,2
6,2009,381800,14,11,3,0
7,2009,381800,18,17,1,0
8,2009,381800,10,8,2,2
9,2009,381800,13,11,2,1
10,2009,381800,20,19,1,1
11,2009,381800,7,7,0,2
12,2009,381800,11,10,1,1
1,2010,381800,17,12,5,0
2,2010,381800,13,9,4,2
3,2010,381800,10,10,0,3
4,2010,381800,12,12,0,3
5,2010,381800,10,7,3,4
6,2010,381800,6,4,2,3
7,2010,381800,10,9,1,4
8,2010,381800,4,3,1,3
9,2010,381800,8,6,2,2
10,2010,381800,11,10,1,3
11,2010,381800,7,7,0,2
12,2010,381800,12,11,1,4
1,2011,381800,13,12,1,1
2,2011,381800,2,1,1,4
1,1999,390400,8,8,0,2
2,1999,390400,5,5,0,0
3,1999,390400,16,13,3,1
4,1999,390400,14,12,2,4
5,1999,390400,11,10,1,3
6,1999,390400,9,9,0,1
7,1999,390400,8,7,1,1
8,1999,390400,14,13,1,0
9,1999,390400,9,7,2,5
10,1999,390400,12,12,0,2
11,1999,390400,12,8,4,5
12,1999,390400,17,17,0,2
1,2000,390400,13,10,3,7
2,2000,390400,12,10,2,3
3,2000,390400,21,18,3,2
4,2000,390400,9,8,1,2
5,2000,390400,8,5,3,3
6,2000,390400,13,11,2,2
7,2000,390400,24,21,3,1
8,2000,390400,25,22,3,4
9,2000,390400,21,20,1,2
10,2000,390400,28,25,3,4
11,2000,390400,24,21,3,3
12,2000,390400,13,12,1,1
1,2001,390400,16,13,3,6
2,2001,390400,8,6,2,3
3,2001,390400,14,12,2,2
4,2001,390400,20,17,3,7
5,2001,390400,10,7,3,1
6,2001,390400,18,17,1,4
7,2001,390400,18,12,6,6
8,2001,390400,22,18,4,4
9,2001,390400,20,18,2,4
10,2001,390400,14,10,4,3
11,2001,390400,8,7,1,4
12,2001,390400,14,13,1,1
1,2002,390400,8,6,2,3
2,2002,390400,8,7,1,4
3,2002,390400,17,16,1,2
4,2002,390400,19,17,2,3
5,2002,390400,15,11,4,5
6,2002,390400,14,10,4,2
7,2002,390400,14,13,1,4
8,2002,390400,13,12,1,6
9,2002,390400,19,18,1,4
10,2002,390400,12,10,2,7
11,2002,390400,14,14,0,2
12,2002,390400,19,12,7,9
1,2003,390400,13,12,1,5
2,2003,390400,8,7,1,4
3,2003,390400,18,13,5,5
4,2003,390400,13,12,1,1
5,2003,390400,19,16,3,0
6,2003,390400,9,7,2,5
7,2003,390400,22,20,2,1
8,2003,390400,16,15,1,3
9,2003,390400,22,20,2,2
10,2003,390400,23,18,5,5
11,2003,390400,18,17,1,2
12,2003,390400,17,15,2,4
1,2004,390400,12,11,1,3
2,2004,390400,19,16,3,5
3,2004,390400,16,16,0,6
4,2004,390400,8,8,0,1
5,2004,390400,17,11,6,2
6,2004,390400,13,11,2,3
7,2004,390400,28,23,5,2
8,2004,390400,16,12,4,1
9,2004,390400,16,16,0,1
10,2004,390400,21,20,1,3
11,2004,390400,16,15,1,2
12,2004,390400,17,15,2,2
1,2005,390400,11,11,0,7
2,2005,390400,18,14,4,4
3,2005,390400,15,13,2,7
4,2005,390400,17,13,4,0
5,2005,390400,25,25,0,0
6,2005,390400,19,18,1,3
7,2005,390400,11,11,0,0
8,2005,390400,12,11,1,5
9,2005,390400,31,27,4,3
10,2005,390400,19,16,3,5
11,2005,390400,17,15,2,0
12,2005,390400,18,14,4,1
1,2006,390400,13,13,0,4
2,2006,390400,11,9,2,1
3,2006,390400,10,5,5,2
4,2006,390400,7,6,1,4
5,2006,390400,18,15,3,6
6,2006,390400,14,10,4,3
7,2006,390400,17,15,2,10
8,2006,390400,13,11,2,3
9,2006,390400,13,10,3,0
10,2006,390400,21,16,5,1
11,2006,390400,18,14,4,0
12,2006,390400,17,15,2,1
1,2007,390400,15,13,2,0
2,2007,390400,8,7,1,0
3,2007,390400,15,13,2,1
4,2007,390400,19,16,3,3
5,2007,390400,10,9,1,1
6,2007,390400,13,10,3,2
7,2007,390400,20,19,1,4
8,2007,390400,18,13,5,5
9,2007,390400,16,12,4,6
10,2007,390400,14,12,2,5
11,2007,390400,12,10,2,3
12,2007,390400,18,18,0,3
1,2008,390400,12,11,1,10
2,2008,390400,11,9,2,2
3,2008,390400,15,13,2,5
4,2008,390400,7,6,1,7
5,2008,390400,21,18,3,4
6,2008,390400,8,7,1,6
7,2008,390400,9,9,0,5
8,2008,390400,9,8,1,7
9,2008,390400,12,12,0,5
10,2008,390400,16,16,0,1
11,2008,390400,10,9,1,2
12,2008,390400,6,5,1,2
1,2009,390400,11,10,1,3
2,2009,390400,10,10,0,1
3,2009,390400,8,6,2,1
4,2009,390400,18,15,3,1
5,2009,390400,18,17,1,1
6,2009,390400,9,7,2,5
7,2009,390400,8,7,1,4
8,2009,390400,17,15,2,6
9,2009,390400,12,10,2,5
10,2009,390400,10,8,2,4
11,2009,390400,16,14,2,6
12,2009,390400,11,11,0,3
1,2010,390400,12,12,0,8
2,2010,390400,15,11,4,3
3,2010,390400,13,13,0,5
4,2010,390400,9,9,0,0
5,2010,390400,14,14,0,3
6,2010,390400,11,9,2,4
7,2010,390400,8,6,2,3
8,2010,390400,16,14,2,9
9,2010,390400,18,14,4,6
10,2010,390400,12,12,0,4
11,2010,390400,15,14,1,3
12,2010,390400,9,9,0,5
1,2011,390400,8,6,2,5
2,2011,390400,4,3,1,1
1,1999,390500,5,5,0,0
2,1999,390500,3,3,0,0
3,1999,390500,4,4,0,2
4,1999,390500,2,2,0,3
5,1999,390500,9,7,2,0
6,1999,390500,9,8,1,0
7,1999,390500,10,10,0,0
8,1999,390500,8,8,0,0
9,1999,390500,6,4,2,0
10,1999,390500,8,7,1,0
11,1999,390500,4,3,1,0
12,1999,390500,4,3,1,0
1,2000,390500,7,7,0,0
2,2000,390500,2,2,0,1
3,2000,390500,7,6,1,0
4,2000,390500,4,3,1,0
5,2000,390500,14,13,1,0
6,2000,390500,5,5,0,0
7,2000,390500,7,7,0,1
8,2000,390500,9,9,0,0
9,2000,390500,3,3,0,0
10,2000,390500,3,3,0,0
11,2000,390500,7,7,0,0
12,2000,390500,7,7,0,0
1,2001,390500,4,4,0,0
2,2001,390500,3,3,0,0
3,2001,390500,6,6,0,0
4,2001,390500,4,4,0,2
5,2001,390500,8,8,0,1
6,2001,390500,4,4,0,0
7,2001,390500,5,4,1,0
8,2001,390500,4,2,2,1
9,2001,390500,10,9,1,1
10,2001,390500,11,11,0,3
11,2001,390500,10,10,0,1
12,2001,390500,7,7,0,0
1,2002,390500,1,0,1,0
2,2002,390500,2,1,1,0
3,2002,390500,3,2,1,0
4,2002,390500,1,1,0,0
5,2002,390500,4,4,0,0
6,2002,390500,6,5,1,0
7,2002,390500,5,4,1,1
8,2002,390500,3,3,0,1
9,2002,390500,4,4,0,1
10,2002,390500,12,11,1,2
11,2002,390500,2,2,0,0
12,2002,390500,6,6,0,0
1,2003,390500,6,6,0,0
2,2003,390500,8,8,0,2
3,2003,390500,9,8,1,0
4,2003,390500,5,4,1,0
5,2003,390500,1,1,0,0
6,2003,390500,8,7,1,0
7,2003,390500,4,4,0,0
8,2003,390500,3,3,0,0
9,2003,390500,9,9,0,0
10,2003,390500,7,6,1,0
11,2003,390500,5,5,0,0
12,2003,390500,7,7,0,0
1,2004,390500,4,4,0,0
2,2004,390500,4,3,1,0
3,2004,390500,4,3,1,0
4,2004,390500,2,2,0,1
5,2004,390500,3,3,0,0
6,2004,390500,3,2,1,0
7,2004,390500,7,7,0,0
8,2004,390500,9,9,0,0
9,2004,390500,2,2,0,1
10,2004,390500,12,12,0,3
11,2004,390500,4,4,0,0
12,2004,390500,2,2,0,0
1,2005,390500,7,7,0,0
2,2005,390500,3,3,0,0
3,2005,390500,2,1,1,2
4,2005,390500,4,4,0,0
5,2005,390500,9,9,0,0
6,2005,390500,3,3,0,0
7,2005,390500,3,2,1,0
8,2005,390500,7,7,0,0
9,2005,390500,7,6,1,0
10,2005,390500,8,7,1,0
11,2005,390500,4,4,0,1
12,2005,390500,7,7,0,0
1,2006,390500,6,6,0,2
2,2006,390500,3,3,0,0
3,2006,390500,2,2,0,0
4,2006,390500,5,5,0,1
5,2006,390500,5,4,1,1
6,2006,390500,3,3,0,0
7,2006,390500,3,2,1,0
8,2006,390500,3,3,0,0
9,2006,390500,1,0,1,0
10,2006,390500,9,9,0,0
11,2006,390500,7,7,0,0
12,2006,390500,7,6,1,0
1,2007,390500,2,1,1,0
2,2007,390500,1,1,0,0
3,2007,390500,5,4,1,0
4,2007,390500,6,5,1,1
5,2007,390500,6,5,1,1
6,2007,390500,3,3,0,0
7,2007,390500,3,3,0,0
8,2007,390500,3,3,0,0
9,2007,390500,3,3,0,0
10,2007,390500,6,5,1,0
11,2007,390500,7,7,0,0
12,2007,390500,1,1,0,0
1,2008,390500,7,7,0,0
2,2008,390500,1,1,0,0
3,2008,390500,0,0,0,1
4,2008,390500,0,0,0,0
5,2008,390500,6,5,1,1
6,2008,390500,7,7,0,0
7,2008,390500,4,4,0,0
8,2008,390500,6,5,1,3
9,2008,390500,0,0,0,0
10,2008,390500,5,4,1,0
11,2008,390500,3,2,1,0
12,2008,390500,3,2,1,0
1,2009,390500,0,0,0,0
2,2009,390500,2,1,1,0
3,2009,390500,3,3,0,0
4,2009,390500,3,3,0,0
5,2009,390500,2,2,0,1
6,2009,390500,5,4,1,1
7,2009,390500,5,5,0,0
8,2009,390500,1,1,0,1
9,2009,390500,5,3,2,1
10,2009,390500,3,3,0,0
11,2009,390500,3,3,0,2
12,2009,390500,2,2,0,2
1,2010,390500,8,8,0,0
2,2010,390500,8,8,0,1
3,2010,390500,3,3,0,0
4,2010,390500,1,1,0,0
5,2010,390500,6,6,0,1
6,2010,390500,6,6,0,3
7,2010,390500,3,3,0,1
8,2010,390500,6,6,0,0
9,2010,390500,0,0,0,2
10,2010,390500,2,2,0,0
11,2010,390500,5,5,0,0
12,2010,390500,1,1,0,0
1,2011,390500,3,3,0,0
2,2011,390500,3,2,1,0
1,1999,390600,3,3,0,0
2,1999,390600,8,8,0,0
3,1999,390600,5,5,0,0
4,1999,390600,12,12,0,0
5,1999,390600,13,13,0,0
6,1999,390600,9,9,0,0
7,1999,390600,11,11,0,0
8,1999,390600,10,10,0,1
9,1999,390600,8,8,0,0
10,1999,390600,15,15,0,0
11,1999,390600,16,15,1,0
12,1999,390600,15,14,1,0
1,2000,390600,12,12,0,0
2,2000,390600,18,18,0,1
3,2000,390600,19,19,0,0
4,2000,390600,14,14,0,0
5,2000,390600,21,20,1,0
6,2000,390600,14,14,0,0
7,2000,390600,27,26,1,0
8,2000,390600,22,22,0,0
9,2000,390600,29,29,0,0
10,2000,390600,29,27,2,0
11,2000,390600,19,19,0,0
12,2000,390600,15,15,0,0
1,2001,390600,25,24,1,0
2,2001,390600,10,10,0,2
3,2001,390600,19,18,1,0
4,2001,390600,20,19,1,0
5,2001,390600,13,13,0,1
6,2001,390600,8,8,0,0
7,2001,390600,23,23,0,0
8,2001,390600,15,15,0,0
9,2001,390600,17,17,0,0
10,2001,390600,23,23,0,0
11,2001,390600,15,14,1,0
12,2001,390600,20,18,2,0
1,2002,390600,12,11,1,0
2,2002,390600,12,12,0,0
3,2002,390600,6,6,0,0
4,2002,390600,17,17,0,0
5,2002,390600,19,19,0,0
6,2002,390600,21,21,0,1
7,2002,390600,20,20,0,0
8,2002,390600,31,31,0,0
9,2002,390600,31,31,0,0
10,2002,390600,19,19,0,1
11,2002,390600,18,17,1,1
12,2002,390600,14,13,1,0
1,2003,390600,15,14,1,1
2,2003,390600,8,7,1,0
3,2003,390600,3,3,0,1
4,2003,390600,14,14,0,0
5,2003,390600,17,16,1,3
6,2003,390600,24,24,0,2
7,2003,390600,12,12,0,0
8,2003,390600,16,15,1,0
9,2003,390600,17,16,1,0
10,2003,390600,15,15,0,2
11,2003,390600,12,12,0,0
12,2003,390600,18,18,0,2
1,2004,390600,10,10,0,0
2,2004,390600,10,10,0,3
3,2004,390600,13,11,2,0
4,2004,390600,15,15,0,1
5,2004,390600,15,15,0,1
6,2004,390600,11,10,1,0
7,2004,390600,5,5,0,0
8,2004,390600,20,19,1,0
9,2004,390600,18,18,0,0
10,2004,390600,12,12,0,0
11,2004,390600,14,13,1,0
12,2004,390600,6,6,0,0
1,2005,390600,10,10,0,0
2,2005,390600,8,8,0,0
3,2005,390600,8,7,1,1
4,2005,390600,11,11,0,0
5,2005,390600,5,4,1,0
6,2005,390600,11,11,0,0
7,2005,390600,21,20,1,0
8,2005,390600,17,17,0,0
9,2005,390600,13,12,1,0
10,2005,390600,11,11,0,0
11,2005,390600,14,14,0,0
12,2005,390600,19,18,1,1
1,2006,390600,12,12,0,0
2,2006,390600,5,5,0,0
3,2006,390600,18,18,0,0
4,2006,390600,9,9,0,0
5,2006,390600,5,5,0,0
6,2006,390600,6,5,1,0
7,2006,390600,7,7,0,0
8,2006,390600,8,8,0,0
9,2006,390600,11,11,0,0
10,2006,390600,9,9,0,0
11,2006,390600,11,11,0,1
12,2006,390600,8,8,0,0
1,2007,390600,4,4,0,0
2,2007,390600,2,2,0,0
3,2007,390600,8,8,0,0
4,2007,390600,6,6,0,0
5,2007,390600,6,6,0,2
6,2007,390600,15,15,0,0
7,2007,390600,9,8,1,0
8,2007,390600,10,9,1,1
9,2007,390600,3,3,0,2
10,2007,390600,6,6,0,0
11,2007,390600,2,2,0,0
12,2007,390600,10,10,0,0
1,2008,390600,5,5,0,0
2,2008,390600,4,4,0,0
3,2008,390600,4,3,1,0
4,2008,390600,4,4,0,0
5,2008,390600,7,6,1,0
6,2008,390600,5,4,1,0
7,2008,390600,10,10,0,0
8,2008,390600,4,4,0,2
9,2008,390600,12,12,0,0
10,2008,390600,5,5,0,0
11,2008,390600,6,5,1,0
12,2008,390600,3,2,1,0
1,2009,390600,5,5,0,0
2,2009,390600,3,3,0,0
3,2009,390600,5,5,0,1
4,2009,390600,1,1,0,0
5,2009,390600,10,10,0,1
6,2009,390600,8,7,1,0
7,2009,390600,7,7,0,0
8,2009,390600,16,16,0,0
9,2009,390600,6,6,0,1
10,2009,390600,4,4,0,0
11,2009,390600,5,5,0,1
12,2009,390600,8,8,0,0
1,2010,390600,3,3,0,1
2,2010,390600,8,8,0,2
3,2010,390600,7,7,0,0
4,2010,390600,11,11,0,0
5,2010,390600,10,10,0,0
6,2010,390600,6,6,0,0
7,2010,390600,9,9,0,0
8,2010,390600,7,7,0,0
9,2010,390600,9,8,1,0
10,2010,390600,4,4,0,0
11,2010,390600,8,8,0,0
12,2010,390600,6,5,1,0
1,2011,390600,3,3,0,0
2,2011,390600,2,2,0,0
1,1999,842800,25,21,4,1
2,1999,842800,21,18,3,3
3,1999,842800,34,30,4,5
4,1999,842800,27,20,7,4
5,1999,842800,23,21,2,5
6,1999,842800,25,22,3,1
7,1999,842800,20,18,2,4
8,1999,842800,30,27,3,2
9,1999,842800,26,24,2,1
10,1999,842800,39,37,2,2
11,1999,842800,29,26,3,2
12,1999,842800,35,32,3,3
1,2000,842800,30,30,0,2
2,2000,842800,23,21,2,2
3,2000,842800,34,32,2,4
4,2000,842800,22,20,2,2
5,2000,842800,27,23,4,2
6,2000,842800,40,35,5,3
7,2000,842800,33,26,7,1
8,2000,842800,32,32,0,5
9,2000,842800,40,36,4,1
10,2000,842800,39,37,2,2
11,2000,842800,37,35,2,4
12,2000,842800,26,25,1,0
1,2001,842800,23,21,2,2
2,2001,842800,18,17,1,3
3,2001,842800,27,27,0,3
4,2001,842800,24,21,3,5
5,2001,842800,25,23,2,5
6,2001,842800,27,24,3,3
7,2001,842800,32,30,2,3
8,2001,842800,27,26,1,3
9,2001,842800,25,24,1,4
10,2001,842800,25,21,4,5
11,2001,842800,28,25,3,1
12,2001,842800,31,27,4,5
1,2002,842800,32,28,4,2
2,2002,842800,17,17,0,0
3,2002,842800,30,27,3,2
4,2002,842800,19,18,1,1
5,2002,842800,34,33,1,2
6,2002,842800,23,21,2,1
7,2002,842800,34,30,4,1
8,2002,842800,30,27,3,1
9,2002,842800,37,34,3,2
10,2002,842800,32,30,2,6
11,2002,842800,28,26,2,3
12,2002,842800,15,13,2,3
1,2003,842800,23,20,3,6
2,2003,842800,12,12,0,2
3,2003,842800,18,17,1,5
4,2003,842800,25,23,2,1
5,2003,842800,20,18,2,3
6,2003,842800,33,27,6,4
7,2003,842800,31,29,2,3
8,2003,842800,22,20,2,3
9,2003,842800,28,26,2,3
10,2003,842800,32,29,3,3
11,2003,842800,19,18,1,6
12,2003,842800,20,16,4,1
1,2004,842800,33,27,6,5
2,2004,842800,18,18,0,3
3,2004,842800,22,21,1,4
4,2004,842800,19,17,2,2
5,2004,842800,23,21,2,4
6,2004,842800,29,28,1,1
7,2004,842800,17,16,1,3
8,2004,842800,23,22,1,3
9,2004,842800,32,29,3,9
10,2004,842800,23,19,4,4
11,2004,842800,22,19,3,1
12,2004,842800,38,36,2,2
1,2005,842800,24,21,3,1
2,2005,842800,14,13,1,6
3,2005,842800,22,21,1,3
4,2005,842800,12,11,1,1
5,2005,842800,21,16,5,4
6,2005,842800,18,18,0,2
7,2005,842800,20,18,2,6
8,2005,842800,22,19,3,5
9,2005,842800,24,23,1,3
10,2005,842800,20,19,1,1
11,2005,842800,25,25,0,3
12,2005,842800,23,21,2,1
1,2006,842800,26,26,0,0
2,2006,842800,23,23,0,3
3,2006,842800,31,29,2,5
4,2006,842800,32,27,5,3
5,2006,842800,21,20,1,1
6,2006,842800,23,21,2,5
7,2006,842800,36,35,1,6
8,2006,842800,32,25,7,2
9,2006,842800,24,21,3,7
10,2006,842800,21,20,1,2
11,2006,842800,23,23,0,6
12,2006,842800,26,21,5,14
1,2007,842800,25,23,2,4
2,2007,842800,13,11,2,2
3,2007,842800,14,12,2,2
4,2007,842800,24,20,4,7
5,2007,842800,23,21,2,5
6,2007,842800,27,22,5,2
7,2007,842800,29,28,1,2
8,2007,842800,30,27,3,3
9,2007,842800,13,12,1,5
10,2007,842800,27,24,3,4
11,2007,842800,33,30,3,0
12,2007,842800,33,30,3,3
1,2008,842800,28,23,5,0
2,2008,842800,19,19,0,2
3,2008,842800,20,15,5,3
4,2008,842800,30,27,3,5
5,2008,842800,40,34,6,3
6,2008,842800,23,21,2,2
7,2008,842800,20,18,2,1
8,2008,842800,35,32,3,5
9,2008,842800,40,40,0,4
10,2008,842800,40,39,1,2
11,2008,842800,25,22,3,0
12,2008,842800,28,28,0,1
1,2009,842800,27,26,1,1
2,2009,842800,15,13,2,5
3,2009,842800,22,16,6,2
4,2009,842800,23,22,1,5
5,2009,842800,28,26,2,4
6,2009,842800,33,27,6,4
7,2009,842800,17,14,3,9
8,2009,842800,25,23,2,7
9,2009,842800,19,16,3,8
10,2009,842800,18,17,1,1
11,2009,842800,24,24,0,3
12,2009,842800,20,19,1,4
1,2010,842800,12,11,1,4
2,2010,842800,17,16,1,4
3,2010,842800,10,9,1,8
4,2010,842800,26,23,3,4
5,2010,842800,32,25,7,2
6,2010,842800,25,24,1,1
7,2010,842800,14,11,3,5
8,2010,842800,18,13,5,5
9,2010,842800,15,14,1,3
10,2010,842800,26,22,4,0
11,2010,842800,24,23,1,2
12,2010,842800,18,17,1,4
1,2011,842800,24,21,3,3
2,2011,842800,7,6,1,0
1,1999,381400,24,21,3,11
2,1999,381400,34,25,9,8
3,1999,381400,35,31,4,12
4,1999,381400,32,27,5,8
5,1999,381400,28,20,8,5
6,1999,381400,44,38,6,6
7,1999,381400,44,38,6,7
8,1999,381400,55,47,8,5
9,1999,381400,51,46,5,9
10,1999,381400,44,38,6,13
11,1999,381400,37,27,10,4
12,1999,381400,29,23,6,12
1,2000,381400,30,23,7,15
2,2000,381400,17,12,5,12
3,2000,381400,33,24,9,19
4,2000,381400,21,17,4,18
5,2000,381400,42,28,14,8
6,2000,381400,38,30,8,9
7,2000,381400,39,34,5,18
8,2000,381400,33,20,13,19
9,2000,381400,32,27,5,10
10,2000,381400,32,23,9,17
11,2000,381400,21,19,2,17
12,2000,381400,27,23,4,18
1,2001,381400,27,19,8,21
2,2001,381400,26,21,5,15
3,2001,381400,15,12,3,23
4,2001,381400,25,20,5,22
5,2001,381400,31,23,8,17
6,2001,381400,25,20,5,26
7,2001,381400,37,23,14,19
8,2001,381400,34,31,3,15
9,2001,381400,33,24,9,19
10,2001,381400,23,16,7,21
11,2001,381400,30,26,4,19
12,2001,381400,23,22,1,18
1,2002,381400,26,20,6,11
2,2002,381400,22,16,6,7
3,2002,381400,18,16,2,22
4,2002,381400,23,15,8,17
5,2002,381400,35,22,13,16
6,2002,381400,35,30,5,8
7,2002,381400,43,36,7,6
8,2002,381400,46,36,10,11
9,2002,381400,27,22,5,5
10,2002,381400,20,18,2,4
11,2002,381400,31,28,3,8
12,2002,381400,25,21,4,18
1,2003,381400,31,27,4,11
2,2003,381400,16,12,4,7
3,2003,381400,16,13,3,7
4,2003,381400,31,27,4,19
5,2003,381400,51,41,10,5
6,2003,381400,20,15,5,5
7,2003,381400,48,39,9,8
8,2003,381400,44,40,4,5
9,2003,381400,41,35,6,11
10,2003,381400,41,33,8,9
11,2003,381400,26,23,3,7
12,2003,381400,32,24,8,7
1,2004,381400,19,17,2,12
2,2004,381400,22,19,3,12
3,2004,381400,23,18,5,9
4,2004,381400,30,21,9,10
5,2004,381400,32,26,6,16
6,2004,381400,29,26,3,13
7,2004,381400,23,16,7,4
8,2004,381400,32,25,7,3
9,2004,381400,21,17,4,8
10,2004,381400,29,26,3,9
11,2004,381400,31,26,5,2
12,2004,381400,21,19,2,14
1,2005,381400,11,9,2,7
2,2005,381400,7,7,0,5
3,2005,381400,17,15,2,14
4,2005,381400,23,18,5,1
5,2005,381400,16,14,2,4
6,2005,381400,34,30,4,2
7,2005,381400,29,20,9,8
8,2005,381400,20,15,5,3
9,2005,381400,16,12,4,12
10,2005,381400,21,16,5,6
11,2005,381400,28,22,6,3
12,2005,381400,26,26,0,12
1,2006,381400,22,18,4,4
2,2006,381400,15,15,0,8
3,2006,381400,20,15,5,3
4,2006,381400,23,19,4,3
5,2006,381400,18,17,1,7
6,2006,381400,22,18,4,4
7,2006,381400,31,22,9,1
8,2006,381400,31,29,2,10
9,2006,381400,23,15,8,1
10,2006,381400,19,16,3,7
11,2006,381400,21,20,1,3
12,2006,381400,19,17,2,7
1,2007,381400,18,18,0,5
2,2007,381400,12,10,2,7
3,2007,381400,21,16,5,2
4,2007,381400,15,8,7,8
5,2007,381400,16,11,5,4
6,2007,381400,12,10,2,7
7,2007,381400,13,9,4,4
8,2007,381400,20,14,6,4
9,2007,381400,18,15,3,12
10,2007,381400,17,13,4,4
11,2007,381400,26,22,4,10
12,2007,381400,27,22,5,6
1,2008,381400,24,22,2,3
2,2008,381400,18,13,5,8
3,2008,381400,18,13,5,4
4,2008,381400,15,12,3,4
5,2008,381400,26,20,6,5
6,2008,381400,13,12,1,3
7,2008,381400,20,18,2,1
8,2008,381400,14,13,1,12
9,2008,381400,16,13,3,9
10,2008,381400,24,22,2,7
11,2008,381400,19,16,3,3
12,2008,381400,18,17,1,3
1,2009,381400,21,21,0,7
2,2009,381400,16,16,0,14
3,2009,381400,16,15,1,11
4,2009,381400,19,16,3,9
5,2009,381400,21,18,3,12
6,2009,381400,11,10,1,17
7,2009,381400,19,13,6,8
8,2009,381400,19,18,1,10
9,2009,381400,13,12,1,4
10,2009,381400,23,20,3,6
11,2009,381400,19,18,1,11
12,2009,381400,11,10,1,5
1,2010,381400,14,12,2,8
2,2010,381400,10,10,0,8
3,2010,381400,16,14,2,7
4,2010,381400,21,18,3,6
5,2010,381400,22,16,6,8
6,2010,381400,8,7,1,7
7,2010,381400,14,14,0,9
8,2010,381400,16,10,6,9
9,2010,381400,14,14,0,4
10,2010,381400,21,21,0,6
11,2010,381400,11,10,1,9
12,2010,381400,11,10,1,9
1,2011,381400,11,9,2,6
2,2011,381400,9,8,1,5
1,1999,381200,24,18,6,6
2,1999,381200,18,13,5,12
3,1999,381200,13,10,3,7
4,1999,381200,23,19,4,2
5,1999,381200,28,21,7,3
6,1999,381200,25,16,9,5
7,1999,381200,30,22,8,7
8,1999,381200,33,24,9,9
9,1999,381200,27,19,8,3
10,1999,381200,32,27,5,6
11,1999,381200,35,28,7,3
12,1999,381200,28,21,7,7
1,2000,381200,23,20,3,8
2,2000,381200,13,8,5,5
3,2000,381200,16,14,2,5
4,2000,381200,28,18,10,6
5,2000,381200,28,19,9,6
6,2000,381200,27,19,8,6
7,2000,381200,32,23,9,13
8,2000,381200,29,24,5,7
9,2000,381200,28,24,4,9
10,2000,381200,30,21,9,6
11,2000,381200,25,22,3,2
12,2000,381200,24,17,7,3
1,2001,381200,21,17,4,11
2,2001,381200,20,13,7,2
3,2001,381200,13,9,4,4
4,2001,381200,24,15,9,3
5,2001,381200,19,10,9,1
6,2001,381200,22,16,6,11
7,2001,381200,24,17,7,5
8,2001,381200,25,21,4,13
9,2001,381200,20,16,4,1
10,2001,381200,26,20,6,5
11,2001,381200,27,22,5,1
12,2001,381200,13,8,5,3
1,2002,381200,16,11,5,4
2,2002,381200,15,13,2,5
3,2002,381200,20,17,3,9
4,2002,381200,28,23,5,7
5,2002,381200,12,9,3,4
6,2002,381200,24,15,9,6
7,2002,381200,25,21,4,2
8,2002,381200,29,21,8,9
9,2002,381200,27,21,6,7
10,2002,381200,18,16,2,5
11,2002,381200,23,20,3,13
12,2002,381200,22,18,4,9
1,2003,381200,19,16,3,12
2,2003,381200,15,13,2,9
3,2003,381200,15,13,2,2
4,2003,381200,15,12,3,9
5,2003,381200,22,19,3,6
6,2003,381200,21,14,7,8
7,2003,381200,18,14,4,2
8,2003,381200,27,21,6,1
9,2003,381200,22,18,4,6
10,2003,381200,21,20,1,3
11,2003,381200,14,13,1,5
12,2003,381200,24,21,3,2
1,2004,381200,16,14,2,4
2,2004,381200,19,16,3,0
3,2004,381200,14,11,3,5
4,2004,381200,20,12,8,10
5,2004,381200,32,26,6,23
6,2004,381200,14,8,6,5
7,2004,381200,35,34,1,4
8,2004,381200,24,17,7,5
9,2004,381200,17,14,3,4
10,2004,381200,23,19,4,3
11,2004,381200,16,13,3,5
12,2004,381200,12,11,1,7
1,2005,381200,18,14,4,28
2,2005,381200,16,13,3,13
3,2005,381200,15,13,2,3
4,2005,381200,21,19,2,5
5,2005,381200,32,29,3,3
6,2005,381200,25,20,5,2
7,2005,381200,24,21,3,4
8,2005,381200,19,16,3,9
9,2005,381200,19,16,3,5
10,2005,381200,18,16,2,7
11,2005,381200,11,10,1,6
12,2005,381200,6,5,1,2
1,2006,381200,29,22,7,2
2,2006,381200,15,11,4,2
3,2006,381200,14,12,2,0
4,2006,381200,19,15,4,3
5,2006,381200,16,12,4,3
6,2006,381200,18,15,3,3
7,2006,381200,22,19,3,4
8,2006,381200,12,11,1,5
9,2006,381200,18,16,2,3
10,2006,381200,22,20,2,6
11,2006,381200,17,15,2,2
12,2006,381200,10,10,0,3
1,2007,381200,9,6,3,5
2,2007,381200,5,2,3,3
3,2007,381200,12,7,5,4
4,2007,381200,17,14,3,3
5,2007,381200,18,15,3,3
6,2007,381200,14,12,2,1
7,2007,381200,21,18,3,3
8,2007,381200,18,13,5,3
9,2007,381200,15,12,3,3
10,2007,381200,16,14,2,4
11,2007,381200,21,16,5,10
12,2007,381200,12,10,2,6
1,2008,381200,20,18,2,4
2,2008,381200,13,8,5,1
3,2008,381200,11,8,3,2
4,2008,381200,15,13,2,9
5,2008,381200,13,10,3,1
6,2008,381200,14,9,5,5
7,2008,381200,19,17,2,1
8,2008,381200,22,18,4,7
9,2008,381200,18,16,2,5
10,2008,381200,13,12,1,4
11,2008,381200,11,8,3,2
12,2008,381200,12,12,0,1
1,2009,381200,12,9,3,3
2,2009,381200,14,12,2,3
3,2009,381200,18,15,3,4
4,2009,381200,13,11,2,6
5,2009,381200,15,14,1,7
6,2009,381200,13,12,1,7
7,2009,381200,16,14,2,0
8,2009,381200,20,15,5,4
9,2009,381200,18,13,5,6
10,2009,381200,14,14,0,3
11,2009,381200,10,9,1,1
12,2009,381200,21,19,2,9
1,2010,381200,9,9,0,1
2,2010,381200,8,8,0,3
3,2010,381200,13,12,1,3
4,2010,381200,17,14,3,2
5,2010,381200,18,17,1,2
6,2010,381200,19,12,7,5
7,2010,381200,7,7,0,0
8,2010,381200,15,12,3,1
9,2010,381200,8,7,1,9
10,2010,381200,14,14,0,3
11,2010,381200,17,15,2,7
12,2010,381200,13,12,1,0
1,2011,381200,11,9,2,8
2,2011,381200,10,10,0,1
1,1999,570100,40,37,3,4
2,1999,570100,28,27,1,2
3,1999,570100,25,24,1,3
4,1999,570100,36,35,1,0
5,1999,570100,44,43,1,0
6,1999,570100,41,39,2,0
7,1999,570100,24,22,2,1
8,1999,570100,28,26,2,1
9,1999,570100,36,34,2,1
10,1999,570100,30,26,4,0
11,1999,570100,38,37,1,1
12,1999,570100,51,49,2,1
1,2000,570100,27,25,2,2
2,2000,570100,32,29,3,3
3,2000,570100,29,27,2,2
4,2000,570100,36,33,3,2
5,2000,570100,29,28,1,0
6,2000,570100,32,30,2,3
7,2000,570100,37,36,1,0
8,2000,570100,24,22,2,0
9,2000,570100,36,35,1,1
10,2000,570100,20,19,1,1
11,2000,570100,19,18,1,1
12,2000,570100,33,30,3,0
1,2001,570100,25,22,3,3
2,2001,570100,15,15,0,0
3,2001,570100,17,16,1,2
4,2001,570100,12,10,2,0
5,2001,570100,13,12,1,2
6,2001,570100,21,20,1,1
7,2001,570100,18,17,1,1
8,2001,570100,25,25,0,1
9,2001,570100,27,23,4,0
10,2001,570100,28,25,3,3
11,2001,570100,26,25,1,0
12,2001,570100,19,18,1,2
1,2002,570100,16,14,2,2
2,2002,570100,18,18,0,1
3,2002,570100,24,24,0,0
4,2002,570100,26,22,4,1
5,2002,570100,23,23,0,0
6,2002,570100,12,11,1,1
7,2002,570100,17,16,1,0
8,2002,570100,17,14,3,0
9,2002,570100,13,12,1,1
10,2002,570100,22,21,1,1
11,2002,570100,12,11,1,0
12,2002,570100,16,16,0,3
1,2003,570100,19,17,2,1
2,2003,570100,17,15,2,4
3,2003,570100,17,16,1,3
4,2003,570100,8,8,0,1
5,2003,570100,19,16,3,0
6,2003,570100,23,21,2,0
7,2003,570100,12,9,3,0
8,2003,570100,12,11,1,1
9,2003,570100,11,11,0,1
10,2003,570100,13,12,1,0
11,2003,570100,14,14,0,0
12,2003,570100,10,8,2,0
1,2004,570100,18,16,2,0
2,2004,570100,11,11,0,1
3,2004,570100,20,19,1,1
4,2004,570100,17,17,0,1
5,2004,570100,19,17,2,0
6,2004,570100,16,14,2,0
7,2004,570100,26,23,3,0
8,2004,570100,21,20,1,2
9,2004,570100,25,22,3,0
10,2004,570100,24,20,4,1
11,2004,570100,21,19,2,0
12,2004,570100,22,22,0,1
1,2005,570100,17,14,3,0
2,2005,570100,14,14,0,2
3,2005,570100,14,14,0,1
4,2005,570100,27,24,3,0
5,2005,570100,18,18,0,6
6,2005,570100,22,19,3,0
7,2005,570100,20,19,1,0
8,2005,570100,14,14,0,4
9,2005,570100,22,20,2,1
10,2005,570100,24,23,1,0
11,2005,570100,17,16,1,0
12,2005,570100,22,21,1,0
1,2006,570100,29,28,1,3
2,2006,570100,24,24,0,1
3,2006,570100,29,24,5,3
4,2006,570100,29,29,0,0
5,2006,570100,23,22,1,5
6,2006,570100,16,14,2,3
7,2006,570100,17,14,3,4
8,2006,570100,14,14,0,2
9,2006,570100,23,22,1,2
10,2006,570100,15,13,2,1
11,2006,570100,22,21,1,2
12,2006,570100,22,21,1,2
1,2007,570100,21,19,2,0
2,2007,570100,15,15,0,4
3,2007,570100,22,19,3,4
4,2007,570100,17,16,1,3
5,2007,570100,14,14,0,3
6,2007,570100,23,21,2,2
7,2007,570100,13,13,0,2
8,2007,570100,19,17,2,2
9,2007,570100,27,24,3,2
10,2007,570100,23,20,3,2
11,2007,570100,22,19,3,2
12,2007,570100,23,22,1,3
1,2008,570100,16,15,1,1
2,2008,570100,15,14,1,2
3,2008,570100,22,21,1,0
4,2008,570100,17,17,0,7
5,2008,570100,16,16,0,4
6,2008,570100,15,13,2,0
7,2008,570100,17,14,3,2
8,2008,570100,17,15,2,4
9,2008,570100,17,14,3,1
10,2008,570100,21,20,1,2
11,2008,570100,21,21,0,1
12,2008,570100,25,25,0,3
1,2009,570100,18,16,2,1
2,2009,570100,20,19,1,1
3,2009,570100,25,25,0,0
4,2009,570100,26,24,2,3
5,2009,570100,20,18,2,2
6,2009,570100,21,18,3,1
7,2009,570100,23,22,1,1
8,2009,570100,22,21,1,1
9,2009,570100,16,14,2,1
10,2009,570100,16,15,1,2
11,2009,570100,15,15,0,5
12,2009,570100,16,15,1,0
1,2010,570100,14,13,1,2
2,2010,570100,16,14,2,2
3,2010,570100,16,16,0,1
4,2010,570100,16,15,1,1
5,2010,570100,19,18,1,1
6,2010,570100,12,10,2,0
7,2010,570100,15,14,1,0
8,2010,570100,11,9,2,1
9,2010,570100,17,16,1,2
10,2010,570100,13,10,3,2
11,2010,570100,17,17,0,3
12,2010,570100,21,21,0,1
1,2011,570100,7,7,0,2
2,2011,570100,14,13,1,2
1,1999,835800,8,7,1,0
2,1999,835800,5,3,2,1
3,1999,835800,14,12,2,1
4,1999,835800,4,3,1,1
5,1999,835800,16,11,5,3
6,1999,835800,19,18,1,0
7,1999,835800,17,12,5,0
8,1999,835800,12,10,2,5
9,1999,835800,16,11,5,1
10,1999,835800,10,9,1,2
11,1999,835800,9,8,1,1
12,1999,835800,12,8,4,1
1,2000,835800,8,7,1,1
2,2000,835800,8,7,1,1
3,2000,835800,17,13,4,1
4,2000,835800,10,9,1,1
5,2000,835800,14,11,3,1
6,2000,835800,16,12,4,2
7,2000,835800,17,12,5,2
8,2000,835800,10,8,2,0
9,2000,835800,11,9,2,4
10,2000,835800,12,8,4,1
11,2000,835800,13,11,2,2
12,2000,835800,7,7,0,3
1,2001,835800,9,8,1,9
2,2001,835800,7,5,2,5
3,2001,835800,14,11,3,5
4,2001,835800,8,7,1,3
5,2001,835800,6,4,2,0
6,2001,835800,13,11,2,1
7,2001,835800,11,9,2,1
8,2001,835800,5,3,2,2
9,2001,835800,7,6,1,2
10,2001,835800,10,8,2,2
11,2001,835800,9,7,2,2
12,2001,835800,9,8,1,8
1,2002,835800,6,4,2,0
2,2002,835800,13,12,1,0
3,2002,835800,11,9,2,1
4,2002,835800,19,19,0,3
5,2002,835800,12,8,4,3
6,2002,835800,16,14,2,0
7,2002,835800,8,8,0,1
8,2002,835800,14,13,1,1
9,2002,835800,12,9,3,2
10,2002,835800,14,11,3,1
11,2002,835800,14,12,2,1
12,2002,835800,13,12,1,0
1,2003,835800,15,8,7,1
2,2003,835800,10,9,1,0
3,2003,835800,8,6,2,2
4,2003,835800,13,9,4,2
5,2003,835800,8,7,1,0
6,2003,835800,12,11,1,0
7,2003,835800,4,4,0,3
8,2003,835800,12,8,4,1
9,2003,835800,11,9,2,1
10,2003,835800,14,14,0,0
11,2003,835800,23,18,5,0
12,2003,835800,21,19,2,3
1,2004,835800,7,7,0,2
2,2004,835800,9,8,1,2
3,2004,835800,22,20,2,2
4,2004,835800,16,11,5,1
5,2004,835800,9,8,1,4
6,2004,835800,7,6,1,0
7,2004,835800,10,9,1,0
8,2004,835800,19,16,3,1
9,2004,835800,18,17,1,0
10,2004,835800,9,8,1,0
11,2004,835800,10,7,3,0
12,2004,835800,14,9,5,2
1,2005,835800,7,5,2,1
2,2005,835800,11,8,3,1
3,2005,835800,10,9,1,1
4,2005,835800,16,14,2,0
5,2005,835800,11,11,0,0
6,2005,835800,4,4,0,2
7,2005,835800,12,11,1,1
8,2005,835800,13,12,1,1
9,2005,835800,12,11,1,0
10,2005,835800,11,10,1,0
11,2005,835800,6,3,3,2
12,2005,835800,6,5,1,0
1,2006,835800,7,7,0,0
2,2006,835800,8,7,1,0
3,2006,835800,6,5,1,1
4,2006,835800,14,13,1,1
5,2006,835800,9,8,1,0
6,2006,835800,3,2,1,0
7,2006,835800,16,14,2,0
8,2006,835800,11,10,1,2
9,2006,835800,8,7,1,1
10,2006,835800,8,8,0,1
11,2006,835800,6,5,1,0
12,2006,835800,2,2,0,0
1,2007,835800,10,8,2,1
2,2007,835800,7,5,2,1
3,2007,835800,4,3,1,0
4,2007,835800,8,5,3,1
5,2007,835800,10,8,2,0
6,2007,835800,18,11,7,1
7,2007,835800,11,9,2,0
8,2007,835800,9,7,2,0
9,2007,835800,5,5,0,3
10,2007,835800,10,9,1,3
11,2007,835800,1,1,0,2
12,2007,835800,5,5,0,2
1,2008,835800,3,3,0,0
2,2008,835800,1,0,1,0
3,2008,835800,6,4,2,0
4,2008,835800,5,4,1,0
5,2008,835800,8,8,0,1
6,2008,835800,4,4,0,1
7,2008,835800,6,5,1,0
8,2008,835800,15,11,4,1
9,2008,835800,11,11,0,1
10,2008,835800,9,9,0,0
11,2008,835800,13,11,2,1
12,2008,835800,11,10,1,1
1,2009,835800,8,7,1,0
2,2009,835800,11,10,1,2
3,2009,835800,9,9,0,3
4,2009,835800,5,4,1,4
5,2009,835800,1,0,1,0
6,2009,835800,11,9,2,2
7,2009,835800,16,15,1,0
8,2009,835800,10,8,2,1
9,2009,835800,3,3,0,0
10,2009,835800,8,8,0,0
11,2009,835800,7,7,0,0
12,2009,835800,8,8,0,1
1,2010,835800,5,5,0,1
2,2010,835800,7,7,0,0
3,2010,835800,5,4,1,0
4,2010,835800,5,4,1,0
5,2010,835800,8,7,1,4
6,2010,835800,4,4,0,3
7,2010,835800,11,11,0,1
8,2010,835800,9,9,0,1
9,2010,835800,5,5,0,1
10,2010,835800,11,10,1,5
11,2010,835800,8,8,0,2
12,2010,835800,4,4,0,1
1,2011,835800,4,4,0,4
2,2011,835800,8,7,1,0
1,1999,560200,10,8,2,14
2,1999,560200,10,9,1,6
3,1999,560200,19,11,8,20
4,1999,560200,22,18,4,16
5,1999,560200,30,16,14,14
6,1999,560200,22,22,0,11
7,1999,560200,21,15,6,15
8,1999,560200,15,7,8,7
9,1999,560200,13,10,3,10
10,1999,560200,18,15,3,25
11,1999,560200,12,8,4,29
12,1999,560200,9,5,4,19
1,2000,560200,14,12,2,18
2,2000,560200,15,7,8,11
3,2000,560200,15,12,3,3
4,2000,560200,18,13,5,8
5,2000,560200,20,13,7,9
6,2000,560200,21,13,8,6
7,2000,560200,21,14,7,0
8,2000,560200,21,16,5,3
9,2000,560200,19,12,7,6
10,2000,560200,22,19,3,13
11,2000,560200,27,18,9,8
12,2000,560200,8,7,1,3
1,2001,560200,8,6,2,5
2,2001,560200,12,5,7,5
3,2001,560200,21,15,6,8
4,2001,560200,13,7,6,10
5,2001,560200,9,6,3,7
6,2001,560200,16,7,9,9
7,2001,560200,7,3,4,10
8,2001,560200,15,12,3,7
9,2001,560200,15,9,6,5
10,2001,560200,13,9,4,11
11,2001,560200,12,7,5,10
12,2001,560200,10,7,3,5
1,2002,560200,8,3,5,10
2,2002,560200,9,7,2,4
3,2002,560200,11,7,4,8
4,2002,560200,11,7,4,5
5,2002,560200,15,10,5,2
6,2002,560200,15,9,6,5
7,2002,560200,24,20,4,2
8,2002,560200,18,12,6,4
9,2002,560200,18,11,7,4
10,2002,560200,19,12,7,7
11,2002,560200,16,12,4,14
12,2002,560200,13,12,1,14
1,2003,560200,4,4,0,7
2,2003,560200,15,10,5,9
3,2003,560200,16,15,1,5
4,2003,560200,13,13,0,4
5,2003,560200,18,14,4,6
6,2003,560200,18,14,4,7
7,2003,560200,14,12,2,6
8,2003,560200,20,15,5,3
9,2003,560200,17,14,3,3
10,2003,560200,20,15,5,3
11,2003,560200,12,12,0,1
12,2003,560200,12,10,2,2
1,2004,560200,19,15,4,11
2,2004,560200,9,7,2,11
3,2004,560200,17,12,5,9
4,2004,560200,14,10,4,5
5,2004,560200,15,15,0,2
6,2004,560200,16,9,7,17
7,2004,560200,23,19,4,13
8,2004,560200,12,7,5,4
9,2004,560200,11,8,3,3
10,2004,560200,13,9,4,4
11,2004,560200,12,8,4,9
12,2004,560200,12,8,4,8
1,2005,560200,9,8,1,8
2,2005,560200,7,3,4,8
3,2005,560200,12,9,3,6
4,2005,560200,17,12,5,9
5,2005,560200,10,6,4,8
6,2005,560200,10,3,7,6
7,2005,560200,18,10,8,6
8,2005,560200,13,11,2,15
9,2005,560200,10,6,4,9
10,2005,560200,10,7,3,6
11,2005,560200,9,9,0,5
12,2005,560200,10,10,0,10
1,2006,560200,12,11,1,7
2,2006,560200,7,5,2,4
3,2006,560200,5,5,0,8
4,2006,560200,8,4,4,3
5,2006,560200,7,4,3,6
6,2006,560200,9,6,3,4
7,2006,560200,8,7,1,2
8,2006,560200,5,3,2,4
9,2006,560200,6,3,3,5
10,2006,560200,15,13,2,4
11,2006,560200,9,5,4,6
12,2006,560200,4,3,1,1
1,2007,560200,10,8,2,11
2,2007,560200,6,5,1,6
3,2007,560200,10,9,1,4
4,2007,560200,8,2,6,2
5,2007,560200,8,7,1,3
6,2007,560200,8,5,3,1
7,2007,560200,14,10,4,5
8,2007,560200,9,8,1,0
9,2007,560200,10,10,0,1
10,2007,560200,13,8,5,6
11,2007,560200,6,4,2,4
12,2007,560200,10,8,2,5
1,2008,560200,7,4,3,3
2,2008,560200,11,9,2,0
3,2008,560200,9,7,2,5
4,2008,560200,10,7,3,10
5,2008,560200,10,8,2,5
6,2008,560200,5,2,3,3
7,2008,560200,13,6,7,10
8,2008,560200,13,7,6,6
9,2008,560200,12,8,4,7
10,2008,560200,13,5,8,1
11,2008,560200,7,5,2,3
12,2008,560200,14,11,3,12
1,2009,560200,7,5,2,7
2,2009,560200,5,5,0,5
3,2009,560200,6,3,3,9
4,2009,560200,10,6,4,1
5,2009,560200,12,10,2,2
6,2009,560200,9,6,3,1
7,2009,560200,9,5,4,11
8,2009,560200,4,2,2,6
9,2009,560200,1,1,0,5
10,2009,560200,6,6,0,1
11,2009,560200,5,5,0,7
12,2009,560200,9,9,0,3
1,2010,560200,4,4,0,2
2,2010,560200,2,2,0,4
3,2010,560200,3,3,0,3
4,2010,560200,3,2,1,8
5,2010,560200,2,1,1,11
6,2010,560200,2,2,0,3
7,2010,560200,2,2,0,3
8,2010,560200,5,4,1,5
9,2010,560200,2,1,1,4
10,2010,560200,7,4,3,2
11,2010,560200,2,1,1,5
12,2010,560200,4,4,0,4
1,2011,560200,0,0,0,2
2,2011,560200,3,3,0,4
1,1999,560100,7,7,0,3
2,1999,560100,9,8,1,3
3,1999,560100,6,5,1,3
4,1999,560100,3,2,1,4
5,1999,560100,3,3,0,2
6,1999,560100,13,11,2,1
7,1999,560100,7,5,2,2
8,1999,560100,9,8,1,5
9,1999,560100,3,3,0,5
10,1999,560100,14,13,1,5
11,1999,560100,3,3,0,6
12,1999,560100,8,8,0,5
1,2000,560100,2,1,1,7
2,2000,560100,6,4,2,5
3,2000,560100,5,5,0,1
4,2000,560100,16,16,0,2
5,2000,560100,6,5,1,2
6,2000,560100,9,8,1,3
7,2000,560100,11,10,1,0
8,2000,560100,16,13,3,2
9,2000,560100,3,3,0,2
10,2000,560100,14,13,1,2
11,2000,560100,3,2,1,4
12,2000,560100,3,3,0,3
1,2001,560100,9,7,2,3
2,2001,560100,5,4,1,1
3,2001,560100,9,9,0,2
4,2001,560100,3,1,2,4
5,2001,560100,10,10,0,3
6,2001,560100,10,8,2,6
7,2001,560100,12,5,7,3
8,2001,560100,13,11,2,6
9,2001,560100,10,9,1,3
10,2001,560100,13,12,1,1
11,2001,560100,7,6,1,3
12,2001,560100,6,4,2,0
1,2002,560100,6,4,2,2
2,2002,560100,9,8,1,0
3,2002,560100,5,4,1,1
4,2002,560100,5,4,1,1
5,2002,560100,9,8,1,2
6,2002,560100,17,12,5,2
7,2002,560100,15,9,6,1
8,2002,560100,8,7,1,1
9,2002,560100,6,4,2,0
10,2002,560100,7,6,1,4
11,2002,560100,9,6,3,4
12,2002,560100,11,11,0,0
1,2003,560100,6,6,0,2
2,2003,560100,4,2,2,3
3,2003,560100,7,6,1,2
4,2003,560100,8,7,1,2
5,2003,560100,20,17,3,10
6,2003,560100,10,9,1,1
7,2003,560100,7,6,1,2
8,2003,560100,5,5,0,6
9,2003,560100,10,10,0,8
10,2003,560100,14,13,1,7
11,2003,560100,17,17,0,2
12,2003,560100,5,5,0,1
1,2004,560100,8,7,1,4
2,2004,560100,4,3,1,2
3,2004,560100,5,5,0,1
4,2004,560100,8,7,1,2
5,2004,560100,7,7,0,1
6,2004,560100,12,12,0,5
7,2004,560100,19,18,1,4
8,2004,560100,13,8,5,3
9,2004,560100,6,3,3,5
10,2004,560100,8,7,1,0
11,2004,560100,9,9,0,0
12,2004,560100,9,6,3,6
1,2005,560100,5,5,0,3
2,2005,560100,8,8,0,4
3,2005,560100,7,7,0,7
4,2005,560100,12,12,0,6
5,2005,560100,7,6,1,2
6,2005,560100,10,9,1,3
7,2005,560100,11,7,4,4
8,2005,560100,8,7,1,3
9,2005,560100,5,5,0,4
10,2005,560100,7,6,1,1
11,2005,560100,7,4,3,1
12,2005,560100,4,4,0,1
1,2006,560100,10,9,1,4
2,2006,560100,6,5,1,0
3,2006,560100,9,9,0,4
4,2006,560100,7,6,1,2
5,2006,560100,8,7,1,1
6,2006,560100,7,5,2,0
7,2006,560100,6,4,2,3
8,2006,560100,9,6,3,5
9,2006,560100,3,3,0,3
10,2006,560100,6,5,1,1
11,2006,560100,8,6,2,3
12,2006,560100,3,3,0,4
1,2007,560100,5,5,0,0
2,2007,560100,7,7,0,2
3,2007,560100,3,3,0,0
4,2007,560100,8,8,0,1
5,2007,560100,8,5,3,1
6,2007,560100,5,4,1,1
7,2007,560100,11,9,2,5
8,2007,560100,9,6,3,2
9,2007,560100,10,9,1,1
10,2007,560100,12,11,1,3
11,2007,560100,9,9,0,0
12,2007,560100,11,10,1,1
1,2008,560100,10,10,0,1
2,2008,560100,6,6,0,2
3,2008,560100,5,5,0,0
4,2008,560100,3,3,0,0
5,2008,560100,4,4,0,4
6,2008,560100,8,6,2,0
7,2008,560100,4,4,0,4
8,2008,560100,6,6,0,3
9,2008,560100,9,8,1,0
10,2008,560100,10,8,2,3
11,2008,560100,9,6,3,5
12,2008,560100,9,7,2,0
1,2009,560100,6,6,0,0
2,2009,560100,4,4,0,2
3,2009,560100,8,7,1,3
4,2009,560100,3,3,0,1
5,2009,560100,8,8,0,4
6,2009,560100,6,5,1,2
7,2009,560100,2,2,0,1
8,2009,560100,2,2,0,2
9,2009,560100,1,1,0,0
10,2009,560100,3,3,0,1
11,2009,560100,5,5,0,0
12,2009,560100,6,6,0,1
1,2010,560100,6,6,0,0
2,2010,560100,4,4,0,0
3,2010,560100,0,0,0,2
4,2010,560100,5,3,2,0
5,2010,560100,3,3,0,1
6,2010,560100,0,0,0,0
7,2010,560100,3,3,0,0
8,2010,560100,2,2,0,1
9,2010,560100,4,4,0,0
10,2010,560100,6,6,0,0
11,2010,560100,4,4,0,1
12,2010,560100,5,4,1,2
1,2011,560100,7,7,0,2
2,2011,560100,4,4,0,1
1,1999,570200,16,16,0,4
2,1999,570200,12,11,1,3
3,1999,570200,16,14,2,1
4,1999,570200,13,12,1,5
5,1999,570200,19,16,3,2
6,1999,570200,15,14,1,0
7,1999,570200,12,11,1,1
8,1999,570200,13,13,0,2
9,1999,570200,16,16,0,1
10,1999,570200,10,10,0,0
11,1999,570200,20,19,1,4
12,1999,570200,11,10,1,2
1,2000,570200,12,11,1,2
2,2000,570200,13,10,3,3
3,2000,570200,16,15,1,3
4,2000,570200,14,13,1,1
5,2000,570200,16,15,1,1
6,2000,570200,12,10,2,0
7,2000,570200,13,13,0,3
8,2000,570200,18,16,2,1
9,2000,570200,12,12,0,1
10,2000,570200,20,18,2,1
11,2000,570200,17,16,1,2
12,2000,570200,9,8,1,3
1,2001,570200,14,13,1,1
2,2001,570200,11,11,0,2
3,2001,570200,20,18,2,4
4,2001,570200,9,9,0,2
5,2001,570200,14,14,0,2
6,2001,570200,10,9,1,2
7,2001,570200,13,8,5,7
8,2001,570200,10,9,1,6
9,2001,570200,9,7,2,5
10,2001,570200,19,18,1,3
11,2001,570200,14,14,0,4
12,2001,570200,15,13,2,1
1,2002,570200,11,9,2,4
2,2002,570200,14,12,2,2
3,2002,570200,21,20,1,3
4,2002,570200,12,9,3,3
5,2002,570200,15,14,1,3
6,2002,570200,19,18,1,1
7,2002,570200,21,20,1,1
8,2002,570200,14,13,1,4
9,2002,570200,13,12,1,1
10,2002,570200,17,14,3,3
11,2002,570200,12,11,1,1
12,2002,570200,21,19,2,2
1,2003,570200,16,15,1,10
2,2003,570200,12,12,0,2
3,2003,570200,15,13,2,3
4,2003,570200,22,19,3,6
5,2003,570200,18,16,2,1
6,2003,570200,13,12,1,2
7,2003,570200,23,22,1,0
8,2003,570200,15,15,0,3
9,2003,570200,28,26,2,0
10,2003,570200,22,21,1,6
11,2003,570200,19,18,1,2
12,2003,570200,10,10,0,0
1,2004,570200,9,9,0,2
2,2004,570200,16,15,1,6
3,2004,570200,14,14,0,4
4,2004,570200,9,9,0,0
5,2004,570200,13,12,1,5
6,2004,570200,16,15,1,3
7,2004,570200,14,12,2,6
8,2004,570200,23,18,5,4
9,2004,570200,12,11,1,5
10,2004,570200,19,18,1,0
11,2004,570200,18,18,0,1
12,2004,570200,15,15,0,1
1,2005,570200,9,9,0,4
2,2005,570200,10,8,2,5
3,2005,570200,18,17,1,0
4,2005,570200,18,18,0,3
5,2005,570200,10,10,0,3
6,2005,570200,11,10,1,3
7,2005,570200,17,17,0,2
8,2005,570200,11,10,1,5
9,2005,570200,18,16,2,12
10,2005,570200,9,9,0,7
11,2005,570200,18,18,0,3
12,2005,570200,14,14,0,1
1,2006,570200,20,19,1,5
2,2006,570200,5,5,0,3
3,2006,570200,17,15,2,7
4,2006,570200,15,13,2,1
5,2006,570200,16,14,2,4
6,2006,570200,11,11,0,0
7,2006,570200,17,15,2,3
8,2006,570200,16,15,1,1
9,2006,570200,6,6,0,1
10,2006,570200,17,15,2,3
11,2006,570200,15,14,1,1
12,2006,570200,21,20,1,2
1,2007,570200,16,16,0,2
2,2007,570200,10,10,0,4
3,2007,570200,6,6,0,1
4,2007,570200,17,16,1,1
5,2007,570200,15,13,2,2
6,2007,570200,16,16,0,2
7,2007,570200,14,14,0,2
8,2007,570200,18,15,3,1
9,2007,570200,21,19,2,5
10,2007,570200,21,17,4,4
11,2007,570200,13,11,2,2
12,2007,570200,16,15,1,1
1,2008,570200,14,13,1,4
2,2008,570200,17,14,3,3
3,2008,570200,18,16,2,5
4,2008,570200,15,12,3,3
5,2008,570200,8,8,0,5
6,2008,570200,13,11,2,2
7,2008,570200,14,12,2,5
8,2008,570200,12,11,1,2
9,2008,570200,8,8,0,0
10,2008,570200,13,13,0,0
11,2008,570200,10,10,0,1
12,2008,570200,15,15,0,1
1,2009,570200,9,9,0,0
2,2009,570200,15,14,1,4
3,2009,570200,9,8,1,1
4,2009,570200,12,10,2,1
5,2009,570200,5,4,1,4
6,2009,570200,10,10,0,1
7,2009,570200,11,11,0,1
8,2009,570200,15,14,1,6
9,2009,570200,17,16,1,0
10,2009,570200,13,12,1,0
11,2009,570200,7,6,1,3
12,2009,570200,14,11,3,1
1,2010,570200,8,8,0,4
2,2010,570200,11,11,0,1
3,2010,570200,11,11,0,0
4,2010,570200,16,15,1,0
5,2010,570200,11,11,0,5
6,2010,570200,5,2,3,0
7,2010,570200,8,8,0,0
8,2010,570200,16,15,1,0
9,2010,570200,13,13,0,0
10,2010,570200,9,7,2,0
11,2010,570200,12,12,0,2
12,2010,570200,8,7,1,1
1,2011,570200,13,13,0,5
2,2011,570200,3,2,1,0
1,1999,842600,43,39,4,4
2,1999,842600,41,34,7,7
3,1999,842600,40,30,10,6
4,1999,842600,59,55,4,4
5,1999,842600,66,64,2,6
6,1999,842600,54,44,10,5
7,1999,842600,56,50,6,5
8,1999,842600,62,55,7,3
9,1999,842600,38,32,6,5
10,1999,842600,39,32,7,3
11,1999,842600,38,34,4,6
12,1999,842600,59,51,8,2
1,2000,842600,67,61,6,4
2,2000,842600,40,35,5,11
3,2000,842600,44,40,4,3
4,2000,842600,49,47,2,5
5,2000,842600,57,52,5,7
6,2000,842600,58,51,7,5
7,2000,842600,63,56,7,6
8,2000,842600,73,66,7,5
9,2000,842600,53,48,5,5
10,2000,842600,45,40,5,3
11,2000,842600,40,39,1,4
12,2000,842600,33,32,1,0
1,2001,842600,34,28,6,2
2,2001,842600,38,36,2,4
3,2001,842600,22,21,1,7
4,2001,842600,35,33,2,7
5,2001,842600,36,33,3,12
6,2001,842600,38,33,5,9
7,2001,842600,40,31,9,5
8,2001,842600,48,43,5,8
9,2001,842600,43,40,3,4
10,2001,842600,57,56,1,5
11,2001,842600,68,62,6,2
12,2001,842600,44,37,7,3
1,2002,842600,36,27,9,2
2,2002,842600,25,24,1,5
3,2002,842600,29,24,5,8
4,2002,842600,38,34,4,10
5,2002,842600,32,25,7,3
6,2002,842600,39,31,8,8
7,2002,842600,44,35,9,11
8,2002,842600,38,37,1,6
9,2002,842600,32,28,4,5
10,2002,842600,39,34,5,2
11,2002,842600,28,25,3,3
12,2002,842600,36,33,3,6
1,2003,842600,32,29,3,1
2,2003,842600,21,18,3,4
3,2003,842600,39,37,2,8
4,2003,842600,26,20,6,3
5,2003,842600,41,33,8,5
6,2003,842600,33,30,3,4
7,2003,842600,28,22,6,6
8,2003,842600,39,36,3,6
9,2003,842600,33,28,5,2
10,2003,842600,59,53,6,3
11,2003,842600,39,36,3,4
12,2003,842600,26,22,4,4
1,2004,842600,31,25,6,1
2,2004,842600,35,32,3,1
3,2004,842600,36,30,6,2
4,2004,842600,28,23,5,5
5,2004,842600,34,28,6,6
6,2004,842600,25,21,4,4
7,2004,842600,36,34,2,1
8,2004,842600,36,30,6,2
9,2004,842600,29,25,4,3
10,2004,842600,28,25,3,5
11,2004,842600,31,29,2,6
12,2004,842600,28,27,1,3
1,2005,842600,22,17,5,2
2,2005,842600,19,15,4,5
3,2005,842600,26,23,3,5
4,2005,842600,25,23,2,5
5,2005,842600,23,16,7,7
6,2005,842600,29,25,4,6
7,2005,842600,23,17,6,6
8,2005,842600,37,35,2,5
9,2005,842600,31,27,4,6
10,2005,842600,33,30,3,4
11,2005,842600,30,28,2,3
12,2005,842600,29,28,1,3
1,2006,842600,28,23,5,3
2,2006,842600,19,14,5,4
3,2006,842600,22,19,3,3
4,2006,842600,30,28,2,5
5,2006,842600,34,29,5,0
6,2006,842600,30,25,5,9
7,2006,842600,34,30,4,3
8,2006,842600,38,37,1,3
9,2006,842600,36,30,6,7
10,2006,842600,33,27,6,2
11,2006,842600,40,35,5,2
12,2006,842600,32,27,5,6
1,2007,842600,24,21,3,10
2,2007,842600,25,21,4,4
3,2007,842600,38,36,2,5
4,2007,842600,25,24,1,4
5,2007,842600,23,18,5,1
6,2007,842600,33,27,6,4
7,2007,842600,27,23,4,3
8,2007,842600,32,29,3,6
9,2007,842600,28,24,4,3
10,2007,842600,39,30,9,7
11,2007,842600,47,42,5,8
12,2007,842600,30,27,3,2
1,2008,842600,34,34,0,1
2,2008,842600,26,22,4,3
3,2008,842600,34,32,2,12
4,2008,842600,40,32,8,4
5,2008,842600,33,27,6,5
6,2008,842600,39,35,4,4
7,2008,842600,25,23,2,9
8,2008,842600,49,44,5,4
9,2008,842600,56,49,7,3
10,2008,842600,34,33,1,5
11,2008,842600,43,40,3,2
12,2008,842600,31,29,2,4
1,2009,842600,34,32,2,8
2,2009,842600,23,19,4,6
3,2009,842600,31,28,3,5
4,2009,842600,30,28,2,4
5,2009,842600,40,35,5,3
6,2009,842600,40,36,4,8
7,2009,842600,33,29,4,5
8,2009,842600,33,27,6,4
9,2009,842600,28,22,6,4
10,2009,842600,26,22,4,5
11,2009,842600,23,21,2,5
12,2009,842600,36,33,3,5
1,2010,842600,34,32,2,6
2,2010,842600,34,29,5,0
3,2010,842600,39,38,1,9
4,2010,842600,59,52,7,6
5,2010,842600,41,40,1,2
6,2010,842600,55,52,3,3
7,2010,842600,51,49,2,4
8,2010,842600,56,55,1,7
9,2010,842600,47,46,1,4
10,2010,842600,43,38,5,2
11,2010,842600,38,33,5,4
12,2010,842600,44,42,2,4
1,2011,842600,29,26,3,3
2,2011,842600,23,21,2,3
1,1999,580400,25,24,1,6
2,1999,580400,32,31,1,5
3,1999,580400,35,33,2,8
4,1999,580400,23,21,2,5
5,1999,580400,35,34,1,5
6,1999,580400,42,42,0,1
7,1999,580400,33,30,3,1
8,1999,580400,40,39,1,3
9,1999,580400,37,30,7,3
10,1999,580400,36,36,0,5
11,1999,580400,39,38,1,0
12,1999,580400,38,36,2,0
1,2000,580400,29,28,1,3
2,2000,580400,19,18,1,2
3,2000,580400,20,19,1,0
4,2000,580400,25,24,1,2
5,2000,580400,23,21,2,3
6,2000,580400,40,38,2,1
7,2000,580400,37,30,7,5
8,2000,580400,34,31,3,6
9,2000,580400,35,31,4,2
10,2000,580400,32,28,4,2
11,2000,580400,30,26,4,1
12,2000,580400,35,34,1,2
1,2001,580400,35,31,4,6
2,2001,580400,21,18,3,6
3,2001,580400,27,26,1,14
4,2001,580400,32,29,3,12
5,2001,580400,29,26,3,7
6,2001,580400,34,28,6,5
7,2001,580400,22,18,4,3
8,2001,580400,21,20,1,4
9,2001,580400,28,25,3,4
10,2001,580400,18,14,4,6
11,2001,580400,29,25,4,4
12,2001,580400,16,15,1,2
1,2002,580400,23,19,4,4
2,2002,580400,26,23,3,6
3,2002,580400,20,19,1,5
4,2002,580400,19,17,2,2
5,2002,580400,20,20,0,4
6,2002,580400,21,19,2,9
7,2002,580400,29,24,5,1
8,2002,580400,29,25,4,7
9,2002,580400,29,28,1,5
10,2002,580400,19,18,1,11
11,2002,580400,30,29,1,7
12,2002,580400,23,20,3,4
1,2003,580400,14,13,1,1
2,2003,580400,20,20,0,7
3,2003,580400,26,24,2,7
4,2003,580400,21,20,1,5
5,2003,580400,20,20,0,10
6,2003,580400,20,19,1,10
7,2003,580400,27,24,3,3
8,2003,580400,40,38,2,10
9,2003,580400,25,23,2,4
10,2003,580400,32,32,0,2
11,2003,580400,26,24,2,5
12,2003,580400,25,23,2,2
1,2004,580400,14,14,0,1
2,2004,580400,21,21,0,7
3,2004,580400,19,17,2,10
4,2004,580400,23,22,1,8
5,2004,580400,22,19,3,4
6,2004,580400,25,23,2,4
7,2004,580400,22,18,4,6
8,2004,580400,30,29,1,4
9,2004,580400,23,23,0,1
10,2004,580400,28,25,3,2
11,2004,580400,24,20,4,2
12,2004,580400,21,21,0,1
1,2005,580400,20,18,2,4
2,2005,580400,24,24,0,7
3,2005,580400,24,23,1,2
4,2005,580400,28,26,2,4
5,2005,580400,25,20,5,3
6,2005,580400,23,21,2,6
7,2005,580400,28,24,4,1
8,2005,580400,23,20,3,1
9,2005,580400,22,20,2,6
10,2005,580400,26,24,2,4
11,2005,580400,25,23,2,0
12,2005,580400,29,26,3,1
1,2006,580400,26,22,4,3
2,2006,580400,15,13,2,5
3,2006,580400,22,19,3,1
4,2006,580400,21,19,2,5
5,2006,580400,30,23,7,3
6,2006,580400,20,19,1,2
7,2006,580400,33,28,5,1
8,2006,580400,27,23,4,1
9,2006,580400,30,28,2,3
10,2006,580400,22,20,2,0
11,2006,580400,26,26,0,4
12,2006,580400,27,25,2,3
1,2007,580400,11,11,0,4
2,2007,580400,17,15,2,3
3,2007,580400,20,18,2,3
4,2007,580400,21,21,0,3
5,2007,580400,18,17,1,1
6,2007,580400,19,14,5,7
7,2007,580400,22,19,3,4
8,2007,580400,27,26,1,3
9,2007,580400,21,16,5,2
10,2007,580400,28,26,2,4
11,2007,580400,21,19,2,2
12,2007,580400,22,21,1,4
1,2008,580400,13,11,2,2
2,2008,580400,13,11,2,4
3,2008,580400,15,14,1,4
4,2008,580400,14,13,1,2
5,2008,580400,35,31,4,4
6,2008,580400,25,22,3,1
7,2008,580400,18,16,2,5
8,2008,580400,19,17,2,5
9,2008,580400,25,23,2,3
10,2008,580400,22,20,2,3
11,2008,580400,26,24,2,4
12,2008,580400,23,21,2,3
1,2009,580400,21,18,3,1
2,2009,580400,17,17,0,1
3,2009,580400,17,15,2,4
4,2009,580400,29,22,7,11
5,2009,580400,19,16,3,3
6,2009,580400,34,31,3,3
7,2009,580400,20,17,3,1
8,2009,580400,24,22,2,0
9,2009,580400,17,15,2,1
10,2009,580400,17,17,0,1
11,2009,580400,18,13,5,2
12,2009,580400,19,17,2,2
1,2010,580400,16,16,0,4
2,2010,580400,6,6,0,2
3,2010,580400,21,17,4,6
4,2010,580400,15,15,0,4
5,2010,580400,18,16,2,5
6,2010,580400,14,13,1,1
7,2010,580400,15,12,3,3
8,2010,580400,23,20,3,4
9,2010,580400,12,11,1,5
10,2010,580400,20,19,1,5
11,2010,580400,17,15,2,1
12,2010,580400,22,22,0,3
1,2011,580400,16,15,1,4
2,2011,580400,16,15,1,4
1,1999,580800,12,9,3,1
2,1999,580800,12,11,1,0
3,1999,580800,5,4,1,0
4,1999,580800,14,13,1,1
5,1999,580800,6,5,1,1
6,1999,580800,10,9,1,1
7,1999,580800,11,10,1,1
8,1999,580800,9,8,1,1
9,1999,580800,11,11,0,1
10,1999,580800,16,11,5,1
11,1999,580800,10,9,1,4
12,1999,580800,11,11,0,1
1,2000,580800,8,7,1,0
2,2000,580800,8,8,0,0
3,2000,580800,4,4,0,1
4,2000,580800,18,15,3,1
5,2000,580800,11,8,3,0
6,2000,580800,15,13,2,2
7,2000,580800,10,7,3,2
8,2000,580800,13,8,5,0
9,2000,580800,11,8,3,2
10,2000,580800,5,4,1,4
11,2000,580800,10,10,0,0
12,2000,580800,10,10,0,0
1,2001,580800,10,8,2,0
2,2001,580800,11,10,1,2
3,2001,580800,10,10,0,3
4,2001,580800,13,11,2,3
5,2001,580800,8,6,2,3
6,2001,580800,7,7,0,2
7,2001,580800,16,15,1,1
8,2001,580800,9,5,4,0
9,2001,580800,12,11,1,0
10,2001,580800,19,17,2,1
11,2001,580800,20,18,2,1
12,2001,580800,22,19,3,1
1,2002,580800,12,12,0,0
2,2002,580800,12,11,1,0
3,2002,580800,25,23,2,3
4,2002,580800,15,13,2,1
5,2002,580800,12,8,4,4
6,2002,580800,17,16,1,0
7,2002,580800,10,10,0,1
8,2002,580800,12,10,2,0
9,2002,580800,14,13,1,1
10,2002,580800,12,10,2,0
11,2002,580800,15,12,3,1
12,2002,580800,9,8,1,1
1,2003,580800,10,8,2,1
2,2003,580800,14,14,0,0
3,2003,580800,8,8,0,3
4,2003,580800,11,9,2,1
5,2003,580800,12,10,2,0
6,2003,580800,10,10,0,0
7,2003,580800,9,9,0,1
8,2003,580800,18,14,4,0
9,2003,580800,18,16,2,0
10,2003,580800,14,12,2,0
11,2003,580800,8,8,0,0
12,2003,580800,13,12,1,1
1,2004,580800,12,12,0,1
2,2004,580800,6,6,0,0
3,2004,580800,15,15,0,4
4,2004,580800,8,8,0,0
5,2004,580800,17,14,3,3
6,2004,580800,9,8,1,3
7,2004,580800,10,10,0,2
8,2004,580800,17,17,0,1
9,2004,580800,14,12,2,0
10,2004,580800,13,13,0,0
11,2004,580800,15,15,0,0
12,2004,580800,20,18,2,0
1,2005,580800,13,13,0,2
2,2005,580800,18,17,1,3
3,2005,580800,10,8,2,2
4,2005,580800,11,11,0,2
5,2005,580800,14,13,1,0
6,2005,580800,10,9,1,1
7,2005,580800,12,11,1,2
8,2005,580800,8,6,2,3
9,2005,580800,7,6,1,0
10,2005,580800,10,10,0,0
11,2005,580800,27,27,0,6
12,2005,580800,13,12,1,1
1,2006,580800,14,14,0,1
2,2006,580800,13,13,0,1
3,2006,580800,17,17,0,1
4,2006,580800,16,16,0,3
5,2006,580800,21,19,2,1
6,2006,580800,13,11,2,4
7,2006,580800,14,14,0,2
8,2006,580800,16,14,2,1
9,2006,580800,16,14,2,1
10,2006,580800,17,16,1,3
11,2006,580800,18,18,0,0
12,2006,580800,15,13,2,7
1,2007,580800,19,18,1,1
2,2007,580800,15,15,0,1
3,2007,580800,13,13,0,2
4,2007,580800,14,13,1,0
5,2007,580800,11,11,0,0
6,2007,580800,10,9,1,1
7,2007,580800,10,9,1,0
8,2007,580800,8,7,1,1
9,2007,580800,9,7,2,1
10,2007,580800,18,18,0,1
11,2007,580800,10,9,1,0
12,2007,580800,10,7,3,3
1,2008,580800,9,9,0,1
2,2008,580800,7,6,1,2
3,2008,580800,7,7,0,4
4,2008,580800,10,9,1,0
5,2008,580800,19,17,2,2
6,2008,580800,19,18,1,1
7,2008,580800,17,16,1,0
8,2008,580800,9,9,0,1
9,2008,580800,11,11,0,1
10,2008,580800,10,9,1,2
11,2008,580800,15,15,0,1
12,2008,580800,9,8,1,2
1,2009,580800,8,8,0,1
2,2009,580800,7,7,0,4
3,2009,580800,10,7,3,1
4,2009,580800,8,8,0,3
5,2009,580800,9,9,0,3
6,2009,580800,15,14,1,2
7,2009,580800,18,17,1,1
8,2009,580800,20,18,2,3
9,2009,580800,13,12,1,2
10,2009,580800,17,16,1,4
11,2009,580800,10,10,0,0
12,2009,580800,19,16,3,0
1,2010,580800,13,12,1,1
2,2010,580800,6,6,0,2
3,2010,580800,19,18,1,1
4,2010,580800,16,16,0,2
5,2010,580800,20,14,6,2
6,2010,580800,13,12,1,1
7,2010,580800,11,11,0,2
8,2010,580800,11,10,1,2
9,2010,580800,18,18,0,1
10,2010,580800,6,6,0,1
11,2010,580800,8,7,1,1
12,2010,580800,4,4,0,0
1,2011,580800,6,4,2,2
2,2011,580800,8,8,0,3
1,1999,610300,51,46,5,2
2,1999,610300,51,47,4,6
3,1999,610300,42,36,6,6
4,1999,610300,39,34,5,12
5,1999,610300,32,27,5,9
6,1999,610300,49,42,7,7
7,1999,610300,45,41,4,6
8,1999,610300,41,33,8,6
9,1999,610300,49,41,8,6
10,1999,610300,61,59,2,12
11,1999,610300,74,68,6,4
12,1999,610300,42,38,4,4
1,2000,610300,59,48,11,4
2,2000,610300,48,45,3,5
3,2000,610300,52,49,3,2
4,2000,610300,59,56,3,5
5,2000,610300,51,47,4,7
6,2000,610300,51,48,3,3
7,2000,610300,44,40,4,3
8,2000,610300,56,49,7,7
9,2000,610300,47,43,4,4
10,2000,610300,45,42,3,4
11,2000,610300,66,60,6,8
12,2000,610300,53,51,2,10
1,2001,610300,35,31,4,9
2,2001,610300,27,26,1,5
3,2001,610300,46,43,3,13
4,2001,610300,54,48,6,13
5,2001,610300,54,46,8,13
6,2001,610300,33,26,7,2
7,2001,610300,51,44,7,13
8,2001,610300,52,43,9,4
9,2001,610300,51,37,14,7
10,2001,610300,65,54,11,2
11,2001,610300,49,40,9,14
12,2001,610300,54,49,5,3
1,2002,610300,42,42,0,7
2,2002,610300,28,26,2,7
3,2002,610300,35,31,4,10
4,2002,610300,35,32,3,8
5,2002,610300,42,37,5,5
6,2002,610300,31,23,8,4
7,2002,610300,43,36,7,5
8,2002,610300,47,44,3,6
9,2002,610300,51,44,7,4
10,2002,610300,36,34,2,1
11,2002,610300,49,47,2,2
12,2002,610300,43,40,3,3
1,2003,610300,37,34,3,9
2,2003,610300,41,38,3,5
3,2003,610300,34,31,3,6
4,2003,610300,48,40,8,6
5,2003,610300,46,41,5,6
6,2003,610300,32,28,4,7
7,2003,610300,67,60,7,5
8,2003,610300,51,44,7,2
9,2003,610300,54,49,5,6
10,2003,610300,41,35,6,8
11,2003,610300,49,44,5,13
12,2003,610300,50,47,3,8
1,2004,610300,44,40,4,6
2,2004,610300,37,33,4,3
3,2004,610300,37,34,3,7
4,2004,610300,42,40,2,10
5,2004,610300,50,45,5,5
6,2004,610300,35,31,4,8
7,2004,610300,45,39,6,9
8,2004,610300,49,41,8,10
9,2004,610300,53,47,6,6
10,2004,610300,68,63,5,8
11,2004,610300,51,47,4,3
12,2004,610300,48,43,5,11
1,2005,610300,35,34,1,6
2,2005,610300,28,24,4,6
3,2005,610300,44,41,3,10
4,2005,610300,45,41,4,5
5,2005,610300,49,44,5,8
6,2005,610300,47,38,9,9
7,2005,610300,51,45,6,4
8,2005,610300,59,49,10,3
9,2005,610300,44,40,4,4
10,2005,610300,45,42,3,6
11,2005,610300,42,39,3,9
12,2005,610300,34,31,3,9
1,2006,610300,38,37,1,10
2,2006,610300,31,28,3,5
3,2006,610300,34,28,6,13
4,2006,610300,38,32,6,11
5,2006,610300,42,36,6,14
6,2006,610300,43,35,8,15
7,2006,610300,68,61,7,18
8,2006,610300,48,41,7,11
9,2006,610300,39,33,6,7
10,2006,610300,49,42,7,7
11,2006,610300,31,30,1,9
12,2006,610300,38,33,5,4
1,2007,610300,34,30,4,12
2,2007,610300,25,20,5,12
3,2007,610300,37,35,2,13
4,2007,610300,35,30,5,7
5,2007,610300,29,24,5,8
6,2007,610300,36,29,7,6
7,2007,610300,29,27,2,9
8,2007,610300,46,42,4,18
9,2007,610300,50,46,4,9
10,2007,610300,44,28,16,12
11,2007,610300,42,37,5,13
12,2007,610300,47,43,4,10
1,2008,610300,38,32,6,8
2,2008,610300,29,21,8,10
3,2008,610300,30,25,5,16
4,2008,610300,36,29,7,4
5,2008,610300,32,25,7,5
6,2008,610300,44,40,4,7
7,2008,610300,42,37,5,10
8,2008,610300,54,50,4,7
9,2008,610300,42,31,11,12
10,2008,610300,47,45,2,5
11,2008,610300,39,34,5,5
12,2008,610300,38,35,3,1
1,2009,610300,23,19,4,1
2,2009,610300,16,12,4,5
3,2009,610300,26,20,6,5
4,2009,610300,38,33,5,2
5,2009,610300,37,30,7,3
6,2009,610300,33,29,4,11
7,2009,610300,27,23,4,6
8,2009,610300,37,35,2,11
9,2009,610300,26,18,8,12
10,2009,610300,33,27,6,10
11,2009,610300,36,33,3,3
12,2009,610300,26,23,3,7
1,2010,610300,26,23,3,7
2,2010,610300,22,21,1,7
3,2010,610300,22,20,2,11
4,2010,610300,22,20,2,3
5,2010,610300,35,32,3,8
6,2010,610300,32,27,5,3
7,2010,610300,37,30,7,14
8,2010,610300,31,28,3,10
9,2010,610300,27,22,5,4
10,2010,610300,30,26,4,4
11,2010,610300,20,16,4,10
12,2010,610300,43,35,8,2
1,2011,610300,32,24,8,5
2,2011,610300,14,13,1,2
1,1999,610400,21,18,3,4
2,1999,610400,17,15,2,1
3,1999,610400,25,21,4,0
4,1999,610400,25,20,5,0
5,1999,610400,16,13,3,1
6,1999,610400,24,22,2,2
7,1999,610400,30,26,4,0
8,1999,610400,35,30,5,3
9,1999,610400,36,33,3,2
10,1999,610400,32,30,2,2
11,1999,610400,17,14,3,1
12,1999,610400,19,17,2,2
1,2000,610400,17,16,1,1
2,2000,610400,25,23,2,1
3,2000,610400,23,22,1,2
4,2000,610400,12,10,2,1
5,2000,610400,17,15,2,1
6,2000,610400,20,17,3,0
7,2000,610400,33,30,3,1
8,2000,610400,19,16,3,0
9,2000,610400,24,20,4,1
10,2000,610400,23,21,2,2
11,2000,610400,25,22,3,2
12,2000,610400,32,26,6,0
1,2001,610400,21,19,2,1
2,2001,610400,17,17,0,3
3,2001,610400,22,20,2,5
4,2001,610400,20,17,3,3
5,2001,610400,15,14,1,0
6,2001,610400,19,16,3,1
7,2001,610400,21,17,4,4
8,2001,610400,17,14,3,1
9,2001,610400,18,15,3,0
10,2001,610400,23,22,1,2
11,2001,610400,22,19,3,2
12,2001,610400,17,16,1,4
1,2002,610400,7,7,0,0
2,2002,610400,13,9,4,2
3,2002,610400,17,17,0,1
4,2002,610400,10,6,4,4
5,2002,610400,13,12,1,1
6,2002,610400,12,11,1,0
7,2002,610400,21,21,0,2
8,2002,610400,25,25,0,1
9,2002,610400,33,30,3,2
10,2002,610400,38,36,2,1
11,2002,610400,29,27,2,0
12,2002,610400,17,16,1,2
1,2003,610400,25,24,1,4
2,2003,610400,13,12,1,2
3,2003,610400,18,13,5,3
4,2003,610400,10,8,2,1
5,2003,610400,8,8,0,1
6,2003,610400,9,8,1,1
7,2003,610400,11,10,1,2
8,2003,610400,17,16,1,1
9,2003,610400,20,19,1,5
10,2003,610400,15,14,1,1
11,2003,610400,14,11,3,3
12,2003,610400,10,10,0,5
1,2004,610400,23,21,2,4
2,2004,610400,16,15,1,3
3,2004,610400,19,15,4,0
4,2004,610400,16,15,1,2
5,2004,610400,24,19,5,6
6,2004,610400,28,26,2,1
7,2004,610400,32,31,1,1
8,2004,610400,27,23,4,2
9,2004,610400,30,26,4,4
10,2004,610400,27,24,3,1
11,2004,610400,16,15,1,6
12,2004,610400,28,26,2,3
1,2005,610400,31,29,2,1
2,2005,610400,12,11,1,6
3,2005,610400,17,16,1,2
4,2005,610400,13,12,1,2
5,2005,610400,21,20,1,5
6,2005,610400,12,12,0,2
7,2005,610400,16,12,4,1
8,2005,610400,14,12,2,0
9,2005,610400,14,13,1,2
10,2005,610400,14,12,2,1
11,2005,610400,21,19,2,3
12,2005,610400,9,6,3,2
1,2006,610400,11,9,2,1
2,2006,610400,12,11,1,5
3,2006,610400,15,12,3,3
4,2006,610400,12,10,2,0
5,2006,610400,13,11,2,0
6,2006,610400,20,13,7,3
7,2006,610400,14,14,0,7
8,2006,610400,19,17,2,2
9,2006,610400,5,5,0,2
10,2006,610400,13,12,1,3
11,2006,610400,14,14,0,4
12,2006,610400,10,9,1,5
1,2007,610400,7,6,1,6
2,2007,610400,7,5,2,2
3,2007,610400,9,6,3,0
4,2007,610400,14,10,4,1
5,2007,610400,8,6,2,1
6,2007,610400,19,16,3,4
7,2007,610400,15,12,3,3
8,2007,610400,21,19,2,6
9,2007,610400,14,12,2,4
10,2007,610400,13,12,1,1
11,2007,610400,6,5,1,2
12,2007,610400,9,8,1,4
1,2008,610400,11,9,2,2
2,2008,610400,11,9,2,5
3,2008,610400,9,9,0,8
4,2008,610400,13,11,2,5
5,2008,610400,8,6,2,5
6,2008,610400,12,10,2,2
7,2008,610400,17,14,3,3
8,2008,610400,10,10,0,0
9,2008,610400,16,12,4,5
10,2008,610400,14,13,1,0
11,2008,610400,16,14,2,2
12,2008,610400,11,10,1,2
1,2009,610400,8,7,1,2
2,2009,610400,12,10,2,1
3,2009,610400,10,9,1,3
4,2009,610400,10,9,1,4
5,2009,610400,9,7,2,2
6,2009,610400,9,9,0,3
7,2009,610400,9,6,3,2
8,2009,610400,10,9,1,3
9,2009,610400,6,6,0,7
10,2009,610400,13,11,2,0
11,2009,610400,13,10,3,3
12,2009,610400,13,10,3,4
1,2010,610400,10,9,1,2
2,2010,610400,7,6,1,2
3,2010,610400,3,3,0,0
4,2010,610400,11,10,1,2
5,2010,610400,11,7,4,1
6,2010,610400,12,5,7,5
7,2010,610400,9,7,2,4
8,2010,610400,10,10,0,1
9,2010,610400,12,10,2,5
10,2010,610400,6,6,0,0
11,2010,610400,11,9,2,2
12,2010,610400,16,14,2,2
1,2011,610400,7,7,0,1
2,2011,610400,5,4,1,3
1,1999,835700,31,22,9,27
2,1999,835700,34,22,12,29
3,1999,835700,31,25,6,38
4,1999,835700,33,12,21,14
5,1999,835700,39,23,16,24
6,1999,835700,41,21,20,11
7,1999,835700,44,22,22,13
8,1999,835700,37,21,16,25
9,1999,835700,32,22,10,11
10,1999,835700,33,20,13,16
11,1999,835700,28,19,9,36
12,1999,835700,28,18,10,31
1,2000,835700,30,18,12,41
2,2000,835700,31,17,14,33
3,2000,835700,30,13,17,35
4,2000,835700,21,12,9,24
5,2000,835700,28,13,15,35
6,2000,835700,43,16,27,38
7,2000,835700,42,14,28,39
8,2000,835700,38,16,22,29
9,2000,835700,18,11,7,26
10,2000,835700,36,18,18,23
11,2000,835700,24,8,16,20
12,2000,835700,23,13,10,20
1,2001,835700,12,5,7,38
2,2001,835700,12,8,4,68
3,2001,835700,18,7,11,52
4,2001,835700,25,15,10,48
5,2001,835700,22,11,11,66
6,2001,835700,16,12,4,93
7,2001,835700,24,17,7,64
8,2001,835700,12,8,4,46
9,2001,835700,24,11,13,67
10,2001,835700,16,12,4,44
11,2001,835700,18,10,8,87
12,2001,835700,12,6,6,104
1,2002,835700,8,3,5,44
2,2002,835700,10,7,3,23
3,2002,835700,8,6,2,34
4,2002,835700,16,7,9,20
5,2002,835700,11,5,6,21
6,2002,835700,8,4,4,50
7,2002,835700,6,2,4,21
8,2002,835700,19,11,8,25
9,2002,835700,10,6,4,29
10,2002,835700,18,8,10,25
11,2002,835700,6,6,0,10
12,2002,835700,9,6,3,8
1,2003,835700,11,8,3,70
2,2003,835700,3,3,0,80
3,2003,835700,4,3,1,65
4,2003,835700,3,1,2,34
5,2003,835700,7,4,3,16
6,2003,835700,9,7,2,33
7,2003,835700,11,5,6,17
8,2003,835700,4,4,0,11
9,2003,835700,7,4,3,16
10,2003,835700,10,8,2,55
11,2003,835700,12,9,3,33
12,2003,835700,7,3,4,142
1,2004,835700,8,5,3,89
2,2004,835700,6,6,0,49
3,2004,835700,14,10,4,64
4,2004,835700,10,5,5,98
5,2004,835700,14,11,3,20
6,2004,835700,10,5,5,13
7,2004,835700,8,4,4,11
8,2004,835700,6,6,0,26
9,2004,835700,7,3,4,70
10,2004,835700,7,3,4,3
11,2004,835700,8,7,1,1
12,2004,835700,5,3,2,2
1,2005,835700,3,3,0,1
2,2005,835700,9,7,2,3
3,2005,835700,7,4,3,0
4,2005,835700,6,3,3,2
5,2005,835700,9,6,3,0
6,2005,835700,12,5,7,0
7,2005,835700,7,5,2,6
8,2005,835700,12,6,6,3
9,2005,835700,6,3,3,16
10,2005,835700,5,3,2,4
11,2005,835700,1,1,0,1
12,2005,835700,4,4,0,0
1,2006,835700,2,2,0,1
2,2006,835700,2,1,1,1
3,2006,835700,2,2,0,0
4,2006,835700,0,0,0,1
5,2006,835700,3,3,0,1
6,2006,835700,2,2,0,0
7,2006,835700,0,0,0,0
8,2006,835700,4,4,0,0
9,2006,835700,1,1,0,0
10,2006,835700,0,0,0,0
11,2006,835700,3,3,0,1
12,2006,835700,4,3,1,0
1,2007,835700,1,1,0,0
2,2007,835700,0,0,0,1
3,2007,835700,2,1,1,0
4,2007,835700,0,0,0,0
5,2007,835700,0,0,0,1
6,2007,835700,2,2,0,0
7,2007,835700,0,0,0,0
8,2007,835700,1,1,0,0
9,2007,835700,2,2,0,2
10,2007,835700,0,0,0,0
11,2007,835700,0,0,0,0
12,2007,835700,1,1,0,0
1,2008,835700,3,3,0,1
2,2008,835700,0,0,0,0
3,2008,835700,1,0,1,0
4,2008,835700,4,3,1,0
5,2008,835700,1,1,0,0
6,2008,835700,1,1,0,0
7,2008,835700,2,2,0,0
8,2008,835700,3,3,0,0
9,2008,835700,1,1,0,0
10,2008,835700,1,1,0,0
11,2008,835700,2,2,0,0
12,2008,835700,2,2,0,0
1,2009,835700,1,0,1,1
2,2009,835700,3,2,1,1
3,2009,835700,3,3,0,0
4,2009,835700,3,2,1,2
5,2009,835700,2,2,0,0
6,2009,835700,2,2,0,0
7,2009,835700,5,5,0,0
8,2009,835700,2,2,0,1
9,2009,835700,1,1,0,0
10,2009,835700,3,2,1,0
11,2009,835700,3,1,2,0
12,2009,835700,1,1,0,0
1,2010,835700,1,1,0,0
2,2010,835700,3,3,0,0
3,2010,835700,1,1,0,0
4,2010,835700,2,1,1,0
5,2010,835700,1,1,0,0
6,2010,835700,6,5,1,0
7,2010,835700,1,1,0,0
8,2010,835700,3,2,1,0
9,2010,835700,2,2,0,0
10,2010,835700,1,1,0,0
11,2010,835700,0,0,0,0
12,2010,835700,0,0,0,1
1,2011,835700,1,1,0,0
2,2011,835700,1,1,0,3
1,1999,390200,15,13,2,1
2,1999,390200,15,14,1,6
3,1999,390200,11,9,2,0
4,1999,390200,14,12,2,8
5,1999,390200,22,21,1,3
6,1999,390200,9,8,1,3
7,1999,390200,22,22,0,2
8,1999,390200,10,7,3,0
9,1999,390200,21,16,5,3
10,1999,390200,21,18,3,2
11,1999,390200,11,10,1,1
12,1999,390200,9,8,1,3
1,2000,390200,14,10,4,0
2,2000,390200,12,11,1,6
3,2000,390200,14,12,2,3
4,2000,390200,12,10,2,4
5,2000,390200,15,15,0,2
6,2000,390200,12,11,1,1
7,2000,390200,14,9,5,1
8,2000,390200,16,15,1,3
9,2000,390200,15,12,3,4
10,2000,390200,14,10,4,2
11,2000,390200,14,13,1,5
12,2000,390200,17,17,0,3
1,2001,390200,10,8,2,2
2,2001,390200,12,10,2,2
3,2001,390200,6,4,2,7
4,2001,390200,14,11,3,8
5,2001,390200,9,8,1,1
6,2001,390200,17,14,3,1
7,2001,390200,10,7,3,1
8,2001,390200,15,13,2,1
9,2001,390200,14,10,4,1
10,2001,390200,11,9,2,3
11,2001,390200,9,8,1,1
12,2001,390200,11,9,2,1
1,2002,390200,11,9,2,1
2,2002,390200,9,8,1,1
3,2002,390200,12,11,1,2
4,2002,390200,9,7,2,1
5,2002,390200,17,17,0,2
6,2002,390200,16,16,0,2
7,2002,390200,17,14,3,2
8,2002,390200,13,10,3,0
9,2002,390200,13,11,2,0
10,2002,390200,8,6,2,1
11,2002,390200,8,8,0,0
12,2002,390200,9,8,1,0
1,2003,390200,10,8,2,2
2,2003,390200,7,7,0,1
3,2003,390200,8,5,3,0
4,2003,390200,11,9,2,3
5,2003,390200,10,6,4,1
6,2003,390200,12,12,0,1
7,2003,390200,11,6,5,0
8,2003,390200,14,14,0,3
9,2003,390200,12,10,2,0
10,2003,390200,13,13,0,0
11,2003,390200,16,15,1,2
12,2003,390200,13,9,4,1
1,2004,390200,7,7,0,2
2,2004,390200,9,7,2,3
3,2004,390200,8,7,1,0
4,2004,390200,5,5,0,0
5,2004,390200,10,9,1,2
6,2004,390200,14,12,2,2
7,2004,390200,3,2,1,3
8,2004,390200,13,11,2,0
9,2004,390200,17,16,1,0
10,2004,390200,19,17,2,1
11,2004,390200,11,10,1,0
12,2004,390200,14,12,2,0
1,2005,390200,13,12,1,0
2,2005,390200,4,4,0,1
3,2005,390200,18,17,1,1
4,2005,390200,19,16,3,0
5,2005,390200,10,10,0,0
6,2005,390200,20,19,1,0
7,2005,390200,11,7,4,0
8,2005,390200,8,8,0,0
9,2005,390200,10,9,1,0
10,2005,390200,17,17,0,0
11,2005,390200,17,13,4,0
12,2005,390200,9,9,0,0
1,2006,390200,9,8,1,1
2,2006,390200,9,7,2,0
3,2006,390200,10,8,2,0
4,2006,390200,9,7,2,5
5,2006,390200,7,6,1,2
6,2006,390200,8,6,2,0
7,2006,390200,8,7,1,4
8,2006,390200,7,7,0,1
9,2006,390200,7,5,2,0
10,2006,390200,6,6,0,1
11,2006,390200,9,8,1,0
12,2006,390200,6,6,0,0
1,2007,390200,5,5,0,2
2,2007,390200,7,6,1,3
3,2007,390200,11,11,0,0
4,2007,390200,8,7,1,1
5,2007,390200,11,10,1,3
6,2007,390200,8,5,3,4
7,2007,390200,11,11,0,3
8,2007,390200,10,9,1,0
9,2007,390200,10,9,1,1
10,2007,390200,14,14,0,0
11,2007,390200,10,10,0,1
12,2007,390200,12,10,2,2
1,2008,390200,9,7,2,0
2,2008,390200,6,5,1,2
3,2008,390200,9,8,1,7
4,2008,390200,11,11,0,6
5,2008,390200,10,7,3,8
6,2008,390200,10,7,3,3
7,2008,390200,11,10,1,4
8,2008,390200,11,10,1,5
9,2008,390200,13,11,2,4
10,2008,390200,11,11,0,0
11,2008,390200,14,13,1,1
12,2008,390200,7,6,1,2
1,2009,390200,5,3,2,2
2,2009,390200,13,13,0,0
3,2009,390200,13,12,1,4
4,2009,390200,16,13,3,1
5,2009,390200,14,12,2,4
6,2009,390200,14,14,0,4
7,2009,390200,16,14,2,2
8,2009,390200,25,23,2,1
9,2009,390200,17,16,1,5
10,2009,390200,20,18,2,3
11,2009,390200,13,12,1,1
12,2009,390200,15,15,0,0
1,2010,390200,4,4,0,0
2,2010,390200,8,8,0,3
3,2010,390200,8,7,1,1
4,2010,390200,6,5,1,1
5,2010,390200,16,16,0,0
6,2010,390200,13,10,3,4
7,2010,390200,14,13,1,0
8,2010,390200,11,11,0,1
9,2010,390200,7,6,1,2
10,2010,390200,8,8,0,2
11,2010,390200,15,15,0,0
12,2010,390200,8,7,1,1
1,2011,390200,12,9,3,4
2,2011,390200,3,3,0,0
1,1999,835500,26,19,7,28
2,1999,835500,27,25,2,34
3,1999,835500,26,24,2,35
4,1999,835500,48,40,8,27
5,1999,835500,43,34,9,21
6,1999,835500,36,33,3,15
7,1999,835500,43,39,4,10
8,1999,835500,46,42,4,13
9,1999,835500,41,33,8,21
10,1999,835500,37,28,9,38
11,1999,835500,36,34,2,32
12,1999,835500,35,29,6,32
1,2000,835500,34,30,4,34
2,2000,835500,29,26,3,29
3,2000,835500,29,26,3,29
4,2000,835500,42,34,8,17
5,2000,835500,33,26,7,47
6,2000,835500,45,35,10,29
7,2000,835500,49,40,9,37
8,2000,835500,47,39,8,38
9,2000,835500,43,38,5,20
10,2000,835500,41,34,7,23
11,2000,835500,27,25,2,31
12,2000,835500,18,17,1,36
1,2001,835500,22,18,4,27
2,2001,835500,17,14,3,21
3,2001,835500,35,30,5,35
4,2001,835500,32,26,6,24
5,2001,835500,17,11,6,29
6,2001,835500,30,24,6,22
7,2001,835500,30,26,4,27
8,2001,835500,37,29,8,27
9,2001,835500,37,35,2,15
10,2001,835500,38,34,4,14
11,2001,835500,27,24,3,28
12,2001,835500,25,21,4,21
1,2002,835500,24,20,4,43
2,2002,835500,24,23,1,26
3,2002,835500,24,22,2,14
4,2002,835500,26,23,3,25
5,2002,835500,20,15,5,22
6,2002,835500,28,23,5,23
7,2002,835500,40,30,10,22
8,2002,835500,29,26,3,30
9,2002,835500,25,23,2,24
10,2002,835500,30,27,3,33
11,2002,835500,26,23,3,44
12,2002,835500,29,22,7,27
1,2003,835500,23,20,3,55
2,2003,835500,15,14,1,67
3,2003,835500,25,23,2,44
4,2003,835500,20,17,3,45
5,2003,835500,21,16,5,44
6,2003,835500,26,22,4,48
7,2003,835500,31,24,7,40
8,2003,835500,24,18,6,30
9,2003,835500,34,23,11,15
10,2003,835500,30,24,6,10
11,2003,835500,21,15,6,15
12,2003,835500,22,18,4,15
1,2004,835500,19,18,1,32
2,2004,835500,7,5,2,24
3,2004,835500,18,15,3,15
4,2004,835500,21,17,4,13
5,2004,835500,29,25,4,5
6,2004,835500,31,24,7,10
7,2004,835500,23,20,3,17
8,2004,835500,27,21,6,12
9,2004,835500,24,20,4,6
10,2004,835500,27,22,5,2
11,2004,835500,16,15,1,6
12,2004,835500,21,20,1,7
1,2005,835500,8,7,1,7
2,2005,835500,18,16,2,9
3,2005,835500,16,13,3,9
4,2005,835500,15,15,0,9
5,2005,835500,17,13,4,6
6,2005,835500,19,18,1,2
7,2005,835500,36,27,9,10
8,2005,835500,35,31,4,5
9,2005,835500,23,21,2,15
10,2005,835500,20,17,3,5
11,2005,835500,21,19,2,5
12,2005,835500,31,27,4,2
1,2006,835500,18,13,5,6
2,2006,835500,18,13,5,8
3,2006,835500,25,23,2,6
4,2006,835500,20,15,5,7
5,2006,835500,29,24,5,2
6,2006,835500,25,18,7,10
7,2006,835500,33,24,9,11
8,2006,835500,28,19,9,23
9,2006,835500,30,28,2,2
10,2006,835500,20,16,4,10
11,2006,835500,20,17,3,9
12,2006,835500,21,20,1,7
1,2007,835500,16,15,1,12
2,2007,835500,9,7,2,8
3,2007,835500,12,11,1,4
4,2007,835500,17,11,6,10
5,2007,835500,17,16,1,5
6,2007,835500,21,16,5,5
7,2007,835500,23,19,4,14
8,2007,835500,26,16,10,11
9,2007,835500,11,9,2,12
10,2007,835500,21,16,5,13
11,2007,835500,19,16,3,7
12,2007,835500,19,18,1,9
1,2008,835500,18,12,6,15
2,2008,835500,12,9,3,8
3,2008,835500,23,21,2,14
4,2008,835500,16,13,3,11
5,2008,835500,13,11,2,7
6,2008,835500,13,9,4,8
7,2008,835500,13,7,6,6
8,2008,835500,30,27,3,7
9,2008,835500,15,10,5,8
10,2008,835500,23,20,3,6
11,2008,835500,15,9,6,5
12,2008,835500,20,19,1,8
1,2009,835500,17,13,4,11
2,2009,835500,12,8,4,11
3,2009,835500,12,9,3,6
4,2009,835500,10,7,3,5
5,2009,835500,19,17,2,8
6,2009,835500,15,14,1,8
7,2009,835500,17,13,4,6
8,2009,835500,16,14,2,11
9,2009,835500,16,11,5,7
10,2009,835500,9,6,3,2
11,2009,835500,13,13,0,8
12,2009,835500,13,10,3,8
1,2010,835500,13,13,0,9
2,2010,835500,6,6,0,10
3,2010,835500,14,13,1,4
4,2010,835500,25,21,4,5
5,2010,835500,28,23,5,8
6,2010,835500,16,15,1,8
7,2010,835500,26,23,3,1
8,2010,835500,22,18,4,9
9,2010,835500,17,14,3,7
10,2010,835500,18,15,3,5
11,2010,835500,25,21,4,3
12,2010,835500,12,12,0,6
1,2011,835500,16,16,0,11
2,2011,835500,13,11,2,3
1,1999,390100,10,9,1,0
2,1999,390100,8,8,0,1
3,1999,390100,4,4,0,0
4,1999,390100,13,13,0,1
5,1999,390100,11,11,0,0
6,1999,390100,11,9,2,0
7,1999,390100,9,7,2,0
8,1999,390100,13,11,2,1
9,1999,390100,10,10,0,0
10,1999,390100,5,4,1,0
11,1999,390100,7,6,1,0
12,1999,390100,11,10,1,0
1,2000,390100,4,4,0,0
2,2000,390100,3,2,1,1
3,2000,390100,9,7,2,1
4,2000,390100,9,7,2,2
5,2000,390100,10,8,2,0
6,2000,390100,8,4,4,0
7,2000,390100,5,4,1,0
8,2000,390100,13,11,2,0
9,2000,390100,8,7,1,0
10,2000,390100,6,5,1,0
11,2000,390100,6,5,1,0
12,2000,390100,16,16,0,0
1,2001,390100,11,10,1,0
2,2001,390100,7,5,2,1
3,2001,390100,4,3,1,0
4,2001,390100,6,6,0,0
5,2001,390100,5,5,0,0
6,2001,390100,10,8,2,0
7,2001,390100,2,2,0,1
8,2001,390100,7,6,1,0
9,2001,390100,7,7,0,1
10,2001,390100,8,8,0,0
11,2001,390100,1,1,0,0
12,2001,390100,7,7,0,0
1,2002,390100,5,3,2,0
2,2002,390100,4,3,1,0
3,2002,390100,3,3,0,0
4,2002,390100,7,5,2,0
5,2002,390100,10,7,3,1
6,2002,390100,6,4,2,0
7,2002,390100,7,7,0,0
8,2002,390100,5,4,1,0
9,2002,390100,12,11,1,0
10,2002,390100,4,3,1,0
11,2002,390100,6,5,1,0
12,2002,390100,10,9,1,0
1,2003,390100,5,5,0,1
2,2003,390100,1,0,1,0
3,2003,390100,3,2,1,0
4,2003,390100,5,5,0,0
5,2003,390100,10,8,2,3
6,2003,390100,6,5,1,0
7,2003,390100,6,5,1,0
8,2003,390100,12,12,0,0
9,2003,390100,8,8,0,0
10,2003,390100,5,5,0,0
11,2003,390100,6,6,0,0
12,2003,390100,9,7,2,0
1,2004,390100,5,3,2,0
2,2004,390100,10,8,2,0
3,2004,390100,5,5,0,0
4,2004,390100,12,9,3,0
5,2004,390100,4,3,1,0
6,2004,390100,8,6,2,0
7,2004,390100,6,6,0,0
8,2004,390100,9,8,1,0
9,2004,390100,8,5,3,0
10,2004,390100,7,5,2,0
11,2004,390100,10,7,3,0
12,2004,390100,7,7,0,0
1,2005,390100,4,2,2,0
2,2005,390100,5,3,2,1
3,2005,390100,5,5,0,0
4,2005,390100,9,8,1,0
5,2005,390100,9,7,2,0
6,2005,390100,8,7,1,0
7,2005,390100,6,6,0,0
8,2005,390100,5,5,0,0
9,2005,390100,12,11,1,0
10,2005,390100,8,7,1,0
11,2005,390100,7,5,2,0
12,2005,390100,3,3,0,0
1,2006,390100,9,7,2,0
2,2006,390100,8,8,0,0
3,2006,390100,9,8,1,0
4,2006,390100,4,2,2,0
5,2006,390100,8,5,3,0
6,2006,390100,5,4,1,1
7,2006,390100,8,7,1,0
8,2006,390100,3,3,0,0
9,2006,390100,4,4,0,0
10,2006,390100,7,5,2,0
11,2006,390100,9,7,2,0
12,2006,390100,7,5,2,0
1,2007,390100,7,7,0,0
2,2007,390100,6,5,1,1
3,2007,390100,5,5,0,0
4,2007,390100,7,7,0,0
5,2007,390100,9,9,0,0
6,2007,390100,10,8,2,0
7,2007,390100,8,8,0,0
8,2007,390100,3,3,0,1
9,2007,390100,5,4,1,0
10,2007,390100,11,10,1,0
11,2007,390100,13,13,0,0
12,2007,390100,8,8,0,1
1,2008,390100,6,4,2,0
2,2008,390100,5,5,0,0
3,2008,390100,7,6,1,0
4,2008,390100,4,3,1,0
5,2008,390100,9,9,0,0
6,2008,390100,3,3,0,0
7,2008,390100,7,7,0,0
8,2008,390100,5,4,1,3
9,2008,390100,6,6,0,0
10,2008,390100,4,3,1,0
11,2008,390100,7,5,2,0
12,2008,390100,3,3,0,1
1,2009,390100,8,8,0,0
2,2009,390100,3,3,0,0
3,2009,390100,10,9,1,1
4,2009,390100,6,6,0,0
5,2009,390100,4,4,0,1
6,2009,390100,4,4,0,3
7,2009,390100,9,9,0,1
8,2009,390100,9,8,1,0
9,2009,390100,6,6,0,1
10,2009,390100,10,10,0,0
11,2009,390100,3,3,0,1
12,2009,390100,4,4,0,0
1,2010,390100,4,4,0,0
2,2010,390100,3,3,0,0
3,2010,390100,5,5,0,0
4,2010,390100,5,5,0,3
5,2010,390100,10,9,1,0
6,2010,390100,2,1,1,1
7,2010,390100,7,7,0,0
8,2010,390100,2,2,0,0
9,2010,390100,9,9,0,0
10,2010,390100,4,3,1,1
11,2010,390100,3,3,0,0
12,2010,390100,3,3,0,0
1,2011,390100,7,7,0,0
2,2011,390100,5,5,0,0
1,1999,610800,3,2,1,0
2,1999,610800,2,1,1,2
3,1999,610800,6,4,2,1
4,1999,610800,3,2,1,0
5,1999,610800,1,1,0,0
6,1999,610800,5,4,1,0
7,1999,610800,4,3,1,0
8,1999,610800,5,5,0,0
9,1999,610800,4,3,1,0
10,1999,610800,5,3,2,0
11,1999,610800,4,3,1,0
12,1999,610800,1,1,0,0
1,2000,610800,4,3,1,0
2,2000,610800,3,2,1,1
3,2000,610800,2,1,1,0
4,2000,610800,2,2,0,0
5,2000,610800,2,2,0,0
6,2000,610800,4,3,1,0
7,2000,610800,3,2,1,0
8,2000,610800,4,3,1,0
9,2000,610800,1,1,0,0
10,2000,610800,3,2,1,0
11,2000,610800,2,2,0,0
12,2000,610800,3,3,0,0
1,2001,610800,3,2,1,0
2,2001,610800,5,4,1,3
3,2001,610800,4,4,0,0
4,2001,610800,6,3,3,0
5,2001,610800,1,1,0,1
6,2001,610800,1,1,0,1
7,2001,610800,3,2,1,0
8,2001,610800,4,4,0,3
9,2001,610800,3,2,1,1
10,2001,610800,2,2,0,1
11,2001,610800,6,6,0,0
12,2001,610800,2,2,0,0
1,2002,610800,1,1,0,0
2,2002,610800,2,2,0,1
3,2002,610800,1,1,0,0
4,2002,610800,1,1,0,0
5,2002,610800,2,2,0,0
6,2002,610800,3,2,1,0
7,2002,610800,4,3,1,0
8,2002,610800,4,4,0,0
9,2002,610800,5,4,1,0
10,2002,610800,1,0,1,0
11,2002,610800,1,0,1,0
12,2002,610800,1,1,0,0
1,2003,610800,1,1,0,0
2,2003,610800,0,0,0,0
3,2003,610800,6,5,1,2
4,2003,610800,3,3,0,3
5,2003,610800,1,0,1,0
6,2003,610800,4,1,3,1
7,2003,610800,3,3,0,1
8,2003,610800,3,2,1,0
9,2003,610800,0,0,0,0
10,2003,610800,4,3,1,1
11,2003,610800,3,0,3,3
12,2003,610800,3,2,1,0
1,2004,610800,2,2,0,0
2,2004,610800,2,2,0,0
3,2004,610800,4,3,1,0
4,2004,610800,5,3,2,0
5,2004,610800,6,6,0,0
6,2004,610800,1,0,1,1
7,2004,610800,5,4,1,1
8,2004,610800,5,4,1,1
9,2004,610800,2,1,1,0
10,2004,610800,4,4,0,0
11,2004,610800,2,2,0,0
12,2004,610800,0,0,0,0
1,2005,610800,1,0,1,0
2,2005,610800,2,2,0,0
3,2005,610800,0,0,0,0
4,2005,610800,1,1,0,0
5,2005,610800,3,3,0,3
6,2005,610800,3,3,0,1
7,2005,610800,3,2,1,1
8,2005,610800,1,1,0,0
9,2005,610800,2,2,0,0
10,2005,610800,4,4,0,0
11,2005,610800,3,3,0,0
12,2005,610800,1,1,0,1
1,2006,610800,4,4,0,0
2,2006,610800,1,1,0,0
3,2006,610800,1,1,0,0
4,2006,610800,0,0,0,0
5,2006,610800,10,10,0,0
6,2006,610800,2,2,0,1
7,2006,610800,3,2,1,1
8,2006,610800,1,1,0,0
9,2006,610800,3,3,0,0
10,2006,610800,3,3,0,0
11,2006,610800,0,0,0,0
12,2006,610800,0,0,0,0
1,2007,610800,6,5,1,2
2,2007,610800,5,5,0,1
3,2007,610800,1,1,0,0
4,2007,610800,2,2,0,0
5,2007,610800,1,1,0,0
6,2007,610800,7,4,3,0
7,2007,610800,3,1,2,2
8,2007,610800,3,3,0,1
9,2007,610800,3,2,1,0
10,2007,610800,3,3,0,0
11,2007,610800,8,7,1,0
12,2007,610800,3,2,1,0
1,2008,610800,1,1,0,0
2,2008,610800,2,1,1,0
3,2008,610800,3,2,1,1
4,2008,610800,0,0,0,1
5,2008,610800,3,3,0,0
6,2008,610800,12,10,2,1
7,2008,610800,7,4,3,1
8,2008,610800,3,3,0,2
9,2008,610800,7,4,3,1
10,2008,610800,3,3,0,1
11,2008,610800,2,2,0,1
12,2008,610800,4,4,0,0
1,2009,610800,4,3,1,0
2,2009,610800,4,3,1,1
3,2009,610800,2,1,1,1
4,2009,610800,4,3,1,3
5,2009,610800,2,2,0,1
6,2009,610800,2,1,1,2
7,2009,610800,2,2,0,1
8,2009,610800,3,3,0,2
9,2009,610800,6,5,1,0
10,2009,610800,3,3,0,0
11,2009,610800,4,2,2,0
12,2009,610800,4,4,0,0
1,2010,610800,4,4,0,0
2,2010,610800,0,0,0,1
3,2010,610800,5,4,1,1
4,2010,610800,2,2,0,1
5,2010,610800,3,2,1,0
6,2010,610800,1,1,0,0
7,2010,610800,4,3,1,0
8,2010,610800,3,2,1,0
9,2010,610800,1,1,0,0
10,2010,610800,2,2,0,0
11,2010,610800,3,3,0,0
12,2010,610800,2,2,0,0
1,2011,610800,1,1,0,2
2,2011,610800,0,0,0,0
1,1999,381500,1,0,1,0
2,1999,381500,1,1,0,0
3,1999,381500,0,0,0,0
4,1999,381500,1,0,1,0
5,1999,381500,2,2,0,0
6,1999,381500,1,0,1,2
7,1999,381500,1,0,1,0
8,1999,381500,3,3,0,1
9,1999,381500,1,1,0,0
10,1999,381500,3,2,1,1
11,1999,381500,2,1,1,1
12,1999,381500,1,1,0,2
1,2000,381500,1,1,0,1
2,2000,381500,0,0,0,2
3,2000,381500,1,1,0,3
4,2000,381500,1,1,0,1
5,2000,381500,1,1,0,0
6,2000,381500,2,2,0,0
7,2000,381500,0,0,0,3
8,2000,381500,1,0,1,0
9,2000,381500,1,0,1,1
10,2000,381500,2,2,0,1
11,2000,381500,6,6,0,1
12,2000,381500,1,1,0,0
1,2001,381500,1,0,1,0
2,2001,381500,0,0,0,0
3,2001,381500,1,1,0,1
4,2001,381500,2,2,0,1
5,2001,381500,0,0,0,4
6,2001,381500,1,1,0,0
7,2001,381500,0,0,0,1
8,2001,381500,0,0,0,0
9,2001,381500,0,0,0,1
10,2001,381500,2,1,1,1
11,2001,381500,0,0,0,0
12,2001,381500,0,0,0,1
1,2002,381500,1,1,0,0
2,2002,381500,6,5,1,3
3,2002,381500,0,0,0,0
4,2002,381500,3,2,1,2
5,2002,381500,0,0,0,2
6,2002,381500,3,2,1,0
7,2002,381500,1,1,0,2
8,2002,381500,0,0,0,1
9,2002,381500,1,1,0,1
10,2002,381500,1,1,0,1
11,2002,381500,4,4,0,1
12,2002,381500,2,2,0,1
1,2003,381500,2,1,1,0
2,2003,381500,3,3,0,3
3,2003,381500,2,1,1,0
4,2003,381500,0,0,0,2
5,2003,381500,0,0,0,3
6,2003,381500,3,3,0,0
7,2003,381500,3,2,1,2
8,2003,381500,2,2,0,1
9,2003,381500,5,4,1,2
10,2003,381500,2,1,1,1
11,2003,381500,1,1,0,5
12,2003,381500,0,0,0,0
1,2004,381500,3,3,0,2
2,2004,381500,2,2,0,1
3,2004,381500,0,0,0,1
4,2004,381500,0,0,0,2
5,2004,381500,2,2,0,1
6,2004,381500,0,0,0,1
7,2004,381500,2,2,0,0
8,2004,381500,1,1,0,0
9,2004,381500,0,0,0,2
10,2004,381500,1,1,0,0
11,2004,381500,2,2,0,0
12,2004,381500,0,0,0,0
1,2005,381500,1,1,0,0
2,2005,381500,0,0,0,1
3,2005,381500,1,0,1,0
4,2005,381500,1,1,0,0
5,2005,381500,2,1,1,0
6,2005,381500,0,0,0,0
7,2005,381500,0,0,0,0
8,2005,381500,3,3,0,0
9,2005,381500,3,3,0,1
10,2005,381500,0,0,0,0
11,2005,381500,1,1,0,0
12,2005,381500,0,0,0,0
1,2006,381500,2,2,0,0
2,2006,381500,0,0,0,0
3,2006,381500,1,1,0,0
4,2006,381500,0,0,0,1
5,2006,381500,1,0,1,0
6,2006,381500,0,0,0,0
7,2006,381500,1,0,1,0
8,2006,381500,2,2,0,1
9,2006,381500,3,3,0,0
10,2006,381500,0,0,0,0
11,2006,381500,2,2,0,3
12,2006,381500,0,0,0,0
1,2007,381500,0,0,0,1
2,2007,381500,1,1,0,0
3,2007,381500,1,1,0,1
4,2007,381500,0,0,0,0
5,2007,381500,3,2,1,0
6,2007,381500,2,0,2,0
7,2007,381500,0,0,0,1
8,2007,381500,0,0,0,0
9,2007,381500,1,0,1,0
10,2007,381500,1,1,0,0
11,2007,381500,2,1,1,0
12,2007,381500,3,3,0,0
1,2008,381500,0,0,0,0
2,2008,381500,0,0,0,0
3,2008,381500,2,1,1,1
4,2008,381500,0,0,0,0
5,2008,381500,1,1,0,2
6,2008,381500,0,0,0,0
7,2008,381500,2,1,1,1
8,2008,381500,1,1,0,0
9,2008,381500,0,0,0,0
10,2008,381500,1,0,1,0
11,2008,381500,1,1,0,0
12,2008,381500,0,0,0,1
1,2009,381500,1,1,0,1
2,2009,381500,0,0,0,0
3,2009,381500,0,0,0,2
4,2009,381500,2,1,1,0
5,2009,381500,0,0,0,2
6,2009,381500,3,3,0,0
7,2009,381500,1,1,0,2
8,2009,381500,1,1,0,0
9,2009,381500,1,1,0,1
10,2009,381500,0,0,0,0
11,2009,381500,1,1,0,0
12,2009,381500,0,0,0,1
1,2010,381500,1,1,0,0
2,2010,381500,0,0,0,0
3,2010,381500,1,1,0,0
4,2010,381500,1,1,0,0
5,2010,381500,3,3,0,0
6,2010,381500,0,0,0,0
7,2010,381500,1,0,1,0
8,2010,381500,1,1,0,1
9,2010,381500,1,1,0,0
10,2010,381500,1,1,0,1
11,2010,381500,1,1,0,0
12,2010,381500,0,0,0,1
1,2011,381500,0,0,0,1
2,2011,381500,0,0,0,0
1,1999,380700,18,14,4,2
2,1999,380700,30,22,8,6
3,1999,380700,21,14,7,10
4,1999,380700,25,17,8,17
5,1999,380700,33,24,9,5
6,1999,380700,31,21,10,2
7,1999,380700,40,33,7,5
8,1999,380700,41,33,8,2
9,1999,380700,21,18,3,3
10,1999,380700,20,17,3,6
11,1999,380700,18,13,5,7
12,1999,380700,22,17,5,1
1,2000,380700,13,8,5,15
2,2000,380700,17,13,4,6
3,2000,380700,10,10,0,15
4,2000,380700,13,11,2,13
5,2000,380700,17,14,3,17
6,2000,380700,24,17,7,11
7,2000,380700,26,16,10,19
8,2000,380700,16,12,4,9
9,2000,380700,19,13,6,6
10,2000,380700,22,15,7,5
11,2000,380700,20,17,3,14
12,2000,380700,12,11,1,2
1,2001,380700,10,6,4,3
2,2001,380700,7,5,2,5
3,2001,380700,12,10,2,5
4,2001,380700,12,8,4,6
5,2001,380700,14,8,6,3
6,2001,380700,15,11,4,7
7,2001,380700,17,11,6,14
8,2001,380700,27,22,5,6
9,2001,380700,12,10,2,3
10,2001,380700,17,14,3,5
11,2001,380700,11,7,4,9
12,2001,380700,14,12,2,2
1,2002,380700,13,12,1,1
2,2002,380700,12,10,2,3
3,2002,380700,19,16,3,2
4,2002,380700,17,17,0,5
5,2002,380700,9,6,3,2
6,2002,380700,4,3,1,0
7,2002,380700,14,12,2,3
8,2002,380700,12,11,1,1
9,2002,380700,12,9,3,0
10,2002,380700,17,14,3,7
11,2002,380700,7,7,0,5
12,2002,380700,17,15,2,3
1,2003,380700,5,5,0,6
2,2003,380700,2,2,0,1
3,2003,380700,6,6,0,3
4,2003,380700,7,6,1,6
5,2003,380700,12,10,2,1
6,2003,380700,13,12,1,2
7,2003,380700,20,17,3,4
8,2003,380700,16,14,2,0
9,2003,380700,11,11,0,3
10,2003,380700,11,11,0,3
11,2003,380700,8,8,0,4
12,2003,380700,11,9,2,1
1,2004,380700,13,8,5,3
2,2004,380700,12,10,2,1
3,2004,380700,7,5,2,2
4,2004,380700,9,8,1,4
5,2004,380700,9,7,2,7
6,2004,380700,12,10,2,4
7,2004,380700,14,13,1,2
8,2004,380700,17,16,1,1
9,2004,380700,9,8,1,2
10,2004,380700,19,17,2,1
11,2004,380700,1,0,1,1
12,2004,380700,9,8,1,1
1,2005,380700,9,6,3,3
2,2005,380700,6,6,0,5
3,2005,380700,10,9,1,1
4,2005,380700,7,5,2,2
5,2005,380700,6,6,0,0
6,2005,380700,6,6,0,1
7,2005,380700,14,10,4,1
8,2005,380700,15,13,2,3
9,2005,380700,14,13,1,8
10,2005,380700,11,10,1,1
11,2005,380700,15,10,5,2
12,2005,380700,12,10,2,2
1,2006,380700,24,19,5,3
2,2006,380700,12,12,0,0
3,2006,380700,8,4,4,4
4,2006,380700,9,7,2,4
5,2006,380700,8,7,1,2
6,2006,380700,10,9,1,0
7,2006,380700,14,12,2,3
8,2006,380700,13,10,3,4
9,2006,380700,10,10,0,1
10,2006,380700,16,14,2,0
11,2006,380700,9,7,2,2
12,2006,380700,9,8,1,1
1,2007,380700,6,5,1,0
2,2007,380700,3,3,0,0
3,2007,380700,8,7,1,0
4,2007,380700,5,4,1,1
5,2007,380700,11,8,3,0
6,2007,380700,20,20,0,2
7,2007,380700,11,11,0,1
8,2007,380700,8,7,1,0
9,2007,380700,9,7,2,3
10,2007,380700,12,10,2,1
11,2007,380700,22,20,2,3
12,2007,380700,7,5,2,2
1,2008,380700,3,2,1,1
2,2008,380700,3,2,1,0
3,2008,380700,9,8,1,3
4,2008,380700,10,9,1,2
5,2008,380700,6,4,2,3
6,2008,380700,5,4,1,4
7,2008,380700,13,8,5,0
8,2008,380700,14,11,3,3
9,2008,380700,16,15,1,2
10,2008,380700,17,15,2,6
11,2008,380700,7,6,1,3
12,2008,380700,10,8,2,2
1,2009,380700,7,5,2,0
2,2009,380700,5,5,0,4
3,2009,380700,9,9,0,4
4,2009,380700,15,13,2,0
5,2009,380700,4,4,0,7
6,2009,380700,10,9,1,1
7,2009,380700,12,10,2,1
8,2009,380700,12,10,2,0
9,2009,380700,7,5,2,1
10,2009,380700,18,16,2,1
11,2009,380700,7,4,3,2
12,2009,380700,13,12,1,0
1,2010,380700,10,8,2,2
2,2010,380700,7,7,0,2
3,2010,380700,11,8,3,1
4,2010,380700,5,4,1,1
5,2010,380700,7,7,0,1
6,2010,380700,6,6,0,1
7,2010,380700,8,6,2,2
8,2010,380700,11,10,1,2
9,2010,380700,3,2,1,2
10,2010,380700,7,7,0,2
11,2010,380700,7,7,0,1
12,2010,380700,6,6,0,1
1,2011,380700,9,7,2,1
2,2011,380700,3,2,1,2
1,1999,390300,8,5,3,1
2,1999,390300,12,12,0,2
3,1999,390300,4,4,0,1
4,1999,390300,7,4,3,4
5,1999,390300,7,6,1,1
6,1999,390300,12,9,3,1
7,1999,390300,11,7,4,3
8,1999,390300,7,6,1,2
9,1999,390300,10,9,1,3
10,1999,390300,9,8,1,4
11,1999,390300,10,10,0,1
12,1999,390300,21,19,2,0
1,2000,390300,6,5,1,1
2,2000,390300,9,6,3,1
3,2000,390300,11,11,0,0
4,2000,390300,20,17,3,2
5,2000,390300,24,22,2,2
6,2000,390300,16,14,2,4
7,2000,390300,24,20,4,0
8,2000,390300,18,13,5,0
9,2000,390300,20,18,2,1
10,2000,390300,8,8,0,1
11,2000,390300,17,15,2,0
12,2000,390300,16,13,3,3
1,2001,390300,14,9,5,2
2,2001,390300,13,13,0,3
3,2001,390300,12,11,1,1
4,2001,390300,12,8,4,1
5,2001,390300,16,14,2,1
6,2001,390300,22,18,4,3
7,2001,390300,24,18,6,4
8,2001,390300,25,23,2,6
9,2001,390300,19,16,3,0
10,2001,390300,19,19,0,1
11,2001,390300,22,20,2,2
12,2001,390300,17,15,2,1
1,2002,390300,13,10,3,1
2,2002,390300,12,10,2,0
3,2002,390300,18,16,2,1
4,2002,390300,17,12,5,2
5,2002,390300,12,9,3,1
6,2002,390300,10,8,2,3
7,2002,390300,16,14,2,0
8,2002,390300,10,10,0,4
9,2002,390300,14,11,3,1
10,2002,390300,16,11,5,0
11,2002,390300,12,9,3,0
12,2002,390300,15,12,3,4
1,2003,390300,9,7,2,3
2,2003,390300,8,6,2,1
3,2003,390300,9,8,1,2
4,2003,390300,19,17,2,3
5,2003,390300,13,11,2,5
6,2003,390300,12,9,3,3
7,2003,390300,21,14,7,4
8,2003,390300,17,16,1,4
9,2003,390300,21,17,4,0
10,2003,390300,26,19,7,5
11,2003,390300,21,17,4,0
12,2003,390300,23,21,2,0
1,2004,390300,13,10,3,2
2,2004,390300,9,8,1,1
3,2004,390300,24,22,2,5
4,2004,390300,21,16,5,2
5,2004,390300,21,19,2,1
6,2004,390300,11,8,3,1
7,2004,390300,23,18,5,2
8,2004,390300,17,13,4,3
9,2004,390300,9,8,1,4
10,2004,390300,25,19,6,2
11,2004,390300,14,11,3,0
12,2004,390300,9,8,1,1
1,2005,390300,23,20,3,1
2,2005,390300,15,14,1,1
3,2005,390300,19,16,3,0
4,2005,390300,18,13,5,3
5,2005,390300,19,16,3,4
6,2005,390300,23,16,7,0
7,2005,390300,15,12,3,4
8,2005,390300,25,21,4,3
9,2005,390300,13,10,3,0
10,2005,390300,26,21,5,4
11,2005,390300,13,12,1,0
12,2005,390300,15,9,6,1
1,2006,390300,18,13,5,4
2,2006,390300,16,13,3,2
3,2006,390300,21,16,5,2
4,2006,390300,16,13,3,3
5,2006,390300,26,21,5,2
6,2006,390300,19,16,3,2
7,2006,390300,20,12,8,1
8,2006,390300,10,8,2,0
9,2006,390300,19,18,1,1
10,2006,390300,21,18,3,0
11,2006,390300,17,14,3,1
12,2006,390300,16,13,3,0
1,2007,390300,7,7,0,0
2,2007,390300,21,19,2,0
3,2007,390300,16,12,4,0
4,2007,390300,19,17,2,1
5,2007,390300,17,16,1,1
6,2007,390300,15,15,0,0
7,2007,390300,18,12,6,8
8,2007,390300,8,7,1,3
9,2007,390300,17,14,3,1
10,2007,390300,18,14,4,1
11,2007,390300,18,16,2,1
12,2007,390300,16,13,3,1
1,2008,390300,8,6,2,3
2,2008,390300,7,7,0,3
3,2008,390300,17,13,4,1
4,2008,390300,15,12,3,3
5,2008,390300,16,11,5,2
6,2008,390300,15,12,3,4
7,2008,390300,14,11,3,0
8,2008,390300,24,21,3,1
9,2008,390300,11,11,0,4
10,2008,390300,13,11,2,1
11,2008,390300,23,20,3,1
12,2008,390300,11,10,1,2
1,2009,390300,7,6,1,3
2,2009,390300,14,11,3,0
3,2009,390300,22,15,7,4
4,2009,390300,19,17,2,2
5,2009,390300,17,17,0,7
6,2009,390300,14,14,0,2
7,2009,390300,15,15,0,3
8,2009,390300,17,15,2,5
9,2009,390300,11,11,0,4
10,2009,390300,14,13,1,3
11,2009,390300,17,15,2,9
12,2009,390300,18,15,3,3
1,2010,390300,16,16,0,4
2,2010,390300,14,13,1,4
3,2010,390300,15,13,2,2
4,2010,390300,20,17,3,2
5,2010,390300,17,16,1,1
6,2010,390300,9,7,2,2
7,2010,390300,13,10,3,3
8,2010,390300,13,11,2,3
9,2010,390300,14,13,1,2
10,2010,390300,7,5,2,0
11,2010,390300,16,14,2,3
12,2010,390300,17,14,3,1
1,2011,390300,21,21,0,3
2,2011,390300,8,7,1,2
1,1999,580502,14,13,1,0
2,1999,580502,8,6,2,3
3,1999,580502,8,6,2,1
4,1999,580502,10,9,1,2
5,1999,580502,26,24,2,4
6,1999,580502,23,21,2,1
7,1999,580502,16,15,1,2
8,1999,580502,12,10,2,1
9,1999,580502,16,15,1,0
10,1999,580502,15,13,2,1
11,1999,580502,17,14,3,2
12,1999,580502,28,27,1,0
1,2000,580502,16,12,4,3
2,2000,580502,17,16,1,2
3,2000,580502,18,16,2,6
4,2000,580502,20,18,2,2
5,2000,580502,21,18,3,4
6,2000,580502,17,15,2,2
7,2000,580502,21,18,3,1
8,2000,580502,24,24,0,2
9,2000,580502,24,23,1,0
10,2000,580502,24,20,4,1
11,2000,580502,18,18,0,3
12,2000,580502,22,21,1,3
1,2001,580502,28,24,4,0
2,2001,580502,24,22,2,0
3,2001,580502,20,18,2,1
4,2001,580502,20,19,1,2
5,2001,580502,8,8,0,0
6,2001,580502,14,12,2,3
7,2001,580502,12,11,1,0
8,2001,580502,8,8,0,0
9,2001,580502,20,15,5,2
10,2001,580502,25,24,1,2
11,2001,580502,27,25,2,0
12,2001,580502,12,9,3,1
1,2002,580502,25,25,0,1
2,2002,580502,17,16,1,3
3,2002,580502,19,15,4,1
4,2002,580502,23,20,3,2
5,2002,580502,29,23,6,5
6,2002,580502,21,19,2,5
7,2002,580502,20,18,2,1
8,2002,580502,22,20,2,1
9,2002,580502,19,19,0,1
10,2002,580502,22,21,1,1
11,2002,580502,20,19,1,2
12,2002,580502,21,21,0,2
1,2003,580502,23,20,3,1
2,2003,580502,13,13,0,3
3,2003,580502,20,18,2,0
4,2003,580502,16,13,3,1
5,2003,580502,35,30,5,0
6,2003,580502,22,21,1,1
7,2003,580502,26,21,5,1
8,2003,580502,17,14,3,1
9,2003,580502,27,24,3,2
10,2003,580502,24,22,2,5
11,2003,580502,28,24,4,1
12,2003,580502,18,18,0,2
1,2004,580502,15,14,1,1
2,2004,580502,15,12,3,1
3,2004,580502,21,17,4,3
4,2004,580502,20,17,3,2
5,2004,580502,28,24,4,3
6,2004,580502,26,22,4,0
7,2004,580502,25,23,2,1
8,2004,580502,21,17,4,3
9,2004,580502,24,21,3,2
10,2004,580502,18,18,0,1
11,2004,580502,27,24,3,3
12,2004,580502,24,23,1,4
1,2005,580502,15,13,2,2
2,2005,580502,14,13,1,2
3,2005,580502,19,19,0,4
4,2005,580502,9,8,1,5
5,2005,580502,26,22,4,3
6,2005,580502,22,16,6,2
7,2005,580502,16,16,0,1
8,2005,580502,20,15,5,1
9,2005,580502,26,21,5,2
10,2005,580502,25,24,1,4
11,2005,580502,19,17,2,2
12,2005,580502,18,15,3,3
1,2006,580502,13,13,0,1
2,2006,580502,12,10,2,0
3,2006,580502,19,18,1,0
4,2006,580502,19,17,2,3
5,2006,580502,18,16,2,4
6,2006,580502,17,13,4,4
7,2006,580502,23,20,3,4
8,2006,580502,16,15,1,2
9,2006,580502,24,23,1,1
10,2006,580502,29,25,4,1
11,2006,580502,20,19,1,5
12,2006,580502,19,18,1,3
1,2007,580502,12,11,1,4
2,2007,580502,13,13,0,2
3,2007,580502,21,18,3,2
4,2007,580502,11,9,2,0
5,2007,580502,20,15,5,4
6,2007,580502,12,11,1,4
7,2007,580502,18,14,4,6
8,2007,580502,10,7,3,4
9,2007,580502,11,11,0,6
10,2007,580502,10,9,1,5
11,2007,580502,17,15,2,5
12,2007,580502,14,13,1,1
1,2008,580502,14,13,1,5
2,2008,580502,13,10,3,3
3,2008,580502,18,15,3,0
4,2008,580502,13,12,1,0
5,2008,580502,15,12,3,1
6,2008,580502,9,7,2,1
7,2008,580502,15,11,4,1
8,2008,580502,25,19,6,7
9,2008,580502,24,19,5,2
10,2008,580502,22,17,5,4
11,2008,580502,21,21,0,1
12,2008,580502,18,16,2,4
1,2009,580502,19,18,1,2
2,2009,580502,7,7,0,1
3,2009,580502,19,17,2,3
4,2009,580502,14,13,1,6
5,2009,580502,15,14,1,4
6,2009,580502,14,14,0,3
7,2009,580502,15,15,0,3
8,2009,580502,8,7,1,4
9,2009,580502,9,4,5,6
10,2009,580502,16,14,2,1
11,2009,580502,9,8,1,4
12,2009,580502,9,6,3,2
1,2010,580502,16,15,1,2
2,2010,580502,11,9,2,5
3,2010,580502,14,13,1,1
4,2010,580502,11,10,1,5
5,2010,580502,12,10,2,4
6,2010,580502,9,8,1,2
7,2010,580502,9,9,0,0
8,2010,580502,12,10,2,1
9,2010,580502,8,6,2,6
10,2010,580502,16,14,2,1
11,2010,580502,21,20,1,2
12,2010,580502,13,11,2,0
1,2011,580502,16,15,1,2
2,2011,580502,13,13,0,0
1,1999,836000,16,12,4,0
2,1999,836000,19,15,4,8
3,1999,836000,18,12,6,3
4,1999,836000,17,9,8,3
5,1999,836000,29,20,9,2
6,1999,836000,25,18,7,10
7,1999,836000,20,14,6,1
8,1999,836000,26,16,10,0
9,1999,836000,25,18,7,0
10,1999,836000,21,14,7,4
11,1999,836000,26,18,8,1
12,1999,836000,23,22,1,2
1,2000,836000,19,13,6,1
2,2000,836000,14,8,6,2
3,2000,836000,19,14,5,3
4,2000,836000,24,20,4,3
5,2000,836000,17,12,5,0
6,2000,836000,26,15,11,5
7,2000,836000,26,21,5,11
8,2000,836000,31,20,11,0
9,2000,836000,26,24,2,0
10,2000,836000,20,16,4,2
11,2000,836000,27,18,9,2
12,2000,836000,14,12,2,3
1,2001,836000,7,4,3,5
2,2001,836000,11,9,2,4
3,2001,836000,13,11,2,2
4,2001,836000,18,13,5,2
5,2001,836000,10,7,3,1
6,2001,836000,22,18,4,5
7,2001,836000,24,18,6,1
8,2001,836000,16,10,6,6
9,2001,836000,14,12,2,4
10,2001,836000,24,21,3,0
11,2001,836000,16,13,3,2
12,2001,836000,12,11,1,0
1,2002,836000,19,17,2,4
2,2002,836000,9,8,1,5
3,2002,836000,16,13,3,2
4,2002,836000,12,8,4,10
5,2002,836000,22,15,7,6
6,2002,836000,14,11,3,9
7,2002,836000,19,15,4,6
8,2002,836000,23,19,4,7
9,2002,836000,16,13,3,11
10,2002,836000,28,22,6,8
11,2002,836000,16,15,1,10
12,2002,836000,23,22,1,8
1,2003,836000,19,18,1,4
2,2003,836000,10,7,3,5
3,2003,836000,19,11,8,8
4,2003,836000,25,22,3,4
5,2003,836000,16,13,3,8
6,2003,836000,19,16,3,3
7,2003,836000,20,18,2,12
8,2003,836000,28,24,4,6
9,2003,836000,27,24,3,7
10,2003,836000,29,23,6,3
11,2003,836000,20,18,2,5
12,2003,836000,30,26,4,6
1,2004,836000,15,14,1,3
2,2004,836000,22,21,1,7
3,2004,836000,15,12,3,6
4,2004,836000,13,11,2,5
5,2004,836000,26,21,5,6
6,2004,836000,26,20,6,8
7,2004,836000,16,12,4,3
8,2004,836000,19,13,6,13
9,2004,836000,16,12,4,6
10,2004,836000,16,12,4,14
11,2004,836000,11,8,3,8
12,2004,836000,17,15,2,5
1,2005,836000,19,15,4,7
2,2005,836000,23,20,3,3
3,2005,836000,16,14,2,5
4,2005,836000,16,13,3,3
5,2005,836000,25,20,5,8
6,2005,836000,16,14,2,6
7,2005,836000,21,16,5,20
8,2005,836000,24,22,2,8
9,2005,836000,37,34,3,6
10,2005,836000,31,27,4,11
11,2005,836000,20,18,2,8
12,2005,836000,15,14,1,4
1,2006,836000,23,22,1,1
2,2006,836000,17,17,0,1
3,2006,836000,20,18,2,1
4,2006,836000,14,11,3,3
5,2006,836000,21,16,5,2
6,2006,836000,25,24,1,1
7,2006,836000,21,16,5,1
8,2006,836000,26,22,4,1
9,2006,836000,19,16,3,1
10,2006,836000,28,22,6,0
11,2006,836000,11,8,3,1
12,2006,836000,28,24,4,0
1,2007,836000,16,15,1,2
2,2007,836000,7,4,3,1
3,2007,836000,10,8,2,0
4,2007,836000,13,10,3,0
5,2007,836000,24,19,5,2
6,2007,836000,24,18,6,4
7,2007,836000,19,15,4,5
8,2007,836000,21,18,3,2
9,2007,836000,24,19,5,3
10,2007,836000,21,19,2,3
11,2007,836000,22,19,3,3
12,2007,836000,21,18,3,5
1,2008,836000,10,7,3,4
2,2008,836000,17,15,2,2
3,2008,836000,14,14,0,2
4,2008,836000,13,13,0,5
5,2008,836000,15,15,0,3
6,2008,836000,18,13,5,0
7,2008,836000,21,16,5,3
8,2008,836000,19,15,4,2
9,2008,836000,15,14,1,3
10,2008,836000,31,28,3,7
11,2008,836000,21,20,1,4
12,2008,836000,20,18,2,6
1,2009,836000,26,23,3,0
2,2009,836000,21,20,1,3
3,2009,836000,20,18,2,4
4,2009,836000,17,14,3,1
5,2009,836000,26,25,1,5
6,2009,836000,25,22,3,8
7,2009,836000,17,15,2,5
8,2009,836000,20,16,4,7
9,2009,836000,27,23,4,18
10,2009,836000,17,17,0,1
11,2009,836000,12,10,2,6
12,2009,836000,24,22,2,1
1,2010,836000,19,16,3,4
2,2010,836000,6,5,1,5
3,2010,836000,13,12,1,6
4,2010,836000,14,12,2,5
5,2010,836000,16,14,2,10
6,2010,836000,12,10,2,7
7,2010,836000,19,19,0,7
8,2010,836000,25,19,6,6
9,2010,836000,13,13,0,4
10,2010,836000,13,12,1,4
11,2010,836000,23,21,2,9
12,2010,836000,18,14,4,3
1,2011,836000,25,19,6,7
2,2011,836000,6,6,0,7
1,1999,580600,12,12,0,0
2,1999,580600,20,14,6,3
3,1999,580600,13,12,1,4
4,1999,580600,20,18,2,2
5,1999,580600,19,19,0,0
6,1999,580600,21,15,6,0
7,1999,580600,27,21,6,4
8,1999,580600,21,17,4,1
9,1999,580600,22,19,3,0
10,1999,580600,14,11,3,2
11,1999,580600,22,21,1,3
12,1999,580600,15,13,2,3
1,2000,580600,18,14,4,4
2,2000,580600,11,9,2,0
3,2000,580600,18,16,2,3
4,2000,580600,14,8,6,1
5,2000,580600,11,11,0,0
6,2000,580600,19,16,3,3
7,2000,580600,20,18,2,2
8,2000,580600,17,15,2,0
9,2000,580600,23,20,3,2
10,2000,580600,21,18,3,1
11,2000,580600,20,19,1,0
12,2000,580600,11,9,2,1
1,2001,580600,16,14,2,1
2,2001,580600,21,21,0,0
3,2001,580600,22,22,0,6
4,2001,580600,14,12,2,0
5,2001,580600,20,17,3,5
6,2001,580600,18,15,3,2
7,2001,580600,26,23,3,1
8,2001,580600,14,13,1,2
9,2001,580600,18,18,0,5
10,2001,580600,15,15,0,2
11,2001,580600,17,15,2,1
12,2001,580600,22,19,3,2
1,2002,580600,17,14,3,0
2,2002,580600,8,8,0,2
3,2002,580600,29,26,3,3
4,2002,580600,15,12,3,5
5,2002,580600,17,14,3,2
6,2002,580600,18,14,4,0
7,2002,580600,21,15,6,3
8,2002,580600,23,20,3,3
9,2002,580600,20,17,3,2
10,2002,580600,14,12,2,0
11,2002,580600,13,12,1,4
12,2002,580600,16,10,6,4
1,2003,580600,23,21,2,1
2,2003,580600,6,6,0,1
3,2003,580600,21,18,3,5
4,2003,580600,10,8,2,2
5,2003,580600,7,5,2,4
6,2003,580600,18,14,4,6
7,2003,580600,17,15,2,2
8,2003,580600,17,16,1,3
9,2003,580600,15,12,3,1
10,2003,580600,13,10,3,3
11,2003,580600,15,12,3,2
12,2003,580600,16,14,2,1
1,2004,580600,15,12,3,1
2,2004,580600,15,12,3,2
3,2004,580600,16,12,4,3
4,2004,580600,12,11,1,2
5,2004,580600,17,13,4,0
6,2004,580600,11,10,1,2
7,2004,580600,23,20,3,0
8,2004,580600,17,15,2,3
9,2004,580600,14,11,3,0
10,2004,580600,12,10,2,3
11,2004,580600,11,9,2,2
12,2004,580600,5,5,0,2
1,2005,580600,14,13,1,1
2,2005,580600,12,11,1,3
3,2005,580600,11,9,2,5
4,2005,580600,14,11,3,2
5,2005,580600,9,8,1,2
6,2005,580600,6,5,1,4
7,2005,580600,6,3,3,0
8,2005,580600,12,12,0,4
9,2005,580600,15,13,2,5
10,2005,580600,9,8,1,3
11,2005,580600,11,10,1,2
12,2005,580600,17,16,1,3
1,2006,580600,14,12,2,1
2,2006,580600,9,8,1,1
3,2006,580600,7,6,1,3
4,2006,580600,9,6,3,3
5,2006,580600,9,8,1,1
6,2006,580600,6,4,2,2
7,2006,580600,12,9,3,12
8,2006,580600,8,6,2,4
9,2006,580600,16,13,3,1
10,2006,580600,16,13,3,6
11,2006,580600,23,19,4,3
12,2006,580600,18,17,1,8
1,2007,580600,19,18,1,4
2,2007,580600,15,13,2,2
3,2007,580600,14,13,1,4
4,2007,580600,6,4,2,2
5,2007,580600,18,16,2,8
6,2007,580600,7,3,4,4
7,2007,580600,17,16,1,4
8,2007,580600,5,5,0,3
9,2007,580600,11,9,2,10
10,2007,580600,6,6,0,2
11,2007,580600,6,4,2,2
12,2007,580600,7,4,3,1
1,2008,580600,11,9,2,9
2,2008,580600,13,10,3,3
3,2008,580600,8,8,0,2
4,2008,580600,14,13,1,3
5,2008,580600,11,11,0,4
6,2008,580600,20,16,4,2
7,2008,580600,21,16,5,3
8,2008,580600,10,9,1,1
9,2008,580600,16,10,6,2
10,2008,580600,10,9,1,1
11,2008,580600,7,7,0,0
12,2008,580600,21,18,3,0
1,2009,580600,9,9,0,3
2,2009,580600,11,10,1,4
3,2009,580600,8,6,2,3
4,2009,580600,19,14,5,4
5,2009,580600,8,7,1,3
6,2009,580600,16,14,2,6
7,2009,580600,13,10,3,4
8,2009,580600,6,4,2,5
9,2009,580600,16,14,2,6
10,2009,580600,8,8,0,2
11,2009,580600,13,11,2,2
12,2009,580600,11,11,0,2
1,2010,580600,11,9,2,6
2,2010,580600,9,8,1,5
3,2010,580600,11,8,3,6
4,2010,580600,7,4,3,4
5,2010,580600,11,8,3,8
6,2010,580600,14,12,2,2
7,2010,580600,15,13,2,4
8,2010,580600,8,7,1,4
9,2010,580600,10,9,1,0
10,2010,580600,19,17,2,5
11,2010,580600,23,17,6,5
12,2010,580600,7,7,0,1
1,2011,580600,19,18,1,2
2,2011,580600,4,3,1,2
1,1999,580700,17,17,0,2
2,1999,580700,14,14,0,9
3,1999,580700,18,13,5,3
4,1999,580700,17,17,0,4
5,1999,580700,23,18,5,2
6,1999,580700,26,19,7,2
7,1999,580700,21,17,4,1
8,1999,580700,19,15,4,0
9,1999,580700,23,18,5,5
10,1999,580700,23,22,1,3
11,1999,580700,23,21,2,2
12,1999,580700,25,22,3,2
1,2000,580700,17,13,4,4
2,2000,580700,20,18,2,4
3,2000,580700,20,19,1,2
4,2000,580700,16,13,3,7
5,2000,580700,23,18,5,8
6,2000,580700,25,17,8,2
7,2000,580700,19,18,1,5
8,2000,580700,17,13,4,9
9,2000,580700,17,16,1,5
10,2000,580700,29,24,5,1
11,2000,580700,29,28,1,2
12,2000,580700,21,20,1,6
1,2001,580700,30,27,3,2
2,2001,580700,17,16,1,4
3,2001,580700,31,26,5,5
4,2001,580700,24,23,1,3
5,2001,580700,22,19,3,5
6,2001,580700,24,18,6,5
7,2001,580700,19,13,6,0
8,2001,580700,20,19,1,3
9,2001,580700,18,15,3,1
10,2001,580700,25,22,3,2
11,2001,580700,23,23,0,3
12,2001,580700,32,28,4,2
1,2002,580700,28,28,0,2
2,2002,580700,21,19,2,0
3,2002,580700,18,15,3,9
4,2002,580700,15,12,3,7
5,2002,580700,21,18,3,10
6,2002,580700,23,18,5,4
7,2002,580700,19,19,0,1
8,2002,580700,17,13,4,3
9,2002,580700,20,14,6,1
10,2002,580700,19,18,1,7
11,2002,580700,25,23,2,1
12,2002,580700,15,12,3,1
1,2003,580700,22,20,2,2
2,2003,580700,18,17,1,2
3,2003,580700,26,24,2,6
4,2003,580700,26,25,1,4
5,2003,580700,30,27,3,3
6,2003,580700,17,17,0,2
7,2003,580700,13,12,1,1
8,2003,580700,23,20,3,6
9,2003,580700,18,16,2,2
10,2003,580700,14,12,2,3
11,2003,580700,14,11,3,5
12,2003,580700,14,11,3,2
1,2004,580700,15,14,1,2
2,2004,580700,11,11,0,5
3,2004,580700,15,13,2,1
4,2004,580700,14,13,1,3
5,2004,580700,15,10,5,3
6,2004,580700,26,22,4,1
7,2004,580700,18,16,2,2
8,2004,580700,23,21,2,2
9,2004,580700,18,15,3,1
10,2004,580700,18,16,2,0
11,2004,580700,12,11,1,0
12,2004,580700,12,10,2,3
1,2005,580700,18,14,4,3
2,2005,580700,7,5,2,4
3,2005,580700,20,16,4,4
4,2005,580700,15,13,2,1
5,2005,580700,13,10,3,2
6,2005,580700,12,8,4,4
7,2005,580700,17,15,2,2
8,2005,580700,15,13,2,2
9,2005,580700,15,13,2,3
10,2005,580700,14,13,1,1
11,2005,580700,23,19,4,6
12,2005,580700,19,17,2,3
1,2006,580700,20,17,3,3
2,2006,580700,19,15,4,2
3,2006,580700,15,14,1,3
4,2006,580700,13,12,1,4
5,2006,580700,18,18,0,2
6,2006,580700,16,15,1,1
7,2006,580700,18,15,3,4
8,2006,580700,16,15,1,7
9,2006,580700,15,14,1,1
10,2006,580700,18,15,3,1
11,2006,580700,20,16,4,1
12,2006,580700,20,18,2,3
1,2007,580700,15,14,1,0
2,2007,580700,11,7,4,5
3,2007,580700,12,9,3,4
4,2007,580700,12,8,4,5
5,2007,580700,14,12,2,2
6,2007,580700,7,4,3,1
7,2007,580700,11,10,1,8
8,2007,580700,20,18,2,2
9,2007,580700,12,10,2,3
10,2007,580700,16,14,2,4
11,2007,580700,14,11,3,2
12,2007,580700,10,8,2,3
1,2008,580700,10,9,1,2
2,2008,580700,11,8,3,1
3,2008,580700,8,6,2,5
4,2008,580700,18,17,1,4
5,2008,580700,10,10,0,6
6,2008,580700,12,12,0,3
7,2008,580700,21,19,2,4
8,2008,580700,11,8,3,3
9,2008,580700,19,19,0,0
10,2008,580700,22,21,1,4
11,2008,580700,18,14,4,0
12,2008,580700,18,16,2,2
1,2009,580700,13,13,0,2
2,2009,580700,13,12,1,5
3,2009,580700,11,11,0,5
4,2009,580700,7,7,0,3
5,2009,580700,11,7,4,0
6,2009,580700,22,19,3,2
7,2009,580700,12,11,1,2
8,2009,580700,17,16,1,4
9,2009,580700,15,14,1,4
10,2009,580700,20,18,2,4
11,2009,580700,24,21,3,4
12,2009,580700,9,8,1,2
1,2010,580700,14,13,1,4
2,2010,580700,13,10,3,5
3,2010,580700,18,15,3,4
4,2010,580700,14,11,3,3
5,2010,580700,17,14,3,0
6,2010,580700,20,16,4,0
7,2010,580700,9,9,0,5
8,2010,580700,14,13,1,1
9,2010,580700,13,12,1,2
10,2010,580700,20,19,1,3
11,2010,580700,24,23,1,1
12,2010,580700,18,17,1,2
1,2011,580700,20,20,0,7
2,2011,580700,12,12,0,1
1,1999,380500,22,18,4,5
2,1999,380500,21,16,5,8
3,1999,380500,21,15,6,8
4,1999,380500,25,18,7,20
5,1999,380500,34,22,12,6
6,1999,380500,41,28,13,4
7,1999,380500,30,18,12,7
8,1999,380500,26,21,5,9
9,1999,380500,31,21,10,4
10,1999,380500,23,15,8,1
11,1999,380500,23,16,7,7
12,1999,380500,18,12,6,12
1,2000,380500,24,14,10,5
2,2000,380500,14,8,6,8
3,2000,380500,21,16,5,19
4,2000,380500,23,18,5,20
5,2000,380500,21,12,9,18
6,2000,380500,25,14,11,18
7,2000,380500,32,14,18,30
8,2000,380500,34,21,13,55
9,2000,380500,18,12,6,43
10,2000,380500,22,16,6,26
11,2000,380500,16,12,4,11
12,2000,380500,9,8,1,23
1,2001,380500,14,13,1,30
2,2001,380500,22,14,8,34
3,2001,380500,14,10,4,31
4,2001,380500,13,6,7,26
5,2001,380500,16,11,5,37
6,2001,380500,19,10,9,16
7,2001,380500,20,10,10,20
8,2001,380500,25,14,11,21
9,2001,380500,9,4,5,9
10,2001,380500,15,7,8,11
11,2001,380500,12,5,7,11
12,2001,380500,14,9,5,17
1,2002,380500,20,14,6,37
2,2002,380500,7,4,3,31
3,2002,380500,8,6,2,67
4,2002,380500,9,6,3,28
5,2002,380500,6,2,4,58
6,2002,380500,9,7,2,10
7,2002,380500,8,5,3,8
8,2002,380500,16,8,8,10
9,2002,380500,12,10,2,5
10,2002,380500,10,8,2,15
11,2002,380500,13,11,2,21
12,2002,380500,3,1,2,25
1,2003,380500,9,6,3,41
2,2003,380500,8,7,1,41
3,2003,380500,7,4,3,68
4,2003,380500,6,5,1,28
5,2003,380500,7,6,1,13
6,2003,380500,14,11,3,17
7,2003,380500,14,9,5,19
8,2003,380500,13,11,2,18
9,2003,380500,7,7,0,12
10,2003,380500,12,12,0,14
11,2003,380500,8,8,0,5
12,2003,380500,6,3,3,0
1,2004,380500,13,10,3,2
2,2004,380500,4,3,1,4
3,2004,380500,13,10,3,4
4,2004,380500,6,5,1,1
5,2004,380500,6,5,1,4
6,2004,380500,13,12,1,1
7,2004,380500,5,5,0,1
8,2004,380500,11,11,0,1
9,2004,380500,7,6,1,3
10,2004,380500,4,3,1,1
11,2004,380500,9,6,3,0
12,2004,380500,5,4,1,1
1,2005,380500,8,7,1,4
2,2005,380500,4,3,1,1
3,2005,380500,5,5,0,3
4,2005,380500,6,5,1,5
5,2005,380500,6,4,2,1
6,2005,380500,6,6,0,0
7,2005,380500,5,4,1,2
8,2005,380500,4,4,0,1
9,2005,380500,10,8,2,4
10,2005,380500,8,6,2,0
11,2005,380500,5,5,0,3
12,2005,380500,6,6,0,5
1,2006,380500,6,4,2,2
2,2006,380500,2,2,0,2
3,2006,380500,4,4,0,1
4,2006,380500,5,5,0,1
5,2006,380500,9,9,0,0
6,2006,380500,9,9,0,0
7,2006,380500,15,11,4,1
8,2006,380500,6,6,0,2
9,2006,380500,6,5,1,0
10,2006,380500,7,6,1,1
11,2006,380500,8,8,0,2
12,2006,380500,9,9,0,0
1,2007,380500,3,3,0,0
2,2007,380500,6,5,1,0
3,2007,380500,4,3,1,1
4,2007,380500,11,10,1,1
5,2007,380500,11,10,1,0
6,2007,380500,12,10,2,0
7,2007,380500,4,4,0,2
8,2007,380500,8,5,3,0
9,2007,380500,5,4,1,1
10,2007,380500,10,8,2,0
11,2007,380500,2,2,0,1
12,2007,380500,5,5,0,0
1,2008,380500,3,1,2,1
2,2008,380500,4,4,0,0
3,2008,380500,8,5,3,1
4,2008,380500,2,2,0,0
5,2008,380500,10,10,0,0
6,2008,380500,5,2,3,0
7,2008,380500,6,4,2,0
8,2008,380500,8,4,4,1
9,2008,380500,5,4,1,0
10,2008,380500,9,7,2,0
11,2008,380500,7,6,1,2
12,2008,380500,4,4,0,0
1,2009,380500,7,6,1,1
2,2009,380500,4,4,0,2
3,2009,380500,7,6,1,0
4,2009,380500,5,5,0,0
5,2009,380500,4,3,1,0
6,2009,380500,3,1,2,2
7,2009,380500,4,3,1,1
8,2009,380500,7,7,0,2
9,2009,380500,6,5,1,0
10,2009,380500,10,7,3,1
11,2009,380500,5,4,1,0
12,2009,380500,2,2,0,0
1,2010,380500,2,1,1,0
2,2010,380500,5,5,0,1
3,2010,380500,3,2,1,2
4,2010,380500,5,5,0,0
5,2010,380500,9,9,0,4
6,2010,380500,6,6,0,5
7,2010,380500,9,9,0,2
8,2010,380500,8,5,3,1
9,2010,380500,8,8,0,3
10,2010,380500,4,3,1,0
11,2010,380500,5,4,1,5
12,2010,380500,5,4,1,2
1,2011,380500,1,1,0,2
2,2011,380500,4,4,0,0
1,1999,835900,36,25,11,7
2,1999,835900,50,37,13,7
3,1999,835900,45,36,9,11
4,1999,835900,61,47,14,7
5,1999,835900,68,48,20,7
6,1999,835900,64,47,17,10
7,1999,835900,67,46,21,8
8,1999,835900,93,78,15,9
9,1999,835900,65,50,15,9
10,1999,835900,53,46,7,4
11,1999,835900,42,35,7,7
12,1999,835900,40,31,9,11
1,2000,835900,34,25,9,7
2,2000,835900,23,17,6,3
3,2000,835900,45,31,14,11
4,2000,835900,57,44,13,13
5,2000,835900,33,25,8,10
6,2000,835900,56,48,8,12
7,2000,835900,73,57,16,18
8,2000,835900,59,44,15,20
9,2000,835900,52,35,17,17
10,2000,835900,45,36,9,17
11,2000,835900,38,29,9,18
12,2000,835900,35,28,7,17
1,2001,835900,25,22,3,7
2,2001,835900,28,20,8,24
3,2001,835900,39,27,12,25
4,2001,835900,39,28,11,12
5,2001,835900,32,24,8,14
6,2001,835900,40,26,14,28
7,2001,835900,37,21,16,15
8,2001,835900,54,43,11,20
9,2001,835900,41,31,10,8
10,2001,835900,58,48,10,13
11,2001,835900,40,24,16,12
12,2001,835900,39,30,9,3
1,2002,835900,34,27,7,9
2,2002,835900,17,15,2,12
3,2002,835900,26,19,7,13
4,2002,835900,25,20,5,14
5,2002,835900,42,33,9,15
6,2002,835900,36,25,11,11
7,2002,835900,43,34,9,10
8,2002,835900,37,28,9,12
9,2002,835900,41,31,10,2
10,2002,835900,56,49,7,15
11,2002,835900,41,34,7,11
12,2002,835900,30,25,5,11
1,2003,835900,30,22,8,21
2,2003,835900,21,18,3,14
3,2003,835900,22,17,5,11
4,2003,835900,32,25,7,11
5,2003,835900,29,23,6,7
6,2003,835900,35,28,7,5
7,2003,835900,47,42,5,7
8,2003,835900,56,46,10,5
9,2003,835900,55,43,12,1
10,2003,835900,46,38,8,3
11,2003,835900,34,28,6,6
12,2003,835900,29,28,1,4
1,2004,835900,39,33,6,10
2,2004,835900,27,23,4,8
3,2004,835900,31,19,12,10
4,2004,835900,34,26,8,17
5,2004,835900,36,32,4,17
6,2004,835900,38,31,7,9
7,2004,835900,40,33,7,13
8,2004,835900,36,27,9,14
9,2004,835900,37,27,10,29
10,2004,835900,35,29,6,26
11,2004,835900,23,18,5,16
12,2004,835900,26,24,2,12
1,2005,835900,22,12,10,19
2,2005,835900,23,16,7,12
3,2005,835900,31,26,5,23
4,2005,835900,31,28,3,16
5,2005,835900,31,26,5,5
6,2005,835900,35,23,12,9
7,2005,835900,43,33,10,12
8,2005,835900,53,43,10,5
9,2005,835900,40,32,8,26
10,2005,835900,45,37,8,13
11,2005,835900,34,31,3,8
12,2005,835900,31,26,5,3
1,2006,835900,44,40,4,7
2,2006,835900,25,19,6,9
3,2006,835900,28,25,3,1
4,2006,835900,53,47,6,12
5,2006,835900,39,36,3,15
6,2006,835900,41,33,8,5
7,2006,835900,44,36,8,5
8,2006,835900,39,37,2,7
9,2006,835900,31,28,3,14
10,2006,835900,31,22,9,7
11,2006,835900,26,21,5,3
12,2006,835900,33,26,7,12
1,2007,835900,34,27,7,8
2,2007,835900,16,12,4,9
3,2007,835900,28,26,2,12
4,2007,835900,22,18,4,8
5,2007,835900,33,29,4,10
6,2007,835900,34,30,4,14
7,2007,835900,45,38,7,5
8,2007,835900,34,26,8,8
9,2007,835900,31,20,11,2
10,2007,835900,44,34,10,9
11,2007,835900,33,25,8,6
12,2007,835900,26,24,2,12
1,2008,835900,21,18,3,11
2,2008,835900,20,13,7,5
3,2008,835900,29,28,1,12
4,2008,835900,44,37,7,13
5,2008,835900,33,29,4,14
6,2008,835900,32,27,5,4
7,2008,835900,31,26,5,13
8,2008,835900,30,23,7,18
9,2008,835900,39,32,7,18
10,2008,835900,38,35,3,19
11,2008,835900,42,40,2,10
12,2008,835900,21,18,3,11
1,2009,835900,32,30,2,18
2,2009,835900,26,24,2,15
3,2009,835900,29,22,7,23
4,2009,835900,31,23,8,23
5,2009,835900,38,29,9,16
6,2009,835900,34,23,11,17
7,2009,835900,45,39,6,16
8,2009,835900,41,32,9,18
9,2009,835900,26,19,7,13
10,2009,835900,34,29,5,17
11,2009,835900,24,20,4,17
12,2009,835900,35,33,2,11
1,2010,835900,25,23,2,19
2,2010,835900,18,17,1,12
3,2010,835900,35,31,4,15
4,2010,835900,24,22,2,10
5,2010,835900,40,32,8,15
6,2010,835900,26,21,5,17
7,2010,835900,30,25,5,18
8,2010,835900,29,27,2,10
9,2010,835900,32,28,4,18
10,2010,835900,25,20,5,15
11,2010,835900,22,18,4,18
12,2010,835900,20,18,2,18
1,2011,835900,18,17,1,21
2,2011,835900,19,15,4,13
1,1999,836400,6,5,1,1
2,1999,836400,6,5,1,1
3,1999,836400,9,7,2,0
4,1999,836400,9,8,1,0
5,1999,836400,14,11,3,3
6,1999,836400,13,11,2,0
7,1999,836400,16,12,4,1
8,1999,836400,5,5,0,3
9,1999,836400,8,8,0,0
10,1999,836400,12,12,0,0
11,1999,836400,13,9,4,2
12,1999,836400,7,7,0,0
1,2000,836400,10,9,1,0
2,2000,836400,10,9,1,1
3,2000,836400,11,8,3,3
4,2000,836400,12,8,4,3
5,2000,836400,14,13,1,4
6,2000,836400,13,12,1,0
7,2000,836400,14,12,2,1
8,2000,836400,14,11,3,1
9,2000,836400,19,15,4,2
10,2000,836400,21,19,2,4
11,2000,836400,5,4,1,0
12,2000,836400,3,2,1,1
1,2001,836400,6,5,1,2
2,2001,836400,9,5,4,2
3,2001,836400,6,3,3,3
4,2001,836400,9,3,6,1
5,2001,836400,4,3,1,1
6,2001,836400,13,7,6,0
7,2001,836400,9,9,0,1
8,2001,836400,8,5,3,1
9,2001,836400,16,16,0,4
10,2001,836400,11,10,1,0
11,2001,836400,8,8,0,0
12,2001,836400,5,5,0,0
1,2002,836400,8,8,0,1
2,2002,836400,7,6,1,1
3,2002,836400,4,4,0,2
4,2002,836400,10,6,4,3
5,2002,836400,12,10,2,0
6,2002,836400,11,9,2,3
7,2002,836400,9,7,2,0
8,2002,836400,11,10,1,0
9,2002,836400,7,6,1,0
10,2002,836400,8,6,2,0
11,2002,836400,7,6,1,0
12,2002,836400,8,7,1,0
1,2003,836400,5,4,1,0
2,2003,836400,4,4,0,0
3,2003,836400,3,1,2,2
4,2003,836400,9,8,1,0
5,2003,836400,9,7,2,1
6,2003,836400,4,3,1,2
7,2003,836400,14,13,1,2
8,2003,836400,7,6,1,0
9,2003,836400,8,7,1,1
10,2003,836400,11,11,0,1
11,2003,836400,10,9,1,0
12,2003,836400,4,4,0,2
1,2004,836400,7,7,0,1
2,2004,836400,6,5,1,0
3,2004,836400,13,11,2,0
4,2004,836400,5,5,0,1
5,2004,836400,14,13,1,2
6,2004,836400,10,9,1,0
7,2004,836400,17,12,5,1
8,2004,836400,12,11,1,1
9,2004,836400,13,12,1,2
10,2004,836400,12,12,0,0
11,2004,836400,8,8,0,0
12,2004,836400,7,7,0,0
1,2005,836400,11,10,1,0
2,2005,836400,5,5,0,0
3,2005,836400,4,4,0,0
4,2005,836400,8,8,0,0
5,2005,836400,8,6,2,1
6,2005,836400,10,8,2,0
7,2005,836400,12,12,0,1
8,2005,836400,21,16,5,0
9,2005,836400,14,7,7,0
10,2005,836400,14,13,1,0
11,2005,836400,9,8,1,1
12,2005,836400,5,3,2,0
1,2006,836400,8,7,1,0
2,2006,836400,17,13,4,0
3,2006,836400,15,10,5,0
4,2006,836400,10,7,3,0
5,2006,836400,12,9,3,0
6,2006,836400,11,9,2,0
7,2006,836400,10,10,0,1
8,2006,836400,6,5,1,0
9,2006,836400,10,9,1,1
10,2006,836400,12,11,1,0
11,2006,836400,11,8,3,0
12,2006,836400,0,0,0,1
1,2007,836400,10,10,0,0
2,2007,836400,1,1,0,1
3,2007,836400,8,7,1,0
4,2007,836400,11,11,0,1
5,2007,836400,5,5,0,0
6,2007,836400,5,4,1,2
7,2007,836400,8,7,1,2
8,2007,836400,8,7,1,3
9,2007,836400,8,8,0,0
10,2007,836400,5,5,0,0
11,2007,836400,7,7,0,3
12,2007,836400,11,9,2,4
1,2008,836400,6,5,1,0
2,2008,836400,8,7,1,0
3,2008,836400,6,6,0,0
4,2008,836400,11,10,1,3
5,2008,836400,16,13,3,5
6,2008,836400,8,7,1,1
7,2008,836400,10,9,1,2
8,2008,836400,6,5,1,2
9,2008,836400,6,6,0,0
10,2008,836400,9,8,1,3
11,2008,836400,9,9,0,2
12,2008,836400,9,8,1,0
1,2009,836400,4,4,0,1
2,2009,836400,5,3,2,0
3,2009,836400,8,8,0,3
4,2009,836400,8,7,1,0
5,2009,836400,10,9,1,1
6,2009,836400,2,2,0,1
7,2009,836400,7,6,1,1
8,2009,836400,14,13,1,2
9,2009,836400,7,7,0,3
10,2009,836400,14,13,1,1
11,2009,836400,4,4,0,4
12,2009,836400,11,11,0,4
1,2010,836400,3,3,0,0
2,2010,836400,7,6,1,1
3,2010,836400,15,14,1,0
4,2010,836400,5,4,1,1
5,2010,836400,10,8,2,1
6,2010,836400,8,6,2,1
7,2010,836400,9,9,0,1
8,2010,836400,14,12,2,4
9,2010,836400,12,9,3,1
10,2010,836400,16,14,2,1
11,2010,836400,11,11,0,1
12,2010,836400,13,11,2,0
1,2011,836400,9,8,1,0
2,2011,836400,5,4,1,0
1,1999,580501,22,19,3,1
2,1999,580501,19,15,4,4
3,1999,580501,19,15,4,6
4,1999,580501,14,12,2,10
5,1999,580501,19,14,5,2
6,1999,580501,22,20,2,0
7,1999,580501,14,11,3,5
8,1999,580501,14,12,2,8
9,1999,580501,17,14,3,9
10,1999,580501,21,18,3,8
11,1999,580501,21,18,3,8
12,1999,580501,14,14,0,5
1,2000,580501,16,16,0,11
2,2000,580501,22,22,0,10
3,2000,580501,20,16,4,6
4,2000,580501,23,20,3,11
5,2000,580501,19,18,1,8
6,2000,580501,15,14,1,3
7,2000,580501,19,17,2,1
8,2000,580501,33,32,1,1
9,2000,580501,23,22,1,6
10,2000,580501,29,26,3,5
11,2000,580501,29,25,4,1
12,2000,580501,16,13,3,5
1,2001,580501,21,19,2,6
2,2001,580501,23,23,0,3
3,2001,580501,11,7,4,4
4,2001,580501,20,18,2,6
5,2001,580501,18,14,4,3
6,2001,580501,12,10,2,6
7,2001,580501,17,15,2,2
8,2001,580501,25,21,4,2
9,2001,580501,19,16,3,12
10,2001,580501,23,17,6,5
11,2001,580501,18,15,3,4
12,2001,580501,19,16,3,7
1,2002,580501,13,11,2,6
2,2002,580501,19,17,2,7
3,2002,580501,21,19,2,5
4,2002,580501,16,15,1,5
5,2002,580501,20,20,0,5
6,2002,580501,23,19,4,4
7,2002,580501,15,14,1,4
8,2002,580501,21,18,3,2
9,2002,580501,19,15,4,4
10,2002,580501,22,16,6,3
11,2002,580501,20,16,4,7
12,2002,580501,11,9,2,5
1,2003,580501,14,13,1,5
2,2003,580501,19,15,4,8
3,2003,580501,19,17,2,8
4,2003,580501,21,18,3,6
5,2003,580501,18,18,0,7
6,2003,580501,19,19,0,4
7,2003,580501,27,21,6,2
8,2003,580501,13,13,0,3
9,2003,580501,16,12,4,7
10,2003,580501,21,16,5,8
11,2003,580501,17,14,3,4
12,2003,580501,20,16,4,2
1,2004,580501,16,13,3,6
2,2004,580501,27,24,3,6
3,2004,580501,10,9,1,9
4,2004,580501,11,8,3,6
5,2004,580501,15,12,3,6
6,2004,580501,13,12,1,6
7,2004,580501,29,26,3,1
8,2004,580501,17,13,4,2
9,2004,580501,20,15,5,5
10,2004,580501,16,12,4,10
11,2004,580501,16,14,2,1
12,2004,580501,14,10,4,6
1,2005,580501,21,17,4,0
2,2005,580501,20,16,4,4
3,2005,580501,18,14,4,7
4,2005,580501,18,12,6,6
5,2005,580501,15,13,2,6
6,2005,580501,16,14,2,3
7,2005,580501,15,11,4,3
8,2005,580501,10,8,2,1
9,2005,580501,18,16,2,3
10,2005,580501,15,13,2,8
11,2005,580501,18,14,4,1
12,2005,580501,23,21,2,1
1,2006,580501,18,15,3,1
2,2006,580501,20,18,2,9
3,2006,580501,16,12,4,3
4,2006,580501,14,13,1,5
5,2006,580501,19,17,2,6
6,2006,580501,18,14,4,2
7,2006,580501,13,7,6,5
8,2006,580501,14,13,1,5
9,2006,580501,15,14,1,3
10,2006,580501,14,14,0,7
11,2006,580501,18,13,5,4
12,2006,580501,14,12,2,7
1,2007,580501,15,15,0,2
2,2007,580501,9,9,0,8
3,2007,580501,22,18,4,6
4,2007,580501,13,10,3,9
5,2007,580501,20,17,3,5
6,2007,580501,18,13,5,2
7,2007,580501,19,15,4,5
8,2007,580501,20,16,4,2
9,2007,580501,13,11,2,4
10,2007,580501,15,10,5,4
11,2007,580501,18,15,3,7
12,2007,580501,11,10,1,6
1,2008,580501,26,24,2,3
2,2008,580501,16,12,4,3
3,2008,580501,14,13,1,6
4,2008,580501,16,13,3,2
5,2008,580501,17,13,4,4
6,2008,580501,19,15,4,1
7,2008,580501,10,10,0,7
8,2008,580501,18,15,3,3
9,2008,580501,6,6,0,0
10,2008,580501,15,9,6,5
11,2008,580501,15,11,4,2
12,2008,580501,10,8,2,4
1,2009,580501,10,10,0,2
2,2009,580501,11,10,1,8
3,2009,580501,16,13,3,1
4,2009,580501,20,17,3,5
5,2009,580501,18,14,4,2
6,2009,580501,12,8,4,2
7,2009,580501,11,9,2,6
8,2009,580501,12,11,1,9
9,2009,580501,7,5,2,4
10,2009,580501,10,9,1,11
11,2009,580501,15,14,1,7
12,2009,580501,12,11,1,6
1,2010,580501,10,7,3,4
2,2010,580501,10,9,1,6
3,2010,580501,8,5,3,8
4,2010,580501,14,9,5,5
5,2010,580501,15,13,2,10
6,2010,580501,16,13,3,3
7,2010,580501,7,6,1,1
8,2010,580501,7,6,1,4
9,2010,580501,12,8,4,5
10,2010,580501,20,14,6,4
11,2010,580501,14,12,2,0
12,2010,580501,23,21,2,1
1,2011,580501,22,19,3,0
2,2011,580501,5,4,1,4
1,1999,380200,23,19,4,3
2,1999,380200,19,18,1,2
3,1999,380200,15,13,2,1
4,1999,380200,14,9,5,2
5,1999,380200,35,29,6,2
6,1999,380200,15,12,3,1
7,1999,380200,24,16,8,0
8,1999,380200,22,19,3,1
9,1999,380200,23,18,5,0
10,1999,380200,27,24,3,3
11,1999,380200,13,10,3,0
12,1999,380200,14,14,0,0
1,2000,380200,14,9,5,0
2,2000,380200,6,4,2,2
3,2000,380200,11,9,2,3
4,2000,380200,15,12,3,4
5,2000,380200,23,19,4,1
6,2000,380200,21,17,4,1
7,2000,380200,15,10,5,1
8,2000,380200,15,14,1,1
9,2000,380200,25,19,6,2
10,2000,380200,12,9,3,1
11,2000,380200,17,9,8,2
12,2000,380200,18,13,5,5
1,2001,380200,15,14,1,2
2,2001,380200,10,8,2,2
3,2001,380200,18,14,4,2
4,2001,380200,22,20,2,1
5,2001,380200,22,17,5,1
6,2001,380200,28,24,4,6
7,2001,380200,19,17,2,1
8,2001,380200,28,23,5,2
9,2001,380200,14,9,5,3
10,2001,380200,14,10,4,1
11,2001,380200,17,16,1,0
12,2001,380200,10,8,2,2
1,2002,380200,25,22,3,0
2,2002,380200,10,7,3,1
3,2002,380200,7,6,1,4
4,2002,380200,11,11,0,5
5,2002,380200,18,15,3,2
6,2002,380200,14,11,3,1
7,2002,380200,13,12,1,6
8,2002,380200,15,12,3,4
9,2002,380200,13,8,5,0
10,2002,380200,18,16,2,1
11,2002,380200,10,8,2,3
12,2002,380200,17,16,1,1
1,2003,380200,11,9,2,7
2,2003,380200,8,8,0,2
3,2003,380200,12,8,4,6
4,2003,380200,8,7,1,6
5,2003,380200,15,12,3,3
6,2003,380200,20,18,2,1
7,2003,380200,16,12,4,1
8,2003,380200,27,26,1,2
9,2003,380200,27,24,3,0
10,2003,380200,28,24,4,4
11,2003,380200,18,14,4,9
12,2003,380200,12,10,2,3
1,2004,380200,14,11,3,3
2,2004,380200,11,8,3,3
3,2004,380200,13,8,5,5
4,2004,380200,12,12,0,2
5,2004,380200,30,29,1,1
6,2004,380200,18,14,4,0
7,2004,380200,29,27,2,1
8,2004,380200,20,16,4,3
9,2004,380200,21,17,4,2
10,2004,380200,13,13,0,4
11,2004,380200,15,14,1,2
12,2004,380200,13,9,4,4
1,2005,380200,19,19,0,7
2,2005,380200,6,5,1,4
3,2005,380200,14,13,1,5
4,2005,380200,18,15,3,9
5,2005,380200,12,10,2,3
6,2005,380200,16,13,3,1
7,2005,380200,10,9,1,4
8,2005,380200,20,15,5,2
9,2005,380200,14,13,1,3
10,2005,380200,18,15,3,0
11,2005,380200,13,11,2,1
12,2005,380200,13,10,3,4
1,2006,380200,19,17,2,5
2,2006,380200,23,22,1,2
3,2006,380200,25,24,1,0
4,2006,380200,17,13,4,3
5,2006,380200,19,17,2,1
6,2006,380200,15,11,4,1
7,2006,380200,19,18,1,0
8,2006,380200,23,20,3,2
9,2006,380200,14,12,2,0
10,2006,380200,19,19,0,2
11,2006,380200,14,13,1,3
12,2006,380200,12,11,1,2
1,2007,380200,11,10,1,1
2,2007,380200,12,7,5,2
3,2007,380200,9,7,2,1
4,2007,380200,9,7,2,0
5,2007,380200,22,17,5,4
6,2007,380200,16,10,6,4
7,2007,380200,9,9,0,0
8,2007,380200,14,12,2,4
9,2007,380200,13,11,2,8
10,2007,380200,16,12,4,2
11,2007,380200,12,11,1,1
12,2007,380200,9,9,0,4
1,2008,380200,17,15,2,1
2,2008,380200,6,6,0,0
3,2008,380200,5,5,0,2
4,2008,380200,12,12,0,3
5,2008,380200,18,16,2,2
6,2008,380200,22,20,2,6
7,2008,380200,19,19,0,3
8,2008,380200,13,12,1,5
9,2008,380200,11,11,0,9
10,2008,380200,11,11,0,3
11,2008,380200,14,13,1,1
12,2008,380200,7,6,1,1
1,2009,380200,15,14,1,4
2,2009,380200,11,9,2,1
3,2009,380200,11,10,1,2
4,2009,380200,8,8,0,4
5,2009,380200,13,11,2,5
6,2009,380200,8,8,0,2
7,2009,380200,10,8,2,1
8,2009,380200,11,10,1,8
9,2009,380200,7,5,2,4
10,2009,380200,7,6,1,3
11,2009,380200,10,9,1,2
12,2009,380200,9,8,1,1
1,2010,380200,10,9,1,10
2,2010,380200,10,10,0,4
3,2010,380200,8,7,1,0
4,2010,380200,3,3,0,2
5,2010,380200,15,14,1,4
6,2010,380200,10,8,2,0
7,2010,380200,4,4,0,1
8,2010,380200,11,11,0,0
9,2010,380200,11,10,1,2
10,2010,380200,5,5,0,1
11,2010,380200,9,9,0,0
12,2010,380200,7,7,0,1
1,2011,380200,4,4,0,1
2,2011,380200,7,7,0,3
1,1999,380100,14,10,4,1
2,1999,380100,11,8,3,1
3,1999,380100,12,8,4,3
4,1999,380100,9,8,1,1
5,1999,380100,13,12,1,1
6,1999,380100,17,11,6,0
7,1999,380100,16,11,5,0
8,1999,380100,15,14,1,5
9,1999,380100,15,12,3,0
10,1999,380100,14,10,4,2
11,1999,380100,12,10,2,5
12,1999,380100,14,13,1,0
1,2000,380100,7,7,0,6
2,2000,380100,6,5,1,6
3,2000,380100,11,10,1,4
4,2000,380100,15,14,1,4
5,2000,380100,12,10,2,5
6,2000,380100,17,14,3,4
7,2000,380100,14,10,4,5
8,2000,380100,13,9,4,1
9,2000,380100,21,16,5,2
10,2000,380100,25,20,5,6
11,2000,380100,12,9,3,2
12,2000,380100,15,9,6,8
1,2001,380100,9,8,1,1
2,2001,380100,8,7,1,1
3,2001,380100,8,5,3,3
4,2001,380100,18,10,8,6
5,2001,380100,14,9,5,5
6,2001,380100,9,7,2,0
7,2001,380100,7,7,0,5
8,2001,380100,17,11,6,4
9,2001,380100,10,7,3,1
10,2001,380100,27,21,6,0
11,2001,380100,5,3,2,4
12,2001,380100,9,8,1,0
1,2002,380100,9,7,2,7
2,2002,380100,6,5,1,7
3,2002,380100,16,12,4,6
4,2002,380100,10,7,3,2
5,2002,380100,9,8,1,4
6,2002,380100,12,9,3,6
7,2002,380100,14,11,3,2
8,2002,380100,22,19,3,4
9,2002,380100,19,11,8,5
10,2002,380100,10,10,0,2
11,2002,380100,12,10,2,5
12,2002,380100,10,6,4,6
1,2003,380100,7,4,3,2
2,2003,380100,7,5,2,2
3,2003,380100,7,4,3,5
4,2003,380100,14,14,0,2
5,2003,380100,12,7,5,5
6,2003,380100,15,14,1,2
7,2003,380100,17,15,2,0
8,2003,380100,21,20,1,2
9,2003,380100,19,17,2,1
10,2003,380100,18,16,2,0
11,2003,380100,12,12,0,3
12,2003,380100,9,8,1,0
1,2004,380100,8,6,2,3
2,2004,380100,14,11,3,7
3,2004,380100,6,6,0,0
4,2004,380100,15,14,1,3
5,2004,380100,17,15,2,4
6,2004,380100,17,13,4,3
7,2004,380100,25,22,3,1
8,2004,380100,13,11,2,1
9,2004,380100,19,14,5,1
10,2004,380100,16,12,4,4
11,2004,380100,20,13,7,0
12,2004,380100,9,6,3,4
1,2005,380100,12,10,2,7
2,2005,380100,7,7,0,5
3,2005,380100,9,9,0,3
4,2005,380100,17,16,1,6
5,2005,380100,13,11,2,6
6,2005,380100,10,6,4,1
7,2005,380100,18,16,2,0
8,2005,380100,12,9,3,2
9,2005,380100,14,11,3,4
10,2005,380100,12,8,4,0
11,2005,380100,16,15,1,0
12,2005,380100,11,8,3,0
1,2006,380100,17,13,4,1
2,2006,380100,8,6,2,6
3,2006,380100,15,10,5,4
4,2006,380100,14,12,2,12
5,2006,380100,18,14,4,4
6,2006,380100,17,14,3,2
7,2006,380100,23,21,2,2
8,2006,380100,22,18,4,1
9,2006,380100,28,24,4,2
10,2006,380100,10,4,6,5
11,2006,380100,10,8,2,2
12,2006,380100,10,7,3,8
1,2007,380100,13,11,2,0
2,2007,380100,11,7,4,4
3,2007,380100,14,14,0,3
4,2007,380100,10,9,1,1
5,2007,380100,10,8,2,0
6,2007,380100,16,12,4,8
7,2007,380100,14,8,6,5
8,2007,380100,16,14,2,10
9,2007,380100,10,10,0,10
10,2007,380100,11,9,2,15
11,2007,380100,4,3,1,13
12,2007,380100,9,7,2,2
1,2008,380100,12,7,5,5
2,2008,380100,11,11,0,9
3,2008,380100,9,7,2,2
4,2008,380100,10,9,1,6
5,2008,380100,17,14,3,1
6,2008,380100,15,12,3,2
7,2008,380100,22,19,3,5
8,2008,380100,15,15,0,11
9,2008,380100,9,7,2,6
10,2008,380100,12,12,0,4
11,2008,380100,10,10,0,6
12,2008,380100,8,7,1,1
1,2009,380100,12,11,1,1
2,2009,380100,7,7,0,2
3,2009,380100,4,3,1,3
4,2009,380100,18,12,6,2
5,2009,380100,12,9,3,2
6,2009,380100,12,11,1,7
7,2009,380100,13,10,3,2
8,2009,380100,15,13,2,3
9,2009,380100,15,13,2,4
10,2009,380100,22,19,3,3
11,2009,380100,13,10,3,4
12,2009,380100,13,13,0,5
1,2010,380100,5,4,1,7
2,2010,380100,6,6,0,5
3,2010,380100,9,6,3,7
4,2010,380100,12,7,5,6
5,2010,380100,9,7,2,3
6,2010,380100,9,8,1,2
7,2010,380100,14,8,6,5
8,2010,380100,15,14,1,4
9,2010,380100,13,12,1,4
10,2010,380100,13,9,4,3
11,2010,380100,8,7,1,4
12,2010,380100,4,4,0,9
1,2011,380100,10,9,1,5
2,2011,380100,7,6,1,4
1,1999,580300,8,7,1,0
2,1999,580300,6,5,1,1
3,1999,580300,2,1,1,1
4,1999,580300,2,1,1,0
5,1999,580300,9,9,0,0
6,1999,580300,4,3,1,0
7,1999,580300,13,11,2,1
8,1999,580300,7,5,2,0
9,1999,580300,5,4,1,1
10,1999,580300,8,8,0,1
11,1999,580300,5,3,2,6
12,1999,580300,8,6,2,2
1,2000,580300,3,2,1,3
2,2000,580300,5,2,3,0
3,2000,580300,9,7,2,3
4,2000,580300,12,12,0,3
5,2000,580300,9,5,4,0
6,2000,580300,11,10,1,2
7,2000,580300,8,7,1,2
8,2000,580300,13,8,5,1
9,2000,580300,5,2,3,0
10,2000,580300,13,11,2,0
11,2000,580300,8,8,0,0
12,2000,580300,10,10,0,1
1,2001,580300,7,6,1,0
2,2001,580300,2,1,1,4
3,2001,580300,7,5,2,1
4,2001,580300,13,10,3,1
5,2001,580300,10,9,1,2
6,2001,580300,8,6,2,1
7,2001,580300,8,5,3,0
8,2001,580300,14,12,2,3
9,2001,580300,14,11,3,1
10,2001,580300,7,7,0,1
11,2001,580300,10,10,0,1
12,2001,580300,3,3,0,2
1,2002,580300,7,6,1,4
2,2002,580300,5,3,2,1
3,2002,580300,6,5,1,3
4,2002,580300,8,6,2,0
5,2002,580300,12,9,3,0
6,2002,580300,5,4,1,2
7,2002,580300,11,9,2,1
8,2002,580300,6,5,1,2
9,2002,580300,11,10,1,0
10,2002,580300,10,8,2,1
11,2002,580300,12,9,3,5
12,2002,580300,13,12,1,1
1,2003,580300,7,7,0,6
2,2003,580300,11,11,0,2
3,2003,580300,12,12,0,1
4,2003,580300,15,11,4,1
5,2003,580300,12,10,2,2
6,2003,580300,7,5,2,1
7,2003,580300,14,11,3,1
8,2003,580300,13,10,3,3
9,2003,580300,6,6,0,1
10,2003,580300,15,12,3,1
11,2003,580300,6,6,0,3
12,2003,580300,6,5,1,4
1,2004,580300,11,10,1,2
2,2004,580300,6,6,0,0
3,2004,580300,8,7,1,3
4,2004,580300,6,6,0,2
5,2004,580300,12,11,1,2
6,2004,580300,15,15,0,2
7,2004,580300,10,8,2,3
8,2004,580300,11,9,2,3
9,2004,580300,11,9,2,1
10,2004,580300,13,7,6,1
11,2004,580300,8,7,1,4
12,2004,580300,8,8,0,2
1,2005,580300,6,6,0,2
2,2005,580300,1,0,1,1
3,2005,580300,8,7,1,2
4,2005,580300,7,7,0,1
5,2005,580300,2,2,0,5
6,2005,580300,6,4,2,1
7,2005,580300,10,9,1,2
8,2005,580300,10,7,3,2
9,2005,580300,10,8,2,0
10,2005,580300,10,6,4,2
11,2005,580300,5,2,3,0
12,2005,580300,3,3,0,0
1,2006,580300,8,6,2,1
2,2006,580300,4,4,0,1
3,2006,580300,9,9,0,2
4,2006,580300,9,6,3,3
5,2006,580300,7,4,3,2
6,2006,580300,7,7,0,0
7,2006,580300,8,8,0,2
8,2006,580300,8,7,1,3
9,2006,580300,10,8,2,1
10,2006,580300,6,5,1,2
11,2006,580300,5,4,1,5
12,2006,580300,5,2,3,4
1,2007,580300,3,2,1,2
2,2007,580300,2,2,0,1
3,2007,580300,6,6,0,4
4,2007,580300,9,8,1,8
5,2007,580300,4,4,0,1
6,2007,580300,6,3,3,1
7,2007,580300,9,6,3,3
8,2007,580300,8,6,2,8
9,2007,580300,4,3,1,3
10,2007,580300,6,6,0,3
11,2007,580300,8,7,1,1
12,2007,580300,4,4,0,0
1,2008,580300,4,3,1,3
2,2008,580300,3,3,0,1
3,2008,580300,5,5,0,2
4,2008,580300,5,5,0,4
5,2008,580300,1,0,1,2
6,2008,580300,4,4,0,3
7,2008,580300,5,5,0,6
8,2008,580300,2,2,0,1
9,2008,580300,5,4,1,1
10,2008,580300,6,6,0,2
11,2008,580300,5,4,1,0
12,2008,580300,2,0,2,2
1,2009,580300,2,2,0,3
2,2009,580300,1,1,0,1
3,2009,580300,3,3,0,1
4,2009,580300,7,6,1,0
5,2009,580300,6,5,1,2
6,2009,580300,2,2,0,1
7,2009,580300,7,5,2,1
8,2009,580300,7,4,3,1
9,2009,580300,9,7,2,1
10,2009,580300,8,6,2,2
11,2009,580300,7,6,1,0
12,2009,580300,9,9,0,1
1,2010,580300,8,8,0,2
2,2010,580300,2,2,0,2
3,2010,580300,6,5,1,1
4,2010,580300,7,7,0,2
5,2010,580300,11,7,4,3
6,2010,580300,11,8,3,2
7,2010,580300,4,3,1,2
8,2010,580300,4,4,0,2
9,2010,580300,1,1,0,1
10,2010,580300,8,7,1,2
11,2010,580300,4,4,0,2
12,2010,580300,9,9,0,1
1,2011,580300,9,8,1,1
2,2011,580300,5,5,0,1
1,1999,580200,7,5,2,1
2,1999,580200,4,3,1,2
3,1999,580200,14,11,3,2
4,1999,580200,11,9,2,4
5,1999,580200,15,10,5,2
6,1999,580200,19,18,1,3
7,1999,580200,10,7,3,8
8,1999,580200,12,9,3,0
9,1999,580200,8,8,0,7
10,1999,580200,12,11,1,4
11,1999,580200,16,14,2,1
12,1999,580200,7,7,0,0
1,2000,580200,5,5,0,1
2,2000,580200,12,10,2,1
3,2000,580200,16,13,3,3
4,2000,580200,3,2,1,3
5,2000,580200,12,11,1,3
6,2000,580200,11,10,1,3
7,2000,580200,9,8,1,0
8,2000,580200,15,13,2,0
9,2000,580200,7,6,1,3
10,2000,580200,19,14,5,2
11,2000,580200,6,5,1,1
12,2000,580200,7,7,0,4
1,2001,580200,7,4,3,3
2,2001,580200,4,4,0,5
3,2001,580200,13,11,2,2
4,2001,580200,8,6,2,4
5,2001,580200,11,9,2,10
6,2001,580200,11,8,3,4
7,2001,580200,9,7,2,2
8,2001,580200,13,9,4,1
9,2001,580200,16,12,4,1
10,2001,580200,8,6,2,3
11,2001,580200,11,10,1,0
12,2001,580200,6,3,3,0
1,2002,580200,11,10,1,4
2,2002,580200,11,10,1,1
3,2002,580200,11,9,2,6
4,2002,580200,14,10,4,8
5,2002,580200,10,9,1,8
6,2002,580200,15,13,2,3
7,2002,580200,13,11,2,0
8,2002,580200,13,11,2,2
9,2002,580200,6,5,1,3
10,2002,580200,13,12,1,1
11,2002,580200,20,16,4,0
12,2002,580200,6,3,3,2
1,2003,580200,14,13,1,5
2,2003,580200,7,7,0,0
3,2003,580200,19,18,1,5
4,2003,580200,12,9,3,1
5,2003,580200,7,7,0,1
6,2003,580200,13,9,4,4
7,2003,580200,10,8,2,3
8,2003,580200,8,6,2,2
9,2003,580200,7,7,0,2
10,2003,580200,8,7,1,2
11,2003,580200,9,7,2,5
12,2003,580200,4,1,3,7
1,2004,580200,3,3,0,2
2,2004,580200,14,10,4,2
3,2004,580200,12,9,3,5
4,2004,580200,3,3,0,6
5,2004,580200,11,8,3,4
6,2004,580200,17,16,1,5
7,2004,580200,10,9,1,4
8,2004,580200,10,8,2,4
9,2004,580200,9,7,2,3
10,2004,580200,16,14,2,0
11,2004,580200,11,11,0,3
12,2004,580200,9,8,1,7
1,2005,580200,15,13,2,7
2,2005,580200,11,8,3,5
3,2005,580200,4,4,0,5
4,2005,580200,8,7,1,1
5,2005,580200,11,9,2,5
6,2005,580200,9,7,2,1
7,2005,580200,13,11,2,2
8,2005,580200,12,9,3,6
9,2005,580200,5,4,1,4
10,2005,580200,8,6,2,4
11,2005,580200,6,5,1,7
12,2005,580200,8,7,1,3
1,2006,580200,7,7,0,0
2,2006,580200,12,9,3,3
3,2006,580200,7,6,1,5
4,2006,580200,9,8,1,4
5,2006,580200,11,8,3,3
6,2006,580200,11,9,2,2
7,2006,580200,12,10,2,10
8,2006,580200,4,4,0,8
9,2006,580200,10,9,1,0
10,2006,580200,18,15,3,9
11,2006,580200,9,8,1,4
12,2006,580200,10,6,4,2
1,2007,580200,9,8,1,1
2,2007,580200,6,6,0,3
3,2007,580200,15,10,5,1
4,2007,580200,11,8,3,2
5,2007,580200,11,10,1,7
6,2007,580200,9,8,1,5
7,2007,580200,11,11,0,4
8,2007,580200,14,13,1,4
9,2007,580200,13,10,3,6
10,2007,580200,14,10,4,4
11,2007,580200,8,7,1,4
12,2007,580200,7,6,1,3
1,2008,580200,9,8,1,5
2,2008,580200,9,8,1,5
3,2008,580200,8,8,0,7
4,2008,580200,5,4,1,3
5,2008,580200,6,4,2,1
6,2008,580200,12,9,3,5
7,2008,580200,10,9,1,7
8,2008,580200,9,9,0,3
9,2008,580200,9,8,1,7
10,2008,580200,10,8,2,6
11,2008,580200,10,9,1,8
12,2008,580200,7,5,2,5
1,2009,580200,7,7,0,2
2,2009,580200,8,6,2,2
3,2009,580200,8,7,1,6
4,2009,580200,6,3,3,7
5,2009,580200,12,9,3,11
6,2009,580200,15,14,1,12
7,2009,580200,5,4,1,6
8,2009,580200,7,6,1,4
9,2009,580200,4,3,1,6
10,2009,580200,10,7,3,8
11,2009,580200,0,0,0,4
12,2009,580200,3,3,0,4
1,2010,580200,8,8,0,3
2,2010,580200,7,5,2,3
3,2010,580200,7,5,2,3
4,2010,580200,7,6,1,4
5,2010,580200,8,6,2,1
6,2010,580200,9,7,2,5
7,2010,580200,14,14,0,3
8,2010,580200,9,9,0,3
9,2010,580200,6,5,1,5
10,2010,580200,8,8,0,3
11,2010,580200,6,5,1,5
12,2010,580200,13,13,0,3
1,2011,580200,10,9,1,1
2,2011,580200,7,6,1,0
1,1999,590500,20,16,4,1
2,1999,590500,18,14,4,4
3,1999,590500,10,7,3,2
4,1999,590500,14,12,2,1
5,1999,590500,15,14,1,0
6,1999,590500,19,17,2,2
7,1999,590500,21,21,0,1
8,1999,590500,28,26,2,6
9,1999,590500,11,11,0,3
10,1999,590500,13,13,0,5
11,1999,590500,15,15,0,0
12,1999,590500,7,6,1,0
1,2000,590500,14,13,1,0
2,2000,590500,15,14,1,2
3,2000,590500,19,18,1,3
4,2000,590500,17,13,4,2
5,2000,590500,15,14,1,1
6,2000,590500,17,17,0,3
7,2000,590500,25,24,1,3
8,2000,590500,20,18,2,0
9,2000,590500,17,16,1,5
10,2000,590500,11,10,1,3
11,2000,590500,11,10,1,7
12,2000,590500,17,16,1,1
1,2001,590500,17,16,1,0
2,2001,590500,11,10,1,3
3,2001,590500,16,14,2,3
4,2001,590500,16,16,0,7
5,2001,590500,23,18,5,3
6,2001,590500,25,21,4,5
7,2001,590500,24,22,2,8
8,2001,590500,20,18,2,6
9,2001,590500,20,18,2,5
10,2001,590500,20,17,3,3
11,2001,590500,11,11,0,2
12,2001,590500,17,16,1,1
1,2002,590500,15,15,0,2
2,2002,590500,14,13,1,1
3,2002,590500,13,12,1,8
4,2002,590500,12,11,1,4
5,2002,590500,14,14,0,2
6,2002,590500,22,21,1,3
7,2002,590500,25,23,2,3
8,2002,590500,14,11,3,2
9,2002,590500,13,11,2,2
10,2002,590500,17,17,0,2
11,2002,590500,13,10,3,1
12,2002,590500,10,9,1,5
1,2003,590500,18,18,0,2
2,2003,590500,15,14,1,2
3,2003,590500,18,18,0,3
4,2003,590500,23,22,1,0
5,2003,590500,17,15,2,2
6,2003,590500,12,11,1,1
7,2003,590500,19,17,2,7
8,2003,590500,22,21,1,5
9,2003,590500,17,15,2,1
10,2003,590500,14,13,1,8
11,2003,590500,16,16,0,3
12,2003,590500,13,13,0,4
1,2004,590500,15,15,0,2
2,2004,590500,15,14,1,3
3,2004,590500,15,14,1,1
4,2004,590500,18,18,0,2
5,2004,590500,10,10,0,5
6,2004,590500,19,16,3,5
7,2004,590500,24,22,2,0
8,2004,590500,18,18,0,4
9,2004,590500,17,16,1,1
10,2004,590500,16,14,2,2
11,2004,590500,24,22,2,2
12,2004,590500,12,11,1,1
1,2005,590500,13,11,2,3
2,2005,590500,12,10,2,2
3,2005,590500,11,11,0,5
4,2005,590500,13,11,2,3
5,2005,590500,20,18,2,5
6,2005,590500,16,14,2,4
7,2005,590500,18,18,0,3
8,2005,590500,8,8,0,0
9,2005,590500,20,19,1,1
10,2005,590500,15,12,3,0
11,2005,590500,12,12,0,2
12,2005,590500,10,10,0,0
1,2006,590500,26,26,0,3
2,2006,590500,9,8,1,0
3,2006,590500,18,16,2,4
4,2006,590500,10,9,1,3
5,2006,590500,14,13,1,2
6,2006,590500,15,14,1,2
7,2006,590500,21,17,4,1
8,2006,590500,23,21,2,3
9,2006,590500,17,15,2,5
10,2006,590500,17,15,2,7
11,2006,590500,10,10,0,1
12,2006,590500,15,15,0,1
1,2007,590500,10,10,0,3
2,2007,590500,11,10,1,3
3,2007,590500,8,7,1,10
4,2007,590500,9,8,1,5
5,2007,590500,11,9,2,1
6,2007,590500,13,12,1,6
7,2007,590500,19,16,3,1
8,2007,590500,7,7,0,5
9,2007,590500,14,12,2,2
10,2007,590500,17,15,2,2
11,2007,590500,14,13,1,2
12,2007,590500,16,16,0,4
1,2008,590500,22,22,0,3
2,2008,590500,7,7,0,1
3,2008,590500,9,8,1,7
4,2008,590500,11,8,3,5
5,2008,590500,15,14,1,4
6,2008,590500,25,23,2,3
7,2008,590500,27,22,5,5
8,2008,590500,20,16,4,7
9,2008,590500,17,14,3,6
10,2008,590500,17,16,1,5
11,2008,590500,14,13,1,7
12,2008,590500,12,11,1,1
1,2009,590500,14,11,3,4
2,2009,590500,7,7,0,4
3,2009,590500,12,11,1,9
4,2009,590500,10,9,1,6
5,2009,590500,14,13,1,4
6,2009,590500,13,12,1,8
7,2009,590500,10,8,2,3
8,2009,590500,17,17,0,8
9,2009,590500,13,12,1,2
10,2009,590500,15,15,0,5
11,2009,590500,12,11,1,4
12,2009,590500,10,10,0,9
1,2010,590500,13,12,1,8
2,2010,590500,4,4,0,5
3,2010,590500,11,10,1,8
4,2010,590500,9,3,6,2
5,2010,590500,10,8,2,2
6,2010,590500,12,10,2,5
7,2010,590500,15,11,4,1
8,2010,590500,13,13,0,9
9,2010,590500,11,10,1,7
10,2010,590500,8,7,1,6
11,2010,590500,23,22,1,2
12,2010,590500,7,7,0,1
1,2011,590500,10,9,1,1
2,2011,590500,6,4,2,2
1,1999,590600,9,7,2,0
2,1999,590600,6,6,0,1
3,1999,590600,4,3,1,0
4,1999,590600,6,5,1,0
5,1999,590600,6,5,1,1
6,1999,590600,11,10,1,1
7,1999,590600,6,5,1,1
8,1999,590600,9,8,1,0
9,1999,590600,8,8,0,0
10,1999,590600,8,6,2,1
11,1999,590600,8,8,0,0
12,1999,590600,12,9,3,1
1,2000,590600,17,14,3,1
2,2000,590600,7,7,0,4
3,2000,590600,9,9,0,1
4,2000,590600,21,17,4,1
5,2000,590600,12,12,0,1
6,2000,590600,9,8,1,0
7,2000,590600,9,8,1,3
8,2000,590600,17,13,4,5
9,2000,590600,11,10,1,1
10,2000,590600,13,10,3,0
11,2000,590600,13,12,1,0
12,2000,590600,12,12,0,1
1,2001,590600,8,8,0,1
2,2001,590600,8,7,1,0
3,2001,590600,6,5,1,4
4,2001,590600,9,8,1,1
5,2001,590600,8,8,0,2
6,2001,590600,10,9,1,0
7,2001,590600,16,15,1,0
8,2001,590600,14,10,4,1
9,2001,590600,11,10,1,0
10,2001,590600,7,6,1,2
11,2001,590600,8,7,1,0
12,2001,590600,23,21,2,0
1,2002,590600,16,16,0,1
2,2002,590600,9,8,1,0
3,2002,590600,11,11,0,0
4,2002,590600,11,11,0,2
5,2002,590600,9,9,0,0
6,2002,590600,17,13,4,2
7,2002,590600,7,7,0,1
8,2002,590600,6,6,0,0
9,2002,590600,9,8,1,1
10,2002,590600,17,16,1,1
11,2002,590600,10,9,1,0
12,2002,590600,12,11,1,1
1,2003,590600,10,8,2,0
2,2003,590600,12,11,1,0
3,2003,590600,17,17,0,0
4,2003,590600,14,11,3,0
5,2003,590600,16,13,3,5
6,2003,590600,14,12,2,1
7,2003,590600,10,8,2,2
8,2003,590600,12,12,0,0
9,2003,590600,11,11,0,1
10,2003,590600,6,6,0,1
11,2003,590600,15,14,1,1
12,2003,590600,9,9,0,2
1,2004,590600,11,9,2,1
2,2004,590600,16,15,1,5
3,2004,590600,10,10,0,4
4,2004,590600,7,7,0,1
5,2004,590600,12,9,3,0
6,2004,590600,15,14,1,1
7,2004,590600,15,14,1,0
8,2004,590600,8,7,1,2
9,2004,590600,6,5,1,0
10,2004,590600,11,8,3,2
11,2004,590600,11,11,0,0
12,2004,590600,9,8,1,1
1,2005,590600,9,8,1,0
2,2005,590600,3,3,0,3
3,2005,590600,4,4,0,1
4,2005,590600,12,11,1,4
5,2005,590600,7,6,1,0
6,2005,590600,5,3,2,0
7,2005,590600,8,5,3,0
8,2005,590600,10,9,1,1
9,2005,590600,5,4,1,4
10,2005,590600,3,3,0,2
11,2005,590600,12,11,1,2
12,2005,590600,10,8,2,1
1,2006,590600,9,8,1,5
2,2006,590600,4,4,0,2
3,2006,590600,10,10,0,1
4,2006,590600,8,6,2,2
5,2006,590600,6,6,0,1
6,2006,590600,7,6,1,4
7,2006,590600,14,11,3,2
8,2006,590600,8,4,4,3
9,2006,590600,9,9,0,3
10,2006,590600,11,10,1,4
11,2006,590600,8,6,2,2
12,2006,590600,7,5,2,0
1,2007,590600,4,3,1,3
2,2007,590600,5,4,1,2
3,2007,590600,12,9,3,4
4,2007,590600,9,9,0,1
5,2007,590600,3,3,0,1
6,2007,590600,8,7,1,1
7,2007,590600,11,9,2,0
8,2007,590600,10,9,1,2
9,2007,590600,10,7,3,2
10,2007,590600,4,4,0,0
11,2007,590600,5,3,2,5
12,2007,590600,6,6,0,0
1,2008,590600,8,7,1,2
2,2008,590600,4,3,1,2
3,2008,590600,6,4,2,1
4,2008,590600,5,4,1,0
5,2008,590600,2,2,0,1
6,2008,590600,12,9,3,0
7,2008,590600,9,6,3,2
8,2008,590600,7,5,2,1
9,2008,590600,3,0,3,0
10,2008,590600,2,2,0,2
11,2008,590600,2,1,1,2
12,2008,590600,5,5,0,2
1,2009,590600,3,3,0,1
2,2009,590600,3,3,0,1
3,2009,590600,11,11,0,6
4,2009,590600,8,7,1,2
5,2009,590600,2,1,1,3
6,2009,590600,6,6,0,2
7,2009,590600,9,7,2,4
8,2009,590600,11,8,3,5
9,2009,590600,8,6,2,7
10,2009,590600,11,11,0,9
11,2009,590600,4,4,0,3
12,2009,590600,7,7,0,2
1,2010,590600,7,7,0,2
2,2010,590600,5,4,1,0
3,2010,590600,7,7,0,3
4,2010,590600,3,3,0,2
5,2010,590600,2,2,0,3
6,2010,590600,9,7,2,2
7,2010,590600,11,10,1,2
8,2010,590600,6,4,2,1
9,2010,590600,7,6,1,3
10,2010,590600,6,6,0,1
11,2010,590600,4,3,1,0
12,2010,590600,11,10,1,1
1,2011,590600,3,2,1,1
2,2011,590600,4,3,1,0
1,1999,590700,19,16,3,0
2,1999,590700,6,5,1,0
3,1999,590700,7,5,2,0
4,1999,590700,3,3,0,0
5,1999,590700,11,10,1,1
6,1999,590700,7,6,1,1
7,1999,590700,8,8,0,0
8,1999,590700,7,7,0,1
9,1999,590700,10,9,1,0
10,1999,590700,12,11,1,1
11,1999,590700,12,8,4,2
12,1999,590700,7,5,2,0
1,2000,590700,15,14,1,1
2,2000,590700,5,5,0,0
3,2000,590700,15,15,0,0
4,2000,590700,11,10,1,1
5,2000,590700,12,12,0,0
6,2000,590700,10,9,1,2
7,2000,590700,15,11,4,0
8,2000,590700,22,18,4,1
9,2000,590700,11,9,2,0
10,2000,590700,12,11,1,1
11,2000,590700,10,8,2,1
12,2000,590700,14,10,4,1
1,2001,590700,13,12,1,2
2,2001,590700,5,5,0,0
3,2001,590700,10,8,2,0
4,2001,590700,12,12,0,1
5,2001,590700,10,10,0,0
6,2001,590700,13,10,3,0
7,2001,590700,15,13,2,1
8,2001,590700,12,11,1,0
9,2001,590700,10,10,0,0
10,2001,590700,12,12,0,0
11,2001,590700,12,10,2,0
12,2001,590700,22,20,2,0
1,2002,590700,10,9,1,0
2,2002,590700,8,7,1,5
3,2002,590700,18,16,2,2
4,2002,590700,5,5,0,0
5,2002,590700,11,10,1,0
6,2002,590700,10,10,0,0
7,2002,590700,21,20,1,0
8,2002,590700,15,15,0,1
9,2002,590700,18,18,0,2
10,2002,590700,18,18,0,2
11,2002,590700,20,18,2,0
12,2002,590700,14,14,0,0
1,2003,590700,10,10,0,2
2,2003,590700,4,4,0,0
3,2003,590700,9,8,1,3
4,2003,590700,11,9,2,0
5,2003,590700,12,12,0,0
6,2003,590700,12,12,0,0
7,2003,590700,9,9,0,0
8,2003,590700,15,15,0,1
9,2003,590700,15,13,2,0
10,2003,590700,14,14,0,1
11,2003,590700,13,13,0,1
12,2003,590700,18,18,0,0
1,2004,590700,6,4,2,1
2,2004,590700,5,5,0,0
3,2004,590700,10,9,1,0
4,2004,590700,8,8,0,0
5,2004,590700,5,5,0,0
6,2004,590700,15,13,2,0
7,2004,590700,20,19,1,1
8,2004,590700,12,12,0,0
9,2004,590700,9,7,2,2
10,2004,590700,11,10,1,0
11,2004,590700,8,8,0,0
12,2004,590700,9,8,1,0
1,2005,590700,7,6,1,0
2,2005,590700,3,2,1,1
3,2005,590700,10,10,0,3
4,2005,590700,12,12,0,0
5,2005,590700,12,12,0,1
6,2005,590700,9,9,0,1
7,2005,590700,7,6,1,0
8,2005,590700,12,10,2,0
9,2005,590700,10,10,0,0
10,2005,590700,8,6,2,0
11,2005,590700,8,8,0,1
12,2005,590700,9,8,1,0
1,2006,590700,13,13,0,0
2,2006,590700,2,2,0,1
3,2006,590700,5,4,1,1
4,2006,590700,7,6,1,1
5,2006,590700,5,5,0,1
6,2006,590700,18,16,2,2
7,2006,590700,9,9,0,0
8,2006,590700,10,10,0,1
9,2006,590700,9,9,0,2
10,2006,590700,14,13,1,2
11,2006,590700,13,12,1,1
12,2006,590700,12,10,2,1
1,2007,590700,5,4,1,0
2,2007,590700,7,7,0,0
3,2007,590700,10,9,1,3
4,2007,590700,10,8,2,2
5,2007,590700,11,10,1,0
6,2007,590700,7,7,0,1
7,2007,590700,7,7,0,1
8,2007,590700,8,8,0,0
9,2007,590700,10,8,2,2
10,2007,590700,4,4,0,1
11,2007,590700,5,5,0,1
12,2007,590700,7,7,0,0
1,2008,590700,4,4,0,0
2,2008,590700,5,5,0,0
3,2008,590700,3,3,0,0
4,2008,590700,1,1,0,1
5,2008,590700,4,4,0,1
6,2008,590700,7,7,0,0
7,2008,590700,11,10,1,2
8,2008,590700,8,7,1,1
9,2008,590700,4,4,0,0
10,2008,590700,3,3,0,0
11,2008,590700,11,11,0,1
12,2008,590700,10,10,0,2
1,2009,590700,9,9,0,1
2,2009,590700,5,5,0,0
3,2009,590700,9,9,0,0
4,2009,590700,4,2,2,4
5,2009,590700,8,6,2,1
6,2009,590700,11,8,3,3
7,2009,590700,6,6,0,1
8,2009,590700,9,8,1,0
9,2009,590700,5,4,1,0
10,2009,590700,10,10,0,4
11,2009,590700,6,6,0,1
12,2009,590700,8,8,0,6
1,2010,590700,8,8,0,1
2,2010,590700,7,7,0,1
3,2010,590700,10,7,3,0
4,2010,590700,8,7,1,1
5,2010,590700,5,3,2,1
6,2010,590700,12,11,1,0
7,2010,590700,11,10,1,1
8,2010,590700,5,4,1,0
9,2010,590700,8,8,0,0
10,2010,590700,9,8,1,1
11,2010,590700,7,7,0,1
12,2010,590700,9,9,0,0
1,2011,590700,5,3,2,3
2,2011,590700,4,3,1,1
1,1999,839900,11,11,0,0
2,1999,839900,7,7,0,1
3,1999,839900,11,9,2,3
4,1999,839900,12,12,0,0
5,1999,839900,14,14,0,3
6,1999,839900,14,13,1,0
7,1999,839900,20,18,2,0
8,1999,839900,19,16,3,3
9,1999,839900,23,20,3,0
10,1999,839900,19,17,2,3
11,1999,839900,12,11,1,0
12,1999,839900,12,12,0,2
1,2000,839900,13,12,1,1
2,2000,839900,15,15,0,1
3,2000,839900,16,15,1,2
4,2000,839900,19,18,1,0
5,2000,839900,20,18,2,0
6,2000,839900,18,16,2,1
7,2000,839900,10,8,2,1
8,2000,839900,18,15,3,1
9,2000,839900,13,10,3,0
10,2000,839900,10,8,2,1
11,2000,839900,14,14,0,1
12,2000,839900,15,14,1,1
1,2001,839900,17,16,1,1
2,2001,839900,8,8,0,1
3,2001,839900,12,11,1,0
4,2001,839900,6,6,0,3
5,2001,839900,6,4,2,0
6,2001,839900,15,12,3,1
7,2001,839900,17,16,1,0
8,2001,839900,20,19,1,0
9,2001,839900,24,23,1,0
10,2001,839900,34,34,0,0
11,2001,839900,25,24,1,2
12,2001,839900,18,18,0,1
1,2002,839900,15,14,1,4
2,2002,839900,4,4,0,2
3,2002,839900,9,8,1,0
4,2002,839900,11,11,0,1
5,2002,839900,14,12,2,1
6,2002,839900,10,8,2,0
7,2002,839900,22,21,1,1
8,2002,839900,11,9,2,1
9,2002,839900,19,17,2,3
10,2002,839900,20,19,1,1
11,2002,839900,8,7,1,3
12,2002,839900,11,8,3,1
1,2003,839900,9,8,1,1
2,2003,839900,5,5,0,0
3,2003,839900,4,4,0,0
4,2003,839900,13,12,1,2
5,2003,839900,10,7,3,3
6,2003,839900,6,4,2,0
7,2003,839900,11,11,0,3
8,2003,839900,15,6,9,2
9,2003,839900,11,10,1,2
10,2003,839900,10,10,0,0
11,2003,839900,9,9,0,3
12,2003,839900,15,15,0,1
1,2004,839900,7,5,2,1
2,2004,839900,7,6,1,1
3,2004,839900,12,10,2,3
4,2004,839900,12,12,0,0
5,2004,839900,15,12,3,1
6,2004,839900,6,5,1,1
7,2004,839900,6,5,1,2
8,2004,839900,8,8,0,2
9,2004,839900,18,15,3,0
10,2004,839900,2,2,0,0
11,2004,839900,12,8,4,0
12,2004,839900,7,6,1,1
1,2005,839900,9,9,0,2
2,2005,839900,7,6,1,0
3,2005,839900,10,10,0,2
4,2005,839900,8,8,0,0
5,2005,839900,9,8,1,0
6,2005,839900,3,2,1,0
7,2005,839900,11,10,1,5
8,2005,839900,11,11,0,1
9,2005,839900,21,20,1,2
10,2005,839900,12,12,0,1
11,2005,839900,7,7,0,0
12,2005,839900,6,5,1,0
1,2006,839900,15,13,2,0
2,2006,839900,5,3,2,0
3,2006,839900,13,11,2,1
4,2006,839900,6,5,1,1
5,2006,839900,18,16,2,3
6,2006,839900,6,6,0,1
7,2006,839900,9,7,2,2
8,2006,839900,11,9,2,1
9,2006,839900,6,6,0,2
10,2006,839900,19,17,2,0
11,2006,839900,12,10,2,0
12,2006,839900,14,14,0,1
1,2007,839900,7,7,0,0
2,2007,839900,8,8,0,1
3,2007,839900,5,5,0,3
4,2007,839900,8,8,0,1
5,2007,839900,10,9,1,0
6,2007,839900,10,7,3,0
7,2007,839900,7,7,0,0
8,2007,839900,5,5,0,3
9,2007,839900,11,11,0,0
10,2007,839900,20,19,1,1
11,2007,839900,10,10,0,3
12,2007,839900,4,4,0,0
1,2008,839900,5,5,0,0
2,2008,839900,12,9,3,2
3,2008,839900,7,7,0,4
4,2008,839900,6,5,1,1
5,2008,839900,11,9,2,1
6,2008,839900,5,4,1,0
7,2008,839900,11,11,0,0
8,2008,839900,23,21,2,1
9,2008,839900,8,8,0,3
10,2008,839900,15,15,0,1
11,2008,839900,10,8,2,0
12,2008,839900,9,7,2,1
1,2009,839900,6,6,0,0
2,2009,839900,4,4,0,1
3,2009,839900,5,5,0,1
4,2009,839900,10,9,1,4
5,2009,839900,4,3,1,0
6,2009,839900,8,7,1,2
7,2009,839900,7,5,2,3
8,2009,839900,12,12,0,3
9,2009,839900,9,8,1,2
10,2009,839900,6,6,0,1
11,2009,839900,12,10,2,1
12,2009,839900,12,11,1,3
1,2010,839900,4,4,0,3
2,2010,839900,7,7,0,2
3,2010,839900,12,10,2,1
4,2010,839900,7,7,0,1
5,2010,839900,6,6,0,0
6,2010,839900,11,10,1,0
7,2010,839900,11,10,1,1
8,2010,839900,14,14,0,2
9,2010,839900,13,12,1,2
10,2010,839900,9,9,0,1
11,2010,839900,8,7,1,2
12,2010,839900,6,6,0,0
1,2011,839900,7,7,0,1
2,2011,839900,3,3,0,1
1,1999,830500,8,8,0,0
2,1999,830500,10,8,2,0
3,1999,830500,19,18,1,2
4,1999,830500,10,10,0,1
5,1999,830500,10,8,2,1
6,1999,830500,9,8,1,1
7,1999,830500,12,9,3,1
8,1999,830500,11,7,4,0
9,1999,830500,14,12,2,0
10,1999,830500,12,11,1,0
11,1999,830500,7,6,1,0
12,1999,830500,10,8,2,1
1,2000,830500,13,12,1,0
2,2000,830500,14,10,4,2
3,2000,830500,18,14,4,1
4,2000,830500,20,18,2,1
5,2000,830500,14,13,1,1
6,2000,830500,14,12,2,0
7,2000,830500,17,15,2,0
8,2000,830500,9,7,2,1
9,2000,830500,8,8,0,1
10,2000,830500,11,10,1,0
11,2000,830500,11,10,1,2
12,2000,830500,15,13,2,0
1,2001,830500,14,14,0,2
2,2001,830500,12,11,1,1
3,2001,830500,11,11,0,0
4,2001,830500,10,7,3,0
5,2001,830500,21,18,3,3
6,2001,830500,13,10,3,4
7,2001,830500,11,10,1,6
8,2001,830500,12,10,2,2
9,2001,830500,11,9,2,0
10,2001,830500,10,10,0,1
11,2001,830500,5,5,0,0
12,2001,830500,9,8,1,1
1,2002,830500,10,10,0,1
2,2002,830500,13,11,2,0
3,2002,830500,5,4,1,1
4,2002,830500,15,14,1,2
5,2002,830500,17,14,3,0
6,2002,830500,7,7,0,1
7,2002,830500,9,9,0,0
8,2002,830500,17,16,1,0
9,2002,830500,10,9,1,0
10,2002,830500,10,8,2,0
11,2002,830500,7,5,2,0
12,2002,830500,8,7,1,2
1,2003,830500,9,9,0,1
2,2003,830500,4,4,0,2
3,2003,830500,9,8,1,1
4,2003,830500,5,5,0,0
5,2003,830500,13,13,0,0
6,2003,830500,11,10,1,2
7,2003,830500,8,6,2,1
8,2003,830500,7,7,0,5
9,2003,830500,10,10,0,1
10,2003,830500,9,7,2,0
11,2003,830500,10,9,1,0
12,2003,830500,12,12,0,0
1,2004,830500,9,9,0,1
2,2004,830500,5,4,1,1
3,2004,830500,12,12,0,3
4,2004,830500,10,10,0,2
5,2004,830500,4,3,1,1
6,2004,830500,5,5,0,0
7,2004,830500,8,8,0,1
8,2004,830500,7,6,1,0
9,2004,830500,16,13,3,1
10,2004,830500,3,2,1,1
11,2004,830500,10,8,2,0
12,2004,830500,17,12,5,4
1,2005,830500,9,8,1,0
2,2005,830500,7,7,0,0
3,2005,830500,13,11,2,0
4,2005,830500,2,2,0,0
5,2005,830500,11,11,0,1
6,2005,830500,9,9,0,0
7,2005,830500,4,3,1,0
8,2005,830500,12,11,1,1
9,2005,830500,9,7,2,0
10,2005,830500,16,15,1,1
11,2005,830500,11,11,0,2
12,2005,830500,16,15,1,0
1,2006,830500,10,9,1,1
2,2006,830500,6,5,1,0
3,2006,830500,9,8,1,1
4,2006,830500,7,4,3,0
5,2006,830500,7,7,0,3
6,2006,830500,5,3,2,0
7,2006,830500,8,8,0,0
8,2006,830500,4,4,0,2
9,2006,830500,19,16,3,1
10,2006,830500,5,5,0,0
11,2006,830500,10,9,1,0
12,2006,830500,10,9,1,1
1,2007,830500,2,0,2,1
2,2007,830500,8,8,0,0
3,2007,830500,8,7,1,2
4,2007,830500,11,9,2,0
5,2007,830500,13,11,2,1
6,2007,830500,13,11,2,0
7,2007,830500,11,9,2,1
8,2007,830500,11,10,1,0
9,2007,830500,10,8,2,2
10,2007,830500,9,7,2,1
11,2007,830500,7,5,2,0
12,2007,830500,7,5,2,0
1,2008,830500,13,10,3,2
2,2008,830500,2,2,0,1
3,2008,830500,6,6,0,0
4,2008,830500,5,4,1,1
5,2008,830500,6,6,0,2
6,2008,830500,12,11,1,1
7,2008,830500,6,6,0,0
8,2008,830500,12,12,0,1
9,2008,830500,10,8,2,0
10,2008,830500,8,7,1,0
11,2008,830500,7,5,2,0
12,2008,830500,9,9,0,1
1,2009,830500,7,4,3,3
2,2009,830500,9,9,0,0
3,2009,830500,12,8,4,1
4,2009,830500,10,8,2,0
5,2009,830500,15,15,0,2
6,2009,830500,9,7,2,4
7,2009,830500,8,8,0,2
8,2009,830500,11,9,2,3
9,2009,830500,10,9,1,2
10,2009,830500,7,6,1,0
11,2009,830500,6,6,0,1
12,2009,830500,6,6,0,0
1,2010,830500,6,5,1,2
2,2010,830500,9,8,1,1
3,2010,830500,12,12,0,1
4,2010,830500,2,2,0,1
5,2010,830500,15,13,2,1
6,2010,830500,11,9,2,1
7,2010,830500,7,6,1,1
8,2010,830500,4,3,1,0
9,2010,830500,11,11,0,3
10,2010,830500,10,9,1,3
11,2010,830500,7,7,0,2
12,2010,830500,15,14,1,0
1,2011,830500,11,11,0,1
2,2011,830500,4,3,1,1
1,1999,580100,8,7,1,1
2,1999,580100,11,11,0,2
3,1999,580100,10,6,4,4
4,1999,580100,10,8,2,2
5,1999,580100,8,7,1,4
6,1999,580100,13,11,2,0
7,1999,580100,8,7,1,2
8,1999,580100,15,14,1,1
9,1999,580100,15,13,2,0
10,1999,580100,8,6,2,5
11,1999,580100,10,9,1,0
12,1999,580100,10,9,1,1
1,2000,580100,4,4,0,1
2,2000,580100,4,3,1,4
3,2000,580100,7,3,4,3
4,2000,580100,8,6,2,4
5,2000,580100,16,14,2,4
6,2000,580100,12,9,3,1
7,2000,580100,10,9,1,1
8,2000,580100,12,9,3,1
9,2000,580100,10,9,1,1
10,2000,580100,9,8,1,0
11,2000,580100,7,6,1,0
12,2000,580100,6,5,1,4
1,2001,580100,5,3,2,2
2,2001,580100,11,10,1,2
3,2001,580100,9,9,0,0
4,2001,580100,14,12,2,2
5,2001,580100,12,11,1,2
6,2001,580100,11,7,4,4
7,2001,580100,7,7,0,2
8,2001,580100,10,7,3,1
9,2001,580100,9,8,1,3
10,2001,580100,10,8,2,3
11,2001,580100,13,13,0,0
12,2001,580100,5,5,0,1
1,2002,580100,10,10,0,0
2,2002,580100,7,6,1,3
3,2002,580100,5,4,1,0
4,2002,580100,12,10,2,0
5,2002,580100,10,9,1,0
6,2002,580100,11,11,0,0
7,2002,580100,8,8,0,0
8,2002,580100,12,8,4,1
9,2002,580100,11,10,1,2
10,2002,580100,16,14,2,0
11,2002,580100,9,9,0,0
12,2002,580100,8,5,3,10
1,2003,580100,12,10,2,0
2,2003,580100,11,11,0,1
3,2003,580100,9,9,0,1
4,2003,580100,15,14,1,2
5,2003,580100,10,10,0,2
6,2003,580100,9,7,2,3
7,2003,580100,7,6,1,1
8,2003,580100,9,8,1,1
9,2003,580100,14,14,0,0
10,2003,580100,12,10,2,0
11,2003,580100,7,6,1,1
12,2003,580100,11,11,0,1
1,2004,580100,10,9,1,0
2,2004,580100,11,10,1,3
3,2004,580100,8,8,0,2
4,2004,580100,4,3,1,2
5,2004,580100,8,8,0,5
6,2004,580100,13,11,2,1
7,2004,580100,13,12,1,3
8,2004,580100,11,10,1,0
9,2004,580100,8,8,0,1
10,2004,580100,7,6,1,2
11,2004,580100,11,8,3,1
12,2004,580100,14,12,2,0
1,2005,580100,6,6,0,1
2,2005,580100,5,4,1,0
3,2005,580100,5,5,0,3
4,2005,580100,9,7,2,1
5,2005,580100,5,4,1,5
6,2005,580100,10,9,1,2
7,2005,580100,9,6,3,0
8,2005,580100,10,9,1,4
9,2005,580100,12,12,0,2
10,2005,580100,11,7,4,0
11,2005,580100,10,8,2,0
12,2005,580100,7,5,2,4
1,2006,580100,9,7,2,1
2,2006,580100,11,9,2,2
3,2006,580100,14,13,1,3
4,2006,580100,8,8,0,4
5,2006,580100,13,11,2,1
6,2006,580100,7,6,1,3
7,2006,580100,15,12,3,4
8,2006,580100,6,4,2,2
9,2006,580100,8,7,1,2
10,2006,580100,18,16,2,0
11,2006,580100,10,10,0,1
12,2006,580100,9,8,1,0
1,2007,580100,6,6,0,2
2,2007,580100,8,8,0,1
3,2007,580100,10,9,1,1
4,2007,580100,10,9,1,4
5,2007,580100,9,8,1,5
6,2007,580100,9,8,1,2
7,2007,580100,7,6,1,0
8,2007,580100,16,14,2,2
9,2007,580100,6,6,0,6
10,2007,580100,12,11,1,0
11,2007,580100,5,5,0,1
12,2007,580100,8,8,0,1
1,2008,580100,9,8,1,0
2,2008,580100,2,2,0,0
3,2008,580100,13,13,0,2
4,2008,580100,8,7,1,2
5,2008,580100,9,9,0,1
6,2008,580100,10,10,0,2
7,2008,580100,6,5,1,0
8,2008,580100,12,10,2,2
9,2008,580100,7,7,0,1
10,2008,580100,3,2,1,1
11,2008,580100,11,11,0,0
12,2008,580100,8,8,0,5
1,2009,580100,11,11,0,0
2,2009,580100,8,8,0,0
3,2009,580100,10,10,0,3
4,2009,580100,8,8,0,1
5,2009,580100,1,1,0,3
6,2009,580100,3,3,0,3
7,2009,580100,4,4,0,4
8,2009,580100,5,3,2,1
9,2009,580100,9,8,1,1
10,2009,580100,9,7,2,2
11,2009,580100,11,8,3,0
12,2009,580100,9,8,1,4
1,2010,580100,7,7,0,2
2,2010,580100,4,3,1,0
3,2010,580100,10,8,2,2
4,2010,580100,12,9,3,1
5,2010,580100,13,12,1,2
6,2010,580100,8,7,1,1
7,2010,580100,5,4,1,3
8,2010,580100,9,9,0,3
9,2010,580100,8,8,0,5
10,2010,580100,5,4,1,0
11,2010,580100,13,11,2,3
12,2010,580100,11,10,1,0
1,2011,580100,11,11,0,0
2,2011,580100,11,10,1,0
1,1999,840300,16,13,3,2
2,1999,840300,17,15,2,3
3,1999,840300,16,16,0,2
4,1999,840300,20,15,5,8
5,1999,840300,9,7,2,2
6,1999,840300,14,11,3,4
7,1999,840300,25,21,4,4
8,1999,840300,17,14,3,8
9,1999,840300,14,11,3,7
10,1999,840300,12,10,2,7
11,1999,840300,21,13,8,8
12,1999,840300,14,13,1,2
1,2000,840300,9,7,2,4
2,2000,840300,18,18,0,7
3,2000,840300,20,18,2,14
4,2000,840300,13,10,3,15
5,2000,840300,18,13,5,31
6,2000,840300,21,16,5,12
7,2000,840300,24,19,5,14
8,2000,840300,18,15,3,14
9,2000,840300,10,8,2,12
10,2000,840300,19,19,0,13
11,2000,840300,18,15,3,12
12,2000,840300,16,14,2,13
1,2001,840300,11,10,1,33
2,2001,840300,12,9,3,23
3,2001,840300,17,15,2,37
4,2001,840300,14,14,0,17
5,2001,840300,19,16,3,10
6,2001,840300,22,19,3,8
7,2001,840300,14,11,3,5
8,2001,840300,13,11,2,11
9,2001,840300,7,6,1,2
10,2001,840300,21,21,0,5
11,2001,840300,13,11,2,3
12,2001,840300,20,18,2,6
1,2002,840300,16,15,1,5
2,2002,840300,8,8,0,6
3,2002,840300,13,11,2,4
4,2002,840300,10,9,1,7
5,2002,840300,25,20,5,6
6,2002,840300,27,23,4,13
7,2002,840300,19,15,4,8
8,2002,840300,19,15,4,7
9,2002,840300,21,17,4,5
10,2002,840300,20,16,4,10
11,2002,840300,23,22,1,2
12,2002,840300,10,10,0,11
1,2003,840300,20,17,3,3
2,2003,840300,14,14,0,14
3,2003,840300,20,16,4,12
4,2003,840300,15,15,0,17
5,2003,840300,22,19,3,12
6,2003,840300,28,26,2,8
7,2003,840300,9,9,0,13
8,2003,840300,16,15,1,5
9,2003,840300,18,16,2,2
10,2003,840300,21,20,1,9
11,2003,840300,12,11,1,8
12,2003,840300,20,17,3,12
1,2004,840300,15,12,3,6
2,2004,840300,19,16,3,4
3,2004,840300,13,12,1,3
4,2004,840300,15,10,5,3
5,2004,840300,26,23,3,3
6,2004,840300,23,17,6,7
7,2004,840300,22,17,5,10
8,2004,840300,13,12,1,11
9,2004,840300,18,15,3,5
10,2004,840300,16,15,1,6
11,2004,840300,22,18,4,5
12,2004,840300,16,15,1,0
1,2005,840300,14,13,1,4
2,2005,840300,11,10,1,5
3,2005,840300,14,13,1,2
4,2005,840300,9,8,1,5
5,2005,840300,12,7,5,8
6,2005,840300,11,10,1,4
7,2005,840300,13,13,0,4
8,2005,840300,13,13,0,6
9,2005,840300,18,14,4,1
10,2005,840300,23,18,5,1
11,2005,840300,16,11,5,2
12,2005,840300,20,20,0,2
1,2006,840300,16,14,2,4
2,2006,840300,11,10,1,4
3,2006,840300,6,3,3,2
4,2006,840300,12,8,4,2
5,2006,840300,18,16,2,2
6,2006,840300,16,15,1,0
7,2006,840300,27,26,1,1
8,2006,840300,30,28,2,1
9,2006,840300,11,9,2,5
10,2006,840300,19,17,2,2
11,2006,840300,12,9,3,2
12,2006,840300,20,17,3,7
1,2007,840300,14,12,2,1
2,2007,840300,14,11,3,3
3,2007,840300,12,11,1,4
4,2007,840300,14,13,1,1
5,2007,840300,18,14,4,6
6,2007,840300,19,16,3,3
7,2007,840300,7,7,0,5
8,2007,840300,23,22,1,3
9,2007,840300,14,12,2,1
10,2007,840300,13,12,1,1
11,2007,840300,18,17,1,1
12,2007,840300,13,13,0,3
1,2008,840300,13,11,2,4
2,2008,840300,15,13,2,1
3,2008,840300,13,12,1,4
4,2008,840300,16,12,4,3
5,2008,840300,16,15,1,4
6,2008,840300,15,14,1,3
7,2008,840300,22,21,1,2
8,2008,840300,23,19,4,1
9,2008,840300,19,17,2,3
10,2008,840300,26,25,1,1
11,2008,840300,18,17,1,1
12,2008,840300,22,20,2,3
1,2009,840300,10,9,1,1
2,2009,840300,16,15,1,5
3,2009,840300,13,9,4,2
4,2009,840300,13,12,1,4
5,2009,840300,8,5,3,3
6,2009,840300,16,9,7,3
7,2009,840300,15,8,7,2
8,2009,840300,13,11,2,5
9,2009,840300,8,6,2,2
10,2009,840300,13,9,4,5
11,2009,840300,21,19,2,2
12,2009,840300,9,8,1,4
1,2010,840300,14,11,3,5
2,2010,840300,16,13,3,2
3,2010,840300,6,4,2,3
4,2010,840300,8,7,1,3
5,2010,840300,11,10,1,2
6,2010,840300,10,9,1,1
7,2010,840300,9,6,3,3
8,2010,840300,6,5,1,2
9,2010,840300,12,10,2,1
10,2010,840300,10,8,2,3
11,2010,840300,12,12,0,2
12,2010,840300,4,4,0,5
1,2011,840300,12,10,2,2
2,2011,840300,10,10,0,1
1,1999,340600,22,15,7,73
2,1999,340600,23,20,3,63
3,1999,340600,37,27,10,43
4,1999,340600,23,17,6,71
5,1999,340600,32,18,14,57
6,1999,340600,28,18,10,44
7,1999,340600,31,18,13,34
8,1999,340600,38,33,5,76
9,1999,340600,27,18,9,50
10,1999,340600,30,24,6,61
11,1999,340600,24,20,4,49
12,1999,340600,30,19,11,79
1,2000,340600,11,8,3,82
2,2000,340600,22,16,6,108
3,2000,340600,32,25,7,99
4,2000,340600,23,14,9,70
5,2000,340600,25,15,10,84
6,2000,340600,30,20,10,74
7,2000,340600,25,15,10,56
8,2000,340600,22,15,7,87
9,2000,340600,27,17,10,81
10,2000,340600,38,31,7,141
11,2000,340600,22,18,4,55
12,2000,340600,12,10,2,62
1,2001,340600,15,14,1,139
2,2001,340600,19,15,4,146
3,2001,340600,30,25,5,211
4,2001,340600,19,12,7,109
5,2001,340600,26,16,10,112
6,2001,340600,26,17,9,56
7,2001,340600,26,13,13,47
8,2001,340600,27,18,9,45
9,2001,340600,20,12,8,73
10,2001,340600,22,17,5,152
11,2001,340600,19,11,8,36
12,2001,340600,10,6,4,17
1,2002,340600,22,17,5,16
2,2002,340600,13,11,2,23
3,2002,340600,19,12,7,63
4,2002,340600,20,12,8,47
5,2002,340600,23,14,9,100
6,2002,340600,27,18,9,52
7,2002,340600,25,21,4,82
8,2002,340600,18,13,5,78
9,2002,340600,22,16,6,36
10,2002,340600,13,10,3,52
11,2002,340600,7,6,1,16
12,2002,340600,13,11,2,23
1,2003,340600,10,10,0,52
2,2003,340600,10,8,2,31
3,2003,340600,14,9,5,31
4,2003,340600,13,10,3,33
5,2003,340600,10,7,3,44
6,2003,340600,17,14,3,13
7,2003,340600,20,16,4,18
8,2003,340600,16,15,1,16
9,2003,340600,17,13,4,22
10,2003,340600,21,18,3,21
11,2003,340600,13,11,2,65
12,2003,340600,10,7,3,24
1,2004,340600,16,15,1,46
2,2004,340600,13,10,3,104
3,2004,340600,9,8,1,79
4,2004,340600,13,9,4,59
5,2004,340600,10,8,2,34
6,2004,340600,23,21,2,59
7,2004,340600,19,19,0,65
8,2004,340600,14,10,4,3
9,2004,340600,8,8,0,4
10,2004,340600,12,12,0,3
11,2004,340600,11,11,0,7
12,2004,340600,8,8,0,2
1,2005,340600,5,5,0,3
2,2005,340600,8,8,0,0
3,2005,340600,15,15,0,3
4,2005,340600,11,11,0,2
5,2005,340600,13,13,0,3
6,2005,340600,15,13,2,3
7,2005,340600,14,11,3,7
8,2005,340600,19,17,2,10
9,2005,340600,17,15,2,10
10,2005,340600,16,16,0,49
11,2005,340600,13,12,1,23
12,2005,340600,16,15,1,26
1,2006,340600,12,11,1,25
2,2006,340600,13,12,1,21
3,2006,340600,12,11,1,17
4,2006,340600,16,12,4,26
5,2006,340600,9,6,3,19
6,2006,340600,23,18,5,26
7,2006,340600,11,10,1,7
8,2006,340600,14,11,3,4
9,2006,340600,15,13,2,2
10,2006,340600,9,9,0,5
11,2006,340600,8,8,0,6
12,2006,340600,6,6,0,1
1,2007,340600,11,8,3,5
2,2007,340600,2,2,0,3
3,2007,340600,7,7,0,0
4,2007,340600,2,1,1,1
5,2007,340600,6,5,1,1
6,2007,340600,10,6,4,2
7,2007,340600,7,6,1,1
8,2007,340600,7,7,0,1
9,2007,340600,4,4,0,3
10,2007,340600,4,2,2,2
11,2007,340600,7,7,0,0
12,2007,340600,1,1,0,2
1,2008,340600,9,9,0,1
2,2008,340600,4,2,2,0
3,2008,340600,3,2,1,0
4,2008,340600,6,4,2,5
5,2008,340600,9,8,1,1
6,2008,340600,9,7,2,3
7,2008,340600,8,5,3,9
8,2008,340600,11,8,3,2
9,2008,340600,3,3,0,2
10,2008,340600,8,8,0,3
11,2008,340600,7,7,0,2
12,2008,340600,10,8,2,1
1,2009,340600,3,3,0,5
2,2009,340600,5,4,1,3
3,2009,340600,3,3,0,3
4,2009,340600,7,5,2,1
5,2009,340600,6,2,4,3
6,2009,340600,5,4,1,4
7,2009,340600,7,6,1,1
8,2009,340600,15,13,2,7
9,2009,340600,6,4,2,8
10,2009,340600,13,9,4,12
11,2009,340600,5,4,1,3
12,2009,340600,7,7,0,1
1,2010,340600,9,8,1,5
2,2010,340600,6,4,2,2
3,2010,340600,7,7,0,1
4,2010,340600,12,9,3,6
5,2010,340600,8,8,0,1
6,2010,340600,8,8,0,2
7,2010,340600,18,17,1,4
8,2010,340600,16,14,2,0
9,2010,340600,11,11,0,4
10,2010,340600,15,14,1,3
11,2010,340600,9,9,0,3
12,2010,340600,12,9,3,1
1,2011,340600,13,13,0,1
2,2011,340600,13,12,1,2
1,1999,840000,1,1,0,0
2,1999,840000,4,4,0,1
3,1999,840000,2,1,1,0
4,1999,840000,1,1,0,0
5,1999,840000,6,6,0,1
6,1999,840000,1,1,0,0
7,1999,840000,8,7,1,1
8,1999,840000,5,5,0,0
9,1999,840000,8,8,0,0
10,1999,840000,7,5,2,0
11,1999,840000,8,8,0,0
12,1999,840000,9,8,1,1
1,2000,840000,5,4,1,0
2,2000,840000,4,3,1,1
3,2000,840000,4,4,0,0
4,2000,840000,5,5,0,0
5,2000,840000,5,4,1,1
6,2000,840000,3,3,0,0
7,2000,840000,3,2,1,1
8,2000,840000,5,4,1,0
9,2000,840000,9,6,3,3
10,2000,840000,4,4,0,1
11,2000,840000,3,3,0,0
12,2000,840000,9,9,0,1
1,2001,840000,3,3,0,0
2,2001,840000,4,4,0,0
3,2001,840000,2,2,0,2
4,2001,840000,2,2,0,0
5,2001,840000,5,5,0,0
6,2001,840000,4,3,1,3
7,2001,840000,6,4,2,0
8,2001,840000,3,3,0,0
9,2001,840000,3,3,0,0
10,2001,840000,8,7,1,1
11,2001,840000,5,4,1,0
12,2001,840000,5,4,1,0
1,2002,840000,6,6,0,0
2,2002,840000,5,5,0,1
3,2002,840000,3,3,0,3
4,2002,840000,2,2,0,2
5,2002,840000,6,5,1,2
6,2002,840000,6,6,0,0
7,2002,840000,11,10,1,0
8,2002,840000,3,3,0,2
9,2002,840000,5,5,0,0
10,2002,840000,4,1,3,3
11,2002,840000,5,5,0,0
12,2002,840000,2,2,0,0
1,2003,840000,3,3,0,0
2,2003,840000,6,6,0,0
3,2003,840000,4,4,0,1
4,2003,840000,7,6,1,1
5,2003,840000,4,4,0,1
6,2003,840000,3,3,0,1
7,2003,840000,6,6,0,1
8,2003,840000,8,5,3,0
9,2003,840000,7,7,0,1
10,2003,840000,1,1,0,0
11,2003,840000,3,3,0,1
12,2003,840000,1,1,0,1
1,2004,840000,1,1,0,0
2,2004,840000,1,1,0,1
3,2004,840000,4,4,0,1
4,2004,840000,4,2,2,1
5,2004,840000,3,3,0,1
6,2004,840000,3,2,1,0
7,2004,840000,3,2,1,0
8,2004,840000,3,3,0,0
9,2004,840000,3,2,1,0
10,2004,840000,4,4,0,0
11,2004,840000,1,1,0,0
12,2004,840000,1,1,0,0
1,2005,840000,2,2,0,0
2,2005,840000,5,3,2,0
3,2005,840000,1,1,0,0
4,2005,840000,4,4,0,1
5,2005,840000,5,4,1,0
6,2005,840000,7,7,0,0
7,2005,840000,5,5,0,1
8,2005,840000,4,4,0,0
9,2005,840000,4,3,1,1
10,2005,840000,7,5,2,0
11,2005,840000,4,4,0,0
12,2005,840000,3,3,0,0
1,2006,840000,0,0,0,0
2,2006,840000,2,2,0,0
3,2006,840000,5,5,0,0
4,2006,840000,3,1,2,0
5,2006,840000,7,6,1,1
6,2006,840000,2,1,1,0
7,2006,840000,5,5,0,0
8,2006,840000,12,11,1,1
9,2006,840000,4,4,0,0
10,2006,840000,3,2,1,0
11,2006,840000,2,2,0,0
12,2006,840000,2,2,0,0
1,2007,840000,5,5,0,0
2,2007,840000,3,3,0,0
3,2007,840000,3,1,2,0
4,2007,840000,1,1,0,1
5,2007,840000,2,1,1,0
6,2007,840000,5,5,0,0
7,2007,840000,9,9,0,0
8,2007,840000,3,2,1,0
9,2007,840000,2,0,2,1
10,2007,840000,0,0,0,0
11,2007,840000,5,4,1,1
12,2007,840000,1,1,0,0
1,2008,840000,0,0,0,0
2,2008,840000,3,2,1,1
3,2008,840000,1,1,0,0
4,2008,840000,8,8,0,0
5,2008,840000,7,5,2,0
6,2008,840000,0,0,0,0
7,2008,840000,5,4,1,1
8,2008,840000,6,5,1,1
9,2008,840000,4,4,0,0
10,2008,840000,5,5,0,0
11,2008,840000,3,3,0,0
12,2008,840000,1,1,0,0
1,2009,840000,1,1,0,0
2,2009,840000,3,2,1,1
3,2009,840000,1,1,0,1
4,2009,840000,2,1,1,0
5,2009,840000,0,0,0,0
6,2009,840000,3,3,0,1
7,2009,840000,6,6,0,0
8,2009,840000,4,3,1,0
9,2009,840000,5,5,0,2
10,2009,840000,6,6,0,0
11,2009,840000,6,5,1,0
12,2009,840000,8,8,0,1
1,2010,840000,2,2,0,0
2,2010,840000,4,4,0,1
3,2010,840000,2,2,0,0
4,2010,840000,4,4,0,5
5,2010,840000,6,6,0,0
6,2010,840000,11,9,2,0
7,2010,840000,8,7,1,0
8,2010,840000,2,1,1,0
9,2010,840000,3,3,0,1
10,2010,840000,1,1,0,2
11,2010,840000,2,2,0,0
12,2010,840000,1,1,0,0
1,2011,840000,1,0,1,0
2,2011,840000,1,1,0,0
1,1999,836500,15,9,6,4
2,1999,836500,9,5,4,13
3,1999,836500,17,9,8,14
4,1999,836500,17,15,2,26
5,1999,836500,21,11,10,15
6,1999,836500,16,9,7,10
7,1999,836500,20,11,9,10
8,1999,836500,14,9,5,11
9,1999,836500,9,7,2,6
10,1999,836500,11,5,6,12
11,1999,836500,6,4,2,17
12,1999,836500,14,12,2,13
1,2000,836500,7,3,4,35
2,2000,836500,4,3,1,12
3,2000,836500,8,6,2,19
4,2000,836500,6,4,2,18
5,2000,836500,12,8,4,18
6,2000,836500,16,14,2,11
7,2000,836500,15,10,5,9
8,2000,836500,14,10,4,5
9,2000,836500,12,6,6,3
10,2000,836500,9,6,3,8
11,2000,836500,9,7,2,7
12,2000,836500,13,12,1,3
1,2001,836500,13,9,4,2
2,2001,836500,7,6,1,14
3,2001,836500,10,7,3,10
4,2001,836500,15,6,9,5
5,2001,836500,5,2,3,14
6,2001,836500,14,11,3,4
7,2001,836500,13,12,1,1
8,2001,836500,7,6,1,5
9,2001,836500,15,14,1,2
10,2001,836500,12,11,1,6
11,2001,836500,9,5,4,3
12,2001,836500,13,9,4,6
1,2002,836500,8,7,1,10
2,2002,836500,8,5,3,13
3,2002,836500,8,7,1,6
4,2002,836500,9,7,2,2
5,2002,836500,6,6,0,3
6,2002,836500,10,9,1,3
7,2002,836500,14,7,7,1
8,2002,836500,8,4,4,0
9,2002,836500,9,7,2,0
10,2002,836500,12,10,2,0
11,2002,836500,6,5,1,0
12,2002,836500,7,4,3,1
1,2003,836500,6,4,2,0
2,2003,836500,5,4,1,1
3,2003,836500,11,7,4,0
4,2003,836500,6,4,2,0
5,2003,836500,6,3,3,0
6,2003,836500,8,5,3,1
7,2003,836500,11,7,4,0
8,2003,836500,5,4,1,3
9,2003,836500,10,8,2,0
10,2003,836500,4,3,1,0
11,2003,836500,4,4,0,1
12,2003,836500,7,5,2,1
1,2004,836500,5,5,0,1
2,2004,836500,7,6,1,1
3,2004,836500,4,3,1,4
4,2004,836500,12,11,1,4
5,2004,836500,4,2,2,3
6,2004,836500,11,5,6,0
7,2004,836500,6,4,2,1
8,2004,836500,9,8,1,2
9,2004,836500,5,2,3,0
10,2004,836500,10,6,4,0
11,2004,836500,3,3,0,0
12,2004,836500,6,5,1,0
1,2005,836500,6,5,1,0
2,2005,836500,8,6,2,1
3,2005,836500,10,8,2,0
4,2005,836500,13,10,3,2
5,2005,836500,8,7,1,0
6,2005,836500,8,6,2,1
7,2005,836500,5,4,1,0
8,2005,836500,9,6,3,0
9,2005,836500,7,6,1,0
10,2005,836500,8,7,1,0
11,2005,836500,3,3,0,0
12,2005,836500,10,10,0,0
1,2006,836500,5,4,1,1
2,2006,836500,8,8,0,2
3,2006,836500,6,5,1,0
4,2006,836500,3,3,0,1
5,2006,836500,9,6,3,0
6,2006,836500,4,4,0,0
7,2006,836500,11,7,4,3
8,2006,836500,5,5,0,0
9,2006,836500,9,7,2,2
10,2006,836500,9,6,3,2
11,2006,836500,5,4,1,2
12,2006,836500,8,6,2,2
1,2007,836500,0,0,0,3
2,2007,836500,12,12,0,1
3,2007,836500,6,4,2,2
4,2007,836500,7,7,0,3
5,2007,836500,11,10,1,3
6,2007,836500,14,10,4,5
7,2007,836500,8,6,2,4
8,2007,836500,7,7,0,2
9,2007,836500,11,9,2,3
10,2007,836500,5,4,1,0
11,2007,836500,9,7,2,2
12,2007,836500,9,9,0,1
1,2008,836500,8,7,1,3
2,2008,836500,3,3,0,1
3,2008,836500,8,7,1,1
4,2008,836500,4,4,0,5
5,2008,836500,6,5,1,2
6,2008,836500,6,6,0,2
7,2008,836500,6,5,1,1
8,2008,836500,3,3,0,9
9,2008,836500,6,5,1,1
10,2008,836500,7,4,3,2
11,2008,836500,4,4,0,6
12,2008,836500,1,1,0,3
1,2009,836500,2,2,0,7
2,2009,836500,3,2,1,1
3,2009,836500,5,2,3,0
4,2009,836500,10,7,3,4
5,2009,836500,7,7,0,5
6,2009,836500,4,2,2,5
7,2009,836500,5,2,3,0
8,2009,836500,10,8,2,3
9,2009,836500,4,3,1,1
10,2009,836500,4,3,1,4
11,2009,836500,7,7,0,0
12,2009,836500,7,6,1,1
1,2010,836500,2,2,0,0
2,2010,836500,2,2,0,2
3,2010,836500,7,7,0,2
4,2010,836500,7,5,2,1
5,2010,836500,11,9,2,2
6,2010,836500,12,11,1,2
7,2010,836500,7,6,1,0
8,2010,836500,9,9,0,1
9,2010,836500,4,4,0,2
10,2010,836500,6,4,2,2
11,2010,836500,5,4,1,1
12,2010,836500,5,5,0,1
1,2011,836500,5,4,1,0
2,2011,836500,5,2,3,0
1,1999,351100,21,13,8,8
2,1999,351100,29,21,8,15
3,1999,351100,33,24,9,13
4,1999,351100,23,13,10,23
5,1999,351100,22,15,7,11
6,1999,351100,28,20,8,8
7,1999,351100,32,19,13,6
8,1999,351100,38,22,16,4
9,1999,351100,26,19,7,3
10,1999,351100,30,19,11,7
11,1999,351100,26,12,14,7
12,1999,351100,24,19,5,11
1,2000,351100,19,11,8,6
2,2000,351100,23,15,8,13
3,2000,351100,13,10,3,10
4,2000,351100,18,9,9,10
5,2000,351100,25,10,15,9
6,2000,351100,24,14,10,4
7,2000,351100,34,16,18,25
8,2000,351100,29,18,11,24
9,2000,351100,22,7,15,15
10,2000,351100,24,20,4,22
11,2000,351100,28,19,9,24
12,2000,351100,26,17,9,41
1,2001,351100,16,8,8,29
2,2001,351100,22,13,9,16
3,2001,351100,20,11,9,25
4,2001,351100,34,15,19,23
5,2001,351100,19,9,10,34
6,2001,351100,22,10,12,21
7,2001,351100,17,12,5,14
8,2001,351100,16,14,2,11
9,2001,351100,14,12,2,15
10,2001,351100,15,5,10,27
11,2001,351100,17,11,6,18
12,2001,351100,14,9,5,31
1,2002,351100,17,11,6,20
2,2002,351100,24,12,12,20
3,2002,351100,11,5,6,24
4,2002,351100,17,8,9,21
5,2002,351100,33,16,17,14
6,2002,351100,25,15,10,13
7,2002,351100,22,12,10,17
8,2002,351100,14,10,4,6
9,2002,351100,15,5,10,30
10,2002,351100,22,13,9,29
11,2002,351100,14,13,1,38
12,2002,351100,17,12,5,35
1,2003,351100,18,15,3,37
2,2003,351100,11,4,7,23
3,2003,351100,22,17,5,22
4,2003,351100,12,6,6,30
5,2003,351100,13,4,9,6
6,2003,351100,10,6,4,5
7,2003,351100,10,7,3,14
8,2003,351100,15,8,7,11
9,2003,351100,14,10,4,11
10,2003,351100,19,10,9,9
11,2003,351100,14,10,4,25
12,2003,351100,14,9,5,25
1,2004,351100,12,8,4,34
2,2004,351100,13,9,4,45
3,2004,351100,13,6,7,38
4,2004,351100,11,7,4,45
5,2004,351100,24,16,8,64
6,2004,351100,29,14,15,29
7,2004,351100,22,15,7,70
8,2004,351100,9,6,3,26
9,2004,351100,18,10,8,59
10,2004,351100,16,9,7,76
11,2004,351100,10,6,4,56
12,2004,351100,15,7,8,37
1,2005,351100,15,7,8,88
2,2005,351100,15,11,4,57
3,2005,351100,9,7,2,83
4,2005,351100,15,7,8,67
5,2005,351100,12,6,6,41
6,2005,351100,19,11,8,34
7,2005,351100,23,13,10,56
8,2005,351100,18,12,6,30
9,2005,351100,15,12,3,67
10,2005,351100,13,9,4,30
11,2005,351100,9,4,5,33
12,2005,351100,7,4,3,30
1,2006,351100,4,3,1,22
2,2006,351100,10,4,6,18
3,2006,351100,8,4,4,13
4,2006,351100,6,3,3,33
5,2006,351100,15,9,6,43
6,2006,351100,10,5,5,12
7,2006,351100,14,6,8,30
8,2006,351100,18,10,8,30
9,2006,351100,11,6,5,75
10,2006,351100,7,2,5,56
11,2006,351100,5,3,2,52
12,2006,351100,6,2,4,74
1,2007,351100,10,5,5,59
2,2007,351100,8,5,3,72
3,2007,351100,11,6,5,29
4,2007,351100,10,7,3,93
5,2007,351100,10,5,5,38
6,2007,351100,13,9,4,30
7,2007,351100,15,9,6,28
8,2007,351100,9,4,5,47
9,2007,351100,11,7,4,35
10,2007,351100,12,7,5,18
11,2007,351100,7,3,4,28
12,2007,351100,4,2,2,38
1,2008,351100,3,2,1,50
2,2008,351100,6,4,2,41
3,2008,351100,5,4,1,62
4,2008,351100,3,2,1,26
5,2008,351100,2,2,0,37
6,2008,351100,10,6,4,10
7,2008,351100,6,5,1,16
8,2008,351100,8,6,2,13
9,2008,351100,3,3,0,0
10,2008,351100,3,3,0,1
11,2008,351100,2,1,1,1
12,2008,351100,1,1,0,0
1,2009,351100,3,3,0,0
2,2009,351100,1,1,0,2
3,2009,351100,1,1,0,1
4,2009,351100,5,5,0,2
5,2009,351100,1,1,0,1
6,2009,351100,4,3,1,1
7,2009,351100,4,3,1,0
8,2009,351100,5,3,2,0
9,2009,351100,3,3,0,0
10,2009,351100,3,3,0,0
11,2009,351100,1,1,0,0
12,2009,351100,2,2,0,0
1,2010,351100,4,4,0,2
2,2010,351100,2,2,0,0
3,2010,351100,4,4,0,0
4,2010,351100,3,3,0,0
5,2010,351100,4,4,0,0
6,2010,351100,3,1,2,1
7,2010,351100,2,2,0,1
8,2010,351100,7,4,3,1
9,2010,351100,4,2,2,2
10,2010,351100,5,4,1,0
11,2010,351100,4,4,0,1
12,2010,351100,2,1,1,0
1,2011,351100,3,2,1,2
2,2011,351100,2,2,0,1
1,1999,360200,5,3,2,0
2,1999,360200,13,7,6,1
3,1999,360200,4,2,2,2
4,1999,360200,8,6,2,5
5,1999,360200,5,0,5,2
6,1999,360200,11,3,8,5
7,1999,360200,10,7,3,5
8,1999,360200,4,1,3,5
9,1999,360200,12,5,7,1
10,1999,360200,6,4,2,0
11,1999,360200,6,3,3,3
12,1999,360200,5,3,2,1
1,2000,360200,16,13,3,4
2,2000,360200,7,3,4,4
3,2000,360200,8,6,2,2
4,2000,360200,6,4,2,2
5,2000,360200,3,3,0,1
6,2000,360200,6,3,3,3
7,2000,360200,14,9,5,4
8,2000,360200,13,7,6,6
9,2000,360200,9,7,2,4
10,2000,360200,7,6,1,4
11,2000,360200,13,6,7,3
12,2000,360200,5,3,2,8
1,2001,360200,1,1,0,13
2,2001,360200,7,3,4,14
3,2001,360200,6,4,2,4
4,2001,360200,8,5,3,7
5,2001,360200,7,4,3,11
6,2001,360200,12,6,6,5
7,2001,360200,8,5,3,7
8,2001,360200,11,3,8,4
9,2001,360200,4,4,0,4
10,2001,360200,3,2,1,7
11,2001,360200,5,5,0,8
12,2001,360200,8,2,6,9
1,2002,360200,11,6,5,12
2,2002,360200,2,2,0,5
3,2002,360200,4,4,0,14
4,2002,360200,5,1,4,19
5,2002,360200,5,5,0,7
6,2002,360200,8,5,3,6
7,2002,360200,9,6,3,11
8,2002,360200,9,8,1,14
9,2002,360200,7,5,2,4
10,2002,360200,5,2,3,10
11,2002,360200,3,1,2,4
12,2002,360200,4,3,1,5
1,2003,360200,4,3,1,4
2,2003,360200,3,2,1,1
3,2003,360200,5,4,1,3
4,2003,360200,3,1,2,3
5,2003,360200,5,4,1,2
6,2003,360200,6,5,1,2
7,2003,360200,3,3,0,2
8,2003,360200,3,2,1,6
9,2003,360200,5,4,1,1
10,2003,360200,1,1,0,3
11,2003,360200,1,1,0,0
12,2003,360200,5,4,1,0
1,2004,360200,5,5,0,5
2,2004,360200,1,0,1,6
3,2004,360200,2,2,0,2
4,2004,360200,3,1,2,2
5,2004,360200,5,4,1,0
6,2004,360200,2,1,1,0
7,2004,360200,6,6,0,2
8,2004,360200,1,0,1,2
9,2004,360200,0,0,0,5
10,2004,360200,2,1,1,0
11,2004,360200,3,3,0,0
12,2004,360200,3,3,0,2
1,2005,360200,4,2,2,6
2,2005,360200,2,1,1,3
3,2005,360200,3,3,0,4
4,2005,360200,3,3,0,4
5,2005,360200,5,3,2,5
6,2005,360200,5,4,1,7
7,2005,360200,3,3,0,5
8,2005,360200,2,2,0,2
9,2005,360200,0,0,0,2
10,2005,360200,4,2,2,0
11,2005,360200,3,3,0,2
12,2005,360200,1,1,0,2
1,2006,360200,1,1,0,2
2,2006,360200,1,1,0,0
3,2006,360200,1,0,1,0
4,2006,360200,2,2,0,1
5,2006,360200,3,2,1,3
6,2006,360200,2,1,1,6
7,2006,360200,5,5,0,5
8,2006,360200,4,3,1,3
9,2006,360200,5,5,0,4
10,2006,360200,0,0,0,2
11,2006,360200,1,1,0,5
12,2006,360200,0,0,0,1
1,2007,360200,7,4,3,6
2,2007,360200,3,2,1,5
3,2007,360200,1,1,0,2
4,2007,360200,2,2,0,4
5,2007,360200,3,3,0,6
6,2007,360200,6,4,2,5
7,2007,360200,5,4,1,15
8,2007,360200,8,8,0,8
9,2007,360200,3,3,0,18
10,2007,360200,7,5,2,5
11,2007,360200,3,3,0,12
12,2007,360200,1,1,0,3
1,2008,360200,7,5,2,5
2,2008,360200,3,3,0,4
3,2008,360200,4,4,0,7
4,2008,360200,1,1,0,1
5,2008,360200,3,2,1,5
6,2008,360200,4,3,1,4
7,2008,360200,19,18,1,8
8,2008,360200,5,4,1,18
9,2008,360200,5,5,0,3
10,2008,360200,2,2,0,1
11,2008,360200,1,1,0,1
12,2008,360200,3,3,0,0
1,2009,360200,2,2,0,0
2,2009,360200,4,3,1,0
3,2009,360200,5,3,2,0
4,2009,360200,5,5,0,4
5,2009,360200,5,5,0,1
6,2009,360200,2,2,0,1
7,2009,360200,9,9,0,2
8,2009,360200,6,6,0,0
9,2009,360200,5,4,1,0
10,2009,360200,5,5,0,0
11,2009,360200,2,1,1,0
12,2009,360200,6,6,0,1
1,2010,360200,2,2,0,1
2,2010,360200,5,5,0,1
3,2010,360200,3,3,0,0
4,2010,360200,3,3,0,1
5,2010,360200,1,1,0,0
6,2010,360200,7,6,1,0
7,2010,360200,6,5,1,0
8,2010,360200,9,7,2,0
9,2010,360200,3,3,0,0
10,2010,360200,4,3,1,0
11,2010,360200,4,4,0,1
12,2010,360200,4,4,0,0
1,2011,360200,4,3,1,1
2,2011,360200,3,3,0,0
1,1999,351400,17,14,3,3
2,1999,351400,18,13,5,2
3,1999,351400,14,7,7,17
4,1999,351400,17,16,1,8
5,1999,351400,17,16,1,0
6,1999,351400,17,15,2,1
7,1999,351400,31,27,4,1
8,1999,351400,20,15,5,0
9,1999,351400,13,10,3,2
10,1999,351400,15,15,0,3
11,1999,351400,16,12,4,2
12,1999,351400,21,17,4,0
1,2000,351400,18,14,4,0
2,2000,351400,10,5,5,2
3,2000,351400,17,13,4,15
4,2000,351400,7,4,3,12
5,2000,351400,12,8,4,5
6,2000,351400,18,13,5,0
7,2000,351400,26,23,3,2
8,2000,351400,24,18,6,5
9,2000,351400,19,16,3,3
10,2000,351400,24,16,8,3
11,2000,351400,21,18,3,4
12,2000,351400,19,18,1,3
1,2001,351400,13,10,3,4
2,2001,351400,18,15,3,6
3,2001,351400,17,13,4,7
4,2001,351400,17,11,6,8
5,2001,351400,13,10,3,5
6,2001,351400,16,10,6,4
7,2001,351400,14,10,4,3
8,2001,351400,16,11,5,4
9,2001,351400,20,16,4,3
10,2001,351400,23,20,3,4
11,2001,351400,13,12,1,3
12,2001,351400,10,9,1,5
1,2002,351400,15,12,3,5
2,2002,351400,16,14,2,4
3,2002,351400,20,17,3,3
4,2002,351400,18,14,4,3
5,2002,351400,15,13,2,5
6,2002,351400,21,17,4,2
7,2002,351400,22,13,9,1
8,2002,351400,22,18,4,1
9,2002,351400,15,11,4,3
10,2002,351400,11,9,2,7
11,2002,351400,17,13,4,2
12,2002,351400,20,16,4,4
1,2003,351400,11,10,1,6
2,2003,351400,14,12,2,2
3,2003,351400,10,6,4,4
4,2003,351400,10,6,4,1
5,2003,351400,22,21,1,1
6,2003,351400,7,6,1,1
7,2003,351400,18,13,5,5
8,2003,351400,19,11,8,3
9,2003,351400,16,14,2,4
10,2003,351400,23,21,2,1
11,2003,351400,16,15,1,6
12,2003,351400,8,7,1,2
1,2004,351400,10,9,1,1
2,2004,351400,11,10,1,0
3,2004,351400,10,9,1,4
4,2004,351400,7,6,1,5
5,2004,351400,17,14,3,3
6,2004,351400,15,10,5,5
7,2004,351400,15,13,2,10
8,2004,351400,15,12,3,6
9,2004,351400,13,10,3,3
10,2004,351400,12,9,3,1
11,2004,351400,12,11,1,5
12,2004,351400,5,3,2,6
1,2005,351400,8,5,3,2
2,2005,351400,15,12,3,5
3,2005,351400,14,13,1,3
4,2005,351400,16,14,2,3
5,2005,351400,17,12,5,1
6,2005,351400,11,6,5,2
7,2005,351400,10,7,3,3
8,2005,351400,13,11,2,1
9,2005,351400,16,11,5,8
10,2005,351400,8,6,2,3
11,2005,351400,14,13,1,5
12,2005,351400,10,9,1,2
1,2006,351400,12,10,2,8
2,2006,351400,3,2,1,5
3,2006,351400,9,8,1,4
4,2006,351400,13,12,1,3
5,2006,351400,25,21,4,5
6,2006,351400,12,11,1,2
7,2006,351400,5,3,2,3
8,2006,351400,15,13,2,0
9,2006,351400,8,7,1,1
10,2006,351400,10,8,2,1
11,2006,351400,6,1,5,1
12,2006,351400,11,10,1,1
1,2007,351400,8,7,1,2
2,2007,351400,6,5,1,0
3,2007,351400,18,12,6,2
4,2007,351400,7,6,1,1
5,2007,351400,13,8,5,1
6,2007,351400,9,6,3,2
7,2007,351400,11,8,3,4
8,2007,351400,12,7,5,4
9,2007,351400,13,10,3,3
10,2007,351400,9,6,3,5
11,2007,351400,6,5,1,5
12,2007,351400,8,6,2,4
1,2008,351400,6,4,2,0
2,2008,351400,11,8,3,3
3,2008,351400,13,11,2,5
4,2008,351400,9,8,1,8
5,2008,351400,10,8,2,5
6,2008,351400,9,6,3,6
7,2008,351400,12,9,3,4
8,2008,351400,6,5,1,7
9,2008,351400,11,10,1,6
10,2008,351400,24,22,2,3
11,2008,351400,6,5,1,2
12,2008,351400,6,6,0,2
1,2009,351400,3,3,0,1
2,2009,351400,7,6,1,3
3,2009,351400,12,9,3,3
4,2009,351400,7,4,3,4
5,2009,351400,13,11,2,12
6,2009,351400,7,5,2,10
7,2009,351400,6,4,2,10
8,2009,351400,8,8,0,6
9,2009,351400,8,7,1,3
10,2009,351400,4,3,1,12
11,2009,351400,14,13,1,0
12,2009,351400,10,9,1,3
1,2010,351400,9,9,0,3
2,2010,351400,9,9,0,2
3,2010,351400,9,7,2,4
4,2010,351400,6,4,2,5
5,2010,351400,5,5,0,1
6,2010,351400,10,9,1,5
7,2010,351400,6,6,0,3
8,2010,351400,11,8,3,6
9,2010,351400,3,3,0,5
10,2010,351400,9,8,1,12
11,2010,351400,11,10,1,7
12,2010,351400,10,10,0,0
1,2011,351400,22,18,4,5
2,2011,351400,0,0,0,2
1,1999,351500,8,6,2,13
2,1999,351500,11,6,5,10
3,1999,351500,11,6,5,11
4,1999,351500,14,12,2,7
5,1999,351500,16,10,6,3
6,1999,351500,11,6,5,7
7,1999,351500,17,13,4,5
8,1999,351500,11,6,5,3
9,1999,351500,18,13,5,5
10,1999,351500,8,4,4,6
11,1999,351500,20,13,7,6
12,1999,351500,8,6,2,6
1,2000,351500,11,7,4,5
2,2000,351500,8,6,2,10
3,2000,351500,4,2,2,15
4,2000,351500,5,3,2,5
5,2000,351500,14,8,6,10
6,2000,351500,17,6,11,12
7,2000,351500,13,10,3,22
8,2000,351500,11,7,4,36
9,2000,351500,11,7,4,24
10,2000,351500,14,7,7,10
11,2000,351500,9,8,1,13
12,2000,351500,12,5,7,35
1,2001,351500,9,4,5,75
2,2001,351500,5,1,4,28
3,2001,351500,6,3,3,36
4,2001,351500,14,6,8,24
5,2001,351500,13,6,7,29
6,2001,351500,17,8,9,21
7,2001,351500,5,3,2,17
8,2001,351500,15,11,4,14
9,2001,351500,11,4,7,10
10,2001,351500,6,3,3,13
11,2001,351500,4,1,3,10
12,2001,351500,9,7,2,18
1,2002,351500,5,4,1,80
2,2002,351500,7,4,3,13
3,2002,351500,6,4,2,8
4,2002,351500,7,3,4,7
5,2002,351500,9,6,3,11
6,2002,351500,12,5,7,3
7,2002,351500,10,6,4,6
8,2002,351500,16,11,5,8
9,2002,351500,7,4,3,14
10,2002,351500,11,7,4,29
11,2002,351500,6,4,2,30
12,2002,351500,3,3,0,33
1,2003,351500,9,3,6,59
2,2003,351500,2,2,0,50
3,2003,351500,4,2,2,65
4,2003,351500,6,4,2,16
5,2003,351500,9,7,2,17
6,2003,351500,6,3,3,13
7,2003,351500,6,5,1,14
8,2003,351500,7,6,1,19
9,2003,351500,7,5,2,18
10,2003,351500,2,2,0,27
11,2003,351500,6,5,1,18
12,2003,351500,2,1,1,2
1,2004,351500,3,2,1,1
2,2004,351500,2,1,1,2
3,2004,351500,2,2,0,7
4,2004,351500,2,1,1,1
5,2004,351500,2,1,1,2
6,2004,351500,5,5,0,8
7,2004,351500,4,2,2,18
8,2004,351500,4,3,1,7
9,2004,351500,5,5,0,4
10,2004,351500,2,2,0,0
11,2004,351500,1,1,0,4
12,2004,351500,1,0,1,3
1,2005,351500,4,4,0,2
2,2005,351500,0,0,0,0
3,2005,351500,1,0,1,2
4,2005,351500,2,1,1,3
5,2005,351500,4,4,0,0
6,2005,351500,3,2,1,3
7,2005,351500,4,2,2,0
8,2005,351500,7,4,3,6
9,2005,351500,4,2,2,3
10,2005,351500,9,8,1,6
11,2005,351500,2,2,0,11
12,2005,351500,3,3,0,12
1,2006,351500,2,1,1,9
2,2006,351500,5,3,2,10
3,2006,351500,3,1,2,3
4,2006,351500,4,1,3,8
5,2006,351500,8,7,1,0
6,2006,351500,5,4,1,2
7,2006,351500,5,5,0,1
8,2006,351500,3,3,0,0
9,2006,351500,1,1,0,0
10,2006,351500,3,2,1,0
11,2006,351500,3,2,1,1
12,2006,351500,0,0,0,0
1,2007,351500,2,2,0,1
2,2007,351500,2,1,1,0
3,2007,351500,4,2,2,0
4,2007,351500,5,5,0,0
5,2007,351500,1,1,0,0
6,2007,351500,6,5,1,2
7,2007,351500,1,1,0,1
8,2007,351500,1,1,0,0
9,2007,351500,3,1,2,0
10,2007,351500,3,2,1,0
11,2007,351500,3,1,2,0
12,2007,351500,1,1,0,0
1,2008,351500,0,0,0,0
2,2008,351500,1,0,1,0
3,2008,351500,2,2,0,0
4,2008,351500,3,2,1,0
5,2008,351500,3,3,0,0
6,2008,351500,2,2,0,0
7,2008,351500,1,1,0,0
8,2008,351500,2,2,0,0
9,2008,351500,10,10,0,0
10,2008,351500,3,3,0,2
11,2008,351500,2,1,1,0
12,2008,351500,1,0,1,0
1,2009,351500,2,2,0,0
2,2009,351500,1,1,0,0
3,2009,351500,1,1,0,0
4,2009,351500,1,1,0,0
5,2009,351500,0,0,0,1
6,2009,351500,2,0,2,5
7,2009,351500,1,1,0,1
8,2009,351500,3,2,1,3
9,2009,351500,2,2,0,2
10,2009,351500,2,2,0,2
11,2009,351500,5,4,1,0
12,2009,351500,4,4,0,0
1,2010,351500,1,1,0,0
2,2010,351500,2,1,1,0
3,2010,351500,0,0,0,1
4,2010,351500,2,2,0,0
5,2010,351500,3,3,0,1
6,2010,351500,3,3,0,2
7,2010,351500,5,5,0,0
8,2010,351500,9,8,1,0
9,2010,351500,6,5,1,0
10,2010,351500,5,5,0,2
11,2010,351500,3,2,1,2
12,2010,351500,4,3,1,0
1,2011,351500,1,0,1,1
2,2011,351500,1,1,0,0
1,1999,839600,14,11,3,5
2,1999,839600,27,20,7,6
3,1999,839600,17,14,3,1
4,1999,839600,32,28,4,3
5,1999,839600,22,21,1,2
6,1999,839600,28,24,4,1
7,1999,839600,28,26,2,0
8,1999,839600,40,33,7,2
9,1999,839600,33,25,8,2
10,1999,839600,21,20,1,2
11,1999,839600,17,15,2,0
12,1999,839600,19,15,4,2
1,2000,839600,17,12,5,1
2,2000,839600,13,10,3,4
3,2000,839600,18,15,3,8
4,2000,839600,20,18,2,8
5,2000,839600,32,24,8,10
6,2000,839600,28,23,5,10
7,2000,839600,18,13,5,18
8,2000,839600,23,19,4,3
9,2000,839600,28,22,6,6
10,2000,839600,14,10,4,2
11,2000,839600,12,11,1,1
12,2000,839600,12,10,2,3
1,2001,839600,10,10,0,10
2,2001,839600,9,6,3,3
3,2001,839600,7,6,1,5
4,2001,839600,9,7,2,6
5,2001,839600,12,12,0,4
6,2001,839600,16,9,7,5
7,2001,839600,16,13,3,1
8,2001,839600,14,12,2,1
9,2001,839600,17,14,3,3
10,2001,839600,15,15,0,6
11,2001,839600,17,13,4,1
12,2001,839600,7,4,3,0
1,2002,839600,10,8,2,3
2,2002,839600,16,10,6,2
3,2002,839600,18,14,4,1
4,2002,839600,15,12,3,1
5,2002,839600,19,14,5,6
6,2002,839600,17,16,1,2
7,2002,839600,13,9,4,0
8,2002,839600,30,26,4,3
9,2002,839600,23,17,6,1
10,2002,839600,15,12,3,2
11,2002,839600,6,6,0,5
12,2002,839600,11,9,2,0
1,2003,839600,9,9,0,7
2,2003,839600,16,15,1,9
3,2003,839600,11,6,5,15
4,2003,839600,11,8,3,1
5,2003,839600,10,6,4,1
6,2003,839600,15,13,2,2
7,2003,839600,19,15,4,3
8,2003,839600,17,12,5,3
9,2003,839600,18,16,2,3
10,2003,839600,19,14,5,1
11,2003,839600,21,16,5,0
12,2003,839600,26,20,6,2
1,2004,839600,17,15,2,3
2,2004,839600,12,12,0,5
3,2004,839600,18,16,2,4
4,2004,839600,17,16,1,3
5,2004,839600,21,16,5,6
6,2004,839600,25,16,9,5
7,2004,839600,11,9,2,8
8,2004,839600,20,16,4,3
9,2004,839600,16,13,3,1
10,2004,839600,14,12,2,3
11,2004,839600,21,18,3,10
12,2004,839600,15,14,1,3
1,2005,839600,12,9,3,7
2,2005,839600,11,11,0,15
3,2005,839600,12,9,3,6
4,2005,839600,16,12,4,8
5,2005,839600,23,16,7,6
6,2005,839600,20,18,2,9
7,2005,839600,17,13,4,6
8,2005,839600,25,21,4,7
9,2005,839600,10,9,1,14
10,2005,839600,15,13,2,7
11,2005,839600,10,9,1,8
12,2005,839600,12,12,0,4
1,2006,839600,11,11,0,5
2,2006,839600,12,12,0,1
3,2006,839600,15,12,3,8
4,2006,839600,13,11,2,2
5,2006,839600,10,8,2,7
6,2006,839600,27,23,4,0
7,2006,839600,13,12,1,2
8,2006,839600,19,16,3,4
9,2006,839600,15,9,6,15
10,2006,839600,19,15,4,12
11,2006,839600,11,11,0,10
12,2006,839600,14,11,3,7
1,2007,839600,12,10,2,17
2,2007,839600,7,7,0,15
3,2007,839600,6,6,0,6
4,2007,839600,11,6,5,6
5,2007,839600,17,14,3,7
6,2007,839600,14,12,2,9
7,2007,839600,18,14,4,2
8,2007,839600,19,17,2,2
9,2007,839600,9,7,2,2
10,2007,839600,11,10,1,3
11,2007,839600,8,3,5,10
12,2007,839600,4,3,1,3
1,2008,839600,15,13,2,4
2,2008,839600,5,4,1,1
3,2008,839600,9,8,1,3
4,2008,839600,9,5,4,1
5,2008,839600,11,10,1,4
6,2008,839600,9,6,3,3
7,2008,839600,4,3,1,1
8,2008,839600,4,3,1,5
9,2008,839600,6,5,1,3
10,2008,839600,9,6,3,4
11,2008,839600,9,6,3,4
12,2008,839600,6,5,1,1
1,2009,839600,4,4,0,5
2,2009,839600,8,7,1,4
3,2009,839600,5,4,1,5
4,2009,839600,6,4,2,1
5,2009,839600,11,8,3,4
6,2009,839600,6,6,0,6
7,2009,839600,3,3,0,8
8,2009,839600,3,3,0,3
9,2009,839600,4,3,1,4
10,2009,839600,5,5,0,3
11,2009,839600,8,7,1,3
12,2009,839600,3,3,0,0
1,2010,839600,5,5,0,2
2,2010,839600,7,7,0,4
3,2010,839600,7,7,0,3
4,2010,839600,6,5,1,3
5,2010,839600,11,11,0,2
6,2010,839600,13,13,0,6
7,2010,839600,11,11,0,4
8,2010,839600,6,6,0,1
9,2010,839600,9,7,2,6
10,2010,839600,6,6,0,3
11,2010,839600,12,11,1,3
12,2010,839600,4,4,0,6
1,2011,839600,8,7,1,1
2,2011,839600,6,6,0,2
1,1999,843500,19,18,1,4
2,1999,843500,23,20,3,5
3,1999,843500,17,15,2,9
4,1999,843500,25,23,2,11
5,1999,843500,26,22,4,9
6,1999,843500,26,25,1,0
7,1999,843500,27,25,2,8
8,1999,843500,29,24,5,7
9,1999,843500,14,14,0,6
10,1999,843500,29,25,4,3
11,1999,843500,19,18,1,5
12,1999,843500,9,8,1,17
1,2000,843500,14,14,0,6
2,2000,843500,26,24,2,9
3,2000,843500,17,16,1,9
4,2000,843500,16,13,3,11
5,2000,843500,14,13,1,7
6,2000,843500,13,12,1,6
7,2000,843500,22,20,2,7
8,2000,843500,15,14,1,3
9,2000,843500,30,29,1,4
10,2000,843500,16,15,1,6
11,2000,843500,17,17,0,6
12,2000,843500,10,10,0,4
1,2001,843500,13,12,1,7
2,2001,843500,16,13,3,2
3,2001,843500,14,12,2,4
4,2001,843500,12,12,0,3
5,2001,843500,16,14,2,2
6,2001,843500,15,14,1,2
7,2001,843500,15,11,4,4
8,2001,843500,17,15,2,1
9,2001,843500,16,12,4,3
10,2001,843500,17,16,1,8
11,2001,843500,16,16,0,6
12,2001,843500,17,13,4,1
1,2002,843500,17,16,1,0
2,2002,843500,15,13,2,3
3,2002,843500,11,8,3,0
4,2002,843500,14,12,2,5
5,2002,843500,21,17,4,4
6,2002,843500,14,13,1,2
7,2002,843500,27,26,1,1
8,2002,843500,22,19,3,4
9,2002,843500,16,15,1,0
10,2002,843500,13,11,2,3
11,2002,843500,11,11,0,0
12,2002,843500,13,12,1,3
1,2003,843500,21,20,1,2
2,2003,843500,20,18,2,4
3,2003,843500,12,12,0,1
4,2003,843500,14,10,4,1
5,2003,843500,18,14,4,1
6,2003,843500,12,6,6,3
7,2003,843500,22,18,4,4
8,2003,843500,17,15,2,2
9,2003,843500,22,21,1,0
10,2003,843500,12,11,1,4
11,2003,843500,15,14,1,1
12,2003,843500,12,10,2,4
1,2004,843500,17,17,0,2
2,2004,843500,15,14,1,3
3,2004,843500,18,17,1,7
4,2004,843500,20,19,1,3
5,2004,843500,20,19,1,4
6,2004,843500,18,15,3,2
7,2004,843500,16,16,0,5
8,2004,843500,19,19,0,4
9,2004,843500,20,17,3,3
10,2004,843500,31,30,1,5
11,2004,843500,36,35,1,3
12,2004,843500,9,6,3,4
1,2005,843500,12,9,3,8
2,2005,843500,10,9,1,2
3,2005,843500,18,16,2,5
4,2005,843500,9,9,0,1
5,2005,843500,14,9,5,2
6,2005,843500,20,19,1,3
7,2005,843500,23,21,2,2
8,2005,843500,19,18,1,1
9,2005,843500,29,27,2,2
10,2005,843500,23,23,0,6
11,2005,843500,27,26,1,2
12,2005,843500,21,20,1,2
1,2006,843500,34,32,2,1
2,2006,843500,15,14,1,3
3,2006,843500,24,21,3,4
4,2006,843500,11,10,1,6
5,2006,843500,9,8,1,1
6,2006,843500,6,5,1,1
7,2006,843500,6,6,0,1
8,2006,843500,14,11,3,6
9,2006,843500,15,15,0,0
10,2006,843500,19,19,0,1
11,2006,843500,20,19,1,0
12,2006,843500,17,17,0,1
1,2007,843500,6,6,0,3
2,2007,843500,10,10,0,1
3,2007,843500,13,13,0,1
4,2007,843500,19,18,1,0
5,2007,843500,10,10,0,3
6,2007,843500,10,10,0,3
7,2007,843500,22,20,2,0
8,2007,843500,15,15,0,1
9,2007,843500,12,12,0,1
10,2007,843500,44,41,3,3
11,2007,843500,18,16,2,1
12,2007,843500,23,21,2,3
1,2008,843500,16,13,3,2
2,2008,843500,7,6,1,0
3,2008,843500,19,18,1,0
4,2008,843500,27,25,2,1
5,2008,843500,25,24,1,1
6,2008,843500,9,9,0,3
7,2008,843500,10,8,2,0
8,2008,843500,9,9,0,0
9,2008,843500,7,6,1,1
10,2008,843500,7,7,0,1
11,2008,843500,10,10,0,6
12,2008,843500,9,9,0,1
1,2009,843500,7,6,1,3
2,2009,843500,6,4,2,1
3,2009,843500,8,6,2,1
4,2009,843500,11,11,0,2
5,2009,843500,11,11,0,2
6,2009,843500,4,4,0,2
7,2009,843500,5,5,0,0
8,2009,843500,10,8,2,4
9,2009,843500,10,9,1,1
10,2009,843500,4,3,1,0
11,2009,843500,9,8,1,0
12,2009,843500,9,9,0,1
1,2010,843500,9,9,0,3
2,2010,843500,10,7,3,1
3,2010,843500,4,3,1,0
4,2010,843500,8,7,1,3
5,2010,843500,10,9,1,1
6,2010,843500,7,7,0,3
7,2010,843500,10,9,1,1
8,2010,843500,6,5,1,2
9,2010,843500,13,11,2,1
10,2010,843500,16,14,2,0
11,2010,843500,8,7,1,4
12,2010,843500,14,13,1,2
1,2011,843500,1,1,0,3
2,2011,843500,6,6,0,4
1,1999,840400,24,20,4,2
2,1999,840400,20,18,2,0
3,1999,840400,27,25,2,1
4,1999,840400,34,30,4,1
5,1999,840400,26,25,1,0
6,1999,840400,23,19,4,1
7,1999,840400,22,19,3,1
8,1999,840400,30,26,4,5
9,1999,840400,25,24,1,1
10,1999,840400,23,20,3,0
11,1999,840400,18,12,6,2
12,1999,840400,20,18,2,1
1,2000,840400,17,15,2,0
2,2000,840400,20,18,2,2
3,2000,840400,36,32,4,2
4,2000,840400,47,46,1,0
5,2000,840400,28,26,2,3
6,2000,840400,45,45,0,2
7,2000,840400,40,37,3,2
8,2000,840400,33,30,3,0
9,2000,840400,32,30,2,1
10,2000,840400,28,24,4,1
11,2000,840400,26,25,1,1
12,2000,840400,28,27,1,0
1,2001,840400,30,29,1,5
2,2001,840400,40,37,3,3
3,2001,840400,33,28,5,2
4,2001,840400,26,23,3,2
5,2001,840400,39,34,5,2
6,2001,840400,35,30,5,0
7,2001,840400,36,31,5,3
8,2001,840400,40,36,4,1
9,2001,840400,35,31,4,1
10,2001,840400,44,41,3,5
11,2001,840400,37,35,2,0
12,2001,840400,31,29,2,0
1,2002,840400,47,43,4,2
2,2002,840400,39,34,5,0
3,2002,840400,30,27,3,0
4,2002,840400,34,32,2,3
5,2002,840400,29,27,2,0
6,2002,840400,33,29,4,0
7,2002,840400,41,37,4,1
8,2002,840400,37,37,0,1
9,2002,840400,29,26,3,1
10,2002,840400,33,28,5,2
11,2002,840400,34,33,1,1
12,2002,840400,24,22,2,2
1,2003,840400,32,30,2,2
2,2003,840400,32,28,4,4
3,2003,840400,44,44,0,1
4,2003,840400,31,29,2,0
5,2003,840400,34,31,3,2
6,2003,840400,33,32,1,1
7,2003,840400,33,28,5,1
8,2003,840400,34,30,4,1
9,2003,840400,20,18,2,5
10,2003,840400,38,35,3,0
11,2003,840400,42,41,1,5
12,2003,840400,32,32,0,2
1,2004,840400,34,30,4,3
2,2004,840400,18,15,3,4
3,2004,840400,27,25,2,1
4,2004,840400,34,30,4,2
5,2004,840400,43,40,3,2
6,2004,840400,41,39,2,1
7,2004,840400,36,31,5,3
8,2004,840400,29,27,2,3
9,2004,840400,37,33,4,3
10,2004,840400,32,28,4,2
11,2004,840400,27,24,3,1
12,2004,840400,32,29,3,0
1,2005,840400,25,25,0,2
2,2005,840400,16,16,0,1
3,2005,840400,31,30,1,4
4,2005,840400,30,24,6,3
5,2005,840400,21,17,4,6
6,2005,840400,27,23,4,2
7,2005,840400,33,30,3,3
8,2005,840400,29,26,3,1
9,2005,840400,39,36,3,7
10,2005,840400,49,43,6,4
11,2005,840400,41,38,3,1
12,2005,840400,28,25,3,0
1,2006,840400,37,35,2,2
2,2006,840400,21,21,0,2
3,2006,840400,19,13,6,3
4,2006,840400,20,17,3,3
5,2006,840400,29,25,4,0
6,2006,840400,20,18,2,7
7,2006,840400,28,25,3,1
8,2006,840400,21,19,2,1
9,2006,840400,23,21,2,2
10,2006,840400,30,28,2,2
11,2006,840400,26,23,3,1
12,2006,840400,45,43,2,3
1,2007,840400,18,17,1,1
2,2007,840400,27,25,2,2
3,2007,840400,29,27,2,4
4,2007,840400,31,29,2,4
5,2007,840400,21,20,1,1
6,2007,840400,26,23,3,1
7,2007,840400,25,24,1,1
8,2007,840400,23,21,2,2
9,2007,840400,28,25,3,4
10,2007,840400,35,34,1,2
11,2007,840400,35,34,1,5
12,2007,840400,25,25,0,2
1,2008,840400,24,24,0,0
2,2008,840400,12,11,1,1
3,2008,840400,13,13,0,1
4,2008,840400,21,21,0,3
5,2008,840400,25,24,1,7
6,2008,840400,26,25,1,4
7,2008,840400,26,22,4,3
8,2008,840400,30,28,2,3
9,2008,840400,24,20,4,2
10,2008,840400,26,25,1,0
11,2008,840400,37,37,0,1
12,2008,840400,32,31,1,2
1,2009,840400,29,29,0,2
2,2009,840400,23,22,1,8
3,2009,840400,38,33,5,9
4,2009,840400,35,34,1,10
5,2009,840400,33,32,1,4
6,2009,840400,41,40,1,2
7,2009,840400,44,42,2,3
8,2009,840400,38,36,2,6
9,2009,840400,35,28,7,3
10,2009,840400,31,30,1,3
11,2009,840400,33,32,1,15
12,2009,840400,32,32,0,5
1,2010,840400,24,24,0,4
2,2010,840400,30,29,1,5
3,2010,840400,27,26,1,4
4,2010,840400,26,25,1,0
5,2010,840400,27,24,3,0
6,2010,840400,32,32,0,3
7,2010,840400,29,26,3,3
8,2010,840400,25,25,0,5
9,2010,840400,29,27,2,2
10,2010,840400,26,25,1,2
11,2010,840400,24,22,2,4
12,2010,840400,27,27,0,1
1,2011,840400,14,14,0,3
2,2011,840400,13,12,1,2
1,1999,839700,15,14,1,2
2,1999,839700,14,14,0,2
3,1999,839700,18,15,3,2
4,1999,839700,22,19,3,2
5,1999,839700,33,27,6,0
6,1999,839700,20,17,3,0
7,1999,839700,18,13,5,2
8,1999,839700,18,15,3,1
9,1999,839700,23,16,7,4
10,1999,839700,23,21,2,0
11,1999,839700,12,12,0,4
12,1999,839700,18,13,5,4
1,2000,839700,16,15,1,2
2,2000,839700,6,5,1,5
3,2000,839700,11,10,1,3
4,2000,839700,21,18,3,4
5,2000,839700,20,17,3,5
6,2000,839700,28,26,2,4
7,2000,839700,27,23,4,1
8,2000,839700,24,23,1,0
9,2000,839700,16,15,1,4
10,2000,839700,10,9,1,4
11,2000,839700,31,27,4,2
12,2000,839700,15,14,1,2
1,2001,839700,11,10,1,0
2,2001,839700,16,15,1,3
3,2001,839700,16,12,4,7
4,2001,839700,7,4,3,0
5,2001,839700,15,15,0,3
6,2001,839700,13,10,3,2
7,2001,839700,18,15,3,1
8,2001,839700,19,15,4,4
9,2001,839700,17,16,1,1
10,2001,839700,33,30,3,9
11,2001,839700,27,25,2,2
12,2001,839700,15,13,2,4
1,2002,839700,11,11,0,1
2,2002,839700,14,13,1,0
3,2002,839700,3,3,0,2
4,2002,839700,7,7,0,3
5,2002,839700,17,15,2,0
6,2002,839700,16,14,2,0
7,2002,839700,23,21,2,1
8,2002,839700,16,15,1,1
9,2002,839700,15,12,3,2
10,2002,839700,12,12,0,0
11,2002,839700,13,11,2,0
12,2002,839700,14,13,1,1
1,2003,839700,19,19,0,1
2,2003,839700,8,6,2,0
3,2003,839700,14,13,1,2
4,2003,839700,16,13,3,1
5,2003,839700,19,19,0,2
6,2003,839700,11,8,3,0
7,2003,839700,15,12,3,1
8,2003,839700,22,21,1,3
9,2003,839700,13,12,1,0
10,2003,839700,19,17,2,2
11,2003,839700,12,10,2,0
12,2003,839700,19,19,0,0
1,2004,839700,14,12,2,0
2,2004,839700,18,17,1,0
3,2004,839700,24,23,1,0
4,2004,839700,12,10,2,0
5,2004,839700,5,5,0,1
6,2004,839700,14,11,3,0
7,2004,839700,16,16,0,1
8,2004,839700,24,22,2,2
9,2004,839700,19,17,2,1
10,2004,839700,21,18,3,0
11,2004,839700,15,14,1,0
12,2004,839700,11,8,3,2
1,2005,839700,16,11,5,1
2,2005,839700,11,10,1,6
3,2005,839700,22,19,3,5
4,2005,839700,13,12,1,1
5,2005,839700,16,14,2,2
6,2005,839700,12,11,1,0
7,2005,839700,14,11,3,4
8,2005,839700,11,11,0,2
9,2005,839700,14,14,0,2
10,2005,839700,15,15,0,3
11,2005,839700,20,17,3,6
12,2005,839700,15,14,1,1
1,2006,839700,14,13,1,3
2,2006,839700,13,11,2,1
3,2006,839700,6,6,0,4
4,2006,839700,16,14,2,1
5,2006,839700,21,18,3,0
6,2006,839700,26,24,2,2
7,2006,839700,19,18,1,0
8,2006,839700,13,11,2,2
9,2006,839700,15,15,0,3
10,2006,839700,8,7,1,0
11,2006,839700,10,10,0,9
12,2006,839700,11,11,0,2
1,2007,839700,16,15,1,0
2,2007,839700,9,7,2,1
3,2007,839700,15,13,2,0
4,2007,839700,12,12,0,2
5,2007,839700,10,10,0,0
6,2007,839700,14,13,1,1
7,2007,839700,5,5,0,1
8,2007,839700,13,12,1,2
9,2007,839700,11,9,2,4
10,2007,839700,13,13,0,0
11,2007,839700,7,5,2,3
12,2007,839700,10,9,1,0
1,2008,839700,17,14,3,0
2,2008,839700,15,14,1,3
3,2008,839700,11,10,1,0
4,2008,839700,14,11,3,2
5,2008,839700,11,10,1,2
6,2008,839700,7,7,0,2
7,2008,839700,14,12,2,2
8,2008,839700,21,21,0,5
9,2008,839700,13,13,0,3
10,2008,839700,16,13,3,1
11,2008,839700,12,12,0,2
12,2008,839700,14,10,4,5
1,2009,839700,6,6,0,5
2,2009,839700,8,6,2,4
3,2009,839700,7,6,1,2
4,2009,839700,8,7,1,2
5,2009,839700,7,5,2,1
6,2009,839700,18,17,1,3
7,2009,839700,16,16,0,1
8,2009,839700,15,14,1,2
9,2009,839700,15,12,3,3
10,2009,839700,15,14,1,2
11,2009,839700,21,19,2,4
12,2009,839700,10,10,0,1
1,2010,839700,6,6,0,2
2,2010,839700,12,12,0,0
3,2010,839700,11,10,1,4
4,2010,839700,13,13,0,2
5,2010,839700,22,20,2,6
6,2010,839700,15,14,1,4
7,2010,839700,18,17,1,2
8,2010,839700,19,18,1,2
9,2010,839700,14,9,5,0
10,2010,839700,11,10,1,3
11,2010,839700,10,9,1,1
12,2010,839700,11,9,2,1
1,2011,839700,7,7,0,0
2,2011,839700,5,5,0,2
1,1999,839800,9,7,2,0
2,1999,839800,11,10,1,0
3,1999,839800,7,6,1,0
4,1999,839800,17,15,2,10
5,1999,839800,11,8,3,2
6,1999,839800,20,17,3,3
7,1999,839800,12,9,3,2
8,1999,839800,10,8,2,1
9,1999,839800,14,14,0,2
10,1999,839800,13,12,1,1
11,1999,839800,6,5,1,1
12,1999,839800,5,4,1,0
1,2000,839800,6,6,0,1
2,2000,839800,10,9,1,1
3,2000,839800,7,6,1,2
4,2000,839800,12,11,1,2
5,2000,839800,12,7,5,1
6,2000,839800,8,6,2,3
7,2000,839800,14,9,5,1
8,2000,839800,12,12,0,1
9,2000,839800,7,6,1,1
10,2000,839800,6,6,0,0
11,2000,839800,7,6,1,2
12,2000,839800,8,7,1,2
1,2001,839800,7,6,1,5
2,2001,839800,6,6,0,0
3,2001,839800,7,7,0,0
4,2001,839800,4,4,0,0
5,2001,839800,4,4,0,5
6,2001,839800,11,10,1,0
7,2001,839800,5,5,0,1
8,2001,839800,9,8,1,1
9,2001,839800,12,9,3,0
10,2001,839800,7,6,1,0
11,2001,839800,14,12,2,2
12,2001,839800,10,9,1,0
1,2002,839800,14,14,0,0
2,2002,839800,12,8,4,0
3,2002,839800,9,8,1,0
4,2002,839800,7,6,1,0
5,2002,839800,6,6,0,0
6,2002,839800,9,7,2,1
7,2002,839800,9,8,1,1
8,2002,839800,13,13,0,1
9,2002,839800,6,5,1,0
10,2002,839800,10,9,1,3
11,2002,839800,12,10,2,0
12,2002,839800,8,6,2,1
1,2003,839800,11,11,0,1
2,2003,839800,9,7,2,1
3,2003,839800,9,6,3,0
4,2003,839800,13,12,1,0
5,2003,839800,10,7,3,0
6,2003,839800,10,10,0,0
7,2003,839800,11,11,0,0
8,2003,839800,10,9,1,2
9,2003,839800,9,9,0,0
10,2003,839800,9,9,0,2
11,2003,839800,13,12,1,2
12,2003,839800,11,10,1,1
1,2004,839800,7,6,1,1
2,2004,839800,7,7,0,0
3,2004,839800,10,8,2,0
4,2004,839800,5,5,0,1
5,2004,839800,4,4,0,1
6,2004,839800,5,5,0,1
7,2004,839800,7,6,1,1
8,2004,839800,5,5,0,2
9,2004,839800,10,9,1,1
10,2004,839800,8,8,0,0
11,2004,839800,7,7,0,0
12,2004,839800,5,5,0,0
1,2005,839800,2,2,0,0
2,2005,839800,3,3,0,2
3,2005,839800,3,3,0,3
4,2005,839800,11,9,2,0
5,2005,839800,11,11,0,2
6,2005,839800,8,8,0,0
7,2005,839800,13,12,1,0
8,2005,839800,13,11,2,0
9,2005,839800,8,7,1,0
10,2005,839800,5,5,0,1
11,2005,839800,4,4,0,0
12,2005,839800,7,6,1,0
1,2006,839800,6,5,1,1
2,2006,839800,9,7,2,1
3,2006,839800,5,5,0,0
4,2006,839800,11,8,3,2
5,2006,839800,4,4,0,1
6,2006,839800,10,10,0,0
7,2006,839800,9,9,0,0
8,2006,839800,6,5,1,3
9,2006,839800,14,10,4,1
10,2006,839800,5,5,0,1
11,2006,839800,9,8,1,1
12,2006,839800,6,6,0,0
1,2007,839800,2,2,0,2
2,2007,839800,7,6,1,0
3,2007,839800,4,4,0,1
4,2007,839800,7,6,1,2
5,2007,839800,10,7,3,1
6,2007,839800,5,4,1,0
7,2007,839800,9,9,0,3
8,2007,839800,3,2,1,1
9,2007,839800,6,4,2,3
10,2007,839800,7,7,0,1
11,2007,839800,6,5,1,0
12,2007,839800,6,4,2,0
1,2008,839800,5,5,0,1
2,2008,839800,6,4,2,2
3,2008,839800,10,10,0,1
4,2008,839800,7,7,0,2
5,2008,839800,7,6,1,1
6,2008,839800,5,4,1,1
7,2008,839800,5,4,1,1
8,2008,839800,8,6,2,1
9,2008,839800,5,4,1,2
10,2008,839800,7,5,2,1
11,2008,839800,3,3,0,0
12,2008,839800,5,5,0,0
1,2009,839800,7,7,0,0
2,2009,839800,3,3,0,0
3,2009,839800,4,4,0,3
4,2009,839800,7,6,1,2
5,2009,839800,10,8,2,1
6,2009,839800,12,10,2,1
7,2009,839800,9,6,3,0
8,2009,839800,12,9,3,1
9,2009,839800,15,14,1,3
10,2009,839800,4,4,0,4
11,2009,839800,15,10,5,2
12,2009,839800,10,9,1,2
1,2010,839800,9,9,0,1
2,2010,839800,8,5,3,1
3,2010,839800,8,8,0,2
4,2010,839800,3,3,0,2
5,2010,839800,3,3,0,1
6,2010,839800,5,5,0,5
7,2010,839800,9,8,1,0
8,2010,839800,7,7,0,3
9,2010,839800,10,10,0,0
10,2010,839800,10,8,2,3
11,2010,839800,12,10,2,1
12,2010,839800,4,4,0,0
1,2011,839800,4,3,1,4
2,2011,839800,5,4,1,1
1,1999,340500,5,5,0,3
2,1999,340500,7,5,2,4
3,1999,340500,5,3,2,2
4,1999,340500,11,9,2,1
5,1999,340500,15,14,1,2
6,1999,340500,10,10,0,5
7,1999,340500,9,7,2,6
8,1999,340500,12,11,1,5
9,1999,340500,6,6,0,5
10,1999,340500,5,5,0,11
11,1999,340500,4,4,0,10
12,1999,340500,7,6,1,4
1,2000,340500,4,4,0,4
2,2000,340500,4,4,0,7
3,2000,340500,6,5,1,7
4,2000,340500,10,9,1,6
5,2000,340500,5,5,0,4
6,2000,340500,18,16,2,2
7,2000,340500,18,16,2,6
8,2000,340500,17,17,0,6
9,2000,340500,8,7,1,1
10,2000,340500,14,14,0,7
11,2000,340500,8,5,3,5
12,2000,340500,2,2,0,4
1,2001,340500,5,5,0,5
2,2001,340500,5,5,0,4
3,2001,340500,3,3,0,5
4,2001,340500,6,6,0,6
5,2001,340500,3,3,0,7
6,2001,340500,15,12,3,2
7,2001,340500,11,9,2,2
8,2001,340500,7,7,0,0
9,2001,340500,7,7,0,2
10,2001,340500,5,5,0,0
11,2001,340500,7,6,1,0
12,2001,340500,13,13,0,2
1,2002,340500,3,3,0,0
2,2002,340500,6,6,0,0
3,2002,340500,4,4,0,2
4,2002,340500,9,7,2,1
5,2002,340500,7,7,0,0
6,2002,340500,11,9,2,5
7,2002,340500,8,7,1,4
8,2002,340500,10,10,0,7
9,2002,340500,13,13,0,0
10,2002,340500,6,5,1,3
11,2002,340500,13,12,1,1
12,2002,340500,4,4,0,1
1,2003,340500,4,4,0,1
2,2003,340500,6,6,0,1
3,2003,340500,6,5,1,5
4,2003,340500,12,11,1,1
5,2003,340500,8,8,0,2
6,2003,340500,13,12,1,4
7,2003,340500,11,11,0,1
8,2003,340500,14,13,1,0
9,2003,340500,11,10,1,0
10,2003,340500,5,4,1,0
11,2003,340500,10,10,0,0
12,2003,340500,13,12,1,0
1,2004,340500,3,2,1,0
2,2004,340500,2,2,0,0
3,2004,340500,9,9,0,1
4,2004,340500,6,4,2,0
5,2004,340500,6,5,1,1
6,2004,340500,14,13,1,2
7,2004,340500,22,21,1,2
8,2004,340500,6,5,1,1
9,2004,340500,3,3,0,2
10,2004,340500,7,7,0,5
11,2004,340500,3,2,1,2
12,2004,340500,7,6,1,0
1,2005,340500,1,1,0,0
2,2005,340500,5,5,0,1
3,2005,340500,5,5,0,1
4,2005,340500,7,7,0,0
5,2005,340500,4,4,0,0
6,2005,340500,4,4,0,0
7,2005,340500,4,4,0,0
8,2005,340500,16,16,0,0
9,2005,340500,8,7,1,0
10,2005,340500,9,9,0,0
11,2005,340500,2,2,0,0
12,2005,340500,3,3,0,0
1,2006,340500,2,2,0,0
2,2006,340500,2,2,0,1
3,2006,340500,7,7,0,0
4,2006,340500,9,8,1,1
5,2006,340500,11,9,2,0
6,2006,340500,9,9,0,1
7,2006,340500,9,8,1,1
8,2006,340500,5,5,0,2
9,2006,340500,9,5,4,1
10,2006,340500,6,6,0,1
11,2006,340500,5,5,0,1
12,2006,340500,9,8,1,0
1,2007,340500,5,3,2,2
2,2007,340500,6,6,0,2
3,2007,340500,5,4,1,1
4,2007,340500,5,5,0,1
5,2007,340500,8,6,2,0
6,2007,340500,10,10,0,1
7,2007,340500,8,7,1,1
8,2007,340500,5,4,1,1
9,2007,340500,9,7,2,0
10,2007,340500,6,6,0,3
11,2007,340500,4,3,1,0
12,2007,340500,2,1,1,0
1,2008,340500,4,3,1,0
2,2008,340500,1,1,0,0
3,2008,340500,6,6,0,2
4,2008,340500,4,3,1,0
5,2008,340500,12,11,1,0
6,2008,340500,15,14,1,2
7,2008,340500,16,16,0,0
8,2008,340500,10,9,1,3
9,2008,340500,3,3,0,0
10,2008,340500,6,6,0,0
11,2008,340500,3,3,0,0
12,2008,340500,4,4,0,1
1,2009,340500,4,4,0,1
2,2009,340500,0,0,0,2
3,2009,340500,4,4,0,0
4,2009,340500,9,6,3,2
5,2009,340500,9,7,2,0
6,2009,340500,9,8,1,0
7,2009,340500,13,12,1,0
8,2009,340500,5,2,3,5
9,2009,340500,10,9,1,0
10,2009,340500,5,5,0,0
11,2009,340500,4,4,0,0
12,2009,340500,8,8,0,2
1,2010,340500,3,3,0,0
2,2010,340500,3,2,1,0
3,2010,340500,10,10,0,0
4,2010,340500,6,6,0,0
5,2010,340500,5,5,0,3
6,2010,340500,8,7,1,0
7,2010,340500,6,6,0,0
8,2010,340500,7,6,1,1
9,2010,340500,10,10,0,1
10,2010,340500,6,6,0,0
11,2010,340500,9,9,0,1
12,2010,340500,3,3,0,0
1,2011,340500,5,5,0,0
2,2011,340500,5,5,0,4
1,1999,842000,34,27,7,9
2,1999,842000,24,22,2,13
3,1999,842000,29,25,4,8
4,1999,842000,37,33,4,16
5,1999,842000,40,39,1,8
6,1999,842000,47,38,9,4
7,1999,842000,55,49,6,13
8,1999,842000,41,34,7,14
9,1999,842000,37,36,1,8
10,1999,842000,45,37,8,17
11,1999,842000,25,20,5,9
12,1999,842000,27,24,3,10
1,2000,842000,25,24,1,6
2,2000,842000,24,20,4,20
3,2000,842000,40,36,4,33
4,2000,842000,30,27,3,27
5,2000,842000,19,16,3,19
6,2000,842000,38,34,4,14
7,2000,842000,44,37,7,19
8,2000,842000,43,37,6,18
9,2000,842000,34,31,3,15
10,2000,842000,34,24,10,9
11,2000,842000,39,31,8,9
12,2000,842000,20,20,0,9
1,2001,842000,34,30,4,39
2,2001,842000,22,17,5,26
3,2001,842000,28,21,7,22
4,2001,842000,23,21,2,20
5,2001,842000,27,20,7,28
6,2001,842000,26,21,5,10
7,2001,842000,37,28,9,9
8,2001,842000,32,28,4,14
9,2001,842000,29,28,1,7
10,2001,842000,46,40,6,12
11,2001,842000,28,25,3,15
12,2001,842000,24,20,4,11
1,2002,842000,22,16,6,11
2,2002,842000,26,21,5,12
3,2002,842000,41,33,8,13
4,2002,842000,39,32,7,13
5,2002,842000,35,33,2,10
6,2002,842000,32,26,6,23
7,2002,842000,38,31,7,11
8,2002,842000,29,25,4,13
9,2002,842000,34,29,5,8
10,2002,842000,30,28,2,7
11,2002,842000,15,15,0,4
12,2002,842000,18,15,3,4
1,2003,842000,19,19,0,4
2,2003,842000,14,12,2,5
3,2003,842000,24,24,0,7
4,2003,842000,29,24,5,8
5,2003,842000,29,26,3,7
6,2003,842000,21,18,3,3
7,2003,842000,22,19,3,6
8,2003,842000,22,22,0,8
9,2003,842000,33,30,3,2
10,2003,842000,28,28,0,10
11,2003,842000,16,15,1,1
12,2003,842000,25,24,1,1
1,2004,842000,20,20,0,4
2,2004,842000,23,17,6,7
3,2004,842000,25,25,0,7
4,2004,842000,28,26,2,4
5,2004,842000,27,22,5,3
6,2004,842000,24,19,5,4
7,2004,842000,31,29,2,5
8,2004,842000,30,27,3,4
9,2004,842000,27,27,0,4
10,2004,842000,25,23,2,3
11,2004,842000,30,28,2,5
12,2004,842000,24,23,1,7
1,2005,842000,21,19,2,6
2,2005,842000,16,14,2,4
3,2005,842000,22,20,2,1
4,2005,842000,19,18,1,0
5,2005,842000,16,15,1,3
6,2005,842000,25,22,3,4
7,2005,842000,32,30,2,5
8,2005,842000,29,25,4,2
9,2005,842000,30,27,3,6
10,2005,842000,32,30,2,3
11,2005,842000,30,28,2,4
12,2005,842000,26,24,2,6
1,2006,842000,33,31,2,8
2,2006,842000,25,24,1,1
3,2006,842000,26,24,2,2
4,2006,842000,25,23,2,2
5,2006,842000,31,31,0,11
6,2006,842000,25,25,0,9
7,2006,842000,23,22,1,7
8,2006,842000,22,21,1,9
9,2006,842000,27,26,1,10
10,2006,842000,21,18,3,8
11,2006,842000,23,20,3,5
12,2006,842000,22,20,2,1
1,2007,842000,16,14,2,5
2,2007,842000,19,18,1,4
3,2007,842000,27,24,3,3
4,2007,842000,17,15,2,6
5,2007,842000,21,20,1,3
6,2007,842000,22,21,1,2
7,2007,842000,26,24,2,0
8,2007,842000,28,21,7,3
9,2007,842000,26,22,4,7
10,2007,842000,42,33,9,6
11,2007,842000,25,21,4,9
12,2007,842000,34,31,3,5
1,2008,842000,18,13,5,11
2,2008,842000,7,6,1,5
3,2008,842000,17,16,1,8
4,2008,842000,25,25,0,6
5,2008,842000,19,13,6,7
6,2008,842000,19,17,2,5
7,2008,842000,34,31,3,12
8,2008,842000,44,42,2,5
9,2008,842000,28,23,5,6
10,2008,842000,24,22,2,5
11,2008,842000,15,15,0,10
12,2008,842000,22,21,1,14
1,2009,842000,23,22,1,7
2,2009,842000,20,18,2,9
3,2009,842000,21,19,2,4
4,2009,842000,18,15,3,2
5,2009,842000,21,16,5,8
6,2009,842000,20,17,3,1
7,2009,842000,25,25,0,11
8,2009,842000,28,24,4,5
9,2009,842000,19,16,3,8
10,2009,842000,23,19,4,3
11,2009,842000,18,16,2,7
12,2009,842000,20,20,0,7
1,2010,842000,19,17,2,12
2,2010,842000,15,15,0,8
3,2010,842000,22,20,2,4
4,2010,842000,29,27,2,4
5,2010,842000,21,19,2,9
6,2010,842000,21,20,1,5
7,2010,842000,18,17,1,4
8,2010,842000,33,29,4,2
9,2010,842000,23,18,5,3
10,2010,842000,22,22,0,9
11,2010,842000,17,17,0,6
12,2010,842000,14,14,0,8
1,2011,842000,24,23,1,11
2,2011,842000,19,19,0,0
1,1999,351000,20,19,1,0
2,1999,351000,16,16,0,1
3,1999,351000,25,20,5,1
4,1999,351000,30,27,3,0
5,1999,351000,24,22,2,4
6,1999,351000,29,27,2,1
7,1999,351000,41,37,4,1
8,1999,351000,25,23,2,1
9,1999,351000,33,29,4,0
10,1999,351000,22,18,4,0
11,1999,351000,35,30,5,1
12,1999,351000,20,18,2,0
1,2000,351000,21,21,0,0
2,2000,351000,34,28,6,3
3,2000,351000,38,31,7,5
4,2000,351000,31,29,2,1
5,2000,351000,36,30,6,0
6,2000,351000,32,31,1,4
7,2000,351000,29,26,3,1
8,2000,351000,44,41,3,3
9,2000,351000,21,18,3,0
10,2000,351000,31,29,2,3
11,2000,351000,23,23,0,0
12,2000,351000,25,23,2,5
1,2001,351000,33,31,2,2
2,2001,351000,21,19,2,2
3,2001,351000,24,16,8,1
4,2001,351000,35,33,2,1
5,2001,351000,35,33,2,1
6,2001,351000,19,17,2,1
7,2001,351000,29,22,7,1
8,2001,351000,23,20,3,1
9,2001,351000,34,31,3,1
10,2001,351000,37,34,3,3
11,2001,351000,31,28,3,0
12,2001,351000,25,24,1,1
1,2002,351000,26,23,3,1
2,2002,351000,17,13,4,1
3,2002,351000,26,24,2,0
4,2002,351000,25,23,2,2
5,2002,351000,24,21,3,4
6,2002,351000,27,20,7,1
7,2002,351000,22,22,0,1
8,2002,351000,31,30,1,0
9,2002,351000,29,26,3,0
10,2002,351000,22,22,0,1
11,2002,351000,17,16,1,2
12,2002,351000,19,18,1,1
1,2003,351000,37,34,3,3
2,2003,351000,26,25,1,0
3,2003,351000,26,22,4,0
4,2003,351000,27,24,3,0
5,2003,351000,23,21,2,0
6,2003,351000,20,18,2,1
7,2003,351000,23,21,2,1
8,2003,351000,23,23,0,2
9,2003,351000,20,16,4,0
10,2003,351000,36,32,4,3
11,2003,351000,19,17,2,2
12,2003,351000,28,28,0,5
1,2004,351000,18,18,0,2
2,2004,351000,23,19,4,1
3,2004,351000,26,24,2,2
4,2004,351000,26,21,5,4
5,2004,351000,23,23,0,3
6,2004,351000,22,20,2,6
7,2004,351000,35,34,1,6
8,2004,351000,29,28,1,6
9,2004,351000,41,36,5,7
10,2004,351000,34,32,2,5
11,2004,351000,21,19,2,5
12,2004,351000,13,13,0,2
1,2005,351000,10,8,2,10
2,2005,351000,15,12,3,13
3,2005,351000,22,20,2,10
4,2005,351000,32,29,3,19
5,2005,351000,18,17,1,11
6,2005,351000,23,20,3,26
7,2005,351000,27,22,5,18
8,2005,351000,22,20,2,4
9,2005,351000,17,17,0,5
10,2005,351000,27,22,5,3
11,2005,351000,21,17,4,0
12,2005,351000,21,20,1,0
1,2006,351000,18,17,1,0
2,2006,351000,16,16,0,1
3,2006,351000,24,22,2,1
4,2006,351000,19,17,2,3
5,2006,351000,23,21,2,5
6,2006,351000,28,21,7,7
7,2006,351000,25,23,2,12
8,2006,351000,17,16,1,12
9,2006,351000,20,17,3,6
10,2006,351000,26,23,3,5
11,2006,351000,25,21,4,4
12,2006,351000,20,18,2,4
1,2007,351000,14,13,1,11
2,2007,351000,17,15,2,26
3,2007,351000,21,19,2,20
4,2007,351000,15,14,1,19
5,2007,351000,27,25,2,31
6,2007,351000,18,18,0,32
7,2007,351000,28,23,5,21
8,2007,351000,34,28,6,20
9,2007,351000,30,27,3,9
10,2007,351000,32,30,2,12
11,2007,351000,26,22,4,16
12,2007,351000,19,15,4,13
1,2008,351000,12,10,2,26
2,2008,351000,18,16,2,22
3,2008,351000,16,14,2,5
4,2008,351000,12,12,0,10
5,2008,351000,21,21,0,11
6,2008,351000,20,18,2,12
7,2008,351000,23,22,1,27
8,2008,351000,31,29,2,22
9,2008,351000,14,13,1,5
10,2008,351000,20,20,0,1
11,2008,351000,17,17,0,0
12,2008,351000,8,7,1,4
1,2009,351000,16,14,2,3
2,2009,351000,8,7,1,0
3,2009,351000,18,17,1,1
4,2009,351000,17,15,2,4
5,2009,351000,20,20,0,5
6,2009,351000,24,22,2,3
7,2009,351000,11,8,3,3
8,2009,351000,19,19,0,2
9,2009,351000,17,15,2,3
10,2009,351000,17,15,2,3
11,2009,351000,16,14,2,1
12,2009,351000,16,15,1,1
1,2010,351000,21,20,1,0
2,2010,351000,7,7,0,6
3,2010,351000,8,7,1,2
4,2010,351000,16,13,3,0
5,2010,351000,15,12,3,1
6,2010,351000,20,18,2,2
7,2010,351000,23,21,2,0
8,2010,351000,19,18,1,8
9,2010,351000,17,15,2,1
10,2010,351000,10,9,1,0
11,2010,351000,10,9,1,0
12,2010,351000,14,13,1,1
1,2011,351000,15,14,1,5
2,2011,351000,7,6,1,1
1,1999,839500,46,46,0,2
2,1999,839500,54,53,1,3
3,1999,839500,40,38,2,2
4,1999,839500,60,60,0,1
5,1999,839500,60,58,2,0
6,1999,839500,56,54,2,4
7,1999,839500,50,48,2,0
8,1999,839500,54,50,4,2
9,1999,839500,44,44,0,0
10,1999,839500,51,50,1,0
11,1999,839500,35,33,2,0
12,1999,839500,43,41,2,3
1,2000,839500,43,41,2,2
2,2000,839500,25,24,1,6
3,2000,839500,24,23,1,2
4,2000,839500,26,22,4,2
5,2000,839500,17,17,0,6
6,2000,839500,30,28,2,3
7,2000,839500,25,24,1,2
8,2000,839500,29,29,0,3
9,2000,839500,35,33,2,2
10,2000,839500,38,38,0,3
11,2000,839500,39,34,5,0
12,2000,839500,42,41,1,0
1,2001,839500,50,48,2,3
2,2001,839500,39,35,4,1
3,2001,839500,49,45,4,1
4,2001,839500,31,27,4,2
5,2001,839500,38,36,2,4
6,2001,839500,39,39,0,3
7,2001,839500,57,55,2,3
8,2001,839500,45,43,2,2
9,2001,839500,49,48,1,0
10,2001,839500,38,33,5,0
11,2001,839500,35,35,0,3
12,2001,839500,33,33,0,0
1,2002,839500,39,37,2,0
2,2002,839500,34,31,3,3
3,2002,839500,29,25,4,1
4,2002,839500,31,30,1,0
5,2002,839500,35,33,2,1
6,2002,839500,34,33,1,2
7,2002,839500,39,37,2,1
8,2002,839500,47,46,1,2
9,2002,839500,36,32,4,1
10,2002,839500,39,38,1,0
11,2002,839500,34,32,2,0
12,2002,839500,39,37,2,3
1,2003,839500,42,42,0,0
2,2003,839500,30,28,2,0
3,2003,839500,31,30,1,6
4,2003,839500,23,22,1,1
5,2003,839500,30,29,1,3
6,2003,839500,28,27,1,1
7,2003,839500,25,22,3,1
8,2003,839500,33,30,3,3
9,2003,839500,27,26,1,0
10,2003,839500,39,37,2,0
11,2003,839500,37,36,1,0
12,2003,839500,25,25,0,1
1,2004,839500,25,25,0,1
2,2004,839500,14,12,2,2
3,2004,839500,24,23,1,2
4,2004,839500,21,20,1,0
5,2004,839500,29,29,0,2
6,2004,839500,25,24,1,1
7,2004,839500,29,29,0,1
8,2004,839500,33,31,2,3
9,2004,839500,29,28,1,0
10,2004,839500,21,20,1,2
11,2004,839500,22,22,0,2
12,2004,839500,22,21,1,2
1,2005,839500,17,16,1,1
2,2005,839500,18,17,1,3
3,2005,839500,26,24,2,4
4,2005,839500,24,23,1,2
5,2005,839500,25,24,1,1
6,2005,839500,20,20,0,0
7,2005,839500,27,26,1,0
8,2005,839500,33,31,2,3
9,2005,839500,28,28,0,1
10,2005,839500,25,24,1,0
11,2005,839500,16,15,1,2
12,2005,839500,15,14,1,1
1,2006,839500,17,16,1,0
2,2006,839500,12,12,0,0
3,2006,839500,25,24,1,2
4,2006,839500,23,23,0,3
5,2006,839500,22,22,0,3
6,2006,839500,24,20,4,3
7,2006,839500,20,19,1,2
8,2006,839500,18,18,0,6
9,2006,839500,20,18,2,2
10,2006,839500,18,18,0,1
11,2006,839500,23,21,2,3
12,2006,839500,19,17,2,3
1,2007,839500,20,20,0,1
2,2007,839500,18,14,4,2
3,2007,839500,17,16,1,1
4,2007,839500,11,11,0,2
5,2007,839500,21,21,0,4
6,2007,839500,17,15,2,2
7,2007,839500,26,23,3,1
8,2007,839500,14,14,0,1
9,2007,839500,23,20,3,2
10,2007,839500,11,11,0,1
11,2007,839500,13,13,0,1
12,2007,839500,17,16,1,1
1,2008,839500,10,8,2,4
2,2008,839500,5,5,0,1
3,2008,839500,14,14,0,3
4,2008,839500,17,17,0,1
5,2008,839500,10,10,0,6
6,2008,839500,16,15,1,6
7,2008,839500,15,15,0,2
8,2008,839500,22,22,0,5
9,2008,839500,19,17,2,6
10,2008,839500,23,21,2,5
11,2008,839500,5,5,0,2
12,2008,839500,11,11,0,4
1,2009,839500,9,9,0,0
2,2009,839500,15,15,0,3
3,2009,839500,6,6,0,4
4,2009,839500,17,15,2,6
5,2009,839500,15,15,0,4
6,2009,839500,15,15,0,2
7,2009,839500,9,8,1,15
8,2009,839500,14,14,0,2
9,2009,839500,14,13,1,6
10,2009,839500,18,18,0,7
11,2009,839500,14,13,1,5
12,2009,839500,10,8,2,1
1,2010,839500,6,6,0,9
2,2010,839500,5,5,0,2
3,2010,839500,11,11,0,3
4,2010,839500,7,7,0,6
5,2010,839500,14,12,2,1
6,2010,839500,9,8,1,3
7,2010,839500,19,18,1,0
8,2010,839500,10,10,0,0
9,2010,839500,17,16,1,4
10,2010,839500,9,8,1,0
11,2010,839500,12,12,0,6
12,2010,839500,9,9,0,1
1,2011,839500,9,8,1,3
2,2011,839500,5,4,1,0
1,1999,600900,15,11,4,2
2,1999,600900,9,7,2,2
3,1999,600900,8,8,0,0
4,1999,600900,26,23,3,1
5,1999,600900,23,22,1,0
6,1999,600900,18,14,4,3
7,1999,600900,11,9,2,1
8,1999,600900,11,9,2,3
9,1999,600900,20,15,5,1
10,1999,600900,11,10,1,0
11,1999,600900,12,11,1,2
12,1999,600900,14,12,2,2
1,2000,600900,16,15,1,1
2,2000,600900,12,11,1,6
3,2000,600900,11,10,1,1
4,2000,600900,15,13,2,1
5,2000,600900,31,27,4,1
6,2000,600900,17,12,5,1
7,2000,600900,22,20,2,0
8,2000,600900,10,6,4,1
9,2000,600900,15,13,2,2
10,2000,600900,14,13,1,2
11,2000,600900,14,11,3,2
12,2000,600900,11,10,1,1
1,2001,600900,12,10,2,3
2,2001,600900,11,9,2,2
3,2001,600900,15,13,2,1
4,2001,600900,12,11,1,8
5,2001,600900,11,11,0,3
6,2001,600900,7,3,4,4
7,2001,600900,19,17,2,1
8,2001,600900,17,16,1,5
9,2001,600900,17,16,1,4
10,2001,600900,22,21,1,2
11,2001,600900,12,10,2,2
12,2001,600900,18,16,2,4
1,2002,600900,12,8,4,3
2,2002,600900,7,6,1,3
3,2002,600900,12,10,2,0
4,2002,600900,20,16,4,4
5,2002,600900,6,6,0,0
6,2002,600900,12,9,3,2
7,2002,600900,17,13,4,1
8,2002,600900,18,18,0,4
9,2002,600900,11,9,2,3
10,2002,600900,12,8,4,4
11,2002,600900,13,12,1,1
12,2002,600900,9,6,3,0
1,2003,600900,16,14,2,4
2,2003,600900,10,9,1,3
3,2003,600900,8,6,2,4
4,2003,600900,10,9,1,1
5,2003,600900,14,13,1,1
6,2003,600900,14,11,3,3
7,2003,600900,4,4,0,1
8,2003,600900,11,10,1,4
9,2003,600900,9,9,0,2
10,2003,600900,17,14,3,1
11,2003,600900,9,7,2,0
12,2003,600900,10,9,1,3
1,2004,600900,14,12,2,0
2,2004,600900,6,6,0,0
3,2004,600900,15,11,4,1
4,2004,600900,4,3,1,1
5,2004,600900,11,10,1,2
6,2004,600900,7,4,3,1
7,2004,600900,15,12,3,1
8,2004,600900,15,12,3,0
9,2004,600900,17,14,3,0
10,2004,600900,10,9,1,3
11,2004,600900,9,9,0,0
12,2004,600900,7,7,0,2
1,2005,600900,6,6,0,1
2,2005,600900,4,4,0,3
3,2005,600900,11,9,2,2
4,2005,600900,13,11,2,4
5,2005,600900,15,12,3,0
6,2005,600900,14,12,2,1
7,2005,600900,15,12,3,1
8,2005,600900,8,7,1,2
9,2005,600900,17,15,2,2
10,2005,600900,18,17,1,1
11,2005,600900,14,12,2,4
12,2005,600900,13,13,0,0
1,2006,600900,16,13,3,0
2,2006,600900,13,13,0,2
3,2006,600900,14,8,6,0
4,2006,600900,13,9,4,0
5,2006,600900,18,13,5,1
6,2006,600900,11,9,2,2
7,2006,600900,18,13,5,2
8,2006,600900,11,10,1,3
9,2006,600900,13,12,1,0
10,2006,600900,10,9,1,1
11,2006,600900,12,9,3,0
12,2006,600900,10,10,0,1
1,2007,600900,17,17,0,0
2,2007,600900,7,6,1,0
3,2007,600900,5,5,0,1
4,2007,600900,9,6,3,3
5,2007,600900,6,4,2,1
6,2007,600900,8,7,1,1
7,2007,600900,14,12,2,4
8,2007,600900,13,11,2,3
9,2007,600900,7,7,0,2
10,2007,600900,14,12,2,0
11,2007,600900,13,13,0,2
12,2007,600900,7,7,0,1
1,2008,600900,12,10,2,1
2,2008,600900,10,7,3,1
3,2008,600900,5,5,0,1
4,2008,600900,5,5,0,2
5,2008,600900,7,4,3,0
6,2008,600900,9,7,2,1
7,2008,600900,10,8,2,2
8,2008,600900,14,10,4,0
9,2008,600900,3,3,0,2
10,2008,600900,19,17,2,2
11,2008,600900,8,5,3,0
12,2008,600900,11,10,1,2
1,2009,600900,5,4,1,0
2,2009,600900,2,2,0,2
3,2009,600900,4,4,0,3
4,2009,600900,6,4,2,2
5,2009,600900,6,6,0,1
6,2009,600900,6,4,2,1
7,2009,600900,9,7,2,1
8,2009,600900,9,9,0,1
9,2009,600900,9,9,0,1
10,2009,600900,10,9,1,3
11,2009,600900,15,14,1,0
12,2009,600900,3,3,0,0
1,2010,600900,12,10,2,4
2,2010,600900,2,2,0,5
3,2010,600900,10,7,3,3
4,2010,600900,7,5,2,3
5,2010,600900,11,8,3,0
6,2010,600900,8,7,1,2
7,2010,600900,9,3,6,1
8,2010,600900,5,5,0,0
9,2010,600900,10,7,3,1
10,2010,600900,10,7,3,1
11,2010,600900,6,5,1,3
12,2010,600900,6,6,0,0
1,2011,600900,4,2,2,2
2,2011,600900,6,6,0,1
1,1999,841300,20,19,1,1
2,1999,841300,19,17,2,4
3,1999,841300,15,15,0,3
4,1999,841300,18,17,1,0
5,1999,841300,30,27,3,3
6,1999,841300,26,21,5,1
7,1999,841300,15,13,2,3
8,1999,841300,40,35,5,4
9,1999,841300,25,24,1,2
10,1999,841300,29,27,2,2
11,1999,841300,19,19,0,1
12,1999,841300,19,19,0,4
1,2000,841300,15,14,1,3
2,2000,841300,20,19,1,1
3,2000,841300,19,16,3,2
4,2000,841300,13,12,1,2
5,2000,841300,18,16,2,5
6,2000,841300,23,16,7,2
7,2000,841300,21,18,3,3
8,2000,841300,22,21,1,2
9,2000,841300,17,14,3,0
10,2000,841300,12,8,4,3
11,2000,841300,20,19,1,2
12,2000,841300,19,17,2,0
1,2001,841300,9,8,1,0
2,2001,841300,21,17,4,0
3,2001,841300,20,20,0,4
4,2001,841300,17,14,3,2
5,2001,841300,24,17,7,5
6,2001,841300,17,12,5,4
7,2001,841300,26,18,8,2
8,2001,841300,28,24,4,2
9,2001,841300,19,18,1,2
10,2001,841300,18,17,1,4
11,2001,841300,16,14,2,0
12,2001,841300,13,9,4,1
1,2002,841300,10,8,2,2
2,2002,841300,11,9,2,0
3,2002,841300,17,11,6,4
4,2002,841300,14,14,0,1
5,2002,841300,20,13,7,2
6,2002,841300,19,16,3,4
7,2002,841300,22,17,5,4
8,2002,841300,18,17,1,5
9,2002,841300,24,21,3,1
10,2002,841300,17,15,2,1
11,2002,841300,17,17,0,7
12,2002,841300,9,9,0,1
1,2003,841300,18,16,2,0
2,2003,841300,17,17,0,2
3,2003,841300,22,20,2,3
4,2003,841300,9,7,2,7
5,2003,841300,19,18,1,0
6,2003,841300,18,17,1,2
7,2003,841300,21,18,3,3
8,2003,841300,33,30,3,3
9,2003,841300,20,19,1,2
10,2003,841300,10,9,1,2
11,2003,841300,11,9,2,0
12,2003,841300,18,16,2,0
1,2004,841300,16,14,2,0
2,2004,841300,17,15,2,1
3,2004,841300,18,15,3,0
4,2004,841300,10,8,2,0
5,2004,841300,9,8,1,2
6,2004,841300,19,18,1,2
7,2004,841300,25,21,4,0
8,2004,841300,23,19,4,1
9,2004,841300,14,12,2,2
10,2004,841300,10,10,0,0
11,2004,841300,15,15,0,1
12,2004,841300,11,11,0,0
1,2005,841300,11,10,1,0
2,2005,841300,17,16,1,0
3,2005,841300,13,11,2,1
4,2005,841300,14,11,3,2
5,2005,841300,11,11,0,2
6,2005,841300,15,12,3,0
7,2005,841300,22,21,1,0
8,2005,841300,17,16,1,3
9,2005,841300,11,9,2,2
10,2005,841300,13,13,0,0
11,2005,841300,24,24,0,1
12,2005,841300,21,18,3,1
1,2006,841300,20,19,1,0
2,2006,841300,19,17,2,3
3,2006,841300,17,16,1,0
4,2006,841300,15,13,2,4
5,2006,841300,19,14,5,1
6,2006,841300,11,10,1,2
7,2006,841300,11,9,2,2
8,2006,841300,16,14,2,1
9,2006,841300,16,14,2,2
10,2006,841300,13,13,0,3
11,2006,841300,11,11,0,3
12,2006,841300,15,15,0,2
1,2007,841300,14,10,4,2
2,2007,841300,4,4,0,1
3,2007,841300,15,12,3,1
4,2007,841300,11,9,2,2
5,2007,841300,15,13,2,0
6,2007,841300,15,15,0,1
7,2007,841300,14,13,1,1
8,2007,841300,11,11,0,6
9,2007,841300,24,19,5,1
10,2007,841300,33,33,0,2
11,2007,841300,19,15,4,0
12,2007,841300,21,21,0,1
1,2008,841300,18,17,1,0
2,2008,841300,13,12,1,1
3,2008,841300,21,21,0,2
4,2008,841300,23,21,2,3
5,2008,841300,18,17,1,2
6,2008,841300,13,12,1,1
7,2008,841300,24,22,2,1
8,2008,841300,19,16,3,4
9,2008,841300,19,18,1,1
10,2008,841300,11,11,0,4
11,2008,841300,7,5,2,3
12,2008,841300,14,14,0,2
1,2009,841300,10,10,0,1
2,2009,841300,8,7,1,1
3,2009,841300,9,9,0,0
4,2009,841300,13,11,2,2
5,2009,841300,25,24,1,0
6,2009,841300,11,10,1,2
7,2009,841300,20,17,3,0
8,2009,841300,10,6,4,0
9,2009,841300,8,7,1,0
10,2009,841300,6,6,0,1
11,2009,841300,14,13,1,0
12,2009,841300,10,8,2,2
1,2010,841300,9,8,1,5
2,2010,841300,13,11,2,0
3,2010,841300,15,12,3,2
4,2010,841300,13,11,2,0
5,2010,841300,8,5,3,0
6,2010,841300,16,14,2,2
7,2010,841300,16,15,1,2
8,2010,841300,12,11,1,3
9,2010,841300,3,3,0,2
10,2010,841300,9,9,0,1
11,2010,841300,11,9,2,1
12,2010,841300,13,11,2,3
1,2011,841300,9,7,2,0
2,2011,841300,5,5,0,2
1,1999,301801,4,4,0,0
2,1999,301801,3,3,0,1
3,1999,301801,7,6,1,0
4,1999,301801,6,5,1,2
5,1999,301801,3,3,0,1
6,1999,301801,3,3,0,3
7,1999,301801,8,8,0,2
8,1999,301801,9,7,2,0
9,1999,301801,8,7,1,3
10,1999,301801,6,5,1,0
11,1999,301801,4,3,1,1
12,1999,301801,13,9,4,0
1,2000,301801,7,6,1,1
2,2000,301801,8,8,0,0
3,2000,301801,10,10,0,0
4,2000,301801,11,11,0,2
5,2000,301801,1,1,0,0
6,2000,301801,6,6,0,0
7,2000,301801,8,8,0,2
8,2000,301801,9,9,0,1
9,2000,301801,11,7,4,0
10,2000,301801,13,12,1,1
11,2000,301801,9,8,1,1
12,2000,301801,4,4,0,2
1,2001,301801,1,0,1,1
2,2001,301801,6,6,0,2
3,2001,301801,6,4,2,1
4,2001,301801,5,4,1,0
5,2001,301801,12,11,1,1
6,2001,301801,6,5,1,0
7,2001,301801,11,11,0,2
8,2001,301801,10,9,1,0
9,2001,301801,14,12,2,0
10,2001,301801,3,2,1,0
11,2001,301801,19,16,3,0
12,2001,301801,13,11,2,0
1,2002,301801,14,13,1,0
2,2002,301801,6,5,1,2
3,2002,301801,4,4,0,0
4,2002,301801,8,3,5,1
5,2002,301801,9,8,1,0
6,2002,301801,8,7,1,0
7,2002,301801,14,12,2,1
8,2002,301801,12,12,0,0
9,2002,301801,5,4,1,0
10,2002,301801,8,7,1,0
11,2002,301801,6,4,2,2
12,2002,301801,5,4,1,1
1,2003,301801,14,13,1,2
2,2003,301801,10,8,2,1
3,2003,301801,5,4,1,0
4,2003,301801,5,5,0,1
5,2003,301801,4,4,0,0
6,2003,301801,5,5,0,0
7,2003,301801,6,6,0,0
8,2003,301801,9,8,1,0
9,2003,301801,7,3,4,1
10,2003,301801,8,7,1,2
11,2003,301801,8,8,0,1
12,2003,301801,8,7,1,0
1,2004,301801,7,7,0,0
2,2004,301801,7,5,2,1
3,2004,301801,4,2,2,2
4,2004,301801,4,2,2,2
5,2004,301801,6,3,3,1
6,2004,301801,5,5,0,3
7,2004,301801,10,9,1,0
8,2004,301801,5,5,0,0
9,2004,301801,10,9,1,1
10,2004,301801,7,5,2,1
11,2004,301801,4,1,3,3
12,2004,301801,6,6,0,0
1,2005,301801,9,5,4,0
2,2005,301801,5,4,1,0
3,2005,301801,3,3,0,3
4,2005,301801,6,5,1,1
5,2005,301801,2,1,1,2
6,2005,301801,10,7,3,0
7,2005,301801,3,2,1,3
8,2005,301801,6,6,0,2
9,2005,301801,3,3,0,5
10,2005,301801,7,5,2,2
11,2005,301801,3,3,0,0
12,2005,301801,8,7,1,0
1,2006,301801,10,6,4,0
2,2006,301801,3,3,0,0
3,2006,301801,4,3,1,0
4,2006,301801,4,1,3,1
5,2006,301801,7,5,2,0
6,2006,301801,8,7,1,1
7,2006,301801,4,4,0,4
8,2006,301801,8,6,2,1
9,2006,301801,6,5,1,1
10,2006,301801,6,4,2,1
11,2006,301801,12,11,1,1
12,2006,301801,5,4,1,2
1,2007,301801,5,5,0,1
2,2007,301801,2,1,1,2
3,2007,301801,5,5,0,1
4,2007,301801,7,7,0,6
5,2007,301801,10,8,2,0
6,2007,301801,6,3,3,3
7,2007,301801,12,12,0,2
8,2007,301801,9,7,2,2
9,2007,301801,6,6,0,1
10,2007,301801,6,4,2,2
11,2007,301801,7,5,2,3
12,2007,301801,7,6,1,6
1,2008,301801,7,6,1,2
2,2008,301801,11,11,0,0
3,2008,301801,16,14,2,0
4,2008,301801,9,5,4,6
5,2008,301801,11,9,2,3
6,2008,301801,8,5,3,2
7,2008,301801,4,4,0,1
8,2008,301801,13,12,1,2
9,2008,301801,6,5,1,0
10,2008,301801,10,9,1,1
11,2008,301801,9,9,0,0
12,2008,301801,9,8,1,2
1,2009,301801,8,7,1,1
2,2009,301801,8,8,0,0
3,2009,301801,8,6,2,1
4,2009,301801,5,5,0,0
5,2009,301801,8,6,2,2
6,2009,301801,7,6,1,0
7,2009,301801,7,5,2,2
8,2009,301801,4,3,1,2
9,2009,301801,5,3,2,1
10,2009,301801,10,9,1,2
11,2009,301801,2,2,0,1
12,2009,301801,2,1,1,1
1,2010,301801,10,7,3,2
2,2010,301801,6,5,1,1
3,2010,301801,8,7,1,2
4,2010,301801,10,8,2,2
5,2010,301801,11,10,1,1
6,2010,301801,13,11,2,3
7,2010,301801,3,3,0,1
8,2010,301801,7,5,2,2
9,2010,301801,9,7,2,1
10,2010,301801,15,15,0,3
11,2010,301801,11,11,0,2
12,2010,301801,9,9,0,1
1,2011,301801,17,17,0,2
2,2011,301801,13,12,1,1
1,1999,301803,4,4,0,1
2,1999,301803,10,5,5,1
3,1999,301803,8,7,1,4
4,1999,301803,13,12,1,5
5,1999,301803,4,3,1,1
6,1999,301803,10,9,1,0
7,1999,301803,14,12,2,0
8,1999,301803,12,12,0,3
9,1999,301803,8,8,0,1
10,1999,301803,12,9,3,3
11,1999,301803,5,5,0,1
12,1999,301803,6,4,2,2
1,2000,301803,12,12,0,1
2,2000,301803,13,12,1,0
3,2000,301803,9,9,0,3
4,2000,301803,12,10,2,3
5,2000,301803,10,9,1,4
6,2000,301803,8,7,1,1
7,2000,301803,17,15,2,1
8,2000,301803,18,17,1,5
9,2000,301803,12,10,2,1
10,2000,301803,9,5,4,2
11,2000,301803,10,8,2,0
12,2000,301803,8,8,0,0
1,2001,301803,10,8,2,2
2,2001,301803,10,7,3,0
3,2001,301803,15,13,2,0
4,2001,301803,6,5,1,1
5,2001,301803,12,10,2,3
6,2001,301803,16,14,2,0
7,2001,301803,17,13,4,0
8,2001,301803,10,7,3,3
9,2001,301803,16,13,3,0
10,2001,301803,13,11,2,0
11,2001,301803,16,16,0,2
12,2001,301803,14,12,2,2
1,2002,301803,12,10,2,2
2,2002,301803,9,9,0,2
3,2002,301803,8,7,1,0
4,2002,301803,9,9,0,2
5,2002,301803,13,11,2,1
6,2002,301803,12,11,1,1
7,2002,301803,9,9,0,2
8,2002,301803,3,3,0,4
9,2002,301803,5,3,2,0
10,2002,301803,10,7,3,2
11,2002,301803,8,8,0,1
12,2002,301803,12,12,0,0
1,2003,301803,12,10,2,0
2,2003,301803,4,4,0,1
3,2003,301803,6,5,1,2
4,2003,301803,8,7,1,1
5,2003,301803,12,12,0,2
6,2003,301803,6,5,1,0
7,2003,301803,14,14,0,5
8,2003,301803,7,6,1,0
9,2003,301803,9,7,2,3
10,2003,301803,10,8,2,0
11,2003,301803,6,5,1,2
12,2003,301803,9,4,5,1
1,2004,301803,6,6,0,1
2,2004,301803,2,2,0,4
3,2004,301803,9,9,0,2
4,2004,301803,7,6,1,0
5,2004,301803,8,5,3,4
6,2004,301803,6,6,0,4
7,2004,301803,8,7,1,2
8,2004,301803,9,7,2,2
9,2004,301803,4,4,0,2
10,2004,301803,12,10,2,0
11,2004,301803,4,2,2,4
12,2004,301803,7,7,0,1
1,2005,301803,7,6,1,0
2,2005,301803,7,4,3,1
3,2005,301803,8,6,2,0
4,2005,301803,3,2,1,2
5,2005,301803,10,9,1,3
6,2005,301803,7,6,1,0
7,2005,301803,15,13,2,2
8,2005,301803,6,6,0,1
9,2005,301803,5,4,1,0
10,2005,301803,15,15,0,0
11,2005,301803,11,10,1,1
12,2005,301803,8,8,0,0
1,2006,301803,6,6,0,0
2,2006,301803,9,8,1,4
3,2006,301803,9,6,3,1
4,2006,301803,10,7,3,2
5,2006,301803,10,9,1,3
6,2006,301803,13,11,2,3
7,2006,301803,7,5,2,5
8,2006,301803,10,10,0,1
9,2006,301803,8,6,2,0
10,2006,301803,9,8,1,5
11,2006,301803,13,10,3,2
12,2006,301803,16,13,3,5
1,2007,301803,14,12,2,3
2,2007,301803,5,4,1,2
3,2007,301803,14,12,2,5
4,2007,301803,5,5,0,3
5,2007,301803,8,6,2,1
6,2007,301803,8,6,2,4
7,2007,301803,8,6,2,3
8,2007,301803,11,9,2,3
9,2007,301803,8,6,2,3
10,2007,301803,6,5,1,1
11,2007,301803,5,5,0,3
12,2007,301803,3,3,0,0
1,2008,301803,6,5,1,1
2,2008,301803,5,3,2,1
3,2008,301803,15,10,5,2
4,2008,301803,6,5,1,4
5,2008,301803,13,13,0,2
6,2008,301803,13,12,1,4
7,2008,301803,12,10,2,1
8,2008,301803,11,8,3,3
9,2008,301803,14,12,2,4
10,2008,301803,10,9,1,3
11,2008,301803,12,12,0,1
12,2008,301803,8,8,0,4
1,2009,301803,6,4,2,1
2,2009,301803,4,3,1,1
3,2009,301803,8,7,1,3
4,2009,301803,9,7,2,2
5,2009,301803,5,5,0,2
6,2009,301803,9,7,2,1
7,2009,301803,7,6,1,4
8,2009,301803,12,9,3,2
9,2009,301803,6,4,2,1
10,2009,301803,8,5,3,3
11,2009,301803,8,7,1,1
12,2009,301803,12,10,2,2
1,2010,301803,10,7,3,0
2,2010,301803,5,4,1,1
3,2010,301803,7,5,2,1
4,2010,301803,5,5,0,2
5,2010,301803,10,8,2,2
6,2010,301803,6,3,3,2
7,2010,301803,14,12,2,2
8,2010,301803,5,4,1,1
9,2010,301803,4,2,2,0
10,2010,301803,9,8,1,1
11,2010,301803,11,10,1,0
12,2010,301803,16,15,1,1
1,2011,301803,6,6,0,0
2,2011,301803,7,7,0,0
1,1999,301702,9,7,2,0
2,1999,301702,10,7,3,1
3,1999,301702,10,9,1,1
4,1999,301702,6,5,1,3
5,1999,301702,7,7,0,2
6,1999,301702,11,10,1,2
7,1999,301702,15,15,0,1
8,1999,301702,12,9,3,1
9,1999,301702,11,11,0,1
10,1999,301702,9,8,1,6
11,1999,301702,7,7,0,1
12,1999,301702,5,4,1,1
1,2000,301702,7,7,0,3
2,2000,301702,16,13,3,3
3,2000,301702,12,10,2,0
4,2000,301702,10,9,1,2
5,2000,301702,15,13,2,0
6,2000,301702,8,6,2,0
7,2000,301702,15,12,3,1
8,2000,301702,20,16,4,2
9,2000,301702,7,7,0,5
10,2000,301702,13,9,4,5
11,2000,301702,12,9,3,0
12,2000,301702,10,10,0,2
1,2001,301702,13,13,0,1
2,2001,301702,8,4,4,6
3,2001,301702,9,7,2,5
4,2001,301702,14,10,4,1
5,2001,301702,21,20,1,1
6,2001,301702,18,15,3,1
7,2001,301702,15,13,2,4
8,2001,301702,14,12,2,1
9,2001,301702,18,12,6,2
10,2001,301702,16,12,4,1
11,2001,301702,14,12,2,0
12,2001,301702,13,11,2,2
1,2002,301702,21,20,1,2
2,2002,301702,17,15,2,1
3,2002,301702,12,10,2,3
4,2002,301702,12,7,5,4
5,2002,301702,11,7,4,4
6,2002,301702,18,15,3,1
7,2002,301702,17,13,4,1
8,2002,301702,16,13,3,3
9,2002,301702,9,6,3,2
10,2002,301702,12,12,0,0
11,2002,301702,1,1,0,4
12,2002,301702,9,9,0,1
1,2003,301702,6,5,1,3
2,2003,301702,5,5,0,1
3,2003,301702,7,4,3,2
4,2003,301702,14,6,8,2
5,2003,301702,11,11,0,4
6,2003,301702,11,7,4,1
7,2003,301702,9,8,1,1
8,2003,301702,10,7,3,0
9,2003,301702,11,10,1,3
10,2003,301702,5,3,2,0
11,2003,301702,9,8,1,0
12,2003,301702,12,11,1,3
1,2004,301702,6,4,2,0
2,2004,301702,11,9,2,0
3,2004,301702,6,6,0,0
4,2004,301702,7,7,0,1
5,2004,301702,12,8,4,0
6,2004,301702,8,5,3,3
7,2004,301702,7,4,3,1
8,2004,301702,12,10,2,2
9,2004,301702,17,13,4,1
10,2004,301702,8,8,0,0
11,2004,301702,7,6,1,3
12,2004,301702,8,7,1,0
1,2005,301702,7,7,0,0
2,2005,301702,8,8,0,1
3,2005,301702,7,4,3,0
4,2005,301702,11,10,1,5
5,2005,301702,8,7,1,0
6,2005,301702,13,7,6,0
7,2005,301702,17,11,6,5
8,2005,301702,10,9,1,1
9,2005,301702,17,15,2,3
10,2005,301702,13,9,4,0
11,2005,301702,11,10,1,2
12,2005,301702,11,10,1,0
1,2006,301702,14,14,0,2
2,2006,301702,7,6,1,1
3,2006,301702,6,5,1,1
4,2006,301702,8,8,0,2
5,2006,301702,13,8,5,1
6,2006,301702,8,6,2,3
7,2006,301702,7,4,3,1
8,2006,301702,6,4,2,1
9,2006,301702,7,7,0,1
10,2006,301702,6,5,1,2
11,2006,301702,18,17,1,1
12,2006,301702,11,11,0,0
1,2007,301702,11,9,2,1
2,2007,301702,9,8,1,2
3,2007,301702,13,11,2,0
4,2007,301702,7,5,2,5
5,2007,301702,9,6,3,3
6,2007,301702,5,3,2,2
7,2007,301702,7,6,1,4
8,2007,301702,8,7,1,2
9,2007,301702,10,7,3,0
10,2007,301702,11,10,1,0
11,2007,301702,9,9,0,0
12,2007,301702,9,7,2,1
1,2008,301702,11,8,3,1
2,2008,301702,6,3,3,1
3,2008,301702,8,7,1,4
4,2008,301702,6,3,3,5
5,2008,301702,11,11,0,1
6,2008,301702,6,6,0,3
7,2008,301702,11,6,5,3
8,2008,301702,10,9,1,1
9,2008,301702,10,9,1,1
10,2008,301702,12,8,4,0
11,2008,301702,9,9,0,0
12,2008,301702,11,9,2,0
1,2009,301702,6,6,0,2
2,2009,301702,4,3,1,0
3,2009,301702,10,7,3,3
4,2009,301702,6,4,2,3
5,2009,301702,11,8,3,1
6,2009,301702,14,9,5,3
7,2009,301702,5,3,2,1
8,2009,301702,13,11,2,0
9,2009,301702,7,5,2,0
10,2009,301702,11,9,2,2
11,2009,301702,5,5,0,1
12,2009,301702,6,6,0,0
1,2010,301702,10,10,0,0
2,2010,301702,7,5,2,0
3,2010,301702,5,2,3,1
4,2010,301702,12,8,4,3
5,2010,301702,7,6,1,1
6,2010,301702,9,7,2,1
7,2010,301702,7,7,0,0
8,2010,301702,10,9,1,4
9,2010,301702,6,5,1,0
10,2010,301702,9,7,2,0
11,2010,301702,8,6,2,0
12,2010,301702,10,10,0,0
1,2011,301702,18,16,2,1
2,2011,301702,7,7,0,0
1,1999,301600,12,9,3,1
2,1999,301600,15,13,2,2
3,1999,301600,15,12,3,2
4,1999,301600,12,11,1,1
5,1999,301600,6,4,2,0
6,1999,301600,12,10,2,4
7,1999,301600,4,3,1,1
8,1999,301600,7,6,1,4
9,1999,301600,9,7,2,4
10,1999,301600,19,14,5,5
11,1999,301600,13,11,2,6
12,1999,301600,15,12,3,6
1,2000,301600,18,15,3,2
2,2000,301600,9,7,2,6
3,2000,301600,10,7,3,2
4,2000,301600,12,10,2,3
5,2000,301600,12,8,4,3
6,2000,301600,7,6,1,1
7,2000,301600,11,10,1,3
8,2000,301600,10,8,2,2
9,2000,301600,11,6,5,1
10,2000,301600,9,9,0,3
11,2000,301600,9,9,0,3
12,2000,301600,11,9,2,1
1,2001,301600,12,12,0,2
2,2001,301600,7,5,2,1
3,2001,301600,9,6,3,6
4,2001,301600,10,6,4,3
5,2001,301600,11,9,2,4
6,2001,301600,4,1,3,1
7,2001,301600,17,12,5,1
8,2001,301600,6,3,3,1
9,2001,301600,14,12,2,3
10,2001,301600,15,13,2,0
11,2001,301600,15,11,4,0
12,2001,301600,9,7,2,3
1,2002,301600,14,12,2,3
2,2002,301600,9,7,2,5
3,2002,301600,9,7,2,3
4,2002,301600,8,7,1,1
5,2002,301600,14,13,1,6
6,2002,301600,9,8,1,1
7,2002,301600,11,8,3,2
8,2002,301600,12,9,3,1
9,2002,301600,16,12,4,1
10,2002,301600,13,11,2,2
11,2002,301600,13,12,1,2
12,2002,301600,8,8,0,5
1,2003,301600,10,6,4,4
2,2003,301600,8,8,0,3
3,2003,301600,12,12,0,2
4,2003,301600,11,9,2,3
5,2003,301600,12,10,2,0
6,2003,301600,10,8,2,3
7,2003,301600,5,4,1,2
8,2003,301600,14,12,2,1
9,2003,301600,5,4,1,3
10,2003,301600,11,10,1,5
11,2003,301600,6,4,2,3
12,2003,301600,13,12,1,2
1,2004,301600,7,7,0,1
2,2004,301600,10,10,0,0
3,2004,301600,7,5,2,0
4,2004,301600,11,10,1,3
5,2004,301600,11,9,2,3
6,2004,301600,7,7,0,5
7,2004,301600,12,11,1,2
8,2004,301600,12,12,0,3
9,2004,301600,12,12,0,3
10,2004,301600,7,5,2,4
11,2004,301600,4,3,1,2
12,2004,301600,4,4,0,2
1,2005,301600,4,4,0,3
2,2005,301600,6,4,2,0
3,2005,301600,5,5,0,3
4,2005,301600,7,5,2,5
5,2005,301600,12,9,3,2
6,2005,301600,12,9,3,4
7,2005,301600,6,3,3,7
8,2005,301600,6,5,1,3
9,2005,301600,6,5,1,6
10,2005,301600,7,7,0,1
11,2005,301600,11,10,1,5
12,2005,301600,4,4,0,0
1,2006,301600,5,5,0,1
2,2006,301600,10,8,2,0
3,2006,301600,6,4,2,6
4,2006,301600,10,7,3,3
5,2006,301600,8,6,2,0
6,2006,301600,2,2,0,3
7,2006,301600,6,6,0,15
8,2006,301600,6,5,1,4
9,2006,301600,7,4,3,2
10,2006,301600,10,10,0,9
11,2006,301600,6,5,1,2
12,2006,301600,4,4,0,4
1,2007,301600,6,5,1,3
2,2007,301600,5,5,0,4
3,2007,301600,6,5,1,2
4,2007,301600,5,5,0,0
5,2007,301600,5,5,0,5
6,2007,301600,8,7,1,3
7,2007,301600,4,3,1,2
8,2007,301600,6,5,1,4
9,2007,301600,10,8,2,1
10,2007,301600,2,2,0,1
11,2007,301600,4,3,1,3
12,2007,301600,6,4,2,1
1,2008,301600,11,11,0,6
2,2008,301600,10,6,4,6
3,2008,301600,6,6,0,2
4,2008,301600,5,5,0,0
5,2008,301600,8,5,3,5
6,2008,301600,4,3,1,0
7,2008,301600,9,8,1,1
8,2008,301600,6,3,3,2
9,2008,301600,12,11,1,1
10,2008,301600,18,12,6,0
11,2008,301600,5,4,1,1
12,2008,301600,7,5,2,0
1,2009,301600,4,2,2,2
2,2009,301600,4,4,0,2
3,2009,301600,9,9,0,3
4,2009,301600,8,7,1,1
5,2009,301600,2,2,0,0
6,2009,301600,8,5,3,2
7,2009,301600,4,4,0,0
8,2009,301600,7,6,1,3
9,2009,301600,7,4,3,0
10,2009,301600,7,5,2,3
11,2009,301600,7,4,3,0
12,2009,301600,3,3,0,1
1,2010,301600,1,1,0,1
2,2010,301600,5,5,0,0
3,2010,301600,6,4,2,2
4,2010,301600,16,12,4,3
5,2010,301600,8,8,0,2
6,2010,301600,3,3,0,0
7,2010,301600,3,3,0,6
8,2010,301600,8,7,1,2
9,2010,301600,4,3,1,0
10,2010,301600,6,4,2,1
11,2010,301600,6,5,1,4
12,2010,301600,5,4,1,0
1,2011,301600,6,6,0,1
2,2011,301600,8,8,0,0
1,1999,840800,16,15,1,1
2,1999,840800,15,14,1,4
3,1999,840800,20,17,3,3
4,1999,840800,6,5,1,7
5,1999,840800,6,5,1,4
6,1999,840800,13,11,2,1
7,1999,840800,9,6,3,0
8,1999,840800,16,12,4,2
9,1999,840800,14,12,2,7
10,1999,840800,14,14,0,1
11,1999,840800,11,10,1,2
12,1999,840800,18,16,2,2
1,2000,840800,16,13,3,2
2,2000,840800,15,15,0,6
3,2000,840800,15,13,2,4
4,2000,840800,6,6,0,3
5,2000,840800,13,12,1,3
6,2000,840800,12,11,1,7
7,2000,840800,14,14,0,0
8,2000,840800,22,15,7,2
9,2000,840800,10,7,3,1
10,2000,840800,23,20,3,1
11,2000,840800,14,14,0,1
12,2000,840800,8,8,0,0
1,2001,840800,8,8,0,5
2,2001,840800,11,9,2,1
3,2001,840800,11,11,0,3
4,2001,840800,7,6,1,2
5,2001,840800,7,6,1,4
6,2001,840800,12,7,5,0
7,2001,840800,11,6,5,1
8,2001,840800,15,11,4,4
9,2001,840800,11,10,1,1
10,2001,840800,11,8,3,3
11,2001,840800,18,16,2,1
12,2001,840800,13,12,1,2
1,2002,840800,10,7,3,2
2,2002,840800,11,9,2,2
3,2002,840800,6,3,3,3
4,2002,840800,17,15,2,2
5,2002,840800,10,9,1,0
6,2002,840800,8,7,1,4
7,2002,840800,12,10,2,7
8,2002,840800,22,21,1,3
9,2002,840800,14,10,4,1
10,2002,840800,16,13,3,2
11,2002,840800,9,8,1,0
12,2002,840800,8,7,1,7
1,2003,840800,5,4,1,0
2,2003,840800,5,4,1,4
3,2003,840800,13,12,1,2
4,2003,840800,10,7,3,3
5,2003,840800,9,7,2,6
6,2003,840800,9,8,1,9
7,2003,840800,16,16,0,6
8,2003,840800,15,14,1,3
9,2003,840800,9,8,1,9
10,2003,840800,15,14,1,4
11,2003,840800,14,13,1,3
12,2003,840800,10,10,0,1
1,2004,840800,13,12,1,2
2,2004,840800,4,3,1,4
3,2004,840800,12,9,3,3
4,2004,840800,10,10,0,1
5,2004,840800,8,5,3,5
6,2004,840800,9,8,1,7
7,2004,840800,10,10,0,4
8,2004,840800,15,9,6,2
9,2004,840800,11,10,1,4
10,2004,840800,9,7,2,1
11,2004,840800,8,7,1,2
12,2004,840800,4,4,0,2
1,2005,840800,4,4,0,0
2,2005,840800,11,8,3,4
3,2005,840800,8,8,0,1
4,2005,840800,4,2,2,4
5,2005,840800,17,12,5,3
6,2005,840800,7,5,2,1
7,2005,840800,10,9,1,1
8,2005,840800,9,9,0,1
9,2005,840800,13,11,2,4
10,2005,840800,15,15,0,1
11,2005,840800,9,8,1,1
12,2005,840800,3,2,1,2
1,2006,840800,15,15,0,2
2,2006,840800,12,11,1,4
3,2006,840800,18,16,2,4
4,2006,840800,14,12,2,4
5,2006,840800,11,7,4,4
6,2006,840800,4,4,0,5
7,2006,840800,13,10,3,4
8,2006,840800,8,6,2,4
9,2006,840800,7,7,0,2
10,2006,840800,10,9,1,6
11,2006,840800,10,7,3,3
12,2006,840800,9,8,1,1
1,2007,840800,2,1,1,5
2,2007,840800,5,5,0,2
3,2007,840800,6,5,1,3
4,2007,840800,8,5,3,3
5,2007,840800,11,10,1,8
6,2007,840800,10,8,2,2
7,2007,840800,10,6,4,1
8,2007,840800,7,7,0,6
9,2007,840800,11,10,1,2
10,2007,840800,11,8,3,9
11,2007,840800,4,4,0,2
12,2007,840800,6,5,1,0
1,2008,840800,8,6,2,11
2,2008,840800,11,10,1,9
3,2008,840800,5,5,0,5
4,2008,840800,5,5,0,1
5,2008,840800,8,8,0,5
6,2008,840800,11,10,1,4
7,2008,840800,6,6,0,2
8,2008,840800,12,9,3,1
9,2008,840800,8,7,1,3
10,2008,840800,16,15,1,0
11,2008,840800,14,14,0,1
12,2008,840800,4,4,0,2
1,2009,840800,6,6,0,3
2,2009,840800,10,9,1,0
3,2009,840800,4,2,2,2
4,2009,840800,8,8,0,0
5,2009,840800,6,5,1,4
6,2009,840800,8,7,1,0
7,2009,840800,7,4,3,1
8,2009,840800,5,2,3,2
9,2009,840800,10,7,3,1
10,2009,840800,9,6,3,3
11,2009,840800,2,2,0,1
12,2009,840800,5,5,0,0
1,2010,840800,5,4,1,3
2,2010,840800,8,6,2,0
3,2010,840800,8,6,2,2
4,2010,840800,6,4,2,0
5,2010,840800,8,6,2,4
6,2010,840800,13,12,1,0
7,2010,840800,7,7,0,1
8,2010,840800,4,2,2,0
9,2010,840800,11,10,1,5
10,2010,840800,13,10,3,1
11,2010,840800,3,2,1,4
12,2010,840800,3,3,0,4
1,2011,840800,13,12,1,0
2,2011,840800,9,8,1,3
1,1999,843200,21,15,6,3
2,1999,843200,37,33,4,3
3,1999,843200,32,31,1,2
4,1999,843200,32,27,5,1
5,1999,843200,24,22,2,4
6,1999,843200,49,46,3,4
7,1999,843200,46,43,3,2
8,1999,843200,41,34,7,3
9,1999,843200,43,36,7,5
10,1999,843200,40,37,3,8
11,1999,843200,27,26,1,4
12,1999,843200,21,18,3,2
1,2000,843200,28,22,6,2
2,2000,843200,37,33,4,8
3,2000,843200,33,28,5,5
4,2000,843200,38,36,2,11
5,2000,843200,47,44,3,4
6,2000,843200,38,37,1,2
7,2000,843200,32,29,3,0
8,2000,843200,41,35,6,7
9,2000,843200,29,24,5,0
10,2000,843200,33,30,3,4
11,2000,843200,23,21,2,5
12,2000,843200,19,18,1,3
1,2001,843200,23,23,0,13
2,2001,843200,32,30,2,9
3,2001,843200,34,30,4,5
4,2001,843200,14,14,0,5
5,2001,843200,28,20,8,8
6,2001,843200,43,38,5,4
7,2001,843200,28,23,5,10
8,2001,843200,27,22,5,3
9,2001,843200,28,25,3,1
10,2001,843200,43,38,5,4
11,2001,843200,18,16,2,2
12,2001,843200,31,27,4,3
1,2002,843200,19,17,2,2
2,2002,843200,11,11,0,2
3,2002,843200,17,15,2,4
4,2002,843200,19,17,2,4
5,2002,843200,20,17,3,1
6,2002,843200,26,22,4,7
7,2002,843200,27,23,4,3
8,2002,843200,28,23,5,3
9,2002,843200,32,27,5,2
10,2002,843200,28,27,1,0
11,2002,843200,23,21,2,4
12,2002,843200,20,19,1,4
1,2003,843200,19,17,2,0
2,2003,843200,22,17,5,4
3,2003,843200,14,14,0,1
4,2003,843200,26,22,4,0
5,2003,843200,30,26,4,3
6,2003,843200,34,29,5,3
7,2003,843200,39,32,7,1
8,2003,843200,26,19,7,2
9,2003,843200,25,19,6,1
10,2003,843200,27,23,4,3
11,2003,843200,25,22,3,6
12,2003,843200,27,26,1,1
1,2004,843200,20,16,4,2
2,2004,843200,23,22,1,1
3,2004,843200,21,21,0,4
4,2004,843200,19,17,2,2
5,2004,843200,24,23,1,3
6,2004,843200,32,29,3,0
7,2004,843200,42,36,6,1
8,2004,843200,25,18,7,2
9,2004,843200,32,30,2,3
10,2004,843200,29,28,1,2
11,2004,843200,28,24,4,4
12,2004,843200,27,25,2,7
1,2005,843200,26,22,4,9
2,2005,843200,28,27,1,4
3,2005,843200,17,13,4,5
4,2005,843200,21,20,1,0
5,2005,843200,35,28,7,2
6,2005,843200,30,24,6,1
7,2005,843200,34,29,5,2
8,2005,843200,29,25,4,3
9,2005,843200,23,20,3,3
10,2005,843200,26,26,0,0
11,2005,843200,22,20,2,3
12,2005,843200,15,15,0,1
1,2006,843200,28,25,3,0
2,2006,843200,12,12,0,1
3,2006,843200,24,20,4,2
4,2006,843200,29,29,0,0
5,2006,843200,27,24,3,0
6,2006,843200,18,18,0,1
7,2006,843200,23,19,4,1
8,2006,843200,34,26,8,2
9,2006,843200,29,27,2,2
10,2006,843200,29,27,2,1
11,2006,843200,20,16,4,6
12,2006,843200,17,14,3,3
1,2007,843200,19,17,2,1
2,2007,843200,18,15,3,3
3,2007,843200,17,10,7,0
4,2007,843200,20,17,3,5
5,2007,843200,24,21,3,4
6,2007,843200,24,18,6,2
7,2007,843200,25,22,3,3
8,2007,843200,24,22,2,5
9,2007,843200,17,13,4,1
10,2007,843200,27,22,5,5
11,2007,843200,35,31,4,1
12,2007,843200,18,16,2,1
1,2008,843200,10,9,1,4
2,2008,843200,18,15,3,0
3,2008,843200,21,19,2,3
4,2008,843200,21,16,5,1
5,2008,843200,23,22,1,5
6,2008,843200,24,19,5,7
7,2008,843200,32,22,10,6
8,2008,843200,12,9,3,1
9,2008,843200,25,23,2,3
10,2008,843200,22,20,2,1
11,2008,843200,14,11,3,4
12,2008,843200,10,9,1,2
1,2009,843200,21,20,1,1
2,2009,843200,16,14,2,5
3,2009,843200,15,12,3,2
4,2009,843200,17,13,4,1
5,2009,843200,13,12,1,5
6,2009,843200,17,16,1,1
7,2009,843200,15,13,2,1
8,2009,843200,21,19,2,5
9,2009,843200,12,12,0,2
10,2009,843200,20,19,1,2
11,2009,843200,14,13,1,2
12,2009,843200,25,24,1,1
1,2010,843200,22,20,2,0
2,2010,843200,9,9,0,3
3,2010,843200,23,21,2,2
4,2010,843200,19,18,1,2
5,2010,843200,14,10,4,0
6,2010,843200,20,17,3,4
7,2010,843200,22,18,4,2
8,2010,843200,19,18,1,0
9,2010,843200,16,14,2,3
10,2010,843200,17,15,2,2
11,2010,843200,19,18,1,1
12,2010,843200,12,12,0,2
1,2011,843200,18,17,1,6
2,2011,843200,6,6,0,2
1,1999,600700,8,7,1,0
2,1999,600700,4,4,0,5
3,1999,600700,16,14,2,2
4,1999,600700,17,16,1,1
5,1999,600700,11,8,3,0
6,1999,600700,6,4,2,2
7,1999,600700,7,6,1,1
8,1999,600700,19,17,2,0
9,1999,600700,10,7,3,1
10,1999,600700,15,12,3,2
11,1999,600700,7,7,0,2
12,1999,600700,6,5,1,1
1,2000,600700,9,8,1,1
2,2000,600700,9,9,0,0
3,2000,600700,13,13,0,1
4,2000,600700,13,11,2,0
5,2000,600700,13,12,1,0
6,2000,600700,5,5,0,0
7,2000,600700,6,5,1,0
8,2000,600700,10,9,1,0
9,2000,600700,13,12,1,1
10,2000,600700,7,4,3,1
11,2000,600700,12,9,3,1
12,2000,600700,9,9,0,1
1,2001,600700,7,7,0,0
2,2001,600700,3,1,2,0
3,2001,600700,10,9,1,0
4,2001,600700,12,11,1,2
5,2001,600700,4,3,1,2
6,2001,600700,10,9,1,0
7,2001,600700,12,12,0,0
8,2001,600700,17,15,2,1
9,2001,600700,11,10,1,0
10,2001,600700,15,13,2,0
11,2001,600700,12,11,1,0
12,2001,600700,6,6,0,2
1,2002,600700,7,5,2,1
2,2002,600700,15,13,2,0
3,2002,600700,13,9,4,1
4,2002,600700,8,6,2,0
5,2002,600700,11,10,1,0
6,2002,600700,14,13,1,0
7,2002,600700,13,11,2,0
8,2002,600700,12,10,2,0
9,2002,600700,17,13,4,0
10,2002,600700,12,11,1,0
11,2002,600700,8,6,2,0
12,2002,600700,10,9,1,0
1,2003,600700,10,10,0,1
2,2003,600700,7,7,0,0
3,2003,600700,10,8,2,1
4,2003,600700,8,8,0,0
5,2003,600700,5,5,0,1
6,2003,600700,12,10,2,5
7,2003,600700,9,7,2,0
8,2003,600700,12,9,3,1
9,2003,600700,7,6,1,2
10,2003,600700,15,14,1,0
11,2003,600700,12,12,0,0
12,2003,600700,5,5,0,0
1,2004,600700,9,8,1,2
2,2004,600700,9,7,2,2
3,2004,600700,13,13,0,1
4,2004,600700,10,7,3,0
5,2004,600700,13,8,5,3
6,2004,600700,6,5,1,2
7,2004,600700,6,6,0,2
8,2004,600700,11,10,1,1
9,2004,600700,11,11,0,1
10,2004,600700,14,11,3,0
11,2004,600700,6,3,3,0
12,2004,600700,6,6,0,0
1,2005,600700,7,7,0,1
2,2005,600700,7,6,1,1
3,2005,600700,9,8,1,2
4,2005,600700,11,10,1,0
5,2005,600700,13,10,3,1
6,2005,600700,12,11,1,1
7,2005,600700,17,13,4,2
8,2005,600700,10,6,4,0
9,2005,600700,4,4,0,0
10,2005,600700,11,8,3,0
11,2005,600700,6,6,0,0
12,2005,600700,7,7,0,3
1,2006,600700,12,11,1,0
2,2006,600700,5,5,0,2
3,2006,600700,11,10,1,0
4,2006,600700,6,6,0,2
5,2006,600700,11,9,2,0
6,2006,600700,9,8,1,0
7,2006,600700,15,9,6,0
8,2006,600700,8,5,3,1
9,2006,600700,11,9,2,2
10,2006,600700,7,7,0,0
11,2006,600700,6,5,1,0
12,2006,600700,4,2,2,0
1,2007,600700,7,5,2,2
2,2007,600700,1,0,1,1
3,2007,600700,3,3,0,1
4,2007,600700,4,3,1,2
5,2007,600700,6,4,2,0
6,2007,600700,5,4,1,2
7,2007,600700,17,15,2,0
8,2007,600700,8,7,1,2
9,2007,600700,10,8,2,0
10,2007,600700,5,3,2,0
11,2007,600700,2,2,0,1
12,2007,600700,7,6,1,0
1,2008,600700,7,7,0,3
2,2008,600700,7,5,2,1
3,2008,600700,9,6,3,0
4,2008,600700,13,13,0,1
5,2008,600700,18,17,1,2
6,2008,600700,10,9,1,0
7,2008,600700,9,8,1,0
8,2008,600700,11,4,7,0
9,2008,600700,8,7,1,0
10,2008,600700,9,9,0,0
11,2008,600700,8,7,1,0
12,2008,600700,6,6,0,0
1,2009,600700,4,4,0,1
2,2009,600700,12,11,1,2
3,2009,600700,3,3,0,2
4,2009,600700,3,2,1,1
5,2009,600700,8,7,1,0
6,2009,600700,8,7,1,0
7,2009,600700,5,5,0,0
8,2009,600700,19,15,4,2
9,2009,600700,5,4,1,0
10,2009,600700,12,11,1,0
11,2009,600700,7,7,0,2
12,2009,600700,9,9,0,1
1,2010,600700,10,10,0,2
2,2010,600700,5,2,3,3
3,2010,600700,10,7,3,0
4,2010,600700,5,5,0,0
5,2010,600700,12,10,2,0
6,2010,600700,9,6,3,2
7,2010,600700,7,6,1,1
8,2010,600700,5,4,1,0
9,2010,600700,2,1,1,2
10,2010,600700,7,5,2,0
11,2010,600700,5,3,2,0
12,2010,600700,6,6,0,2
1,2011,600700,4,3,1,0
2,2011,600700,5,5,0,3
1,1999,600600,4,3,1,0
2,1999,600600,11,9,2,1
3,1999,600600,10,9,1,0
4,1999,600600,17,15,2,0
5,1999,600600,4,4,0,0
6,1999,600600,12,9,3,0
7,1999,600600,10,9,1,0
8,1999,600600,5,4,1,0
9,1999,600600,11,9,2,3
10,1999,600600,14,13,1,0
11,1999,600600,10,9,1,1
12,1999,600600,17,15,2,0
1,2000,600600,13,12,1,0
2,2000,600600,5,5,0,0
3,2000,600600,12,10,2,2
4,2000,600600,8,7,1,0
5,2000,600600,12,8,4,0
6,2000,600600,8,8,0,0
7,2000,600600,8,8,0,0
8,2000,600600,13,11,2,0
9,2000,600600,9,8,1,1
10,2000,600600,6,6,0,0
11,2000,600600,9,8,1,0
12,2000,600600,11,9,2,0
1,2001,600600,6,5,1,1
2,2001,600600,10,10,0,0
3,2001,600600,5,3,2,1
4,2001,600600,1,1,0,0
5,2001,600600,4,4,0,1
6,2001,600600,7,6,1,1
7,2001,600600,17,10,7,0
8,2001,600600,15,15,0,1
9,2001,600600,14,11,3,2
10,2001,600600,8,6,2,2
11,2001,600600,13,12,1,0
12,2001,600600,7,7,0,1
1,2002,600600,9,8,1,0
2,2002,600600,7,7,0,0
3,2002,600600,11,9,2,0
4,2002,600600,10,9,1,0
5,2002,600600,9,6,3,0
6,2002,600600,12,8,4,1
7,2002,600600,13,11,2,0
8,2002,600600,8,6,2,2
9,2002,600600,11,9,2,0
10,2002,600600,8,7,1,0
11,2002,600600,6,5,1,0
12,2002,600600,6,5,1,0
1,2003,600600,9,9,0,0
2,2003,600600,9,8,1,0
3,2003,600600,11,10,1,0
4,2003,600600,15,14,1,0
5,2003,600600,13,13,0,0
6,2003,600600,10,9,1,0
7,2003,600600,12,10,2,1
8,2003,600600,12,11,1,1
9,2003,600600,8,6,2,2
10,2003,600600,9,9,0,1
11,2003,600600,5,3,2,1
12,2003,600600,10,8,2,1
1,2004,600600,9,8,1,2
2,2004,600600,6,5,1,0
3,2004,600600,13,10,3,1
4,2004,600600,4,4,0,0
5,2004,600600,8,8,0,3
6,2004,600600,10,7,3,0
7,2004,600600,9,7,2,0
8,2004,600600,10,10,0,0
9,2004,600600,12,8,4,0
10,2004,600600,9,8,1,0
11,2004,600600,7,7,0,0
12,2004,600600,6,4,2,1
1,2005,600600,3,3,0,0
2,2005,600600,9,7,2,0
3,2005,600600,7,7,0,2
4,2005,600600,13,11,2,0
5,2005,600600,8,4,4,0
6,2005,600600,8,4,4,1
7,2005,600600,5,4,1,0
8,2005,600600,5,2,3,2
9,2005,600600,10,7,3,1
10,2005,600600,5,4,1,3
11,2005,600600,4,3,1,0
12,2005,600600,5,4,1,1
1,2006,600600,6,5,1,2
2,2006,600600,1,1,0,2
3,2006,600600,5,3,2,1
4,2006,600600,11,10,1,3
5,2006,600600,8,6,2,2
6,2006,600600,13,12,1,4
7,2006,600600,16,11,5,2
8,2006,600600,19,16,3,3
9,2006,600600,10,9,1,1
10,2006,600600,2,2,0,1
11,2006,600600,9,8,1,1
12,2006,600600,9,9,0,0
1,2007,600600,9,9,0,0
2,2007,600600,3,3,0,2
3,2007,600600,5,5,0,0
4,2007,600600,4,4,0,3
5,2007,600600,10,8,2,1
6,2007,600600,7,6,1,2
7,2007,600600,13,13,0,3
8,2007,600600,3,1,2,1
9,2007,600600,6,5,1,5
10,2007,600600,7,7,0,2
11,2007,600600,5,5,0,0
12,2007,600600,8,6,2,0
1,2008,600600,10,9,1,2
2,2008,600600,3,3,0,1
3,2008,600600,9,9,0,0
4,2008,600600,8,8,0,0
5,2008,600600,7,7,0,1
6,2008,600600,9,7,2,3
7,2008,600600,7,5,2,2
8,2008,600600,7,6,1,1
9,2008,600600,11,7,4,0
10,2008,600600,3,3,0,3
11,2008,600600,8,7,1,1
12,2008,600600,6,6,0,1
1,2009,600600,5,5,0,0
2,2009,600600,3,3,0,0
3,2009,600600,9,8,1,1
4,2009,600600,3,3,0,5
5,2009,600600,1,1,0,2
6,2009,600600,9,8,1,0
7,2009,600600,7,7,0,1
8,2009,600600,5,5,0,1
9,2009,600600,8,6,2,4
10,2009,600600,9,8,1,2
11,2009,600600,9,8,1,2
12,2009,600600,4,1,3,0
1,2010,600600,4,3,1,0
2,2010,600600,1,1,0,2
3,2010,600600,3,3,0,2
4,2010,600600,4,3,1,2
5,2010,600600,8,6,2,0
6,2010,600600,5,2,3,2
7,2010,600600,10,7,3,0
8,2010,600600,7,7,0,0
9,2010,600600,9,7,2,0
10,2010,600600,3,3,0,0
11,2010,600600,5,5,0,0
12,2010,600600,9,7,2,0
1,2011,600600,1,1,0,1
2,2011,600600,4,3,1,2
1,1999,840200,10,9,1,2
2,1999,840200,3,2,1,1
3,1999,840200,12,10,2,4
4,1999,840200,13,13,0,0
5,1999,840200,16,11,5,0
6,1999,840200,24,22,2,3
7,1999,840200,13,11,2,0
8,1999,840200,16,15,1,3
9,1999,840200,18,18,0,6
10,1999,840200,22,22,0,1
11,1999,840200,9,8,1,2
12,1999,840200,9,8,1,0
1,2000,840200,11,10,1,1
2,2000,840200,8,8,0,1
3,2000,840200,7,6,1,1
4,2000,840200,7,6,1,3
5,2000,840200,8,6,2,0
6,2000,840200,17,15,2,0
7,2000,840200,12,12,0,1
8,2000,840200,14,12,2,1
9,2000,840200,10,9,1,1
10,2000,840200,18,17,1,0
11,2000,840200,10,10,0,0
12,2000,840200,9,9,0,0
1,2001,840200,16,14,2,0
2,2001,840200,6,6,0,2
3,2001,840200,8,8,0,0
4,2001,840200,11,10,1,2
5,2001,840200,19,16,3,1
6,2001,840200,9,8,1,0
7,2001,840200,15,12,3,0
8,2001,840200,12,12,0,1
9,2001,840200,12,11,1,4
10,2001,840200,12,10,2,1
11,2001,840200,11,10,1,0
12,2001,840200,14,12,2,0
1,2002,840200,12,12,0,0
2,2002,840200,12,11,1,1
3,2002,840200,11,11,0,2
4,2002,840200,12,11,1,0
5,2002,840200,17,14,3,1
6,2002,840200,15,12,3,2
7,2002,840200,16,16,0,1
8,2002,840200,16,15,1,1
9,2002,840200,9,8,1,1
10,2002,840200,18,14,4,2
11,2002,840200,8,8,0,1
12,2002,840200,6,6,0,2
1,2003,840200,14,13,1,1
2,2003,840200,15,15,0,1
3,2003,840200,15,14,1,0
4,2003,840200,17,15,2,0
5,2003,840200,27,25,2,0
6,2003,840200,15,13,2,1
7,2003,840200,12,9,3,4
8,2003,840200,17,15,2,1
9,2003,840200,12,11,1,0
10,2003,840200,12,11,1,0
11,2003,840200,12,11,1,0
12,2003,840200,8,8,0,0
1,2004,840200,9,8,1,1
2,2004,840200,10,9,1,0
3,2004,840200,12,11,1,0
4,2004,840200,8,8,0,1
5,2004,840200,10,8,2,4
6,2004,840200,12,12,0,0
7,2004,840200,19,17,2,2
8,2004,840200,11,8,3,1
9,2004,840200,14,13,1,3
10,2004,840200,15,12,3,3
11,2004,840200,13,13,0,1
12,2004,840200,16,14,2,0
1,2005,840200,8,6,2,0
2,2005,840200,14,12,2,0
3,2005,840200,12,12,0,1
4,2005,840200,18,16,2,0
5,2005,840200,21,19,2,1
6,2005,840200,15,13,2,0
7,2005,840200,9,6,3,0
8,2005,840200,15,14,1,0
9,2005,840200,11,8,3,0
10,2005,840200,20,19,1,3
11,2005,840200,8,7,1,5
12,2005,840200,10,10,0,0
1,2006,840200,23,23,0,2
2,2006,840200,10,9,1,1
3,2006,840200,10,10,0,0
4,2006,840200,14,13,1,4
5,2006,840200,15,15,0,0
6,2006,840200,17,16,1,1
7,2006,840200,15,10,5,2
8,2006,840200,13,13,0,1
9,2006,840200,2,2,0,2
10,2006,840200,12,12,0,0
11,2006,840200,3,1,2,0
12,2006,840200,8,7,1,1
1,2007,840200,8,8,0,3
2,2007,840200,7,7,0,1
3,2007,840200,6,5,1,0
4,2007,840200,6,6,0,1
5,2007,840200,12,11,1,2
6,2007,840200,14,13,1,1
7,2007,840200,13,10,3,2
8,2007,840200,14,10,4,2
9,2007,840200,10,7,3,2
10,2007,840200,6,4,2,4
11,2007,840200,13,12,1,3
12,2007,840200,12,11,1,1
1,2008,840200,9,7,2,1
2,2008,840200,11,11,0,2
3,2008,840200,9,7,2,4
4,2008,840200,7,5,2,2
5,2008,840200,15,13,2,0
6,2008,840200,22,18,4,0
7,2008,840200,17,15,2,6
8,2008,840200,5,4,1,1
9,2008,840200,5,4,1,1
10,2008,840200,11,11,0,0
11,2008,840200,16,14,2,1
12,2008,840200,16,12,4,2
1,2009,840200,10,9,1,3
2,2009,840200,8,8,0,2
3,2009,840200,9,8,1,0
4,2009,840200,9,8,1,1
5,2009,840200,13,9,4,1
6,2009,840200,12,11,1,2
7,2009,840200,23,20,3,2
8,2009,840200,17,17,0,0
9,2009,840200,13,12,1,4
10,2009,840200,14,13,1,0
11,2009,840200,16,16,0,4
12,2009,840200,10,10,0,1
1,2010,840200,9,9,0,0
2,2010,840200,10,9,1,5
3,2010,840200,14,13,1,1
4,2010,840200,10,10,0,1
5,2010,840200,10,9,1,1
6,2010,840200,9,9,0,3
7,2010,840200,14,13,1,1
8,2010,840200,18,18,0,0
9,2010,840200,15,15,0,1
10,2010,840200,11,11,0,2
11,2010,840200,13,12,1,1
12,2010,840200,9,8,1,4
1,2011,840200,9,8,1,4
2,2011,840200,4,4,0,0
1,1999,600400,19,19,0,0
2,1999,600400,20,19,1,0
3,1999,600400,17,16,1,1
4,1999,600400,14,13,1,0
5,1999,600400,21,21,0,0
6,1999,600400,26,25,1,1
7,1999,600400,31,24,7,0
8,1999,600400,21,21,0,4
9,1999,600400,16,13,3,0
10,1999,600400,10,9,1,0
11,1999,600400,11,10,1,1
12,1999,600400,11,9,2,0
1,2000,600400,18,16,2,0
2,2000,600400,10,9,1,2
3,2000,600400,15,15,0,3
4,2000,600400,24,23,1,2
5,2000,600400,21,20,1,0
6,2000,600400,16,15,1,3
7,2000,600400,24,19,5,4
8,2000,600400,14,12,2,3
9,2000,600400,18,18,0,2
10,2000,600400,17,16,1,0
11,2000,600400,16,16,0,3
12,2000,600400,26,24,2,0
1,2001,600400,10,10,0,0
2,2001,600400,8,7,1,0
3,2001,600400,7,7,0,0
4,2001,600400,10,10,0,2
5,2001,600400,7,6,1,1
6,2001,600400,19,17,2,0
7,2001,600400,15,13,2,0
8,2001,600400,14,14,0,1
9,2001,600400,20,20,0,0
10,2001,600400,15,14,1,0
11,2001,600400,19,17,2,1
12,2001,600400,10,9,1,1
1,2002,600400,22,22,0,1
2,2002,600400,20,19,1,0
3,2002,600400,11,9,2,1
4,2002,600400,17,15,2,1
5,2002,600400,9,7,2,1
6,2002,600400,7,6,1,0
7,2002,600400,16,15,1,0
8,2002,600400,7,7,0,1
9,2002,600400,17,15,2,1
10,2002,600400,18,18,0,0
11,2002,600400,17,17,0,1
12,2002,600400,15,13,2,0
1,2003,600400,11,9,2,1
2,2003,600400,7,7,0,0
3,2003,600400,13,10,3,2
4,2003,600400,24,24,0,0
5,2003,600400,13,13,0,0
6,2003,600400,18,18,0,0
7,2003,600400,20,19,1,1
8,2003,600400,29,26,3,1
9,2003,600400,12,11,1,0
10,2003,600400,17,15,2,3
11,2003,600400,22,21,1,0
12,2003,600400,16,16,0,0
1,2004,600400,12,10,2,0
2,2004,600400,7,4,3,1
3,2004,600400,18,16,2,0
4,2004,600400,16,14,2,0
5,2004,600400,11,11,0,2
6,2004,600400,8,6,2,0
7,2004,600400,21,20,1,0
8,2004,600400,11,10,1,1
9,2004,600400,14,13,1,0
10,2004,600400,18,17,1,2
11,2004,600400,22,21,1,0
12,2004,600400,20,18,2,0
1,2005,600400,14,11,3,2
2,2005,600400,18,17,1,2
3,2005,600400,9,9,0,3
4,2005,600400,22,18,4,2
5,2005,600400,19,17,2,0
6,2005,600400,26,23,3,0
7,2005,600400,13,12,1,0
8,2005,600400,25,20,5,1
9,2005,600400,17,17,0,0
10,2005,600400,12,11,1,1
11,2005,600400,18,18,0,0
12,2005,600400,15,14,1,0
1,2006,600400,21,17,4,0
2,2006,600400,10,10,0,2
3,2006,600400,7,7,0,0
4,2006,600400,11,11,0,0
5,2006,600400,13,12,1,1
6,2006,600400,15,15,0,0
7,2006,600400,14,11,3,1
8,2006,600400,10,8,2,1
9,2006,600400,10,10,0,1
10,2006,600400,12,12,0,1
11,2006,600400,17,17,0,1
12,2006,600400,18,17,1,0
1,2007,600400,12,12,0,1
2,2007,600400,5,5,0,0
3,2007,600400,13,13,0,4
4,2007,600400,11,9,2,0
5,2007,600400,20,20,0,1
6,2007,600400,19,18,1,1
7,2007,600400,10,10,0,1
8,2007,600400,13,12,1,2
9,2007,600400,12,11,1,0
10,2007,600400,15,15,0,2
11,2007,600400,7,7,0,0
12,2007,600400,10,8,2,1
1,2008,600400,12,11,1,0
2,2008,600400,8,8,0,0
3,2008,600400,8,7,1,3
4,2008,600400,13,11,2,0
5,2008,600400,10,10,0,1
6,2008,600400,18,18,0,1
7,2008,600400,13,11,2,0
8,2008,600400,13,12,1,1
9,2008,600400,15,14,1,4
10,2008,600400,20,19,1,1
11,2008,600400,10,10,0,0
12,2008,600400,11,11,0,0
1,2009,600400,8,8,0,0
2,2009,600400,11,8,3,1
3,2009,600400,13,12,1,0
4,2009,600400,10,10,0,3
5,2009,600400,7,6,1,0
6,2009,600400,11,10,1,1
7,2009,600400,17,15,2,2
8,2009,600400,13,12,1,3
9,2009,600400,16,14,2,5
10,2009,600400,15,13,2,3
11,2009,600400,16,14,2,5
12,2009,600400,10,10,0,3
1,2010,600400,15,14,1,3
2,2010,600400,8,7,1,5
3,2010,600400,19,13,6,0
4,2010,600400,18,17,1,3
5,2010,600400,15,13,2,0
6,2010,600400,10,10,0,1
7,2010,600400,8,7,1,2
8,2010,600400,16,15,1,0
9,2010,600400,12,10,2,1
10,2010,600400,9,8,1,0
11,2010,600400,10,10,0,0
12,2010,600400,11,10,1,1
1,2011,600400,10,7,3,1
2,2011,600400,8,7,1,0
1,1999,840100,4,4,0,0
2,1999,840100,6,5,1,0
3,1999,840100,7,6,1,1
4,1999,840100,7,7,0,1
5,1999,840100,11,8,3,2
6,1999,840100,15,14,1,2
7,1999,840100,8,7,1,0
8,1999,840100,10,10,0,3
9,1999,840100,7,4,3,0
10,1999,840100,10,10,0,1
11,1999,840100,6,4,2,0
12,1999,840100,6,5,1,0
1,2000,840100,8,8,0,0
2,2000,840100,3,3,0,0
3,2000,840100,6,6,0,0
4,2000,840100,5,4,1,0
5,2000,840100,7,5,2,0
6,2000,840100,6,5,1,1
7,2000,840100,6,6,0,0
8,2000,840100,3,3,0,1
9,2000,840100,6,6,0,0
10,2000,840100,5,4,1,0
11,2000,840100,7,7,0,1
12,2000,840100,11,11,0,0
1,2001,840100,8,8,0,2
2,2001,840100,9,9,0,3
3,2001,840100,8,7,1,0
4,2001,840100,6,5,1,0
5,2001,840100,4,4,0,0
6,2001,840100,2,2,0,1
7,2001,840100,6,4,2,1
8,2001,840100,7,6,1,0
9,2001,840100,2,2,0,1
10,2001,840100,6,4,2,0
11,2001,840100,2,2,0,0
12,2001,840100,4,4,0,0
1,2002,840100,7,6,1,0
2,2002,840100,3,3,0,1
3,2002,840100,6,5,1,0
4,2002,840100,6,4,2,1
5,2002,840100,7,6,1,0
6,2002,840100,3,3,0,2
7,2002,840100,12,10,2,0
8,2002,840100,2,2,0,3
9,2002,840100,6,6,0,1
10,2002,840100,3,3,0,2
11,2002,840100,7,6,1,0
12,2002,840100,4,4,0,1
1,2003,840100,9,7,2,2
2,2003,840100,9,8,1,0
3,2003,840100,4,4,0,0
4,2003,840100,10,10,0,1
5,2003,840100,6,6,0,1
6,2003,840100,4,3,1,0
7,2003,840100,5,5,0,1
8,2003,840100,5,5,0,1
9,2003,840100,2,2,0,0
10,2003,840100,8,7,1,1
11,2003,840100,6,6,0,0
12,2003,840100,2,2,0,1
1,2004,840100,6,5,1,0
2,2004,840100,6,4,2,0
3,2004,840100,5,5,0,0
4,2004,840100,5,5,0,2
5,2004,840100,4,3,1,0
6,2004,840100,8,8,0,4
7,2004,840100,6,6,0,0
8,2004,840100,5,5,0,0
9,2004,840100,8,8,0,0
10,2004,840100,6,5,1,1
11,2004,840100,6,6,0,0
12,2004,840100,5,4,1,0
1,2005,840100,1,1,0,0
2,2005,840100,1,1,0,0
3,2005,840100,8,7,1,0
4,2005,840100,11,8,3,0
5,2005,840100,7,7,0,0
6,2005,840100,6,5,1,0
7,2005,840100,1,1,0,0
8,2005,840100,9,9,0,1
9,2005,840100,5,4,1,0
10,2005,840100,9,8,1,0
11,2005,840100,5,4,1,0
12,2005,840100,2,2,0,0
1,2006,840100,5,5,0,0
2,2006,840100,5,5,0,0
3,2006,840100,4,4,0,0
4,2006,840100,3,3,0,0
5,2006,840100,6,6,0,2
6,2006,840100,5,4,1,0
7,2006,840100,4,3,1,0
8,2006,840100,4,3,1,2
9,2006,840100,5,3,2,1
10,2006,840100,14,14,0,0
11,2006,840100,6,6,0,0
12,2006,840100,2,2,0,1
1,2007,840100,1,1,0,0
2,2007,840100,6,5,1,0
3,2007,840100,3,2,1,3
4,2007,840100,1,1,0,0
5,2007,840100,4,4,0,0
6,2007,840100,7,7,0,0
7,2007,840100,3,3,0,1
8,2007,840100,5,5,0,0
9,2007,840100,5,5,0,1
10,2007,840100,6,6,0,2
11,2007,840100,2,2,0,0
12,2007,840100,3,3,0,0
1,2008,840100,7,7,0,0
2,2008,840100,5,4,1,0
3,2008,840100,3,3,0,1
4,2008,840100,6,6,0,1
5,2008,840100,7,7,0,0
6,2008,840100,6,5,1,3
7,2008,840100,7,6,1,2
8,2008,840100,8,8,0,0
9,2008,840100,7,6,1,0
10,2008,840100,4,4,0,0
11,2008,840100,4,4,0,0
12,2008,840100,6,5,1,2
1,2009,840100,7,7,0,0
2,2009,840100,2,2,0,2
3,2009,840100,5,5,0,0
4,2009,840100,4,4,0,2
5,2009,840100,5,5,0,2
6,2009,840100,7,7,0,2
7,2009,840100,5,5,0,0
8,2009,840100,10,10,0,0
9,2009,840100,4,4,0,2
10,2009,840100,4,4,0,0
11,2009,840100,1,1,0,2
12,2009,840100,4,4,0,4
1,2010,840100,5,5,0,0
2,2010,840100,8,8,0,2
3,2010,840100,5,5,0,2
4,2010,840100,5,4,1,1
5,2010,840100,4,4,0,0
6,2010,840100,4,4,0,0
7,2010,840100,3,2,1,0
8,2010,840100,8,8,0,1
9,2010,840100,6,6,0,0
10,2010,840100,2,2,0,0
11,2010,840100,4,4,0,0
12,2010,840100,4,3,1,1
1,2011,840100,3,3,0,1
2,2011,840100,1,1,0,0
1,1999,340300,4,4,0,0
2,1999,340300,4,3,1,0
3,1999,340300,1,1,0,0
4,1999,340300,4,4,0,0
5,1999,340300,10,9,1,0
6,1999,340300,7,6,1,4
7,1999,340300,9,6,3,0
8,1999,340300,4,4,0,0
9,1999,340300,14,14,0,0
10,1999,340300,6,5,1,0
11,1999,340300,4,4,0,0
12,1999,340300,3,3,0,0
1,2000,340300,5,5,0,0
2,2000,340300,1,1,0,0
3,2000,340300,7,6,1,1
4,2000,340300,3,3,0,0
5,2000,340300,2,2,0,0
6,2000,340300,7,7,0,0
7,2000,340300,7,6,1,1
8,2000,340300,6,5,1,0
9,2000,340300,5,5,0,0
10,2000,340300,9,7,2,0
11,2000,340300,4,4,0,0
12,2000,340300,4,4,0,0
1,2001,340300,5,5,0,0
2,2001,340300,2,2,0,1
3,2001,340300,2,2,0,0
4,2001,340300,4,4,0,2
5,2001,340300,3,2,1,0
6,2001,340300,6,4,2,0
7,2001,340300,4,4,0,0
8,2001,340300,4,3,1,0
9,2001,340300,2,1,1,0
10,2001,340300,8,7,1,1
11,2001,340300,5,5,0,0
12,2001,340300,4,4,0,1
1,2002,340300,3,2,1,0
2,2002,340300,2,2,0,1
3,2002,340300,6,4,2,0
4,2002,340300,2,2,0,1
5,2002,340300,8,7,1,0
6,2002,340300,4,3,1,0
7,2002,340300,13,12,1,0
8,2002,340300,9,9,0,0
9,2002,340300,9,7,2,0
10,2002,340300,3,3,0,0
11,2002,340300,3,3,0,0
12,2002,340300,4,4,0,1
1,2003,340300,1,1,0,0
2,2003,340300,2,2,0,0
3,2003,340300,3,3,0,0
4,2003,340300,8,7,1,0
5,2003,340300,4,4,0,0
6,2003,340300,5,5,0,1
7,2003,340300,3,2,1,0
8,2003,340300,7,7,0,0
9,2003,340300,10,10,0,0
10,2003,340300,4,3,1,0
11,2003,340300,6,5,1,0
12,2003,340300,4,4,0,0
1,2004,340300,5,5,0,0
2,2004,340300,4,2,2,0
3,2004,340300,5,5,0,0
4,2004,340300,4,3,1,0
5,2004,340300,1,1,0,0
6,2004,340300,5,4,1,0
7,2004,340300,0,0,0,1
8,2004,340300,4,4,0,0
9,2004,340300,5,5,0,0
10,2004,340300,6,6,0,0
11,2004,340300,4,4,0,0
12,2004,340300,8,8,0,0
1,2005,340300,5,5,0,1
2,2005,340300,1,1,0,0
3,2005,340300,2,2,0,0
4,2005,340300,3,3,0,0
5,2005,340300,7,7,0,0
6,2005,340300,2,2,0,0
7,2005,340300,8,7,1,0
8,2005,340300,15,15,0,2
9,2005,340300,12,12,0,0
10,2005,340300,5,5,0,0
11,2005,340300,10,9,1,0
12,2005,340300,2,2,0,0
1,2006,340300,8,7,1,1
2,2006,340300,11,9,2,2
3,2006,340300,5,5,0,0
4,2006,340300,7,7,0,0
5,2006,340300,6,5,1,1
6,2006,340300,6,6,0,0
7,2006,340300,5,4,1,0
8,2006,340300,4,4,0,0
9,2006,340300,6,5,1,0
10,2006,340300,5,4,1,0
11,2006,340300,4,4,0,0
12,2006,340300,4,3,1,1
1,2007,340300,3,3,0,0
2,2007,340300,2,2,0,0
3,2007,340300,5,4,1,0
4,2007,340300,6,5,1,0
5,2007,340300,4,4,0,1
6,2007,340300,3,2,1,1
7,2007,340300,4,4,0,1
8,2007,340300,2,2,0,0
9,2007,340300,3,3,0,0
10,2007,340300,3,3,0,0
11,2007,340300,5,5,0,1
12,2007,340300,4,3,1,1
1,2008,340300,5,5,0,1
2,2008,340300,3,3,0,0
3,2008,340300,6,6,0,0
4,2008,340300,12,12,0,0
5,2008,340300,2,2,0,0
6,2008,340300,3,3,0,0
7,2008,340300,4,4,0,0
8,2008,340300,3,3,0,1
9,2008,340300,5,4,1,0
10,2008,340300,6,6,0,0
11,2008,340300,7,7,0,0
12,2008,340300,4,4,0,0
1,2009,340300,3,2,1,0
2,2009,340300,2,2,0,1
3,2009,340300,7,7,0,0
4,2009,340300,4,4,0,1
5,2009,340300,2,2,0,0
6,2009,340300,3,3,0,0
7,2009,340300,3,2,1,0
8,2009,340300,4,4,0,1
9,2009,340300,6,5,1,0
10,2009,340300,3,3,0,0
11,2009,340300,6,6,0,2
12,2009,340300,3,3,0,0
1,2010,340300,2,2,0,0
2,2010,340300,6,6,0,1
3,2010,340300,6,6,0,0
4,2010,340300,4,4,0,0
5,2010,340300,4,3,1,0
6,2010,340300,6,6,0,1
7,2010,340300,6,6,0,0
8,2010,340300,5,5,0,0
9,2010,340300,3,3,0,0
10,2010,340300,1,1,0,1
11,2010,340300,4,4,0,0
12,2010,340300,2,2,0,0
1,2011,340300,2,2,0,0
2,2011,340300,4,4,0,0
1,1999,340400,7,7,0,3
2,1999,340400,1,1,0,5
3,1999,340400,10,8,2,4
4,1999,340400,10,7,3,3
5,1999,340400,12,12,0,6
6,1999,340400,14,11,3,7
7,1999,340400,16,16,0,2
8,1999,340400,16,16,0,3
9,1999,340400,12,11,1,3
10,1999,340400,9,8,1,13
11,1999,340400,7,4,3,10
12,1999,340400,10,9,1,10
1,2000,340400,6,5,1,3
2,2000,340400,12,11,1,11
3,2000,340400,1,1,0,11
4,2000,340400,7,7,0,4
5,2000,340400,9,7,2,1
6,2000,340400,10,7,3,4
7,2000,340400,14,13,1,3
8,2000,340400,15,10,5,7
9,2000,340400,8,8,0,10
10,2000,340400,4,3,1,8
11,2000,340400,11,9,2,11
12,2000,340400,9,9,0,15
1,2001,340400,7,6,1,19
2,2001,340400,1,1,0,9
3,2001,340400,3,1,2,8
4,2001,340400,14,14,0,10
5,2001,340400,5,5,0,5
6,2001,340400,12,11,1,18
7,2001,340400,10,8,2,6
8,2001,340400,9,8,1,8
9,2001,340400,13,11,2,6
10,2001,340400,16,14,2,6
11,2001,340400,11,11,0,0
12,2001,340400,5,4,1,4
1,2002,340400,6,5,1,11
2,2002,340400,4,3,1,7
3,2002,340400,3,3,0,9
4,2002,340400,2,2,0,6
5,2002,340400,9,6,3,4
6,2002,340400,12,11,1,2
7,2002,340400,8,7,1,0
8,2002,340400,18,13,5,12
9,2002,340400,7,7,0,10
10,2002,340400,11,9,2,14
11,2002,340400,13,12,1,7
12,2002,340400,8,8,0,4
1,2003,340400,8,6,2,29
2,2003,340400,5,4,1,4
3,2003,340400,9,7,2,4
4,2003,340400,16,15,1,5
5,2003,340400,8,7,1,2
6,2003,340400,10,10,0,6
7,2003,340400,11,9,2,7
8,2003,340400,19,17,2,9
9,2003,340400,13,12,1,6
10,2003,340400,6,6,0,4
11,2003,340400,6,4,2,7
12,2003,340400,11,9,2,3
1,2004,340400,8,8,0,2
2,2004,340400,3,2,1,7
3,2004,340400,7,6,1,1
4,2004,340400,7,5,2,3
5,2004,340400,9,9,0,1
6,2004,340400,11,11,0,1
7,2004,340400,13,13,0,3
8,2004,340400,9,6,3,3
9,2004,340400,7,5,2,6
10,2004,340400,12,9,3,3
11,2004,340400,12,12,0,5
12,2004,340400,6,5,1,9
1,2005,340400,5,4,1,6
2,2005,340400,10,9,1,1
3,2005,340400,8,7,1,2
4,2005,340400,8,7,1,1
5,2005,340400,8,6,2,4
6,2005,340400,8,7,1,2
7,2005,340400,9,7,2,3
8,2005,340400,20,19,1,0
9,2005,340400,8,8,0,1
10,2005,340400,8,7,1,3
11,2005,340400,9,8,1,3
12,2005,340400,5,4,1,4
1,2006,340400,14,13,1,10
2,2006,340400,9,9,0,2
3,2006,340400,12,12,0,0
4,2006,340400,5,5,0,0
5,2006,340400,9,9,0,2
6,2006,340400,14,10,4,1
7,2006,340400,7,7,0,1
8,2006,340400,13,13,0,0
9,2006,340400,6,5,1,0
10,2006,340400,11,11,0,0
11,2006,340400,11,10,1,0
12,2006,340400,5,5,0,0
1,2007,340400,5,5,0,0
2,2007,340400,6,5,1,0
3,2007,340400,6,5,1,0
4,2007,340400,5,5,0,2
5,2007,340400,11,11,0,0
6,2007,340400,4,4,0,0
7,2007,340400,9,9,0,2
8,2007,340400,3,3,0,0
9,2007,340400,8,6,2,0
10,2007,340400,8,7,1,0
11,2007,340400,14,13,1,0
12,2007,340400,9,3,6,0
1,2008,340400,10,10,0,1
2,2008,340400,9,9,0,0
3,2008,340400,10,7,3,0
4,2008,340400,5,4,1,1
5,2008,340400,7,7,0,2
6,2008,340400,14,14,0,0
7,2008,340400,9,9,0,0
8,2008,340400,10,9,1,4
9,2008,340400,8,8,0,0
10,2008,340400,12,10,2,0
11,2008,340400,6,6,0,2
12,2008,340400,9,8,1,1
1,2009,340400,1,0,1,0
2,2009,340400,6,5,1,2
3,2009,340400,7,7,0,1
4,2009,340400,3,3,0,0
5,2009,340400,2,2,0,2
6,2009,340400,9,9,0,0
7,2009,340400,8,6,2,0
8,2009,340400,12,12,0,1
9,2009,340400,10,10,0,0
10,2009,340400,4,4,0,0
11,2009,340400,8,7,1,0
12,2009,340400,10,10,0,1
1,2010,340400,10,10,0,0
2,2010,340400,14,14,0,0
3,2010,340400,9,9,0,1
4,2010,340400,10,10,0,1
5,2010,340400,10,10,0,0
6,2010,340400,3,3,0,0
7,2010,340400,10,9,1,2
8,2010,340400,9,9,0,3
9,2010,340400,9,7,2,1
10,2010,340400,3,2,1,0
11,2010,340400,9,9,0,0
12,2010,340400,5,5,0,0
1,2011,340400,4,4,0,0
2,2011,340400,2,2,0,0
1,1999,350400,6,5,1,26
2,1999,350400,13,10,3,29
3,1999,350400,20,16,4,37
4,1999,350400,18,10,8,36
5,1999,350400,23,18,5,18
6,1999,350400,6,4,2,25
7,1999,350400,19,14,5,36
8,1999,350400,25,17,8,23
9,1999,350400,18,14,4,21
10,1999,350400,13,6,7,41
11,1999,350400,12,10,2,60
12,1999,350400,10,7,3,44
1,2000,350400,18,11,7,34
2,2000,350400,16,11,5,34
3,2000,350400,15,12,3,18
4,2000,350400,14,12,2,18
5,2000,350400,19,14,5,2
6,2000,350400,19,12,7,9
7,2000,350400,13,7,6,17
8,2000,350400,15,4,11,18
9,2000,350400,21,15,6,28
10,2000,350400,16,13,3,62
11,2000,350400,9,8,1,21
12,2000,350400,14,10,4,52
1,2001,350400,11,6,5,78
2,2001,350400,9,4,5,37
3,2001,350400,10,8,2,48
4,2001,350400,12,7,5,31
5,2001,350400,7,2,5,37
6,2001,350400,20,11,9,40
7,2001,350400,16,8,8,25
8,2001,350400,17,12,5,18
9,2001,350400,8,4,4,12
10,2001,350400,12,7,5,18
11,2001,350400,10,2,8,21
12,2001,350400,6,5,1,10
1,2002,350400,7,4,3,28
2,2002,350400,4,3,1,36
3,2002,350400,7,3,4,22
4,2002,350400,10,1,9,64
5,2002,350400,15,9,6,13
6,2002,350400,10,8,2,8
7,2002,350400,14,10,4,14
8,2002,350400,10,7,3,24
9,2002,350400,12,6,6,60
10,2002,350400,8,3,5,33
11,2002,350400,5,5,0,16
12,2002,350400,8,3,5,20
1,2003,350400,7,5,2,21
2,2003,350400,5,3,2,9
3,2003,350400,6,5,1,30
4,2003,350400,4,3,1,16
5,2003,350400,8,4,4,16
6,2003,350400,10,4,6,17
7,2003,350400,13,9,4,19
8,2003,350400,8,3,5,23
9,2003,350400,7,4,3,26
10,2003,350400,13,10,3,35
11,2003,350400,11,6,5,30
12,2003,350400,11,8,3,22
1,2004,350400,6,4,2,28
2,2004,350400,5,3,2,35
3,2004,350400,13,9,4,24
4,2004,350400,10,5,5,60
5,2004,350400,14,5,9,26
6,2004,350400,16,8,8,14
7,2004,350400,13,10,3,13
8,2004,350400,22,15,7,60
9,2004,350400,8,5,3,47
10,2004,350400,6,2,4,57
11,2004,350400,13,8,5,95
12,2004,350400,10,6,4,61
1,2005,350400,15,11,4,134
2,2005,350400,5,4,1,107
3,2005,350400,6,2,4,68
4,2005,350400,11,4,7,48
5,2005,350400,7,2,5,66
6,2005,350400,11,5,6,64
7,2005,350400,14,4,10,74
8,2005,350400,13,9,4,58
9,2005,350400,12,9,3,67
10,2005,350400,5,2,3,60
11,2005,350400,13,11,2,50
12,2005,350400,4,3,1,39
1,2006,350400,8,5,3,48
2,2006,350400,8,5,3,39
3,2006,350400,11,6,5,34
4,2006,350400,13,8,5,32
5,2006,350400,13,9,4,53
6,2006,350400,14,7,7,109
7,2006,350400,20,15,5,61
8,2006,350400,13,8,5,103
9,2006,350400,7,4,3,36
10,2006,350400,11,6,5,66
11,2006,350400,8,3,5,71
12,2006,350400,11,8,3,10
1,2007,350400,4,3,1,98
2,2007,350400,9,6,3,27
3,2007,350400,6,3,3,24
4,2007,350400,6,4,2,28
5,2007,350400,9,7,2,13
6,2007,350400,3,3,0,32
7,2007,350400,5,3,2,20
8,2007,350400,6,6,0,19
9,2007,350400,8,6,2,9
10,2007,350400,11,8,3,19
11,2007,350400,8,7,1,9
12,2007,350400,6,5,1,11
1,2008,350400,5,5,0,16
2,2008,350400,3,3,0,39
3,2008,350400,5,2,3,10
4,2008,350400,9,8,1,18
5,2008,350400,4,2,2,28
6,2008,350400,13,7,6,6
7,2008,350400,8,6,2,14
8,2008,350400,2,2,0,18
9,2008,350400,4,1,3,19
10,2008,350400,2,1,1,43
11,2008,350400,5,4,1,37
12,2008,350400,2,2,0,44
1,2009,350400,4,3,1,29
2,2009,350400,0,0,0,12
3,2009,350400,5,3,2,16
4,2009,350400,4,2,2,2
5,2009,350400,4,3,1,8
6,2009,350400,2,2,0,1
7,2009,350400,1,1,0,0
8,2009,350400,3,1,2,1
9,2009,350400,4,3,1,3
10,2009,350400,3,2,1,3
11,2009,350400,1,0,1,3
12,2009,350400,0,0,0,1
1,2010,350400,0,0,0,2
2,2010,350400,0,0,0,1
3,2010,350400,2,2,0,0
4,2010,350400,1,1,0,0
5,2010,350400,4,3,1,0
6,2010,350400,5,5,0,0
7,2010,350400,1,1,0,0
8,2010,350400,5,3,2,1
9,2010,350400,4,3,1,2
10,2010,350400,3,3,0,2
11,2010,350400,2,0,2,0
12,2010,350400,3,1,2,0
1,2011,350400,3,3,0,0
2,2011,350400,4,4,0,0
1,1999,839200,45,37,8,6
2,1999,839200,46,44,2,4
3,1999,839200,31,27,4,2
4,1999,839200,35,29,6,9
5,1999,839200,44,33,11,14
6,1999,839200,47,36,11,14
7,1999,839200,58,49,9,7
8,1999,839200,58,52,6,9
9,1999,839200,59,55,4,4
10,1999,839200,64,58,6,21
11,1999,839200,46,40,6,10
12,1999,839200,37,31,6,4
1,2000,839200,31,26,5,14
2,2000,839200,22,18,4,10
3,2000,839200,42,34,8,22
4,2000,839200,27,25,2,11
5,2000,839200,32,26,6,1
6,2000,839200,32,30,2,4
7,2000,839200,44,41,3,7
8,2000,839200,45,40,5,9
9,2000,839200,46,41,5,5
10,2000,839200,38,31,7,6
11,2000,839200,31,29,2,5
12,2000,839200,23,20,3,2
1,2001,839200,38,35,3,21
2,2001,839200,19,17,2,4
3,2001,839200,35,26,9,9
4,2001,839200,31,25,6,6
5,2001,839200,24,20,4,6
6,2001,839200,46,42,4,4
7,2001,839200,36,34,2,3
8,2001,839200,29,27,2,5
9,2001,839200,36,33,3,4
10,2001,839200,42,39,3,1
11,2001,839200,26,21,5,4
12,2001,839200,20,19,1,0
1,2002,839200,23,20,3,2
2,2002,839200,23,20,3,5
3,2002,839200,35,30,5,2
4,2002,839200,43,39,4,1
5,2002,839200,40,35,5,2
6,2002,839200,38,35,3,3
7,2002,839200,55,49,6,3
8,2002,839200,44,41,3,3
9,2002,839200,30,26,4,4
10,2002,839200,32,30,2,0
11,2002,839200,20,20,0,1
12,2002,839200,17,17,0,1
1,2003,839200,24,23,1,4
2,2003,839200,28,27,1,1
3,2003,839200,25,24,1,3
4,2003,839200,22,21,1,5
5,2003,839200,39,35,4,1
6,2003,839200,30,30,0,0
7,2003,839200,21,16,5,1
8,2003,839200,14,13,1,0
9,2003,839200,34,31,3,2
10,2003,839200,29,28,1,2
11,2003,839200,23,20,3,2
12,2003,839200,25,25,0,3
1,2004,839200,22,19,3,0
2,2004,839200,11,11,0,7
3,2004,839200,24,23,1,3
4,2004,839200,18,16,2,1
5,2004,839200,30,28,2,5
6,2004,839200,39,38,1,0
7,2004,839200,51,49,2,0
8,2004,839200,32,31,1,0
9,2004,839200,36,35,1,6
10,2004,839200,47,44,3,2
11,2004,839200,35,35,0,6
12,2004,839200,30,28,2,5
1,2005,839200,33,32,1,2
2,2005,839200,18,18,0,4
3,2005,839200,34,33,1,1
4,2005,839200,28,26,2,6
5,2005,839200,31,28,3,3
6,2005,839200,35,33,2,1
7,2005,839200,27,26,1,0
8,2005,839200,33,29,4,4
9,2005,839200,37,36,1,1
10,2005,839200,41,35,6,5
11,2005,839200,37,36,1,7
12,2005,839200,20,18,2,0
1,2006,839200,38,37,1,1
2,2006,839200,25,24,1,7
3,2006,839200,32,29,3,4
4,2006,839200,42,38,4,2
5,2006,839200,29,28,1,7
6,2006,839200,30,28,2,2
7,2006,839200,36,33,3,3
8,2006,839200,31,29,2,3
9,2006,839200,23,21,2,4
10,2006,839200,41,40,1,8
11,2006,839200,34,32,2,4
12,2006,839200,27,22,5,7
1,2007,839200,26,25,1,1
2,2007,839200,24,20,4,8
3,2007,839200,24,21,3,2
4,2007,839200,21,18,3,5
5,2007,839200,24,22,2,4
6,2007,839200,20,19,1,4
7,2007,839200,16,13,3,1
8,2007,839200,30,25,5,4
9,2007,839200,23,21,2,1
10,2007,839200,28,27,1,6
11,2007,839200,28,28,0,3
12,2007,839200,34,32,2,8
1,2008,839200,21,20,1,5
2,2008,839200,22,19,3,8
3,2008,839200,25,22,3,3
4,2008,839200,28,25,3,5
5,2008,839200,31,29,2,3
6,2008,839200,24,23,1,3
7,2008,839200,24,23,1,4
8,2008,839200,21,20,1,1
9,2008,839200,31,28,3,6
10,2008,839200,26,24,2,9
11,2008,839200,15,14,1,3
12,2008,839200,16,15,1,4
1,2009,839200,26,22,4,8
2,2009,839200,15,14,1,4
3,2009,839200,31,29,2,2
4,2009,839200,14,11,3,7
5,2009,839200,37,35,2,4
6,2009,839200,28,26,2,0
7,2009,839200,17,15,2,2
8,2009,839200,24,23,1,2
9,2009,839200,18,18,0,1
10,2009,839200,37,37,0,2
11,2009,839200,28,26,2,3
12,2009,839200,19,17,2,0
1,2010,839200,29,27,2,2
2,2010,839200,31,30,1,9
3,2010,839200,38,36,2,5
4,2010,839200,15,12,3,1
5,2010,839200,26,26,0,1
6,2010,839200,24,22,2,1
7,2010,839200,8,8,0,1
8,2010,839200,19,16,3,0
9,2010,839200,30,30,0,3
10,2010,839200,31,29,2,0
11,2010,839200,17,16,1,3
12,2010,839200,13,11,2,0
1,2011,839200,19,19,0,1
2,2011,839200,10,10,0,3
1,1999,350100,8,8,0,0
2,1999,350100,7,7,0,0
3,1999,350100,8,8,0,0
4,1999,350100,7,6,1,0
5,1999,350100,6,6,0,0
6,1999,350100,3,3,0,1
7,1999,350100,6,6,0,0
8,1999,350100,6,6,0,0
9,1999,350100,5,5,0,1
10,1999,350100,4,4,0,0
11,1999,350100,3,3,0,0
12,1999,350100,6,6,0,0
1,2000,350100,3,3,0,1
2,2000,350100,4,3,1,1
3,2000,350100,7,7,0,0
4,2000,350100,3,3,0,1
5,2000,350100,2,2,0,0
6,2000,350100,3,3,0,0
7,2000,350100,3,3,0,0
8,2000,350100,1,1,0,0
9,2000,350100,2,1,1,0
10,2000,350100,7,6,1,0
11,2000,350100,1,1,0,3
12,2000,350100,1,1,0,0
1,2001,350100,5,5,0,0
2,2001,350100,2,2,0,1
3,2001,350100,5,5,0,1
4,2001,350100,9,9,0,0
5,2001,350100,4,3,1,0
6,2001,350100,4,4,0,0
7,2001,350100,9,7,2,0
8,2001,350100,7,7,0,0
9,2001,350100,3,3,0,0
10,2001,350100,1,1,0,0
11,2001,350100,2,2,0,0
12,2001,350100,1,0,1,0
1,2002,350100,2,2,0,0
2,2002,350100,2,2,0,0
3,2002,350100,4,4,0,0
4,2002,350100,2,2,0,0
5,2002,350100,2,2,0,0
6,2002,350100,2,1,1,0
7,2002,350100,6,5,1,0
8,2002,350100,5,5,0,0
9,2002,350100,7,7,0,0
10,2002,350100,8,7,1,0
11,2002,350100,0,0,0,0
12,2002,350100,3,3,0,1
1,2003,350100,5,5,0,0
2,2003,350100,2,2,0,0
3,2003,350100,5,5,0,0
4,2003,350100,9,9,0,0
5,2003,350100,3,3,0,2
6,2003,350100,4,4,0,0
7,2003,350100,10,10,0,0
8,2003,350100,2,2,0,0
9,2003,350100,3,3,0,0
10,2003,350100,10,9,1,0
11,2003,350100,5,5,0,0
12,2003,350100,2,2,0,0
1,2004,350100,2,2,0,1
2,2004,350100,2,2,0,0
3,2004,350100,3,2,1,0
4,2004,350100,4,4,0,0
5,2004,350100,3,3,0,0
6,2004,350100,5,5,0,0
7,2004,350100,7,7,0,0
8,2004,350100,1,1,0,0
9,2004,350100,1,1,0,0
10,2004,350100,6,6,0,0
11,2004,350100,5,5,0,0
12,2004,350100,4,3,1,0
1,2005,350100,1,1,0,0
2,2005,350100,4,3,1,0
3,2005,350100,4,3,1,1
4,2005,350100,5,5,0,0
5,2005,350100,3,3,0,0
6,2005,350100,3,3,0,0
7,2005,350100,1,1,0,0
8,2005,350100,3,2,1,0
9,2005,350100,4,3,1,1
10,2005,350100,2,2,0,0
11,2005,350100,6,6,0,0
12,2005,350100,2,2,0,0
1,2006,350100,4,4,0,0
2,2006,350100,2,2,0,1
3,2006,350100,2,2,0,0
4,2006,350100,1,1,0,0
5,2006,350100,1,1,0,0
6,2006,350100,4,4,0,0
7,2006,350100,4,4,0,0
8,2006,350100,6,6,0,0
9,2006,350100,1,0,1,1
10,2006,350100,2,2,0,0
11,2006,350100,3,3,0,0
12,2006,350100,3,3,0,0
1,2007,350100,1,1,0,0
2,2007,350100,3,2,1,0
3,2007,350100,1,1,0,0
4,2007,350100,2,2,0,0
5,2007,350100,1,1,0,0
6,2007,350100,1,1,0,0
7,2007,350100,2,2,0,0
8,2007,350100,3,3,0,1
9,2007,350100,6,4,2,1
10,2007,350100,2,2,0,0
11,2007,350100,5,5,0,0
12,2007,350100,0,0,0,0
1,2008,350100,3,3,0,0
2,2008,350100,0,0,0,0
3,2008,350100,1,1,0,0
4,2008,350100,1,1,0,0
5,2008,350100,0,0,0,0
6,2008,350100,7,6,1,0
7,2008,350100,7,7,0,0
8,2008,350100,1,1,0,0
9,2008,350100,2,2,0,0
10,2008,350100,2,2,0,0
11,2008,350100,2,2,0,0
12,2008,350100,1,1,0,0
1,2009,350100,1,1,0,0
2,2009,350100,0,0,0,0
3,2009,350100,2,2,0,0
4,2009,350100,1,1,0,1
5,2009,350100,6,6,0,2
6,2009,350100,1,1,0,0
7,2009,350100,1,1,0,0
8,2009,350100,1,1,0,0
9,2009,350100,0,0,0,0
10,2009,350100,2,2,0,0
11,2009,350100,4,4,0,1
12,2009,350100,2,2,0,0
1,2010,350100,0,0,0,0
2,2010,350100,0,0,0,0
3,2010,350100,1,1,0,0
4,2010,350100,4,4,0,1
5,2010,350100,1,1,0,0
6,2010,350100,2,2,0,0
7,2010,350100,0,0,0,1
8,2010,350100,0,0,0,0
9,2010,350100,2,2,0,0
10,2010,350100,0,0,0,0
11,2010,350100,2,2,0,0
12,2010,350100,1,1,0,0
1,2011,350100,0,0,0,0
2,2011,350100,0,0,0,0
1,1999,301701,13,9,4,0
2,1999,301701,6,5,1,0
3,1999,301701,13,12,1,1
4,1999,301701,9,7,2,0
5,1999,301701,17,10,7,2
6,1999,301701,15,14,1,4
7,1999,301701,20,15,5,0
8,1999,301701,10,6,4,4
9,1999,301701,11,8,3,1
10,1999,301701,17,11,6,3
11,1999,301701,9,8,1,3
12,1999,301701,6,4,2,0
1,2000,301701,9,9,0,0
2,2000,301701,7,2,5,1
3,2000,301701,12,9,3,1
4,2000,301701,14,10,4,1
5,2000,301701,5,4,1,0
6,2000,301701,10,9,1,4
7,2000,301701,14,11,3,3
8,2000,301701,8,6,2,0
9,2000,301701,13,13,0,4
10,2000,301701,7,6,1,2
11,2000,301701,12,10,2,0
12,2000,301701,15,12,3,2
1,2001,301701,8,7,1,0
2,2001,301701,16,12,4,4
3,2001,301701,14,10,4,1
4,2001,301701,10,6,4,1
5,2001,301701,16,14,2,2
6,2001,301701,7,6,1,0
7,2001,301701,11,8,3,0
8,2001,301701,23,20,3,0
9,2001,301701,20,13,7,1
10,2001,301701,22,20,2,0
11,2001,301701,11,10,1,1
12,2001,301701,20,17,3,0
1,2002,301701,26,24,2,0
2,2002,301701,15,12,3,0
3,2002,301701,10,8,2,1
4,2002,301701,13,7,6,0
5,2002,301701,10,10,0,1
6,2002,301701,12,7,5,0
7,2002,301701,15,8,7,0
8,2002,301701,13,8,5,1
9,2002,301701,14,11,3,1
10,2002,301701,8,6,2,0
11,2002,301701,11,10,1,1
12,2002,301701,8,7,1,1
1,2003,301701,8,6,2,2
2,2003,301701,7,6,1,0
3,2003,301701,9,4,5,0
4,2003,301701,9,8,1,0
5,2003,301701,14,10,4,1
6,2003,301701,6,6,0,3
7,2003,301701,10,8,2,0
8,2003,301701,12,8,4,2
9,2003,301701,11,9,2,1
10,2003,301701,11,8,3,4
11,2003,301701,9,7,2,1
12,2003,301701,9,7,2,0
1,2004,301701,6,6,0,1
2,2004,301701,10,9,1,0
3,2004,301701,2,1,1,0
4,2004,301701,7,6,1,1
5,2004,301701,10,8,2,4
6,2004,301701,9,7,2,5
7,2004,301701,15,14,1,3
8,2004,301701,16,14,2,0
9,2004,301701,12,9,3,0
10,2004,301701,7,6,1,1
11,2004,301701,4,4,0,0
12,2004,301701,8,8,0,1
1,2005,301701,12,10,2,1
2,2005,301701,3,2,1,1
3,2005,301701,6,6,0,1
4,2005,301701,14,9,5,0
5,2005,301701,11,10,1,3
6,2005,301701,10,9,1,0
7,2005,301701,12,10,2,2
8,2005,301701,10,7,3,3
9,2005,301701,7,5,2,4
10,2005,301701,16,15,1,4
11,2005,301701,11,10,1,4
12,2005,301701,11,9,2,0
1,2006,301701,7,7,0,1
2,2006,301701,12,10,2,0
3,2006,301701,5,5,0,1
4,2006,301701,9,6,3,6
5,2006,301701,13,11,2,0
6,2006,301701,6,4,2,3
7,2006,301701,5,5,0,2
8,2006,301701,8,6,2,0
9,2006,301701,12,9,3,0
10,2006,301701,10,9,1,1
11,2006,301701,12,12,0,1
12,2006,301701,15,13,2,3
1,2007,301701,13,12,1,3
2,2007,301701,7,6,1,2
3,2007,301701,6,4,2,0
4,2007,301701,7,5,2,1
5,2007,301701,11,7,4,3
6,2007,301701,8,6,2,8
7,2007,301701,9,5,4,3
8,2007,301701,12,9,3,3
9,2007,301701,6,6,0,3
10,2007,301701,6,6,0,1
11,2007,301701,11,9,2,2
12,2007,301701,8,6,2,0
1,2008,301701,9,8,1,2
2,2008,301701,1,1,0,1
3,2008,301701,7,4,3,2
4,2008,301701,8,7,1,1
5,2008,301701,13,13,0,0
6,2008,301701,10,9,1,1
7,2008,301701,7,6,1,2
8,2008,301701,8,6,2,1
9,2008,301701,8,7,1,0
10,2008,301701,17,15,2,0
11,2008,301701,6,5,1,2
12,2008,301701,9,8,1,1
1,2009,301701,5,4,1,6
2,2009,301701,12,11,1,3
3,2009,301701,11,11,0,2
4,2009,301701,6,6,0,2
5,2009,301701,10,10,0,0
6,2009,301701,11,8,3,1
7,2009,301701,6,4,2,0
8,2009,301701,11,9,2,0
9,2009,301701,10,9,1,2
10,2009,301701,7,6,1,3
11,2009,301701,6,4,2,0
12,2009,301701,8,6,2,0
1,2010,301701,8,8,0,0
2,2010,301701,0,0,0,4
3,2010,301701,7,7,0,0
4,2010,301701,13,11,2,0
5,2010,301701,9,7,2,1
6,2010,301701,13,13,0,1
7,2010,301701,10,8,2,1
8,2010,301701,7,7,0,2
9,2010,301701,7,7,0,0
10,2010,301701,6,6,0,1
11,2010,301701,10,8,2,0
12,2010,301701,10,10,0,0
1,2011,301701,10,10,0,0
2,2011,301701,4,4,0,2
1,1999,301802,16,14,2,3
2,1999,301802,10,9,1,0
3,1999,301802,9,8,1,1
4,1999,301802,22,20,2,3
5,1999,301802,15,13,2,2
6,1999,301802,13,12,1,1
7,1999,301802,17,15,2,1
8,1999,301802,18,14,4,6
9,1999,301802,23,19,4,1
10,1999,301802,20,15,5,5
11,1999,301802,22,14,8,6
12,1999,301802,18,13,5,1
1,2000,301802,18,18,0,5
2,2000,301802,10,10,0,2
3,2000,301802,17,16,1,3
4,2000,301802,19,14,5,3
5,2000,301802,21,20,1,7
6,2000,301802,18,15,3,3
7,2000,301802,26,26,0,3
8,2000,301802,24,20,4,3
9,2000,301802,27,24,3,1
10,2000,301802,20,20,0,3
11,2000,301802,17,14,3,2
12,2000,301802,16,13,3,2
1,2001,301802,18,18,0,1
2,2001,301802,14,12,2,3
3,2001,301802,19,19,0,0
4,2001,301802,22,21,1,4
5,2001,301802,24,19,5,2
6,2001,301802,19,13,6,4
7,2001,301802,18,17,1,2
8,2001,301802,25,20,5,3
9,2001,301802,24,18,6,2
10,2001,301802,15,10,5,3
11,2001,301802,22,19,3,1
12,2001,301802,17,15,2,1
1,2002,301802,22,18,4,2
2,2002,301802,18,18,0,6
3,2002,301802,17,16,1,1
4,2002,301802,21,18,3,9
5,2002,301802,18,13,5,0
6,2002,301802,16,12,4,3
7,2002,301802,21,21,0,0
8,2002,301802,20,15,5,2
9,2002,301802,18,14,4,3
10,2002,301802,22,21,1,3
11,2002,301802,23,19,4,0
12,2002,301802,13,9,4,4
1,2003,301802,16,14,2,0
2,2003,301802,14,13,1,0
3,2003,301802,8,7,1,3
4,2003,301802,10,9,1,3
5,2003,301802,17,17,0,2
6,2003,301802,19,14,5,2
7,2003,301802,15,13,2,1
8,2003,301802,21,18,3,1
9,2003,301802,25,19,6,3
10,2003,301802,9,8,1,1
11,2003,301802,25,19,6,2
12,2003,301802,25,22,3,2
1,2004,301802,16,14,2,3
2,2004,301802,19,15,4,3
3,2004,301802,13,11,2,4
4,2004,301802,19,18,1,8
5,2004,301802,20,15,5,5
6,2004,301802,8,7,1,3
7,2004,301802,13,12,1,2
8,2004,301802,11,10,1,7
9,2004,301802,19,16,3,2
10,2004,301802,12,10,2,3
11,2004,301802,9,7,2,3
12,2004,301802,12,12,0,2
1,2005,301802,12,11,1,1
2,2005,301802,10,8,2,1
3,2005,301802,14,11,3,2
4,2005,301802,17,13,4,1
5,2005,301802,24,19,5,1
6,2005,301802,16,16,0,2
7,2005,301802,14,12,2,1
8,2005,301802,15,11,4,2
9,2005,301802,25,22,3,2
10,2005,301802,21,20,1,3
11,2005,301802,19,16,3,0
12,2005,301802,12,9,3,1
1,2006,301802,13,12,1,1
2,2006,301802,7,5,2,2
3,2006,301802,13,12,1,5
4,2006,301802,12,11,1,6
5,2006,301802,10,10,0,5
6,2006,301802,17,12,5,3
7,2006,301802,16,15,1,5
8,2006,301802,15,13,2,6
9,2006,301802,12,10,2,0
10,2006,301802,8,8,0,6
11,2006,301802,8,6,2,2
12,2006,301802,15,13,2,2
1,2007,301802,25,20,5,0
2,2007,301802,12,9,3,4
3,2007,301802,14,13,1,0
4,2007,301802,13,11,2,6
5,2007,301802,14,14,0,8
6,2007,301802,7,5,2,6
7,2007,301802,16,15,1,3
8,2007,301802,18,13,5,5
9,2007,301802,16,14,2,1
10,2007,301802,13,11,2,1
11,2007,301802,12,11,1,3
12,2007,301802,11,9,2,0
1,2008,301802,16,13,3,7
2,2008,301802,13,12,1,5
3,2008,301802,17,16,1,6
4,2008,301802,15,11,4,4
5,2008,301802,15,14,1,1
6,2008,301802,23,20,3,2
7,2008,301802,20,14,6,4
8,2008,301802,19,16,3,1
9,2008,301802,17,14,3,1
10,2008,301802,19,15,4,2
11,2008,301802,13,10,3,2
12,2008,301802,20,14,6,0
1,2009,301802,9,7,2,1
2,2009,301802,10,8,2,0
3,2009,301802,13,11,2,4
4,2009,301802,15,13,2,3
5,2009,301802,17,15,2,4
6,2009,301802,18,17,1,2
7,2009,301802,11,9,2,4
8,2009,301802,16,11,5,3
9,2009,301802,18,14,4,3
10,2009,301802,14,9,5,4
11,2009,301802,10,10,0,1
12,2009,301802,9,8,1,3
1,2010,301802,17,12,5,2
2,2010,301802,10,9,1,3
3,2010,301802,11,9,2,3
4,2010,301802,15,13,2,2
5,2010,301802,7,7,0,1
6,2010,301802,10,9,1,0
7,2010,301802,11,8,3,2
8,2010,301802,10,9,1,2
9,2010,301802,16,16,0,3
10,2010,301802,18,16,2,0
11,2010,301802,22,21,1,1
12,2010,301802,9,9,0,2
1,2011,301802,15,11,4,3
2,2011,301802,11,10,1,2
1,1999,300500,8,8,0,0
2,1999,300500,8,7,1,0
3,1999,300500,10,9,1,1
4,1999,300500,5,5,0,1
5,1999,300500,3,2,1,1
6,1999,300500,5,4,1,0
7,1999,300500,10,10,0,1
8,1999,300500,8,6,2,2
9,1999,300500,1,1,0,0
10,1999,300500,8,5,3,3
11,1999,300500,6,4,2,2
12,1999,300500,5,5,0,0
1,2000,300500,6,3,3,0
2,2000,300500,1,1,0,0
3,2000,300500,7,6,1,4
4,2000,300500,5,3,2,0
5,2000,300500,4,3,1,0
6,2000,300500,8,8,0,0
7,2000,300500,11,8,3,1
8,2000,300500,9,5,4,0
9,2000,300500,8,7,1,1
10,2000,300500,10,9,1,1
11,2000,300500,11,11,0,1
12,2000,300500,10,9,1,0
1,2001,300500,8,8,0,3
2,2001,300500,6,6,0,1
3,2001,300500,7,6,1,0
4,2001,300500,3,3,0,2
5,2001,300500,15,14,1,1
6,2001,300500,8,7,1,0
7,2001,300500,6,4,2,2
8,2001,300500,14,12,2,0
9,2001,300500,7,5,2,0
10,2001,300500,9,5,4,2
11,2001,300500,11,8,3,0
12,2001,300500,10,9,1,1
1,2002,300500,8,7,1,0
2,2002,300500,9,9,0,0
3,2002,300500,11,10,1,1
4,2002,300500,10,8,2,1
5,2002,300500,14,10,4,0
6,2002,300500,5,4,1,1
7,2002,300500,7,7,0,2
8,2002,300500,11,10,1,4
9,2002,300500,6,5,1,1
10,2002,300500,10,9,1,1
11,2002,300500,5,4,1,0
12,2002,300500,4,2,2,1
1,2003,300500,4,3,1,2
2,2003,300500,6,6,0,2
3,2003,300500,8,6,2,0
4,2003,300500,9,9,0,0
5,2003,300500,5,4,1,2
6,2003,300500,5,4,1,4
7,2003,300500,10,8,2,0
8,2003,300500,9,7,2,0
9,2003,300500,6,4,2,0
10,2003,300500,4,4,0,1
11,2003,300500,10,10,0,1
12,2003,300500,9,8,1,2
1,2004,300500,6,6,0,3
2,2004,300500,9,7,2,0
3,2004,300500,8,6,2,1
4,2004,300500,1,1,0,0
5,2004,300500,7,4,3,3
6,2004,300500,3,3,0,1
7,2004,300500,4,2,2,3
8,2004,300500,15,12,3,0
9,2004,300500,5,4,1,2
10,2004,300500,7,5,2,1
11,2004,300500,6,5,1,2
12,2004,300500,6,5,1,1
1,2005,300500,7,5,2,1
2,2005,300500,9,6,3,1
3,2005,300500,5,5,0,0
4,2005,300500,8,7,1,3
5,2005,300500,7,5,2,0
6,2005,300500,12,9,3,0
7,2005,300500,7,5,2,0
8,2005,300500,8,7,1,1
9,2005,300500,7,5,2,1
10,2005,300500,12,11,1,2
11,2005,300500,9,6,3,4
12,2005,300500,5,5,0,0
1,2006,300500,5,4,1,2
2,2006,300500,2,2,0,0
3,2006,300500,8,6,2,1
4,2006,300500,9,8,1,0
5,2006,300500,6,5,1,1
6,2006,300500,3,2,1,0
7,2006,300500,10,10,0,0
8,2006,300500,6,6,0,1
9,2006,300500,3,2,1,2
10,2006,300500,10,7,3,1
11,2006,300500,2,0,2,1
12,2006,300500,4,3,1,0
1,2007,300500,6,6,0,0
2,2007,300500,3,3,0,3
3,2007,300500,9,6,3,2
4,2007,300500,2,2,0,0
5,2007,300500,5,4,1,4
6,2007,300500,9,6,3,5
7,2007,300500,7,3,4,1
8,2007,300500,7,4,3,1
9,2007,300500,5,4,1,1
10,2007,300500,3,3,0,1
11,2007,300500,4,3,1,1
12,2007,300500,3,3,0,0
1,2008,300500,2,2,0,1
2,2008,300500,3,3,0,1
3,2008,300500,3,3,0,2
4,2008,300500,8,7,1,1
5,2008,300500,6,6,0,0
6,2008,300500,11,6,5,2
7,2008,300500,14,12,2,3
8,2008,300500,8,7,1,0
9,2008,300500,7,7,0,0
10,2008,300500,6,5,1,0
11,2008,300500,5,5,0,0
12,2008,300500,5,5,0,0
1,2009,300500,7,5,2,0
2,2009,300500,3,2,1,0
3,2009,300500,10,9,1,2
4,2009,300500,8,8,0,0
5,2009,300500,6,6,0,1
6,2009,300500,6,5,1,0
7,2009,300500,7,7,0,0
8,2009,300500,7,6,1,0
9,2009,300500,7,6,1,1
10,2009,300500,1,1,0,0
11,2009,300500,2,2,0,2
12,2009,300500,4,3,1,0
1,2010,300500,5,5,0,0
2,2010,300500,7,6,1,0
3,2010,300500,8,7,1,2
4,2010,300500,8,5,3,0
5,2010,300500,12,8,4,1
6,2010,300500,3,2,1,0
7,2010,300500,1,1,0,1
8,2010,300500,6,6,0,1
9,2010,300500,8,5,3,1
10,2010,300500,10,9,1,2
11,2010,300500,8,6,2,0
12,2010,300500,6,6,0,0
1,2011,300500,5,5,0,0
2,2011,300500,6,4,2,0
1,1999,300600,7,7,0,0
2,1999,300600,10,7,3,0
3,1999,300600,12,10,2,1
4,1999,300600,9,7,2,0
5,1999,300600,8,8,0,0
6,1999,300600,11,9,2,1
7,1999,300600,9,8,1,1
8,1999,300600,11,6,5,0
9,1999,300600,15,11,4,1
10,1999,300600,9,8,1,2
11,1999,300600,18,15,3,1
12,1999,300600,7,3,4,0
1,2000,300600,6,5,1,1
2,2000,300600,11,9,2,0
3,2000,300600,12,12,0,1
4,2000,300600,13,13,0,4
5,2000,300600,16,12,4,1
6,2000,300600,20,17,3,0
7,2000,300600,18,16,2,1
8,2000,300600,23,19,4,1
9,2000,300600,12,10,2,3
10,2000,300600,16,14,2,1
11,2000,300600,12,10,2,1
12,2000,300600,17,16,1,0
1,2001,300600,10,6,4,0
2,2001,300600,8,7,1,2
3,2001,300600,18,15,3,5
4,2001,300600,8,6,2,3
5,2001,300600,10,9,1,1
6,2001,300600,13,11,2,4
7,2001,300600,12,10,2,0
8,2001,300600,9,9,0,1
9,2001,300600,11,9,2,2
10,2001,300600,11,9,2,1
11,2001,300600,13,9,4,1
12,2001,300600,17,8,9,1
1,2002,300600,9,8,1,3
2,2002,300600,12,11,1,1
3,2002,300600,11,11,0,0
4,2002,300600,16,15,1,1
5,2002,300600,6,5,1,4
6,2002,300600,11,6,5,1
7,2002,300600,10,8,2,0
8,2002,300600,17,11,6,2
9,2002,300600,19,15,4,0
10,2002,300600,10,9,1,0
11,2002,300600,13,11,2,0
12,2002,300600,5,4,1,0
1,2003,300600,13,10,3,0
2,2003,300600,7,5,2,0
3,2003,300600,8,8,0,0
4,2003,300600,18,17,1,2
5,2003,300600,12,12,0,1
6,2003,300600,16,15,1,0
7,2003,300600,7,6,1,0
8,2003,300600,23,22,1,0
9,2003,300600,10,10,0,0
10,2003,300600,13,11,2,2
11,2003,300600,9,9,0,0
12,2003,300600,4,4,0,0
1,2004,300600,15,14,1,1
2,2004,300600,13,13,0,0
3,2004,300600,15,15,0,1
4,2004,300600,12,11,1,0
5,2004,300600,17,16,1,1
6,2004,300600,4,2,2,2
7,2004,300600,17,16,1,1
8,2004,300600,20,20,0,1
9,2004,300600,11,9,2,4
10,2004,300600,4,2,2,4
11,2004,300600,8,6,2,0
12,2004,300600,8,7,1,1
1,2005,300600,3,3,0,0
2,2005,300600,7,6,1,1
3,2005,300600,4,4,0,2
4,2005,300600,2,2,0,2
5,2005,300600,13,11,2,1
6,2005,300600,15,15,0,2
7,2005,300600,16,15,1,1
8,2005,300600,16,14,2,1
9,2005,300600,8,8,0,3
10,2005,300600,13,10,3,0
11,2005,300600,9,8,1,1
12,2005,300600,9,9,0,3
1,2006,300600,6,5,1,0
2,2006,300600,2,1,1,0
3,2006,300600,12,8,4,0
4,2006,300600,13,7,6,0
5,2006,300600,6,5,1,0
6,2006,300600,6,6,0,1
7,2006,300600,14,13,1,2
8,2006,300600,9,9,0,4
9,2006,300600,4,4,0,1
10,2006,300600,9,7,2,2
11,2006,300600,10,9,1,2
12,2006,300600,5,5,0,0
1,2007,300600,8,7,1,1
2,2007,300600,7,6,1,1
3,2007,300600,6,6,0,1
4,2007,300600,7,5,2,4
5,2007,300600,3,3,0,2
6,2007,300600,4,3,1,2
7,2007,300600,7,5,2,1
8,2007,300600,9,7,2,2
9,2007,300600,8,4,4,3
10,2007,300600,16,13,3,2
11,2007,300600,7,7,0,0
12,2007,300600,9,7,2,0
1,2008,300600,9,8,1,0
2,2008,300600,10,8,2,1
3,2008,300600,8,7,1,5
4,2008,300600,7,6,1,0
5,2008,300600,7,7,0,0
6,2008,300600,9,6,3,3
7,2008,300600,13,11,2,0
8,2008,300600,10,10,0,0
9,2008,300600,6,6,0,1
10,2008,300600,6,5,1,1
11,2008,300600,4,4,0,0
12,2008,300600,3,3,0,0
1,2009,300600,4,4,0,1
2,2009,300600,4,4,0,0
3,2009,300600,1,1,0,2
4,2009,300600,6,6,0,1
5,2009,300600,9,8,1,2
6,2009,300600,12,9,3,0
7,2009,300600,8,6,2,1
8,2009,300600,11,9,2,0
9,2009,300600,6,5,1,2
10,2009,300600,11,9,2,1
11,2009,300600,10,8,2,0
12,2009,300600,6,6,0,0
1,2010,300600,5,4,1,0
2,2010,300600,4,4,0,0
3,2010,300600,11,11,0,1
4,2010,300600,3,3,0,0
5,2010,300600,4,3,1,1
6,2010,300600,9,9,0,1
7,2010,300600,4,4,0,0
8,2010,300600,13,12,1,1
9,2010,300600,8,6,2,1
10,2010,300600,3,3,0,0
11,2010,300600,3,3,0,0
12,2010,300600,9,8,1,0
1,2011,300600,6,6,0,0
2,2011,300600,6,6,0,1
1,1999,300700,13,12,1,11
2,1999,300700,13,12,1,7
3,1999,300700,16,12,4,11
4,1999,300700,18,14,4,9
5,1999,300700,22,18,4,7
6,1999,300700,20,15,5,7
7,1999,300700,15,13,2,8
8,1999,300700,22,15,7,7
9,1999,300700,18,15,3,9
10,1999,300700,17,13,4,14
11,1999,300700,9,8,1,10
12,1999,300700,18,16,2,11
1,2000,300700,25,22,3,7
2,2000,300700,23,21,2,8
3,2000,300700,21,18,3,7
4,2000,300700,20,18,2,5
5,2000,300700,22,17,5,6
6,2000,300700,20,16,4,9
7,2000,300700,20,17,3,7
8,2000,300700,18,17,1,8
9,2000,300700,21,18,3,12
10,2000,300700,13,10,3,7
11,2000,300700,29,24,5,5
12,2000,300700,17,16,1,5
1,2001,300700,13,12,1,14
2,2001,300700,18,18,0,3
3,2001,300700,12,12,0,2
4,2001,300700,13,9,4,3
5,2001,300700,18,16,2,2
6,2001,300700,11,9,2,3
7,2001,300700,11,9,2,2
8,2001,300700,17,14,3,9
9,2001,300700,19,17,2,3
10,2001,300700,17,13,4,2
11,2001,300700,20,13,7,3
12,2001,300700,15,12,3,5
1,2002,300700,21,17,4,4
2,2002,300700,11,10,1,2
3,2002,300700,11,10,1,4
4,2002,300700,19,16,3,5
5,2002,300700,13,9,4,6
6,2002,300700,11,8,3,3
7,2002,300700,19,15,4,2
8,2002,300700,28,24,4,2
9,2002,300700,15,13,2,1
10,2002,300700,16,12,4,1
11,2002,300700,13,12,1,9
12,2002,300700,18,16,2,11
1,2003,300700,18,14,4,4
2,2003,300700,9,6,3,3
3,2003,300700,20,18,2,1
4,2003,300700,9,9,0,3
5,2003,300700,6,5,1,8
6,2003,300700,18,14,4,2
7,2003,300700,26,21,5,4
8,2003,300700,23,21,2,1
9,2003,300700,19,17,2,4
10,2003,300700,19,17,2,9
11,2003,300700,21,18,3,3
12,2003,300700,11,11,0,3
1,2004,300700,11,10,1,4
2,2004,300700,10,8,2,9
3,2004,300700,15,10,5,2
4,2004,300700,10,6,4,4
5,2004,300700,24,22,2,7
6,2004,300700,17,13,4,13
7,2004,300700,20,16,4,7
8,2004,300700,23,21,2,8
9,2004,300700,13,12,1,11
10,2004,300700,11,8,3,9
11,2004,300700,15,10,5,12
12,2004,300700,6,5,1,5
1,2005,300700,12,7,5,4
2,2005,300700,7,6,1,5
3,2005,300700,9,8,1,5
4,2005,300700,8,7,1,5
5,2005,300700,11,9,2,5
6,2005,300700,10,8,2,4
7,2005,300700,19,17,2,6
8,2005,300700,12,11,1,5
9,2005,300700,16,13,3,17
10,2005,300700,14,13,1,2
11,2005,300700,12,11,1,14
12,2005,300700,11,7,4,1
1,2006,300700,10,8,2,1
2,2006,300700,7,6,1,11
3,2006,300700,9,6,3,5
4,2006,300700,16,14,2,6
5,2006,300700,11,9,2,8
6,2006,300700,15,14,1,10
7,2006,300700,12,10,2,0
8,2006,300700,14,13,1,5
9,2006,300700,11,9,2,5
10,2006,300700,11,8,3,10
11,2006,300700,19,14,5,5
12,2006,300700,9,7,2,3
1,2007,300700,26,24,2,11
2,2007,300700,10,9,1,3
3,2007,300700,14,12,2,8
4,2007,300700,13,10,3,10
5,2007,300700,13,9,4,16
6,2007,300700,17,12,5,5
7,2007,300700,19,13,6,14
8,2007,300700,9,7,2,10
9,2007,300700,14,12,2,12
10,2007,300700,19,16,3,9
11,2007,300700,5,4,1,6
12,2007,300700,14,13,1,4
1,2008,300700,17,16,1,4
2,2008,300700,2,1,1,2
3,2008,300700,13,11,2,6
4,2008,300700,9,7,2,4
5,2008,300700,17,15,2,2
6,2008,300700,10,8,2,2
7,2008,300700,13,9,4,3
8,2008,300700,16,15,1,2
9,2008,300700,13,12,1,2
10,2008,300700,15,12,3,5
11,2008,300700,6,4,2,3
12,2008,300700,8,5,3,4
1,2009,300700,6,5,1,3
2,2009,300700,4,4,0,5
3,2009,300700,10,9,1,11
4,2009,300700,9,8,1,8
5,2009,300700,11,10,1,5
6,2009,300700,10,5,5,4
7,2009,300700,11,10,1,5
8,2009,300700,14,12,2,9
9,2009,300700,16,12,4,5
10,2009,300700,12,6,6,2
11,2009,300700,8,6,2,3
12,2009,300700,16,15,1,2
1,2010,300700,10,8,2,6
2,2010,300700,7,5,2,6
3,2010,300700,9,9,0,3
4,2010,300700,11,10,1,12
5,2010,300700,14,11,3,5
6,2010,300700,13,11,2,4
7,2010,300700,19,17,2,8
8,2010,300700,12,12,0,1
9,2010,300700,11,8,3,6
10,2010,300700,15,13,2,2
11,2010,300700,7,5,2,6
12,2010,300700,14,11,3,4
1,2011,300700,16,14,2,1
2,2011,300700,3,3,0,2
1,1999,300800,22,19,3,5
2,1999,300800,16,14,2,7
3,1999,300800,15,13,2,10
4,1999,300800,27,24,3,15
5,1999,300800,21,21,0,6
6,1999,300800,17,12,5,2
7,1999,300800,18,15,3,10
8,1999,300800,18,13,5,2
9,1999,300800,21,19,2,10
10,1999,300800,20,16,4,6
11,1999,300800,12,10,2,11
12,1999,300800,17,16,1,9
1,2000,300800,24,20,4,7
2,2000,300800,13,10,3,14
3,2000,300800,23,22,1,6
4,2000,300800,20,17,3,13
5,2000,300800,18,15,3,7
6,2000,300800,13,11,2,19
7,2000,300800,22,15,7,6
8,2000,300800,18,14,4,8
9,2000,300800,29,21,8,7
10,2000,300800,20,18,2,6
11,2000,300800,20,17,3,12
12,2000,300800,21,19,2,9
1,2001,300800,22,15,7,6
2,2001,300800,20,15,5,5
3,2001,300800,22,18,4,10
4,2001,300800,19,14,5,9
5,2001,300800,16,11,5,8
6,2001,300800,11,9,2,4
7,2001,300800,15,13,2,5
8,2001,300800,17,15,2,8
9,2001,300800,17,14,3,8
10,2001,300800,21,18,3,5
11,2001,300800,22,15,7,4
12,2001,300800,16,13,3,4
1,2002,300800,18,15,3,2
2,2002,300800,17,17,0,2
3,2002,300800,17,10,7,8
4,2002,300800,15,13,2,4
5,2002,300800,13,11,2,8
6,2002,300800,24,17,7,4
7,2002,300800,19,16,3,8
8,2002,300800,20,18,2,3
9,2002,300800,23,21,2,8
10,2002,300800,27,25,2,6
11,2002,300800,14,14,0,4
12,2002,300800,10,7,3,8
1,2003,300800,21,19,2,11
2,2003,300800,13,12,1,14
3,2003,300800,18,14,4,6
4,2003,300800,18,18,0,6
5,2003,300800,28,24,4,9
6,2003,300800,8,5,3,6
7,2003,300800,15,14,1,6
8,2003,300800,14,12,2,2
9,2003,300800,18,18,0,5
10,2003,300800,21,16,5,8
11,2003,300800,10,6,4,5
12,2003,300800,16,15,1,3
1,2004,300800,13,11,2,4
2,2004,300800,17,15,2,11
3,2004,300800,23,21,2,9
4,2004,300800,11,9,2,11
5,2004,300800,13,8,5,14
6,2004,300800,8,6,2,14
7,2004,300800,18,18,0,5
8,2004,300800,22,20,2,5
9,2004,300800,9,8,1,10
10,2004,300800,12,8,4,4
11,2004,300800,15,13,2,10
12,2004,300800,9,9,0,8
1,2005,300800,11,7,4,3
2,2005,300800,12,10,2,13
3,2005,300800,11,9,2,11
4,2005,300800,13,11,2,11
5,2005,300800,11,11,0,5
6,2005,300800,13,8,5,3
7,2005,300800,10,7,3,7
8,2005,300800,10,8,2,3
9,2005,300800,18,14,4,3
10,2005,300800,21,17,4,6
11,2005,300800,13,12,1,4
12,2005,300800,10,9,1,4
1,2006,300800,7,7,0,1
2,2006,300800,17,15,2,5
3,2006,300800,12,10,2,11
4,2006,300800,7,6,1,6
5,2006,300800,16,13,3,4
6,2006,300800,11,11,0,3
7,2006,300800,15,14,1,7
8,2006,300800,13,12,1,3
9,2006,300800,14,12,2,6
10,2006,300800,18,12,6,10
11,2006,300800,17,14,3,3
12,2006,300800,20,17,3,6
1,2007,300800,12,6,6,8
2,2007,300800,9,9,0,6
3,2007,300800,14,14,0,12
4,2007,300800,8,7,1,10
5,2007,300800,9,8,1,7
6,2007,300800,17,14,3,11
7,2007,300800,14,12,2,7
8,2007,300800,14,14,0,6
9,2007,300800,12,9,3,8
10,2007,300800,18,14,4,8
11,2007,300800,12,10,2,10
12,2007,300800,16,16,0,5
1,2008,300800,23,18,5,9
2,2008,300800,12,10,2,8
3,2008,300800,21,20,1,5
4,2008,300800,15,13,2,7
5,2008,300800,11,11,0,8
6,2008,300800,8,7,1,6
7,2008,300800,12,11,1,8
8,2008,300800,15,11,4,7
9,2008,300800,16,14,2,7
10,2008,300800,26,23,3,4
11,2008,300800,9,7,2,3
12,2008,300800,8,6,2,3
1,2009,300800,7,7,0,3
2,2009,300800,15,13,2,0
3,2009,300800,5,4,1,4
4,2009,300800,11,7,4,3
5,2009,300800,14,12,2,2
6,2009,300800,12,8,4,2
7,2009,300800,11,9,2,4
8,2009,300800,12,9,3,9
9,2009,300800,8,4,4,1
10,2009,300800,14,13,1,6
11,2009,300800,15,12,3,2
12,2009,300800,18,15,3,8
1,2010,300800,11,11,0,9
2,2010,300800,7,5,2,3
3,2010,300800,12,11,1,6
4,2010,300800,11,9,2,7
5,2010,300800,19,13,6,3
6,2010,300800,10,8,2,13
7,2010,300800,9,8,1,7
8,2010,300800,7,7,0,7
9,2010,300800,13,11,2,5
10,2010,300800,13,12,1,8
11,2010,300800,13,9,4,6
12,2010,300800,6,5,1,4
1,2011,300800,11,7,4,6
2,2011,300800,2,2,0,1
1,1999,300900,17,14,3,2
2,1999,300900,16,13,3,5
3,1999,300900,19,16,3,1
4,1999,300900,22,20,2,3
5,1999,300900,18,15,3,6
6,1999,300900,15,12,3,3
7,1999,300900,15,11,4,2
8,1999,300900,15,11,4,6
9,1999,300900,18,16,2,2
10,1999,300900,18,16,2,5
11,1999,300900,11,11,0,5
12,1999,300900,18,15,3,1
1,2000,300900,21,12,9,3
2,2000,300900,11,10,1,4
3,2000,300900,21,20,1,8
4,2000,300900,22,21,1,1
5,2000,300900,22,19,3,6
6,2000,300900,22,17,5,3
7,2000,300900,23,18,5,3
8,2000,300900,21,20,1,4
9,2000,300900,22,19,3,2
10,2000,300900,17,14,3,6
11,2000,300900,24,23,1,2
12,2000,300900,13,11,2,2
1,2001,300900,11,9,2,0
2,2001,300900,17,17,0,4
3,2001,300900,15,13,2,2
4,2001,300900,26,24,2,2
5,2001,300900,14,12,2,5
6,2001,300900,18,13,5,1
7,2001,300900,23,19,4,2
8,2001,300900,24,23,1,0
9,2001,300900,21,15,6,4
10,2001,300900,21,15,6,2
11,2001,300900,19,15,4,1
12,2001,300900,21,21,0,0
1,2002,300900,13,10,3,0
2,2002,300900,14,11,3,0
3,2002,300900,15,11,4,1
4,2002,300900,20,17,3,1
5,2002,300900,20,17,3,0
6,2002,300900,19,15,4,0
7,2002,300900,23,20,3,0
8,2002,300900,25,23,2,4
9,2002,300900,25,22,3,0
10,2002,300900,16,15,1,0
11,2002,300900,23,20,3,2
12,2002,300900,13,13,0,6
1,2003,300900,14,14,0,4
2,2003,300900,12,10,2,4
3,2003,300900,19,19,0,1
4,2003,300900,17,17,0,4
5,2003,300900,21,20,1,2
6,2003,300900,16,13,3,7
7,2003,300900,29,28,1,4
8,2003,300900,25,23,2,5
9,2003,300900,14,12,2,2
10,2003,300900,21,21,0,1
11,2003,300900,17,14,3,0
12,2003,300900,13,13,0,3
1,2004,300900,10,10,0,0
2,2004,300900,16,14,2,4
3,2004,300900,19,18,1,2
4,2004,300900,14,11,3,3
5,2004,300900,9,9,0,4
6,2004,300900,18,11,7,5
7,2004,300900,21,20,1,3
8,2004,300900,18,15,3,4
9,2004,300900,24,21,3,6
10,2004,300900,8,8,0,3
11,2004,300900,13,11,2,8
12,2004,300900,13,12,1,4
1,2005,300900,18,16,2,2
2,2005,300900,10,9,1,4
3,2005,300900,7,4,3,8
4,2005,300900,7,5,2,2
5,2005,300900,20,19,1,2
6,2005,300900,21,18,3,0
7,2005,300900,17,15,2,0
8,2005,300900,16,14,2,2
9,2005,300900,13,8,5,2
10,2005,300900,16,12,4,3
11,2005,300900,21,19,2,4
12,2005,300900,12,9,3,3
1,2006,300900,14,14,0,1
2,2006,300900,10,8,2,3
3,2006,300900,10,9,1,4
4,2006,300900,10,8,2,2
5,2006,300900,11,11,0,1
6,2006,300900,8,8,0,1
7,2006,300900,18,13,5,3
8,2006,300900,13,11,2,3
9,2006,300900,10,9,1,5
10,2006,300900,20,17,3,4
11,2006,300900,7,5,2,9
12,2006,300900,15,14,1,3
1,2007,300900,15,14,1,4
2,2007,300900,14,11,3,4
3,2007,300900,9,7,2,1
4,2007,300900,9,8,1,4
5,2007,300900,10,10,0,5
6,2007,300900,15,9,6,7
7,2007,300900,20,19,1,8
8,2007,300900,8,7,1,6
9,2007,300900,6,6,0,4
10,2007,300900,13,12,1,6
11,2007,300900,8,7,1,7
12,2007,300900,19,17,2,8
1,2008,300900,14,11,3,7
2,2008,300900,7,7,0,10
3,2008,300900,17,16,1,7
4,2008,300900,17,15,2,6
5,2008,300900,13,11,2,6
6,2008,300900,11,10,1,2
7,2008,300900,17,16,1,1
8,2008,300900,16,14,2,2
9,2008,300900,7,3,4,3
10,2008,300900,12,11,1,3
11,2008,300900,9,9,0,4
12,2008,300900,8,7,1,1
1,2009,300900,14,9,5,2
2,2009,300900,12,10,2,4
3,2009,300900,3,2,1,5
4,2009,300900,8,7,1,1
5,2009,300900,9,7,2,0
6,2009,300900,11,9,2,2
7,2009,300900,12,8,4,3
8,2009,300900,9,8,1,1
9,2009,300900,16,12,4,0
10,2009,300900,10,8,2,3
11,2009,300900,15,14,1,3
12,2009,300900,15,14,1,6
1,2010,300900,15,15,0,9
2,2010,300900,16,15,1,0
3,2010,300900,10,7,3,4
4,2010,300900,10,8,2,2
5,2010,300900,13,11,2,4
6,2010,300900,12,11,1,3
7,2010,300900,10,8,2,6
8,2010,300900,10,9,1,4
9,2010,300900,9,6,3,3
10,2010,300900,14,14,0,5
11,2010,300900,11,8,3,5
12,2010,300900,11,8,3,4
1,2011,300900,5,5,0,2
2,2011,300900,11,8,3,3
1,1999,301100,15,13,2,1
2,1999,301100,19,17,2,3
3,1999,301100,11,9,2,1
4,1999,301100,15,14,1,6
5,1999,301100,11,10,1,4
6,1999,301100,9,6,3,3
7,1999,301100,16,12,4,1
8,1999,301100,6,4,2,2
9,1999,301100,12,11,1,0
10,1999,301100,9,7,2,3
11,1999,301100,13,13,0,5
12,1999,301100,16,16,0,3
1,2000,301100,11,8,3,0
2,2000,301100,8,6,2,0
3,2000,301100,16,13,3,1
4,2000,301100,18,14,4,1
5,2000,301100,11,9,2,3
6,2000,301100,8,7,1,2
7,2000,301100,15,11,4,3
8,2000,301100,8,7,1,1
9,2000,301100,10,7,3,1
10,2000,301100,12,11,1,4
11,2000,301100,10,9,1,0
12,2000,301100,9,7,2,1
1,2001,301100,8,6,2,2
2,2001,301100,10,9,1,3
3,2001,301100,9,7,2,3
4,2001,301100,6,4,2,3
5,2001,301100,13,12,1,2
6,2001,301100,10,7,3,2
7,2001,301100,8,8,0,4
8,2001,301100,16,11,5,3
9,2001,301100,9,7,2,2
10,2001,301100,20,15,5,5
11,2001,301100,9,7,2,1
12,2001,301100,11,10,1,0
1,2002,301100,3,3,0,1
2,2002,301100,6,5,1,2
3,2002,301100,8,5,3,1
4,2002,301100,7,4,3,2
5,2002,301100,16,13,3,1
6,2002,301100,15,13,2,2
7,2002,301100,10,8,2,1
8,2002,301100,13,10,3,4
9,2002,301100,8,7,1,1
10,2002,301100,9,8,1,1
11,2002,301100,6,6,0,0
12,2002,301100,7,5,2,1
1,2003,301100,3,3,0,0
2,2003,301100,3,1,2,0
3,2003,301100,10,7,3,2
4,2003,301100,11,10,1,1
5,2003,301100,9,9,0,2
6,2003,301100,8,5,3,1
7,2003,301100,13,12,1,2
8,2003,301100,14,12,2,1
9,2003,301100,8,7,1,1
10,2003,301100,12,11,1,0
11,2003,301100,5,4,1,3
12,2003,301100,12,9,3,3
1,2004,301100,8,6,2,0
2,2004,301100,7,7,0,5
3,2004,301100,8,6,2,1
4,2004,301100,8,5,3,3
5,2004,301100,13,11,2,3
6,2004,301100,11,10,1,5
7,2004,301100,15,12,3,3
8,2004,301100,22,22,0,0
9,2004,301100,13,10,3,1
10,2004,301100,8,8,0,0
11,2004,301100,10,7,3,4
12,2004,301100,12,10,2,0
1,2005,301100,8,7,1,1
2,2005,301100,3,3,0,1
3,2005,301100,11,9,2,3
4,2005,301100,8,5,3,6
5,2005,301100,8,7,1,7
6,2005,301100,8,6,2,3
7,2005,301100,10,9,1,1
8,2005,301100,6,5,1,2
9,2005,301100,8,8,0,1
10,2005,301100,15,9,6,2
11,2005,301100,2,1,1,0
12,2005,301100,8,7,1,0
1,2006,301100,9,8,1,3
2,2006,301100,3,2,1,5
3,2006,301100,5,4,1,2
4,2006,301100,10,9,1,2
5,2006,301100,7,7,0,2
6,2006,301100,7,7,0,2
7,2006,301100,9,6,3,4
8,2006,301100,6,4,2,3
9,2006,301100,6,4,2,5
10,2006,301100,6,5,1,5
11,2006,301100,5,3,2,3
12,2006,301100,5,5,0,0
1,2007,301100,5,3,2,2
2,2007,301100,5,5,0,1
3,2007,301100,13,11,2,7
4,2007,301100,8,7,1,2
5,2007,301100,7,5,2,4
6,2007,301100,4,3,1,9
7,2007,301100,6,6,0,0
8,2007,301100,4,4,0,4
9,2007,301100,9,8,1,1
10,2007,301100,12,11,1,2
11,2007,301100,7,6,1,1
12,2007,301100,8,7,1,0
1,2008,301100,4,4,0,4
2,2008,301100,6,5,1,3
3,2008,301100,2,2,0,5
4,2008,301100,5,4,1,6
5,2008,301100,4,4,0,1
6,2008,301100,3,2,1,2
7,2008,301100,8,5,3,2
8,2008,301100,8,6,2,4
9,2008,301100,7,6,1,4
10,2008,301100,8,6,2,1
11,2008,301100,5,1,4,3
12,2008,301100,3,2,1,1
1,2009,301100,4,3,1,2
2,2009,301100,4,2,2,1
3,2009,301100,4,4,0,2
4,2009,301100,4,3,1,1
5,2009,301100,9,6,3,0
6,2009,301100,3,3,0,2
7,2009,301100,7,4,3,3
8,2009,301100,7,6,1,0
9,2009,301100,9,9,0,3
10,2009,301100,3,2,1,2
11,2009,301100,4,4,0,2
12,2009,301100,8,8,0,0
1,2010,301100,5,5,0,3
2,2010,301100,4,3,1,2
3,2010,301100,9,8,1,0
4,2010,301100,3,3,0,3
5,2010,301100,8,6,2,5
6,2010,301100,6,6,0,0
7,2010,301100,6,5,1,0
8,2010,301100,2,2,0,3
9,2010,301100,4,3,1,9
10,2010,301100,5,1,4,2
11,2010,301100,5,2,3,3
12,2010,301100,3,2,1,0
1,2011,301100,4,2,2,1
2,2011,301100,7,6,1,0
1,1999,301200,11,8,3,3
2,1999,301200,21,17,4,0
3,1999,301200,13,11,2,4
4,1999,301200,13,10,3,4
5,1999,301200,24,20,4,3
6,1999,301200,15,11,4,4
7,1999,301200,24,19,5,0
8,1999,301200,15,14,1,5
9,1999,301200,26,23,3,3
10,1999,301200,23,20,3,5
11,1999,301200,17,15,2,5
12,1999,301200,16,14,2,2
1,2000,301200,16,15,1,3
2,2000,301200,17,11,6,1
3,2000,301200,10,8,2,1
4,2000,301200,16,13,3,3
5,2000,301200,18,13,5,1
6,2000,301200,7,4,3,2
7,2000,301200,16,9,7,2
8,2000,301200,16,13,3,8
9,2000,301200,23,17,6,3
10,2000,301200,12,11,1,2
11,2000,301200,10,8,2,5
12,2000,301200,15,10,5,2
1,2001,301200,16,14,2,2
2,2001,301200,14,10,4,3
3,2001,301200,9,5,4,4
4,2001,301200,11,9,2,3
5,2001,301200,23,19,4,1
6,2001,301200,14,11,3,1
7,2001,301200,11,10,1,0
8,2001,301200,32,29,3,4
9,2001,301200,22,20,2,1
10,2001,301200,13,12,1,2
11,2001,301200,15,12,3,2
12,2001,301200,21,21,0,3
1,2002,301200,22,18,4,1
2,2002,301200,15,14,1,2
3,2002,301200,11,8,3,3
4,2002,301200,18,12,6,0
5,2002,301200,19,16,3,4
6,2002,301200,21,19,2,3
7,2002,301200,19,13,6,4
8,2002,301200,25,22,3,2
9,2002,301200,32,30,2,4
10,2002,301200,18,16,2,1
11,2002,301200,14,13,1,1
12,2002,301200,13,10,3,5
1,2003,301200,15,14,1,2
2,2003,301200,7,5,2,2
3,2003,301200,12,12,0,1
4,2003,301200,17,16,1,0
5,2003,301200,12,11,1,1
6,2003,301200,17,12,5,2
7,2003,301200,28,23,5,7
8,2003,301200,17,15,2,5
9,2003,301200,20,16,4,3
10,2003,301200,28,17,11,3
11,2003,301200,16,14,2,1
12,2003,301200,14,11,3,1
1,2004,301200,10,7,3,1
2,2004,301200,14,13,1,3
3,2004,301200,15,11,4,1
4,2004,301200,12,9,3,3
5,2004,301200,7,5,2,6
6,2004,301200,12,10,2,5
7,2004,301200,25,21,4,0
8,2004,301200,12,10,2,7
9,2004,301200,21,20,1,1
10,2004,301200,22,18,4,5
11,2004,301200,13,13,0,9
12,2004,301200,15,12,3,5
1,2005,301200,13,11,2,3
2,2005,301200,18,10,8,5
3,2005,301200,11,9,2,3
4,2005,301200,21,12,9,4
5,2005,301200,15,9,6,6
6,2005,301200,22,13,9,3
7,2005,301200,25,21,4,0
8,2005,301200,20,19,1,4
9,2005,301200,21,16,5,3
10,2005,301200,15,12,3,2
11,2005,301200,22,20,2,9
12,2005,301200,13,11,2,0
1,2006,301200,24,20,4,2
2,2006,301200,6,5,1,7
3,2006,301200,11,8,3,3
4,2006,301200,12,10,2,2
5,2006,301200,10,8,2,4
6,2006,301200,18,15,3,1
7,2006,301200,12,10,2,4
8,2006,301200,14,12,2,9
9,2006,301200,9,5,4,1
10,2006,301200,15,10,5,8
11,2006,301200,9,9,0,11
12,2006,301200,18,14,4,4
1,2007,301200,16,14,2,3
2,2007,301200,7,5,2,3
3,2007,301200,13,10,3,3
4,2007,301200,13,10,3,2
5,2007,301200,15,12,3,4
6,2007,301200,17,14,3,1
7,2007,301200,17,15,2,3
8,2007,301200,18,14,4,4
9,2007,301200,15,9,6,1
10,2007,301200,18,13,5,5
11,2007,301200,13,12,1,5
12,2007,301200,9,7,2,4
1,2008,301200,10,7,3,6
2,2008,301200,5,5,0,2
3,2008,301200,19,16,3,2
4,2008,301200,13,13,0,3
5,2008,301200,8,6,2,5
6,2008,301200,10,8,2,3
7,2008,301200,10,7,3,1
8,2008,301200,17,12,5,2
9,2008,301200,15,13,2,7
10,2008,301200,10,9,1,2
11,2008,301200,17,13,4,2
12,2008,301200,9,8,1,5
1,2009,301200,4,4,0,2
2,2009,301200,11,10,1,1
3,2009,301200,5,3,2,1
4,2009,301200,12,8,4,6
5,2009,301200,8,6,2,3
6,2009,301200,9,7,2,1
7,2009,301200,3,2,1,2
8,2009,301200,5,5,0,0
9,2009,301200,10,7,3,0
10,2009,301200,10,6,4,1
11,2009,301200,11,10,1,2
12,2009,301200,6,6,0,1
1,2010,301200,4,4,0,6
2,2010,301200,7,5,2,2
3,2010,301200,8,6,2,2
4,2010,301200,8,7,1,1
5,2010,301200,10,6,4,1
6,2010,301200,7,6,1,4
7,2010,301200,9,8,1,1
8,2010,301200,16,12,4,2
9,2010,301200,12,9,3,0
10,2010,301200,17,13,4,5
11,2010,301200,10,9,1,2
12,2010,301200,12,11,1,1
1,2011,301200,13,13,0,2
2,2011,301200,3,2,1,2
1,1999,841000,58,44,14,8
2,1999,841000,53,41,12,16
3,1999,841000,50,41,9,17
4,1999,841000,59,50,9,29
5,1999,841000,59,42,17,17
6,1999,841000,58,41,17,18
7,1999,841000,52,42,10,15
8,1999,841000,78,62,16,18
9,1999,841000,88,71,17,7
10,1999,841000,37,30,7,50
11,1999,841000,44,41,3,28
12,1999,841000,40,35,5,26
1,2000,841000,45,37,8,21
2,2000,841000,43,37,6,35
3,2000,841000,38,33,5,28
4,2000,841000,45,35,10,32
5,2000,841000,56,47,9,12
6,2000,841000,45,39,6,14
7,2000,841000,49,39,10,11
8,2000,841000,61,40,21,25
9,2000,841000,60,49,11,22
10,2000,841000,68,59,9,27
11,2000,841000,59,46,13,21
12,2000,841000,31,28,3,24
1,2001,841000,51,43,8,47
2,2001,841000,30,25,5,28
3,2001,841000,27,22,5,47
4,2001,841000,44,38,6,33
5,2001,841000,48,39,9,34
6,2001,841000,50,34,16,39
7,2001,841000,66,51,15,29
8,2001,841000,57,39,18,23
9,2001,841000,57,48,9,31
10,2001,841000,48,42,6,18
11,2001,841000,55,45,10,12
12,2001,841000,37,30,7,31
1,2002,841000,45,36,9,36
2,2002,841000,36,30,6,87
3,2002,841000,36,29,7,32
4,2002,841000,29,25,4,49
5,2002,841000,37,32,5,21
6,2002,841000,38,30,8,11
7,2002,841000,40,29,11,12
8,2002,841000,47,39,8,24
9,2002,841000,44,35,9,19
10,2002,841000,44,32,12,29
11,2002,841000,39,31,8,17
12,2002,841000,41,37,4,23
1,2003,841000,36,29,7,16
2,2003,841000,34,29,5,29
3,2003,841000,33,29,4,28
4,2003,841000,26,20,6,15
5,2003,841000,44,33,11,23
6,2003,841000,44,32,12,29
7,2003,841000,38,34,4,9
8,2003,841000,49,43,6,11
9,2003,841000,34,30,4,20
10,2003,841000,48,36,12,11
11,2003,841000,29,27,2,15
12,2003,841000,48,41,7,11
1,2004,841000,39,31,8,19
2,2004,841000,21,15,6,21
3,2004,841000,33,28,5,18
4,2004,841000,41,31,10,19
5,2004,841000,23,17,6,29
6,2004,841000,53,44,9,12
7,2004,841000,63,56,7,10
8,2004,841000,53,44,9,12
9,2004,841000,44,34,10,19
10,2004,841000,51,45,6,29
11,2004,841000,25,22,3,40
12,2004,841000,16,12,4,40
1,2005,841000,38,32,6,41
2,2005,841000,26,19,7,37
3,2005,841000,31,23,8,34
4,2005,841000,44,34,10,32
5,2005,841000,24,17,7,34
6,2005,841000,44,37,7,37
7,2005,841000,32,26,6,34
8,2005,841000,44,34,10,36
9,2005,841000,41,34,7,46
10,2005,841000,39,35,4,53
11,2005,841000,41,38,3,29
12,2005,841000,25,19,6,28
1,2006,841000,18,13,5,39
2,2006,841000,28,20,8,30
3,2006,841000,33,26,7,46
4,2006,841000,40,32,8,49
5,2006,841000,36,31,5,45
6,2006,841000,55,41,14,53
7,2006,841000,42,36,6,72
8,2006,841000,42,35,7,59
9,2006,841000,42,37,5,30
10,2006,841000,47,42,5,74
11,2006,841000,37,34,3,75
12,2006,841000,49,44,5,47
1,2007,841000,21,19,2,57
2,2007,841000,17,15,2,38
3,2007,841000,36,30,6,39
4,2007,841000,16,14,2,36
5,2007,841000,30,28,2,24
6,2007,841000,23,23,0,16
7,2007,841000,25,20,5,7
8,2007,841000,21,17,4,23
9,2007,841000,26,25,1,16
10,2007,841000,28,23,5,9
11,2007,841000,26,22,4,29
12,2007,841000,26,25,1,12
1,2008,841000,26,23,3,30
2,2008,841000,21,19,2,27
3,2008,841000,27,21,6,74
4,2008,841000,26,18,8,64
5,2008,841000,28,24,4,59
6,2008,841000,24,18,6,41
7,2008,841000,37,31,6,48
8,2008,841000,24,21,3,37
9,2008,841000,24,22,2,26
10,2008,841000,30,24,6,50
11,2008,841000,26,24,2,47
12,2008,841000,24,22,2,32
1,2009,841000,12,9,3,25
2,2009,841000,15,12,3,13
3,2009,841000,20,17,3,9
4,2009,841000,18,16,2,9
5,2009,841000,12,9,3,8
6,2009,841000,11,11,0,4
7,2009,841000,13,13,0,12
8,2009,841000,12,10,2,11
9,2009,841000,10,9,1,18
10,2009,841000,24,23,1,3
11,2009,841000,19,17,2,4
12,2009,841000,8,7,1,3
1,2010,841000,14,12,2,4
2,2010,841000,16,15,1,1
3,2010,841000,24,23,1,4
4,2010,841000,11,11,0,3
5,2010,841000,14,14,0,3
6,2010,841000,15,15,0,0
7,2010,841000,8,8,0,3
8,2010,841000,21,19,2,5
9,2010,841000,10,10,0,0
10,2010,841000,19,17,2,1
11,2010,841000,14,14,0,2
12,2010,841000,8,7,1,2
1,2011,841000,10,9,1,0
2,2011,841000,6,6,0,0
1,1999,841100,28,28,0,1
2,1999,841100,29,28,1,3
3,1999,841100,40,39,1,1
4,1999,841100,29,28,1,0
5,1999,841100,47,46,1,1
6,1999,841100,47,45,2,1
7,1999,841100,73,70,3,1
8,1999,841100,63,62,1,5
9,1999,841100,35,35,0,0
10,1999,841100,48,47,1,2
11,1999,841100,44,40,4,3
12,1999,841100,46,44,2,0
1,2000,841100,54,53,1,0
2,2000,841100,22,21,1,0
3,2000,841100,27,25,2,0
4,2000,841100,30,30,0,1
5,2000,841100,36,36,0,5
6,2000,841100,25,23,2,1
7,2000,841100,37,34,3,2
8,2000,841100,36,35,1,1
9,2000,841100,25,25,0,3
10,2000,841100,40,38,2,4
11,2000,841100,37,36,1,4
12,2000,841100,41,40,1,1
1,2001,841100,34,32,2,3
2,2001,841100,31,29,2,0
3,2001,841100,43,42,1,2
4,2001,841100,40,38,2,0
5,2001,841100,38,38,0,1
6,2001,841100,62,60,2,2
7,2001,841100,66,65,1,1
8,2001,841100,59,56,3,3
9,2001,841100,59,59,0,2
10,2001,841100,33,29,4,1
11,2001,841100,39,36,3,0
12,2001,841100,40,39,1,0
1,2002,841100,41,41,0,1
2,2002,841100,32,30,2,5
3,2002,841100,31,30,1,0
4,2002,841100,23,23,0,0
5,2002,841100,36,33,3,1
6,2002,841100,29,25,4,0
7,2002,841100,34,31,3,0
8,2002,841100,51,49,2,1
9,2002,841100,27,25,2,0
10,2002,841100,29,25,4,1
11,2002,841100,26,25,1,2
12,2002,841100,22,22,0,0
1,2003,841100,19,19,0,3
2,2003,841100,35,35,0,0
3,2003,841100,40,40,0,0
4,2003,841100,46,45,1,2
5,2003,841100,51,48,3,0
6,2003,841100,20,15,5,0
7,2003,841100,42,40,2,1
8,2003,841100,27,26,1,0
9,2003,841100,32,28,4,0
10,2003,841100,31,26,5,0
11,2003,841100,33,32,1,1
12,2003,841100,34,33,1,0
1,2004,841100,29,28,1,3
2,2004,841100,26,24,2,0
3,2004,841100,34,33,1,0
4,2004,841100,39,39,0,0
5,2004,841100,33,32,1,0
6,2004,841100,34,31,3,1
7,2004,841100,54,52,2,5
8,2004,841100,50,45,5,3
9,2004,841100,36,32,4,3
10,2004,841100,32,32,0,2
11,2004,841100,20,20,0,0
12,2004,841100,38,35,3,0
1,2005,841100,30,30,0,0
2,2005,841100,30,29,1,0
3,2005,841100,37,36,1,0
4,2005,841100,29,28,1,2
5,2005,841100,29,28,1,0
6,2005,841100,29,29,0,1
7,2005,841100,33,29,4,0
8,2005,841100,46,42,4,2
9,2005,841100,40,37,3,1
10,2005,841100,30,30,0,1
11,2005,841100,30,27,3,2
12,2005,841100,30,30,0,0
1,2006,841100,31,30,1,0
2,2006,841100,23,23,0,2
3,2006,841100,39,37,2,2
4,2006,841100,29,27,2,1
5,2006,841100,27,24,3,3
6,2006,841100,29,29,0,2
7,2006,841100,36,34,2,5
8,2006,841100,29,28,1,1
9,2006,841100,23,22,1,2
10,2006,841100,31,29,2,2
11,2006,841100,30,29,1,0
12,2006,841100,26,24,2,1
1,2007,841100,20,18,2,3
2,2007,841100,11,10,1,1
3,2007,841100,20,17,3,0
4,2007,841100,18,16,2,0
5,2007,841100,21,20,1,8
6,2007,841100,25,24,1,4
7,2007,841100,26,25,1,8
8,2007,841100,23,22,1,4
9,2007,841100,18,15,3,2
10,2007,841100,28,25,3,3
11,2007,841100,28,27,1,4
12,2007,841100,25,24,1,0
1,2008,841100,23,23,0,2
2,2008,841100,31,30,1,1
3,2008,841100,19,19,0,2
4,2008,841100,25,25,0,1
5,2008,841100,21,19,2,2
6,2008,841100,34,32,2,2
7,2008,841100,35,35,0,2
8,2008,841100,28,26,2,3
9,2008,841100,27,27,0,2
10,2008,841100,30,29,1,2
11,2008,841100,19,19,0,5
12,2008,841100,30,29,1,1
1,2009,841100,29,28,1,1
2,2009,841100,26,23,3,1
3,2009,841100,19,17,2,0
4,2009,841100,25,25,0,1
5,2009,841100,19,17,2,0
6,2009,841100,28,28,0,0
7,2009,841100,23,22,1,1
8,2009,841100,28,26,2,5
9,2009,841100,35,35,0,2
10,2009,841100,34,34,0,4
11,2009,841100,28,27,1,12
12,2009,841100,26,25,1,1
1,2010,841100,30,27,3,1
2,2010,841100,43,42,1,0
3,2010,841100,34,34,0,0
4,2010,841100,21,20,1,2
5,2010,841100,26,26,0,0
6,2010,841100,29,28,1,2
7,2010,841100,28,26,2,2
8,2010,841100,21,20,1,1
9,2010,841100,31,25,6,3
10,2010,841100,18,17,1,2
11,2010,841100,24,23,1,1
12,2010,841100,21,21,0,8
1,2011,841100,19,19,0,3
2,2011,841100,12,11,1,0
1,1999,843400,7,6,1,1
2,1999,843400,3,2,1,1
3,1999,843400,11,8,3,0
4,1999,843400,12,10,2,0
5,1999,843400,9,6,3,1
6,1999,843400,7,7,0,0
7,1999,843400,8,8,0,1
8,1999,843400,19,17,2,3
9,1999,843400,11,9,2,4
10,1999,843400,6,5,1,2
11,1999,843400,9,9,0,0
12,1999,843400,11,10,1,3
1,2000,843400,7,5,2,0
2,2000,843400,5,5,0,0
3,2000,843400,7,6,1,1
4,2000,843400,10,9,1,1
5,2000,843400,7,5,2,2
6,2000,843400,4,4,0,0
7,2000,843400,12,9,3,0
8,2000,843400,12,12,0,0
9,2000,843400,8,7,1,1
10,2000,843400,10,10,0,1
11,2000,843400,14,14,0,0
12,2000,843400,10,8,2,0
1,2001,843400,12,11,1,1
2,2001,843400,11,9,2,0
3,2001,843400,10,7,3,1
4,2001,843400,4,4,0,0
5,2001,843400,7,6,1,0
6,2001,843400,12,9,3,2
7,2001,843400,7,7,0,1
8,2001,843400,4,4,0,1
9,2001,843400,10,10,0,0
10,2001,843400,17,17,0,0
11,2001,843400,13,11,2,1
12,2001,843400,18,16,2,0
1,2002,843400,10,7,3,0
2,2002,843400,13,12,1,0
3,2002,843400,9,9,0,0
4,2002,843400,6,5,1,2
5,2002,843400,10,9,1,0
6,2002,843400,10,6,4,0
7,2002,843400,9,6,3,1
8,2002,843400,18,12,6,1
9,2002,843400,8,7,1,2
10,2002,843400,13,12,1,0
11,2002,843400,10,9,1,0
12,2002,843400,9,9,0,4
1,2003,843400,11,9,2,1
2,2003,843400,5,5,0,3
3,2003,843400,7,7,0,0
4,2003,843400,6,5,1,0
5,2003,843400,10,9,1,1
6,2003,843400,9,7,2,1
7,2003,843400,11,10,1,0
8,2003,843400,13,10,3,0
9,2003,843400,9,8,1,0
10,2003,843400,9,9,0,1
11,2003,843400,17,11,6,0
12,2003,843400,8,7,1,1
1,2004,843400,7,6,1,2
2,2004,843400,8,7,1,1
3,2004,843400,6,6,0,2
4,2004,843400,5,4,1,1
5,2004,843400,4,4,0,2
6,2004,843400,7,6,1,3
7,2004,843400,10,9,1,3
8,2004,843400,11,10,1,6
9,2004,843400,15,13,2,2
10,2004,843400,9,8,1,5
11,2004,843400,10,9,1,2
12,2004,843400,6,4,2,1
1,2005,843400,4,4,0,2
2,2005,843400,6,4,2,2
3,2005,843400,8,7,1,1
4,2005,843400,12,9,3,0
5,2005,843400,15,12,3,2
6,2005,843400,12,9,3,0
7,2005,843400,15,12,3,3
8,2005,843400,8,6,2,3
9,2005,843400,8,7,1,1
10,2005,843400,7,6,1,3
11,2005,843400,7,7,0,1
12,2005,843400,3,3,0,0
1,2006,843400,12,11,1,1
2,2006,843400,4,4,0,1
3,2006,843400,8,7,1,1
4,2006,843400,6,5,1,1
5,2006,843400,12,11,1,2
6,2006,843400,6,6,0,1
7,2006,843400,7,7,0,2
8,2006,843400,7,7,0,2
9,2006,843400,9,8,1,2
10,2006,843400,7,7,0,1
11,2006,843400,7,6,1,3
12,2006,843400,6,6,0,1
1,2007,843400,8,7,1,3
2,2007,843400,8,7,1,2
3,2007,843400,9,8,1,1
4,2007,843400,6,4,2,7
5,2007,843400,10,8,2,4
6,2007,843400,12,9,3,2
7,2007,843400,8,6,2,3
8,2007,843400,10,8,2,2
9,2007,843400,6,6,0,1
10,2007,843400,4,3,1,0
11,2007,843400,4,4,0,0
12,2007,843400,4,3,1,0
1,2008,843400,3,3,0,4
2,2008,843400,5,4,1,1
3,2008,843400,7,4,3,3
4,2008,843400,8,4,4,0
5,2008,843400,9,7,2,2
6,2008,843400,11,10,1,2
7,2008,843400,8,6,2,1
8,2008,843400,8,8,0,1
9,2008,843400,9,9,0,3
10,2008,843400,7,6,1,2
11,2008,843400,11,9,2,4
12,2008,843400,7,3,4,4
1,2009,843400,9,8,1,1
2,2009,843400,2,1,1,3
3,2009,843400,5,5,0,4
4,2009,843400,8,5,3,2
5,2009,843400,11,9,2,3
6,2009,843400,12,10,2,2
7,2009,843400,10,10,0,3
8,2009,843400,2,0,2,3
9,2009,843400,10,9,1,3
10,2009,843400,12,11,1,1
11,2009,843400,7,6,1,1
12,2009,843400,10,8,2,0
1,2010,843400,5,4,1,2
2,2010,843400,7,5,2,1
3,2010,843400,5,4,1,0
4,2010,843400,13,13,0,3
5,2010,843400,7,5,2,2
6,2010,843400,7,6,1,3
7,2010,843400,9,7,2,4
8,2010,843400,8,4,4,0
9,2010,843400,6,6,0,2
10,2010,843400,9,7,2,4
11,2010,843400,6,6,0,3
12,2010,843400,5,4,1,1
1,2011,843400,6,6,0,0
2,2011,843400,3,2,1,0
1,1999,840700,29,25,4,8
2,1999,840700,20,14,6,0
3,1999,840700,28,25,3,6
4,1999,840700,37,25,12,5
5,1999,840700,24,20,4,2
6,1999,840700,27,21,6,3
7,1999,840700,39,25,14,5
8,1999,840700,33,26,7,0
9,1999,840700,36,28,8,7
10,1999,840700,41,29,12,8
11,1999,840700,34,30,4,10
12,1999,840700,37,31,6,0
1,2000,840700,24,20,4,3
2,2000,840700,25,21,4,6
3,2000,840700,34,30,4,4
4,2000,840700,35,31,4,7
5,2000,840700,34,22,12,8
6,2000,840700,24,18,6,1
7,2000,840700,26,21,5,3
8,2000,840700,29,23,6,4
9,2000,840700,35,30,5,1
10,2000,840700,34,29,5,2
11,2000,840700,46,37,9,5
12,2000,840700,25,21,4,3
1,2001,840700,24,19,5,2
2,2001,840700,21,19,2,3
3,2001,840700,31,24,7,1
4,2001,840700,35,27,8,3
5,2001,840700,26,22,4,4
6,2001,840700,24,18,6,1
7,2001,840700,32,26,6,6
8,2001,840700,22,22,0,4
9,2001,840700,35,25,10,4
10,2001,840700,42,34,8,10
11,2001,840700,44,35,9,3
12,2001,840700,34,27,7,5
1,2002,840700,31,28,3,4
2,2002,840700,29,27,2,4
3,2002,840700,36,32,4,5
4,2002,840700,32,20,12,5
5,2002,840700,62,49,13,2
6,2002,840700,30,24,6,4
7,2002,840700,54,41,13,2
8,2002,840700,48,42,6,6
9,2002,840700,52,44,8,6
10,2002,840700,41,36,5,4
11,2002,840700,21,17,4,7
12,2002,840700,30,24,6,3
1,2003,840700,35,29,6,8
2,2003,840700,23,22,1,7
3,2003,840700,40,30,10,3
4,2003,840700,31,25,6,3
5,2003,840700,27,23,4,6
6,2003,840700,48,44,4,2
7,2003,840700,47,44,3,4
8,2003,840700,55,49,6,5
9,2003,840700,28,23,5,8
10,2003,840700,28,21,7,2
11,2003,840700,33,27,6,10
12,2003,840700,32,26,6,7
1,2004,840700,33,30,3,7
2,2004,840700,14,14,0,7
3,2004,840700,36,29,7,8
4,2004,840700,27,22,5,7
5,2004,840700,32,25,7,3
6,2004,840700,49,42,7,8
7,2004,840700,62,53,9,13
8,2004,840700,49,41,8,6
9,2004,840700,36,27,9,7
10,2004,840700,38,28,10,7
11,2004,840700,25,23,2,7
12,2004,840700,26,22,4,15
1,2005,840700,19,16,3,5
2,2005,840700,28,22,6,5
3,2005,840700,19,14,5,12
4,2005,840700,25,23,2,12
5,2005,840700,33,26,7,4
6,2005,840700,43,42,1,9
7,2005,840700,46,41,5,7
8,2005,840700,36,32,4,6
9,2005,840700,40,30,10,12
10,2005,840700,28,23,5,6
11,2005,840700,21,19,2,8
12,2005,840700,23,17,6,3
1,2006,840700,23,20,3,2
2,2006,840700,17,16,1,9
3,2006,840700,26,21,5,7
4,2006,840700,21,15,6,4
5,2006,840700,32,25,7,5
6,2006,840700,41,35,6,7
7,2006,840700,36,28,8,15
8,2006,840700,32,23,9,10
9,2006,840700,25,22,3,2
10,2006,840700,27,21,6,8
11,2006,840700,28,23,5,7
12,2006,840700,33,29,4,6
1,2007,840700,24,18,6,3
2,2007,840700,17,17,0,5
3,2007,840700,33,27,6,4
4,2007,840700,23,12,11,6
5,2007,840700,38,31,7,18
6,2007,840700,26,25,1,7
7,2007,840700,30,21,9,5
8,2007,840700,28,25,3,2
9,2007,840700,26,20,6,9
10,2007,840700,39,35,4,4
11,2007,840700,33,29,4,5
12,2007,840700,24,21,3,4
1,2008,840700,30,27,3,17
2,2008,840700,29,24,5,11
3,2008,840700,28,23,5,14
4,2008,840700,27,24,3,3
5,2008,840700,22,18,4,5
6,2008,840700,31,26,5,4
7,2008,840700,27,21,6,8
8,2008,840700,38,27,11,5
9,2008,840700,28,20,8,10
10,2008,840700,26,23,3,4
11,2008,840700,27,22,5,5
12,2008,840700,21,18,3,5
1,2009,840700,19,19,0,3
2,2009,840700,14,10,4,8
3,2009,840700,27,19,8,7
4,2009,840700,15,11,4,3
5,2009,840700,21,20,1,7
6,2009,840700,16,6,10,1
7,2009,840700,20,15,5,2
8,2009,840700,33,25,8,4
9,2009,840700,23,16,7,7
10,2009,840700,24,22,2,5
11,2009,840700,18,16,2,3
12,2009,840700,19,18,1,4
1,2010,840700,28,24,4,8
2,2010,840700,23,19,4,3
3,2010,840700,16,11,5,1
4,2010,840700,17,12,5,3
5,2010,840700,30,24,6,10
6,2010,840700,31,22,9,3
7,2010,840700,23,20,3,7
8,2010,840700,30,25,5,4
9,2010,840700,18,16,2,6
10,2010,840700,27,20,7,3
11,2010,840700,27,24,3,5
12,2010,840700,21,19,2,2
1,2011,840700,21,21,0,2
2,2011,840700,20,18,2,2
1,1999,330100,84,79,5,1
2,1999,330100,77,73,4,9
3,1999,330100,95,91,4,4
4,1999,330100,63,55,8,5
5,1999,330100,85,79,6,7
6,1999,330100,82,79,3,10
7,1999,330100,99,94,5,5
8,1999,330100,95,89,6,9
9,1999,330100,82,77,5,7
10,1999,330100,72,69,3,13
11,1999,330100,67,63,4,12
12,1999,330100,62,57,5,10
1,2000,330100,78,72,6,4
2,2000,330100,83,78,5,11
3,2000,330100,85,82,3,10
4,2000,330100,83,78,5,9
5,2000,330100,94,89,5,6
6,2000,330100,76,71,5,8
7,2000,330100,88,83,5,9
8,2000,330100,101,94,7,5
9,2000,330100,114,110,4,1
10,2000,330100,105,98,7,8
11,2000,330100,120,119,1,3
12,2000,330100,55,51,4,6
1,2001,330100,57,54,3,11
2,2001,330100,64,62,2,10
3,2001,330100,64,61,3,10
4,2001,330100,65,62,3,9
5,2001,330100,63,59,4,15
6,2001,330100,69,61,8,13
7,2001,330100,64,61,3,14
8,2001,330100,93,85,8,22
9,2001,330100,91,81,10,12
10,2001,330100,92,87,5,14
11,2001,330100,73,73,0,14
12,2001,330100,44,39,5,9
1,2002,330100,56,55,1,10
2,2002,330100,44,40,4,13
3,2002,330100,56,54,2,17
4,2002,330100,68,66,2,13
5,2002,330100,79,77,2,15
6,2002,330100,91,85,6,5
7,2002,330100,65,63,2,18
8,2002,330100,66,61,5,9
9,2002,330100,87,81,6,8
10,2002,330100,62,57,5,8
11,2002,330100,60,57,3,2
12,2002,330100,70,65,5,4
1,2003,330100,63,60,3,5
2,2003,330100,57,53,4,6
3,2003,330100,50,48,2,7
4,2003,330100,57,55,2,4
5,2003,330100,64,61,3,7
6,2003,330100,56,54,2,5
7,2003,330100,77,70,7,10
8,2003,330100,63,55,8,5
9,2003,330100,55,54,1,10
10,2003,330100,64,64,0,5
11,2003,330100,49,47,2,3
12,2003,330100,61,59,2,1
1,2004,330100,58,56,2,5
2,2004,330100,42,38,4,3
3,2004,330100,57,54,3,1
4,2004,330100,48,43,5,2
5,2004,330100,66,62,4,3
6,2004,330100,109,106,3,7
7,2004,330100,125,121,4,4
8,2004,330100,99,96,3,7
9,2004,330100,65,61,4,3
10,2004,330100,58,56,2,5
11,2004,330100,68,66,2,4
12,2004,330100,43,42,1,1
1,2005,330100,46,45,1,2
2,2005,330100,47,44,3,5
3,2005,330100,40,38,2,5
4,2005,330100,62,58,4,5
5,2005,330100,96,89,7,4
6,2005,330100,83,81,2,8
7,2005,330100,70,68,2,7
8,2005,330100,66,64,2,11
9,2005,330100,74,74,0,9
10,2005,330100,88,81,7,5
11,2005,330100,77,75,2,5
12,2005,330100,61,60,1,2
1,2006,330100,67,63,4,1
2,2006,330100,70,68,2,5
3,2006,330100,62,59,3,5
4,2006,330100,52,51,1,2
5,2006,330100,69,68,1,6
6,2006,330100,74,73,1,3
7,2006,330100,90,85,5,8
8,2006,330100,61,58,3,6
9,2006,330100,80,76,4,4
10,2006,330100,83,80,3,4
11,2006,330100,65,63,2,5
12,2006,330100,39,37,2,6
1,2007,330100,47,45,2,8
2,2007,330100,55,53,2,5
3,2007,330100,55,54,1,10
4,2007,330100,53,50,3,1
5,2007,330100,63,59,4,9
6,2007,330100,62,61,1,4
7,2007,330100,82,79,3,4
8,2007,330100,75,73,2,7
9,2007,330100,68,65,3,7
10,2007,330100,66,65,1,3
11,2007,330100,60,57,3,5
12,2007,330100,55,55,0,3
1,2008,330100,69,69,0,9
2,2008,330100,53,50,3,4
3,2008,330100,55,52,3,4
4,2008,330100,67,65,2,11
5,2008,330100,59,57,2,14
6,2008,330100,57,55,2,5
7,2008,330100,73,65,8,3
8,2008,330100,54,52,2,9
9,2008,330100,66,65,1,8
10,2008,330100,62,60,2,11
11,2008,330100,68,66,2,7
12,2008,330100,51,47,4,2
1,2009,330100,44,42,2,4
2,2009,330100,42,40,2,23
3,2009,330100,26,26,0,7
4,2009,330100,23,21,2,16
5,2009,330100,39,37,2,11
6,2009,330100,50,49,1,9
7,2009,330100,61,60,1,11
8,2009,330100,38,35,3,12
9,2009,330100,52,51,1,20
10,2009,330100,53,51,2,11
11,2009,330100,60,57,3,4
12,2009,330100,45,43,2,6
1,2010,330100,45,42,3,7
2,2010,330100,43,42,1,5
3,2010,330100,54,49,5,7
4,2010,330100,39,35,4,6
5,2010,330100,45,40,5,6
6,2010,330100,61,58,3,5
7,2010,330100,79,78,1,8
8,2010,330100,68,65,3,8
9,2010,330100,59,57,2,8
10,2010,330100,51,47,4,6
11,2010,330100,53,50,3,4
12,2010,330100,51,50,1,2
1,2011,330100,52,49,3,2
2,2011,330100,39,38,1,2
1,1999,292500,26,24,2,10
2,1999,292500,23,18,5,18
3,1999,292500,28,21,7,15
4,1999,292500,38,29,9,8
5,1999,292500,27,16,11,17
6,1999,292500,37,27,10,24
7,1999,292500,32,27,5,10
8,1999,292500,31,27,4,12
9,1999,292500,34,27,7,14
10,1999,292500,30,26,4,15
11,1999,292500,24,17,7,12
12,1999,292500,22,16,6,19
1,2000,292500,27,20,7,17
2,2000,292500,18,15,3,26
3,2000,292500,31,23,8,23
4,2000,292500,21,12,9,20
5,2000,292500,30,22,8,24
6,2000,292500,25,16,9,13
7,2000,292500,37,30,7,3
8,2000,292500,18,12,6,10
9,2000,292500,32,25,7,10
10,2000,292500,26,19,7,18
11,2000,292500,24,18,6,4
12,2000,292500,15,13,2,3
1,2001,292500,23,18,5,17
2,2001,292500,25,16,9,10
3,2001,292500,32,22,10,13
4,2001,292500,30,21,9,6
5,2001,292500,25,23,2,14
6,2001,292500,27,21,6,14
7,2001,292500,22,18,4,7
8,2001,292500,39,33,6,11
9,2001,292500,41,29,12,13
10,2001,292500,36,27,9,5
11,2001,292500,22,15,7,6
12,2001,292500,32,23,9,14
1,2002,292500,26,22,4,10
2,2002,292500,26,20,6,12
3,2002,292500,20,12,8,8
4,2002,292500,22,19,3,13
5,2002,292500,34,21,13,20
6,2002,292500,23,16,7,8
7,2002,292500,41,27,14,12
8,2002,292500,43,28,15,18
9,2002,292500,30,21,9,14
10,2002,292500,33,28,5,22
11,2002,292500,29,20,9,8
12,2002,292500,38,34,4,12
1,2003,292500,50,38,12,12
2,2003,292500,25,22,3,15
3,2003,292500,33,26,7,16
4,2003,292500,28,21,7,13
5,2003,292500,41,33,8,16
6,2003,292500,29,22,7,12
7,2003,292500,32,23,9,10
8,2003,292500,48,40,8,25
9,2003,292500,33,24,9,29
10,2003,292500,31,28,3,20
11,2003,292500,26,19,7,16
12,2003,292500,32,24,8,33
1,2004,292500,39,35,4,60
2,2004,292500,37,30,7,88
3,2004,292500,41,34,7,99
4,2004,292500,31,25,6,84
5,2004,292500,29,23,6,41
6,2004,292500,25,19,6,22
7,2004,292500,31,27,4,28
8,2004,292500,44,34,10,34
9,2004,292500,39,35,4,54
10,2004,292500,47,41,6,73
11,2004,292500,20,18,2,21
12,2004,292500,18,15,3,12
1,2005,292500,23,17,6,22
2,2005,292500,16,13,3,34
3,2005,292500,22,17,5,31
4,2005,292500,26,24,2,25
5,2005,292500,38,30,8,25
6,2005,292500,40,26,14,23
7,2005,292500,33,28,5,63
8,2005,292500,24,15,9,20
9,2005,292500,21,13,8,30
10,2005,292500,36,28,8,29
11,2005,292500,36,30,6,48
12,2005,292500,31,25,6,41
1,2006,292500,31,25,6,49
2,2006,292500,22,19,3,29
3,2006,292500,16,12,4,22
4,2006,292500,20,17,3,24
5,2006,292500,21,19,2,20
6,2006,292500,28,25,3,27
7,2006,292500,24,20,4,18
8,2006,292500,28,23,5,14
9,2006,292500,25,21,4,18
10,2006,292500,18,17,1,9
11,2006,292500,27,22,5,9
12,2006,292500,16,15,1,6
1,2007,292500,20,17,3,12
2,2007,292500,15,13,2,8
3,2007,292500,21,19,2,14
4,2007,292500,20,11,9,15
5,2007,292500,25,21,4,23
6,2007,292500,32,26,6,20
7,2007,292500,38,33,5,10
8,2007,292500,33,28,5,9
9,2007,292500,26,21,5,14
10,2007,292500,23,22,1,7
11,2007,292500,20,19,1,8
12,2007,292500,24,20,4,12
1,2008,292500,22,21,1,7
2,2008,292500,9,9,0,7
3,2008,292500,28,24,4,10
4,2008,292500,18,13,5,9
5,2008,292500,24,22,2,5
6,2008,292500,28,23,5,2
7,2008,292500,26,22,4,6
8,2008,292500,23,21,2,4
9,2008,292500,26,22,4,8
10,2008,292500,35,29,6,5
11,2008,292500,22,15,7,11
12,2008,292500,17,13,4,5
1,2009,292500,18,17,1,6
2,2009,292500,15,12,3,6
3,2009,292500,21,17,4,16
4,2009,292500,21,19,2,15
5,2009,292500,33,28,5,11
6,2009,292500,14,11,3,7
7,2009,292500,25,19,6,4
8,2009,292500,14,11,3,11
9,2009,292500,33,25,8,10
10,2009,292500,28,23,5,5
11,2009,292500,26,23,3,8
12,2009,292500,19,15,4,7
1,2010,292500,21,14,7,8
2,2010,292500,21,18,3,6
3,2010,292500,20,16,4,7
4,2010,292500,27,23,4,4
5,2010,292500,30,23,7,9
6,2010,292500,20,17,3,14
7,2010,292500,23,17,6,6
8,2010,292500,30,28,2,5
9,2010,292500,15,10,5,9
10,2010,292500,21,20,1,3
11,2010,292500,25,21,4,7
12,2010,292500,30,25,5,9
1,2011,292500,20,18,2,3
2,2011,292500,9,7,2,6
1,1999,292400,15,11,4,22
2,1999,292400,19,15,4,11
3,1999,292400,10,8,2,17
4,1999,292400,17,14,3,12
5,1999,292400,19,14,5,8
6,1999,292400,23,16,7,15
7,1999,292400,26,18,8,13
8,1999,292400,21,16,5,12
9,1999,292400,28,20,8,25
10,1999,292400,33,25,8,16
11,1999,292400,27,22,5,15
12,1999,292400,25,23,2,18
1,2000,292400,24,21,3,16
2,2000,292400,24,22,2,13
3,2000,292400,34,22,12,24
4,2000,292400,20,15,5,28
5,2000,292400,27,18,9,38
6,2000,292400,19,12,7,24
7,2000,292400,18,12,6,15
8,2000,292400,25,17,8,16
9,2000,292400,27,22,5,23
10,2000,292400,17,14,3,35
11,2000,292400,15,14,1,14
12,2000,292400,10,9,1,2
1,2001,292400,19,17,2,8
2,2001,292400,12,8,4,8
3,2001,292400,26,18,8,17
4,2001,292400,16,12,4,9
5,2001,292400,26,19,7,13
6,2001,292400,26,20,6,12
7,2001,292400,19,11,8,17
8,2001,292400,19,14,5,18
9,2001,292400,19,13,6,10
10,2001,292400,20,15,5,5
11,2001,292400,22,19,3,9
12,2001,292400,18,15,3,12
1,2002,292400,17,12,5,30
2,2002,292400,18,12,6,28
3,2002,292400,16,10,6,17
4,2002,292400,27,24,3,22
5,2002,292400,12,7,5,29
6,2002,292400,26,23,3,26
7,2002,292400,29,17,12,21
8,2002,292400,22,20,2,22
9,2002,292400,23,16,7,16
10,2002,292400,22,19,3,13
11,2002,292400,18,16,2,21
12,2002,292400,19,16,3,28
1,2003,292400,24,22,2,14
2,2003,292400,17,15,2,14
3,2003,292400,26,20,6,17
4,2003,292400,23,22,1,16
5,2003,292400,21,16,5,25
6,2003,292400,13,11,2,12
7,2003,292400,24,17,7,14
8,2003,292400,30,27,3,20
9,2003,292400,26,21,5,19
10,2003,292400,22,20,2,20
11,2003,292400,16,14,2,16
12,2003,292400,21,18,3,6
1,2004,292400,10,9,1,15
2,2004,292400,26,24,2,6
3,2004,292400,19,17,2,9
4,2004,292400,22,17,5,16
5,2004,292400,19,14,5,17
6,2004,292400,21,14,7,14
7,2004,292400,26,20,6,9
8,2004,292400,28,27,1,6
9,2004,292400,33,25,8,17
10,2004,292400,29,22,7,13
11,2004,292400,23,23,0,18
12,2004,292400,21,13,8,21
1,2005,292400,15,12,3,16
2,2005,292400,20,17,3,23
3,2005,292400,13,9,4,15
4,2005,292400,29,25,4,15
5,2005,292400,29,24,5,18
6,2005,292400,34,27,7,7
7,2005,292400,21,18,3,15
8,2005,292400,33,31,2,13
9,2005,292400,18,18,0,7
10,2005,292400,26,22,4,13
11,2005,292400,23,20,3,17
12,2005,292400,22,21,1,12
1,2006,292400,20,17,3,10
2,2006,292400,18,16,2,11
3,2006,292400,29,25,4,12
4,2006,292400,15,13,2,15
5,2006,292400,17,14,3,19
6,2006,292400,24,21,3,18
7,2006,292400,30,23,7,26
8,2006,292400,38,27,11,19
9,2006,292400,14,12,2,26
10,2006,292400,31,27,4,7
11,2006,292400,27,23,4,7
12,2006,292400,25,20,5,6
1,2007,292400,21,18,3,14
2,2007,292400,12,10,2,7
3,2007,292400,26,25,1,7
4,2007,292400,19,16,3,6
5,2007,292400,21,17,4,13
6,2007,292400,20,13,7,14
7,2007,292400,20,17,3,10
8,2007,292400,23,20,3,14
9,2007,292400,29,23,6,12
10,2007,292400,22,17,5,16
11,2007,292400,19,14,5,13
12,2007,292400,28,22,6,14
1,2008,292400,18,17,1,7
2,2008,292400,8,7,1,11
3,2008,292400,17,12,5,23
4,2008,292400,25,21,4,7
5,2008,292400,13,11,2,6
6,2008,292400,27,21,6,10
7,2008,292400,36,32,4,7
8,2008,292400,30,26,4,14
9,2008,292400,25,21,4,10
10,2008,292400,32,29,3,18
11,2008,292400,20,17,3,17
12,2008,292400,18,13,5,11
1,2009,292400,18,16,2,15
2,2009,292400,13,10,3,14
3,2009,292400,18,17,1,25
4,2009,292400,24,18,6,8
5,2009,292400,23,18,5,17
6,2009,292400,24,19,5,17
7,2009,292400,17,13,4,11
8,2009,292400,18,17,1,9
9,2009,292400,23,20,3,8
10,2009,292400,17,16,1,12
11,2009,292400,21,16,5,12
12,2009,292400,25,20,5,4
1,2010,292400,16,16,0,13
2,2010,292400,24,20,4,11
3,2010,292400,15,13,2,12
4,2010,292400,17,13,4,14
5,2010,292400,25,21,4,18
6,2010,292400,29,22,7,16
7,2010,292400,23,21,2,11
8,2010,292400,16,12,4,9
9,2010,292400,21,18,3,11
10,2010,292400,24,20,4,13
11,2010,292400,23,19,4,12
12,2010,292400,26,24,2,12
1,2011,292400,24,21,3,10
2,2011,292400,12,11,1,6
1,1999,841400,19,16,3,6
2,1999,841400,18,14,4,5
3,1999,841400,28,23,5,7
4,1999,841400,12,9,3,10
5,1999,841400,27,21,6,6
6,1999,841400,34,27,7,10
7,1999,841400,27,22,5,8
8,1999,841400,13,8,5,10
9,1999,841400,25,18,7,3
10,1999,841400,26,14,12,8
11,1999,841400,23,16,7,16
12,1999,841400,12,11,1,5
1,2000,841400,20,16,4,17
2,2000,841400,12,8,4,6
3,2000,841400,9,8,1,10
4,2000,841400,21,18,3,4
5,2000,841400,19,12,7,10
6,2000,841400,18,17,1,8
7,2000,841400,27,21,6,5
8,2000,841400,28,24,4,13
9,2000,841400,21,17,4,9
10,2000,841400,17,14,3,15
11,2000,841400,26,23,3,7
12,2000,841400,22,19,3,7
1,2001,841400,21,15,6,5
2,2001,841400,17,12,5,9
3,2001,841400,20,16,4,5
4,2001,841400,20,15,5,1
5,2001,841400,15,11,4,9
6,2001,841400,18,13,5,5
7,2001,841400,21,14,7,1
8,2001,841400,27,25,2,9
9,2001,841400,22,16,6,3
10,2001,841400,21,13,8,11
11,2001,841400,22,18,4,19
12,2001,841400,21,15,6,10
1,2002,841400,16,12,4,19
2,2002,841400,15,13,2,7
3,2002,841400,10,6,4,9
4,2002,841400,17,13,4,6
5,2002,841400,26,19,7,7
6,2002,841400,21,18,3,8
7,2002,841400,26,22,4,7
8,2002,841400,27,19,8,2
9,2002,841400,32,28,4,6
10,2002,841400,17,11,6,9
11,2002,841400,14,11,3,8
12,2002,841400,21,17,4,8
1,2003,841400,13,9,4,14
2,2003,841400,10,6,4,9
3,2003,841400,18,15,3,4
4,2003,841400,14,12,2,12
5,2003,841400,19,16,3,13
6,2003,841400,17,12,5,21
7,2003,841400,15,12,3,19
8,2003,841400,20,15,5,8
9,2003,841400,28,23,5,20
10,2003,841400,20,19,1,12
11,2003,841400,24,19,5,11
12,2003,841400,9,8,1,11
1,2004,841400,16,12,4,5
2,2004,841400,13,12,1,5
3,2004,841400,19,16,3,16
4,2004,841400,20,14,6,9
5,2004,841400,21,20,1,14
6,2004,841400,14,14,0,17
7,2004,841400,20,14,6,15
8,2004,841400,25,17,8,7
9,2004,841400,21,16,5,9
10,2004,841400,15,12,3,22
11,2004,841400,9,8,1,13
12,2004,841400,19,18,1,8
1,2005,841400,11,8,3,3
2,2005,841400,8,7,1,14
3,2005,841400,16,14,2,14
4,2005,841400,18,16,2,16
5,2005,841400,20,11,9,6
6,2005,841400,27,22,5,9
7,2005,841400,20,18,2,8
8,2005,841400,34,31,3,5
9,2005,841400,21,17,4,5
10,2005,841400,24,22,2,11
11,2005,841400,21,19,2,11
12,2005,841400,13,9,4,8
1,2006,841400,19,15,4,8
2,2006,841400,17,14,3,10
3,2006,841400,14,11,3,8
4,2006,841400,19,18,1,10
5,2006,841400,19,17,2,9
6,2006,841400,17,15,2,9
7,2006,841400,26,23,3,11
8,2006,841400,14,11,3,17
9,2006,841400,16,13,3,10
10,2006,841400,18,15,3,7
11,2006,841400,10,7,3,6
12,2006,841400,11,11,0,9
1,2007,841400,17,15,2,8
2,2007,841400,11,10,1,5
3,2007,841400,20,16,4,4
4,2007,841400,16,14,2,9
5,2007,841400,11,8,3,17
6,2007,841400,16,11,5,25
7,2007,841400,22,15,7,6
8,2007,841400,27,21,6,14
9,2007,841400,18,13,5,13
10,2007,841400,21,19,2,9
11,2007,841400,20,20,0,29
12,2007,841400,11,9,2,4
1,2008,841400,17,16,1,10
2,2008,841400,11,11,0,22
3,2008,841400,20,18,2,16
4,2008,841400,9,7,2,8
5,2008,841400,18,14,4,10
6,2008,841400,17,13,4,17
7,2008,841400,24,18,6,26
8,2008,841400,15,13,2,8
9,2008,841400,19,15,4,9
10,2008,841400,18,15,3,9
11,2008,841400,14,11,3,7
12,2008,841400,16,15,1,3
1,2009,841400,15,12,3,7
2,2009,841400,13,8,5,3
3,2009,841400,15,11,4,4
4,2009,841400,18,16,2,4
5,2009,841400,15,12,3,10
6,2009,841400,20,15,5,10
7,2009,841400,16,14,2,5
8,2009,841400,16,13,3,2
9,2009,841400,23,19,4,0
10,2009,841400,18,18,0,3
11,2009,841400,8,6,2,3
12,2009,841400,13,10,3,4
1,2010,841400,13,10,3,4
2,2010,841400,18,16,2,8
3,2010,841400,27,20,7,3
4,2010,841400,25,23,2,7
5,2010,841400,27,27,0,5
6,2010,841400,34,30,4,2
7,2010,841400,23,21,2,2
8,2010,841400,20,17,3,3
9,2010,841400,28,26,2,4
10,2010,841400,19,18,1,6
11,2010,841400,27,22,5,6
12,2010,841400,21,16,5,0
1,2011,841400,13,10,3,7
2,2011,841400,4,4,0,4
1,1999,841700,21,19,2,5
2,1999,841700,11,10,1,4
3,1999,841700,21,18,3,3
4,1999,841700,26,22,4,2
5,1999,841700,21,14,7,1
6,1999,841700,24,17,7,6
7,1999,841700,40,35,5,3
8,1999,841700,27,19,8,7
9,1999,841700,14,11,3,8
10,1999,841700,26,22,4,7
11,1999,841700,16,14,2,6
12,1999,841700,16,10,6,10
1,2000,841700,27,23,4,1
2,2000,841700,17,14,3,3
3,2000,841700,21,18,3,2
4,2000,841700,30,26,4,1
5,2000,841700,28,22,6,12
6,2000,841700,26,22,4,6
7,2000,841700,30,26,4,8
8,2000,841700,29,25,4,7
9,2000,841700,22,18,4,2
10,2000,841700,22,20,2,5
11,2000,841700,23,16,7,3
12,2000,841700,22,19,3,0
1,2001,841700,17,14,3,2
2,2001,841700,18,16,2,3
3,2001,841700,17,13,4,7
4,2001,841700,21,18,3,1
5,2001,841700,29,24,5,3
6,2001,841700,16,13,3,6
7,2001,841700,19,16,3,1
8,2001,841700,24,19,5,14
9,2001,841700,25,19,6,14
10,2001,841700,24,20,4,8
11,2001,841700,37,32,5,3
12,2001,841700,20,19,1,3
1,2002,841700,18,16,2,5
2,2002,841700,7,6,1,4
3,2002,841700,18,15,3,4
4,2002,841700,19,15,4,10
5,2002,841700,17,15,2,7
6,2002,841700,32,28,4,7
7,2002,841700,33,29,4,6
8,2002,841700,32,25,7,11
9,2002,841700,34,25,9,7
10,2002,841700,18,15,3,7
11,2002,841700,28,23,5,2
12,2002,841700,10,8,2,7
1,2003,841700,21,19,2,11
2,2003,841700,15,9,6,4
3,2003,841700,20,18,2,1
4,2003,841700,17,14,3,6
5,2003,841700,19,16,3,22
6,2003,841700,17,12,5,8
7,2003,841700,27,22,5,10
8,2003,841700,25,22,3,12
9,2003,841700,18,16,2,14
10,2003,841700,22,18,4,4
11,2003,841700,15,12,3,4
12,2003,841700,18,13,5,8
1,2004,841700,11,10,1,2
2,2004,841700,15,12,3,5
3,2004,841700,15,12,3,5
4,2004,841700,12,10,2,7
5,2004,841700,15,11,4,12
6,2004,841700,30,24,6,5
7,2004,841700,34,31,3,5
8,2004,841700,31,26,5,5
9,2004,841700,20,18,2,5
10,2004,841700,15,14,1,6
11,2004,841700,24,19,5,14
12,2004,841700,12,10,2,6
1,2005,841700,19,16,3,5
2,2005,841700,9,8,1,7
3,2005,841700,13,12,1,2
4,2005,841700,14,9,5,12
5,2005,841700,18,17,1,3
6,2005,841700,19,14,5,3
7,2005,841700,25,21,4,8
8,2005,841700,21,18,3,3
9,2005,841700,26,23,3,6
10,2005,841700,25,21,4,2
11,2005,841700,14,13,1,5
12,2005,841700,22,16,6,2
1,2006,841700,19,19,0,2
2,2006,841700,15,13,2,11
3,2006,841700,21,17,4,8
4,2006,841700,18,15,3,7
5,2006,841700,25,22,3,3
6,2006,841700,24,21,3,6
7,2006,841700,23,15,8,2
8,2006,841700,26,21,5,7
9,2006,841700,16,13,3,7
10,2006,841700,7,7,0,0
11,2006,841700,21,17,4,3
12,2006,841700,24,22,2,6
1,2007,841700,15,13,2,5
2,2007,841700,15,15,0,3
3,2007,841700,18,16,2,3
4,2007,841700,22,21,1,7
5,2007,841700,22,19,3,12
6,2007,841700,13,12,1,11
7,2007,841700,18,16,2,7
8,2007,841700,16,16,0,7
9,2007,841700,27,23,4,10
10,2007,841700,25,23,2,12
11,2007,841700,18,17,1,1
12,2007,841700,21,18,3,5
1,2008,841700,16,14,2,9
2,2008,841700,20,18,2,14
3,2008,841700,19,16,3,2
4,2008,841700,12,7,5,6
5,2008,841700,14,12,2,1
6,2008,841700,22,20,2,5
7,2008,841700,16,11,5,4
8,2008,841700,21,16,5,18
9,2008,841700,30,25,5,3
10,2008,841700,14,13,1,5
11,2008,841700,9,8,1,0
12,2008,841700,6,6,0,2
1,2009,841700,14,11,3,4
2,2009,841700,14,11,3,3
3,2009,841700,17,14,3,7
4,2009,841700,14,11,3,4
5,2009,841700,18,14,4,4
6,2009,841700,10,8,2,8
7,2009,841700,19,15,4,3
8,2009,841700,18,18,0,2
9,2009,841700,20,17,3,6
10,2009,841700,13,10,3,7
11,2009,841700,17,16,1,0
12,2009,841700,15,13,2,1
1,2010,841700,21,19,2,5
2,2010,841700,14,11,3,3
3,2010,841700,15,10,5,2
4,2010,841700,13,9,4,1
5,2010,841700,8,6,2,3
6,2010,841700,16,15,1,2
7,2010,841700,9,7,2,3
8,2010,841700,15,11,4,5
9,2010,841700,19,15,4,3
10,2010,841700,19,17,2,2
11,2010,841700,10,10,0,4
12,2010,841700,16,16,0,4
1,2011,841700,9,7,2,11
2,2011,841700,8,7,1,0
1,1999,841200,32,27,5,7
2,1999,841200,32,25,7,4
3,1999,841200,46,42,4,8
4,1999,841200,46,40,6,2
5,1999,841200,53,48,5,7
6,1999,841200,55,50,5,5
7,1999,841200,49,44,5,6
8,1999,841200,64,58,6,5
9,1999,841200,47,46,1,4
10,1999,841200,48,44,4,5
11,1999,841200,31,26,5,3
12,1999,841200,29,24,5,1
1,2000,841200,24,18,6,3
2,2000,841200,37,35,2,6
3,2000,841200,34,28,6,5
4,2000,841200,51,46,5,4
5,2000,841200,38,27,11,4
6,2000,841200,54,53,1,10
7,2000,841200,51,40,11,4
8,2000,841200,35,32,3,6
9,2000,841200,32,27,5,5
10,2000,841200,40,37,3,5
11,2000,841200,44,40,4,2
12,2000,841200,38,37,1,5
1,2001,841200,35,33,2,5
2,2001,841200,36,30,6,2
3,2001,841200,36,35,1,10
4,2001,841200,31,23,8,4
5,2001,841200,40,35,5,11
6,2001,841200,37,31,6,5
7,2001,841200,48,42,6,5
8,2001,841200,47,37,10,7
9,2001,841200,50,45,5,6
10,2001,841200,46,44,2,2
11,2001,841200,31,27,4,4
12,2001,841200,36,32,4,3
1,2002,841200,27,23,4,3
2,2002,841200,20,19,1,5
3,2002,841200,28,22,6,2
4,2002,841200,29,22,7,4
5,2002,841200,32,29,3,5
6,2002,841200,20,17,3,4
7,2002,841200,35,31,4,3
8,2002,841200,36,34,2,2
9,2002,841200,33,28,5,2
10,2002,841200,30,25,5,1
11,2002,841200,34,31,3,4
12,2002,841200,33,29,4,3
1,2003,841200,18,14,4,4
2,2003,841200,22,20,2,3
3,2003,841200,27,24,3,6
4,2003,841200,22,21,1,5
5,2003,841200,25,23,2,7
6,2003,841200,31,27,4,5
7,2003,841200,55,48,7,6
8,2003,841200,57,48,9,9
9,2003,841200,26,22,4,8
10,2003,841200,31,29,2,8
11,2003,841200,28,25,3,1
12,2003,841200,19,19,0,1
1,2004,841200,20,19,1,4
2,2004,841200,22,20,2,2
3,2004,841200,32,28,4,2
4,2004,841200,34,30,4,3
5,2004,841200,35,30,5,4
6,2004,841200,28,26,2,8
7,2004,841200,42,41,1,3
8,2004,841200,37,33,4,8
9,2004,841200,18,15,3,4
10,2004,841200,33,26,7,2
11,2004,841200,27,26,1,3
12,2004,841200,31,29,2,4
1,2005,841200,19,15,4,2
2,2005,841200,20,18,2,6
3,2005,841200,29,23,6,6
4,2005,841200,22,14,8,5
5,2005,841200,20,13,7,4
6,2005,841200,37,31,6,2
7,2005,841200,33,30,3,2
8,2005,841200,27,25,2,4
9,2005,841200,20,18,2,5
10,2005,841200,34,29,5,5
11,2005,841200,18,17,1,0
12,2005,841200,21,20,1,1
1,2006,841200,22,22,0,6
2,2006,841200,10,10,0,0
3,2006,841200,20,17,3,9
4,2006,841200,15,13,2,4
5,2006,841200,15,11,4,5
6,2006,841200,27,24,3,3
7,2006,841200,24,22,2,4
8,2006,841200,24,18,6,3
9,2006,841200,22,22,0,2
10,2006,841200,23,17,6,3
11,2006,841200,22,18,4,2
12,2006,841200,27,24,3,5
1,2007,841200,20,17,3,3
2,2007,841200,16,14,2,5
3,2007,841200,21,19,2,6
4,2007,841200,20,18,2,10
5,2007,841200,16,13,3,1
6,2007,841200,23,17,6,2
7,2007,841200,30,26,4,3
8,2007,841200,36,34,2,5
9,2007,841200,22,21,1,5
10,2007,841200,33,30,3,5
11,2007,841200,25,22,3,12
12,2007,841200,27,23,4,3
1,2008,841200,16,15,1,10
2,2008,841200,17,16,1,8
3,2008,841200,24,19,5,5
4,2008,841200,16,13,3,4
5,2008,841200,32,26,6,9
6,2008,841200,21,16,5,4
7,2008,841200,22,21,1,5
8,2008,841200,25,21,4,10
9,2008,841200,18,16,2,4
10,2008,841200,22,15,7,5
11,2008,841200,28,28,0,3
12,2008,841200,23,22,1,6
1,2009,841200,25,19,6,5
2,2009,841200,16,15,1,7
3,2009,841200,21,18,3,6
4,2009,841200,19,16,3,2
5,2009,841200,38,36,2,3
6,2009,841200,13,12,1,6
7,2009,841200,32,27,5,5
8,2009,841200,18,14,4,4
9,2009,841200,19,17,2,5
10,2009,841200,20,17,3,2
11,2009,841200,20,15,5,2
12,2009,841200,17,15,2,4
1,2010,841200,18,16,2,5
2,2010,841200,15,12,3,5
3,2010,841200,16,14,2,8
4,2010,841200,14,11,3,5
5,2010,841200,16,16,0,3
6,2010,841200,23,21,2,5
7,2010,841200,24,24,0,7
8,2010,841200,19,17,2,6
9,2010,841200,19,16,3,4
10,2010,841200,22,21,1,6
11,2010,841200,26,24,2,6
12,2010,841200,13,12,1,13
1,2011,841200,17,17,0,5
2,2011,841200,13,11,2,3
1,1999,310900,26,25,1,0
2,1999,310900,15,13,2,7
3,1999,310900,15,14,1,8
4,1999,310900,21,18,3,5
5,1999,310900,30,25,5,7
6,1999,310900,29,21,8,7
7,1999,310900,17,12,5,8
8,1999,310900,21,14,7,6
9,1999,310900,36,31,5,11
10,1999,310900,32,26,6,9
11,1999,310900,23,18,5,3
12,1999,310900,16,12,4,7
1,2000,310900,25,22,3,3
2,2000,310900,22,16,6,9
3,2000,310900,27,20,7,17
4,2000,310900,22,16,6,10
5,2000,310900,21,17,4,7
6,2000,310900,26,21,5,8
7,2000,310900,29,22,7,10
8,2000,310900,30,26,4,8
9,2000,310900,30,26,4,5
10,2000,310900,18,16,2,7
11,2000,310900,22,19,3,8
12,2000,310900,21,19,2,3
1,2001,310900,21,20,1,8
2,2001,310900,19,17,2,4
3,2001,310900,24,19,5,8
4,2001,310900,17,13,4,6
5,2001,310900,25,20,5,10
6,2001,310900,20,13,7,9
7,2001,310900,34,22,12,4
8,2001,310900,25,20,5,4
9,2001,310900,27,23,4,9
10,2001,310900,28,23,5,6
11,2001,310900,25,18,7,7
12,2001,310900,27,24,3,4
1,2002,310900,18,13,5,5
2,2002,310900,14,12,2,8
3,2002,310900,21,17,4,5
4,2002,310900,17,15,2,4
5,2002,310900,23,19,4,5
6,2002,310900,26,19,7,4
7,2002,310900,19,13,6,2
8,2002,310900,27,23,4,3
9,2002,310900,24,17,7,1
10,2002,310900,20,17,3,3
11,2002,310900,14,13,1,2
12,2002,310900,18,17,1,2
1,2003,310900,21,18,3,3
2,2003,310900,11,10,1,0
3,2003,310900,19,15,4,5
4,2003,310900,22,19,3,2
5,2003,310900,19,16,3,9
6,2003,310900,29,23,6,7
7,2003,310900,35,29,6,6
8,2003,310900,28,25,3,10
9,2003,310900,21,18,3,4
10,2003,310900,25,23,2,6
11,2003,310900,19,18,1,6
12,2003,310900,23,20,3,3
1,2004,310900,23,20,3,8
2,2004,310900,12,10,2,4
3,2004,310900,15,12,3,1
4,2004,310900,19,16,3,3
5,2004,310900,17,12,5,5
6,2004,310900,24,20,4,5
7,2004,310900,40,38,2,4
8,2004,310900,26,20,6,5
9,2004,310900,28,19,9,2
10,2004,310900,23,20,3,0
11,2004,310900,20,15,5,2
12,2004,310900,16,14,2,3
1,2005,310900,22,18,4,2
2,2005,310900,26,24,2,9
3,2005,310900,22,19,3,3
4,2005,310900,23,17,6,4
5,2005,310900,17,15,2,3
6,2005,310900,15,13,2,5
7,2005,310900,21,18,3,3
8,2005,310900,23,18,5,2
9,2005,310900,24,18,6,2
10,2005,310900,30,26,4,1
11,2005,310900,20,17,3,0
12,2005,310900,16,15,1,1
1,2006,310900,20,16,4,1
2,2006,310900,21,15,6,2
3,2006,310900,23,20,3,0
4,2006,310900,15,12,3,3
5,2006,310900,18,17,1,6
6,2006,310900,21,18,3,3
7,2006,310900,35,27,8,3
8,2006,310900,13,13,0,3
9,2006,310900,17,15,2,2
10,2006,310900,19,18,1,2
11,2006,310900,16,15,1,3
12,2006,310900,10,9,1,4
1,2007,310900,16,16,0,2
2,2007,310900,11,9,2,2
3,2007,310900,13,11,2,8
4,2007,310900,12,11,1,8
5,2007,310900,23,18,5,3
6,2007,310900,16,12,4,6
7,2007,310900,16,13,3,10
8,2007,310900,19,14,5,5
9,2007,310900,16,13,3,10
10,2007,310900,15,11,4,6
11,2007,310900,11,10,1,6
12,2007,310900,22,19,3,1
1,2008,310900,14,13,1,3
2,2008,310900,13,12,1,2
3,2008,310900,11,9,2,4
4,2008,310900,18,15,3,0
5,2008,310900,22,15,7,8
6,2008,310900,13,11,2,3
7,2008,310900,18,16,2,5
8,2008,310900,20,13,7,1
9,2008,310900,21,19,2,5
10,2008,310900,19,16,3,5
11,2008,310900,13,12,1,2
12,2008,310900,17,15,2,1
1,2009,310900,17,14,3,2
2,2009,310900,15,13,2,3
3,2009,310900,17,14,3,1
4,2009,310900,9,9,0,6
5,2009,310900,18,12,6,2
6,2009,310900,13,11,2,4
7,2009,310900,15,13,2,3
8,2009,310900,10,10,0,1
9,2009,310900,16,14,2,5
10,2009,310900,10,10,0,3
11,2009,310900,20,13,7,1
12,2009,310900,19,15,4,2
1,2010,310900,9,8,1,7
2,2010,310900,6,6,0,6
3,2010,310900,11,9,2,5
4,2010,310900,11,7,4,6
5,2010,310900,18,15,3,14
6,2010,310900,22,18,4,4
7,2010,310900,16,15,1,8
8,2010,310900,16,12,4,6
9,2010,310900,18,16,2,3
10,2010,310900,9,7,2,1
11,2010,310900,16,14,2,3
12,2010,310900,6,5,1,5
1,2011,310900,17,14,3,4
2,2011,310900,8,7,1,0
1,1999,310200,8,8,0,1
2,1999,310200,1,1,0,0
3,1999,310200,10,9,1,1
4,1999,310200,9,9,0,0
5,1999,310200,10,9,1,0
6,1999,310200,10,8,2,0
7,1999,310200,4,4,0,1
8,1999,310200,13,13,0,1
9,1999,310200,10,10,0,1
10,1999,310200,7,7,0,1
11,1999,310200,3,2,1,1
12,1999,310200,6,6,0,0
1,2000,310200,7,6,1,3
2,2000,310200,4,4,0,0
3,2000,310200,8,7,1,0
4,2000,310200,8,7,1,0
5,2000,310200,4,4,0,0
6,2000,310200,12,11,1,2
7,2000,310200,7,7,0,1
8,2000,310200,5,5,0,0
9,2000,310200,11,8,3,2
10,2000,310200,10,8,2,0
11,2000,310200,5,5,0,1
12,2000,310200,5,5,0,2
1,2001,310200,5,4,1,1
2,2001,310200,6,5,1,0
3,2001,310200,4,3,1,1
4,2001,310200,7,7,0,1
5,2001,310200,3,3,0,1
6,2001,310200,8,7,1,1
7,2001,310200,8,5,3,3
8,2001,310200,7,5,2,0
9,2001,310200,5,4,1,2
10,2001,310200,6,5,1,2
11,2001,310200,3,3,0,0
12,2001,310200,5,4,1,1
1,2002,310200,5,5,0,0
2,2002,310200,6,5,1,0
3,2002,310200,5,3,2,1
4,2002,310200,8,7,1,2
5,2002,310200,6,6,0,0
6,2002,310200,3,2,1,0
7,2002,310200,10,10,0,1
8,2002,310200,6,4,2,2
9,2002,310200,6,5,1,0
10,2002,310200,7,6,1,0
11,2002,310200,5,5,0,0
12,2002,310200,11,11,0,3
1,2003,310200,10,10,0,1
2,2003,310200,9,9,0,0
3,2003,310200,10,10,0,0
4,2003,310200,6,6,0,0
5,2003,310200,10,10,0,0
6,2003,310200,4,4,0,0
7,2003,310200,6,3,3,0
8,2003,310200,5,5,0,0
9,2003,310200,8,8,0,1
10,2003,310200,2,1,1,3
11,2003,310200,5,5,0,4
12,2003,310200,4,3,1,0
1,2004,310200,5,5,0,8
2,2004,310200,3,3,0,1
3,2004,310200,9,9,0,1
4,2004,310200,8,8,0,0
5,2004,310200,5,5,0,0
6,2004,310200,5,5,0,1
7,2004,310200,4,4,0,1
8,2004,310200,8,8,0,1
9,2004,310200,8,8,0,0
10,2004,310200,5,5,0,3
11,2004,310200,5,5,0,0
12,2004,310200,7,7,0,0
1,2005,310200,5,5,0,0
2,2005,310200,6,6,0,0
3,2005,310200,4,3,1,0
4,2005,310200,5,5,0,0
5,2005,310200,6,4,2,0
6,2005,310200,4,4,0,2
7,2005,310200,11,7,4,2
8,2005,310200,7,7,0,0
9,2005,310200,7,5,2,1
10,2005,310200,3,3,0,0
11,2005,310200,4,4,0,0
12,2005,310200,4,4,0,0
1,2006,310200,7,4,3,1
2,2006,310200,7,7,0,0
3,2006,310200,10,10,0,1
4,2006,310200,7,6,1,0
5,2006,310200,3,2,1,0
6,2006,310200,6,6,0,0
7,2006,310200,12,11,1,0
8,2006,310200,8,8,0,0
9,2006,310200,4,4,0,0
10,2006,310200,11,9,2,1
11,2006,310200,8,8,0,1
12,2006,310200,11,11,0,0
1,2007,310200,7,7,0,0
2,2007,310200,7,7,0,0
3,2007,310200,6,5,1,0
4,2007,310200,2,2,0,2
5,2007,310200,5,5,0,0
6,2007,310200,13,12,1,1
7,2007,310200,3,3,0,1
8,2007,310200,4,4,0,1
9,2007,310200,6,6,0,2
10,2007,310200,5,5,0,0
11,2007,310200,5,5,0,0
12,2007,310200,3,3,0,0
1,2008,310200,6,5,1,0
2,2008,310200,2,1,1,0
3,2008,310200,6,4,2,1
4,2008,310200,3,2,1,0
5,2008,310200,7,7,0,1
6,2008,310200,3,3,0,0
7,2008,310200,5,4,1,1
8,2008,310200,5,5,0,0
9,2008,310200,3,3,0,0
10,2008,310200,4,4,0,0
11,2008,310200,2,2,0,1
12,2008,310200,5,5,0,0
1,2009,310200,5,4,1,0
2,2009,310200,5,4,1,0
3,2009,310200,10,8,2,3
4,2009,310200,4,3,1,0
5,2009,310200,4,3,1,1
6,2009,310200,5,4,1,0
7,2009,310200,7,6,1,1
8,2009,310200,8,8,0,1
9,2009,310200,10,9,1,0
10,2009,310200,5,5,0,1
11,2009,310200,4,4,0,1
12,2009,310200,1,1,0,0
1,2010,310200,5,5,0,0
2,2010,310200,4,4,0,0
3,2010,310200,5,5,0,2
4,2010,310200,8,8,0,2
5,2010,310200,7,7,0,0
6,2010,310200,5,4,1,0
7,2010,310200,6,5,1,0
8,2010,310200,2,1,1,1
9,2010,310200,5,5,0,0
10,2010,310200,4,3,1,1
11,2010,310200,4,4,0,1
12,2010,310200,4,4,0,0
1,2011,310200,9,9,0,1
2,2011,310200,8,7,1,0
1,1999,310700,11,9,2,0
2,1999,310700,14,13,1,0
3,1999,310700,10,5,5,1
4,1999,310700,4,2,2,1
5,1999,310700,14,11,3,0
6,1999,310700,8,5,3,1
7,1999,310700,17,12,5,1
8,1999,310700,19,14,5,1
9,1999,310700,14,13,1,2
10,1999,310700,18,17,1,2
11,1999,310700,11,7,4,2
12,1999,310700,8,7,1,2
1,2000,310700,11,10,1,2
2,2000,310700,8,6,2,1
3,2000,310700,10,7,3,4
4,2000,310700,13,9,4,0
5,2000,310700,10,10,0,0
6,2000,310700,18,15,3,0
7,2000,310700,10,7,3,2
8,2000,310700,20,15,5,2
9,2000,310700,10,8,2,0
10,2000,310700,14,11,3,2
11,2000,310700,12,10,2,1
12,2000,310700,14,14,0,0
1,2001,310700,11,9,2,2
2,2001,310700,4,3,1,1
3,2001,310700,3,3,0,0
4,2001,310700,12,10,2,2
5,2001,310700,11,7,4,0
6,2001,310700,5,4,1,1
7,2001,310700,18,13,5,3
8,2001,310700,6,6,0,2
9,2001,310700,11,8,3,1
10,2001,310700,6,5,1,2
11,2001,310700,12,9,3,2
12,2001,310700,14,9,5,2
1,2002,310700,11,9,2,0
2,2002,310700,3,3,0,2
3,2002,310700,7,5,2,3
4,2002,310700,6,6,0,1
5,2002,310700,12,11,1,2
6,2002,310700,5,5,0,1
7,2002,310700,5,4,1,0
8,2002,310700,8,7,1,2
9,2002,310700,10,7,3,1
10,2002,310700,6,4,2,1
11,2002,310700,11,8,3,1
12,2002,310700,16,13,3,3
1,2003,310700,8,7,1,3
2,2003,310700,6,5,1,6
3,2003,310700,11,9,2,0
4,2003,310700,11,9,2,1
5,2003,310700,11,9,2,3
6,2003,310700,9,7,2,0
7,2003,310700,14,13,1,0
8,2003,310700,14,11,3,0
9,2003,310700,12,9,3,0
10,2003,310700,18,17,1,1
11,2003,310700,10,9,1,1
12,2003,310700,12,9,3,0
1,2004,310700,3,2,1,2
2,2004,310700,8,7,1,1
3,2004,310700,7,7,0,4
4,2004,310700,8,8,0,4
5,2004,310700,7,7,0,0
6,2004,310700,5,5,0,1
7,2004,310700,18,16,2,1
8,2004,310700,9,8,1,1
9,2004,310700,15,14,1,0
10,2004,310700,9,7,2,0
11,2004,310700,6,6,0,0
12,2004,310700,9,8,1,1
1,2005,310700,11,10,1,1
2,2005,310700,2,2,0,0
3,2005,310700,0,0,0,4
4,2005,310700,6,5,1,0
5,2005,310700,11,7,4,1
6,2005,310700,10,6,4,1
7,2005,310700,8,8,0,1
8,2005,310700,1,1,0,1
9,2005,310700,14,12,2,2
10,2005,310700,4,4,0,1
11,2005,310700,11,11,0,2
12,2005,310700,8,8,0,0
1,2006,310700,14,9,5,0
2,2006,310700,2,2,0,0
3,2006,310700,6,5,1,2
4,2006,310700,2,2,0,1
5,2006,310700,2,2,0,1
6,2006,310700,8,6,2,3
7,2006,310700,11,7,4,0
8,2006,310700,14,11,3,2
9,2006,310700,14,14,0,0
10,2006,310700,15,13,2,1
11,2006,310700,5,4,1,0
12,2006,310700,7,7,0,0
1,2007,310700,4,4,0,1
2,2007,310700,5,3,2,0
3,2007,310700,6,4,2,2
4,2007,310700,7,7,0,4
5,2007,310700,6,5,1,2
6,2007,310700,8,6,2,0
7,2007,310700,9,4,5,2
8,2007,310700,16,14,2,1
9,2007,310700,7,7,0,2
10,2007,310700,3,3,0,4
11,2007,310700,4,4,0,1
12,2007,310700,2,2,0,0
1,2008,310700,5,4,1,3
2,2008,310700,9,7,2,0
3,2008,310700,6,5,1,2
4,2008,310700,4,4,0,1
5,2008,310700,11,10,1,1
6,2008,310700,14,11,3,2
7,2008,310700,5,4,1,0
8,2008,310700,2,0,2,0
9,2008,310700,9,5,4,1
10,2008,310700,4,4,0,2
11,2008,310700,3,2,1,0
12,2008,310700,5,4,1,0
1,2009,310700,5,5,0,0
2,2009,310700,8,7,1,1
3,2009,310700,2,2,0,0
4,2009,310700,5,5,0,0
5,2009,310700,6,4,2,0
6,2009,310700,2,2,0,3
7,2009,310700,5,5,0,0
8,2009,310700,12,11,1,0
9,2009,310700,6,6,0,1
10,2009,310700,5,5,0,0
11,2009,310700,6,5,1,0
12,2009,310700,8,7,1,0
1,2010,310700,7,7,0,0
2,2010,310700,4,4,0,0
3,2010,310700,5,2,3,1
4,2010,310700,12,11,1,1
5,2010,310700,6,6,0,0
6,2010,310700,3,3,0,0
7,2010,310700,12,12,0,1
8,2010,310700,2,1,1,2
9,2010,310700,4,4,0,0
10,2010,310700,4,3,1,2
11,2010,310700,10,9,1,0
12,2010,310700,5,5,0,1
1,2011,310700,5,5,0,0
2,2011,310700,11,11,0,1
1,1999,310600,36,27,9,9
2,1999,310600,31,26,5,10
3,1999,310600,30,22,8,8
4,1999,310600,26,24,2,7
5,1999,310600,37,29,8,21
6,1999,310600,33,17,16,8
7,1999,310600,43,27,16,10
8,1999,310600,42,28,14,15
9,1999,310600,40,31,9,5
10,1999,310600,47,35,12,11
11,1999,310600,24,18,6,12
12,1999,310600,33,22,11,7
1,2000,310600,29,18,11,10
2,2000,310600,31,23,8,14
3,2000,310600,34,26,8,12
4,2000,310600,42,32,10,11
5,2000,310600,46,34,12,14
6,2000,310600,30,18,12,10
7,2000,310600,42,38,4,5
8,2000,310600,48,38,10,17
9,2000,310600,43,40,3,7
10,2000,310600,44,33,11,11
11,2000,310600,30,24,6,7
12,2000,310600,27,22,5,2
1,2001,310600,31,26,5,6
2,2001,310600,25,18,7,5
3,2001,310600,33,23,10,10
4,2001,310600,44,30,14,15
5,2001,310600,34,23,11,11
6,2001,310600,28,15,13,13
7,2001,310600,18,17,1,13
8,2001,310600,38,26,12,11
9,2001,310600,26,16,10,10
10,2001,310600,32,27,5,14
11,2001,310600,28,22,6,7
12,2001,310600,27,20,7,3
1,2002,310600,21,14,7,5
2,2002,310600,26,21,5,14
3,2002,310600,22,17,5,6
4,2002,310600,18,15,3,5
5,2002,310600,31,23,8,10
6,2002,310600,36,29,7,7
7,2002,310600,31,23,8,11
8,2002,310600,38,32,6,8
9,2002,310600,36,26,10,7
10,2002,310600,29,24,5,2
11,2002,310600,25,22,3,5
12,2002,310600,17,13,4,13
1,2003,310600,18,16,2,8
2,2003,310600,19,16,3,10
3,2003,310600,27,23,4,7
4,2003,310600,30,25,5,7
5,2003,310600,26,24,2,11
6,2003,310600,26,18,8,1
7,2003,310600,34,25,9,12
8,2003,310600,28,22,6,9
9,2003,310600,23,18,5,10
10,2003,310600,26,24,2,8
11,2003,310600,25,20,5,6
12,2003,310600,27,23,4,9
1,2004,310600,25,20,5,13
2,2004,310600,22,17,5,13
3,2004,310600,15,14,1,6
4,2004,310600,26,21,5,7
5,2004,310600,17,14,3,11
6,2004,310600,16,16,0,0
7,2004,310600,24,20,4,1
8,2004,310600,26,21,5,9
9,2004,310600,21,18,3,10
10,2004,310600,31,24,7,6
11,2004,310600,29,24,5,7
12,2004,310600,26,25,1,4
1,2005,310600,20,17,3,7
2,2005,310600,19,17,2,6
3,2005,310600,11,10,1,11
4,2005,310600,14,10,4,4
5,2005,310600,20,15,5,2
6,2005,310600,22,17,5,7
7,2005,310600,23,18,5,5
8,2005,310600,25,21,4,3
9,2005,310600,26,22,4,2
10,2005,310600,16,16,0,3
11,2005,310600,18,14,4,5
12,2005,310600,22,20,2,1
1,2006,310600,20,15,5,4
2,2006,310600,13,9,4,8
3,2006,310600,16,13,3,8
4,2006,310600,7,6,1,2
5,2006,310600,19,17,2,7
6,2006,310600,21,17,4,4
7,2006,310600,24,21,3,2
8,2006,310600,29,24,5,3
9,2006,310600,22,17,5,5
10,2006,310600,19,19,0,13
11,2006,310600,28,24,4,12
12,2006,310600,17,16,1,3
1,2007,310600,10,7,3,3
2,2007,310600,13,10,3,5
3,2007,310600,21,15,6,2
4,2007,310600,8,3,5,11
5,2007,310600,16,14,2,15
6,2007,310600,24,21,3,5
7,2007,310600,23,19,4,4
8,2007,310600,20,18,2,11
9,2007,310600,14,10,4,6
10,2007,310600,21,20,1,2
11,2007,310600,18,14,4,8
12,2007,310600,12,11,1,11
1,2008,310600,12,11,1,1
2,2008,310600,16,12,4,4
3,2008,310600,17,11,6,7
4,2008,310600,14,11,3,7
5,2008,310600,16,16,0,3
6,2008,310600,28,21,7,3
7,2008,310600,22,19,3,6
8,2008,310600,28,25,3,8
9,2008,310600,14,13,1,6
10,2008,310600,16,15,1,5
11,2008,310600,12,11,1,6
12,2008,310600,6,4,2,0
1,2009,310600,14,13,1,1
2,2009,310600,17,14,3,6
3,2009,310600,19,15,4,4
4,2009,310600,16,13,3,6
5,2009,310600,12,9,3,10
6,2009,310600,7,5,2,5
7,2009,310600,16,11,5,3
8,2009,310600,9,8,1,2
9,2009,310600,14,10,4,7
10,2009,310600,13,10,3,0
11,2009,310600,14,13,1,1
12,2009,310600,10,9,1,1
1,2010,310600,7,4,3,4
2,2010,310600,12,11,1,6
3,2010,310600,2,2,0,7
4,2010,310600,15,14,1,3
5,2010,310600,20,16,4,4
6,2010,310600,17,16,1,1
7,2010,310600,18,15,3,2
8,2010,310600,10,8,2,3
9,2010,310600,19,17,2,7
10,2010,310600,16,13,3,7
11,2010,310600,11,10,1,6
12,2010,310600,16,16,0,5
1,2011,310600,9,8,1,1
2,2011,310600,10,10,0,2
1,1999,310800,18,15,3,1
2,1999,310800,16,14,2,3
3,1999,310800,19,13,6,3
4,1999,310800,15,13,2,4
5,1999,310800,15,7,8,4
6,1999,310800,16,10,6,2
7,1999,310800,20,15,5,1
8,1999,310800,26,21,5,3
9,1999,310800,19,12,7,4
10,1999,310800,15,8,7,1
11,1999,310800,21,17,4,7
12,1999,310800,10,5,5,3
1,2000,310800,17,16,1,4
2,2000,310800,12,9,3,4
3,2000,310800,22,17,5,1
4,2000,310800,21,15,6,3
5,2000,310800,21,18,3,4
6,2000,310800,19,12,7,4
7,2000,310800,13,9,4,3
8,2000,310800,30,23,7,1
9,2000,310800,18,15,3,4
10,2000,310800,20,15,5,9
11,2000,310800,11,10,1,1
12,2000,310800,22,16,6,1
1,2001,310800,19,15,4,3
2,2001,310800,7,4,3,2
3,2001,310800,11,11,0,5
4,2001,310800,12,6,6,9
5,2001,310800,14,10,4,5
6,2001,310800,11,7,4,3
7,2001,310800,17,13,4,5
8,2001,310800,17,10,7,1
9,2001,310800,17,8,9,3
10,2001,310800,21,16,5,6
11,2001,310800,12,10,2,6
12,2001,310800,19,10,9,1
1,2002,310800,13,9,4,1
2,2002,310800,11,9,2,5
3,2002,310800,8,7,1,3
4,2002,310800,13,13,0,5
5,2002,310800,11,6,5,5
6,2002,310800,17,15,2,3
7,2002,310800,12,8,4,3
8,2002,310800,13,11,2,8
9,2002,310800,18,15,3,5
10,2002,310800,21,16,5,8
11,2002,310800,12,9,3,4
12,2002,310800,18,15,3,3
1,2003,310800,14,10,4,1
2,2003,310800,12,10,2,3
3,2003,310800,19,14,5,4
4,2003,310800,17,14,3,8
5,2003,310800,7,6,1,4
6,2003,310800,16,13,3,0
7,2003,310800,25,23,2,5
8,2003,310800,16,11,5,3
9,2003,310800,18,14,4,3
10,2003,310800,13,12,1,3
11,2003,310800,12,10,2,2
12,2003,310800,12,9,3,1
1,2004,310800,7,6,1,1
2,2004,310800,6,5,1,5
3,2004,310800,8,7,1,1
4,2004,310800,15,12,3,7
5,2004,310800,13,8,5,5
6,2004,310800,14,12,2,3
7,2004,310800,14,11,3,4
8,2004,310800,21,16,5,2
9,2004,310800,17,13,4,4
10,2004,310800,16,11,5,5
11,2004,310800,15,9,6,1
12,2004,310800,13,9,4,0
1,2005,310800,12,10,2,0
2,2005,310800,8,6,2,1
3,2005,310800,12,10,2,2
4,2005,310800,5,4,1,3
5,2005,310800,12,10,2,5
6,2005,310800,16,11,5,2
7,2005,310800,12,11,1,2
8,2005,310800,11,11,0,1
9,2005,310800,7,4,3,3
10,2005,310800,13,10,3,4
11,2005,310800,6,4,2,3
12,2005,310800,18,18,0,1
1,2006,310800,10,9,1,0
2,2006,310800,5,5,0,4
3,2006,310800,18,16,2,2
4,2006,310800,15,12,3,1
5,2006,310800,10,7,3,3
6,2006,310800,10,7,3,1
7,2006,310800,9,9,0,3
8,2006,310800,17,17,0,1
9,2006,310800,12,12,0,3
10,2006,310800,11,8,3,1
11,2006,310800,13,12,1,2
12,2006,310800,7,6,1,0
1,2007,310800,9,9,0,2
2,2007,310800,5,4,1,0
3,2007,310800,9,7,2,4
4,2007,310800,7,5,2,0
5,2007,310800,12,11,1,4
6,2007,310800,11,10,1,1
7,2007,310800,14,11,3,1
8,2007,310800,12,11,1,1
9,2007,310800,8,8,0,1
10,2007,310800,10,8,2,4
11,2007,310800,9,7,2,6
12,2007,310800,11,9,2,1
1,2008,310800,5,5,0,1
2,2008,310800,5,5,0,0
3,2008,310800,7,6,1,1
4,2008,310800,13,7,6,0
5,2008,310800,7,7,0,1
6,2008,310800,14,11,3,2
7,2008,310800,5,5,0,2
8,2008,310800,20,14,6,1
9,2008,310800,8,6,2,0
10,2008,310800,14,12,2,1
11,2008,310800,6,6,0,0
12,2008,310800,13,13,0,4
1,2009,310800,10,8,2,1
2,2009,310800,6,6,0,2
3,2009,310800,15,11,4,1
4,2009,310800,8,7,1,2
5,2009,310800,5,3,2,0
6,2009,310800,6,5,1,7
7,2009,310800,10,5,5,0
8,2009,310800,2,1,1,1
9,2009,310800,6,4,2,4
10,2009,310800,9,6,3,4
11,2009,310800,6,5,1,1
12,2009,310800,7,7,0,0
1,2010,310800,1,1,0,1
2,2010,310800,4,4,0,0
3,2010,310800,11,8,3,2
4,2010,310800,15,13,2,4
5,2010,310800,14,13,1,3
6,2010,310800,10,8,2,1
7,2010,310800,5,5,0,2
8,2010,310800,12,9,3,3
9,2010,310800,8,7,1,3
10,2010,310800,7,6,1,3
11,2010,310800,11,11,0,1
12,2010,310800,7,5,2,0
1,2011,310800,10,9,1,7
2,2011,310800,8,7,1,1
1,1999,310500,4,3,1,6
2,1999,310500,12,10,2,6
3,1999,310500,6,5,1,5
4,1999,310500,9,6,3,5
5,1999,310500,12,11,1,0
6,1999,310500,8,5,3,4
7,1999,310500,14,10,4,3
8,1999,310500,13,10,3,1
9,1999,310500,6,5,1,6
10,1999,310500,7,3,4,5
11,1999,310500,9,8,1,2
12,1999,310500,9,7,2,2
1,2000,310500,5,4,1,0
2,2000,310500,6,6,0,3
3,2000,310500,12,9,3,3
4,2000,310500,3,3,0,2
5,2000,310500,8,3,5,2
6,2000,310500,11,9,2,2
7,2000,310500,9,6,3,0
8,2000,310500,12,12,0,3
9,2000,310500,12,9,3,2
10,2000,310500,8,8,0,2
11,2000,310500,6,5,1,4
12,2000,310500,6,6,0,1
1,2001,310500,4,4,0,3
2,2001,310500,4,3,1,2
3,2001,310500,8,6,2,3
4,2001,310500,9,6,3,5
5,2001,310500,12,9,3,4
6,2001,310500,9,6,3,1
7,2001,310500,5,3,2,3
8,2001,310500,14,9,5,0
9,2001,310500,5,4,1,3
10,2001,310500,5,3,2,1
11,2001,310500,12,7,5,1
12,2001,310500,9,8,1,0
1,2002,310500,6,4,2,4
2,2002,310500,5,3,2,8
3,2002,310500,4,2,2,11
4,2002,310500,5,5,0,2
5,2002,310500,9,6,3,4
6,2002,310500,2,2,0,1
7,2002,310500,9,8,1,2
8,2002,310500,10,8,2,7
9,2002,310500,6,3,3,4
10,2002,310500,3,3,0,2
11,2002,310500,8,5,3,1
12,2002,310500,10,8,2,2
1,2003,310500,8,6,2,2
2,2003,310500,8,4,4,3
3,2003,310500,10,5,5,1
4,2003,310500,3,3,0,0
5,2003,310500,10,8,2,1
6,2003,310500,8,5,3,1
7,2003,310500,9,7,2,3
8,2003,310500,8,4,4,4
9,2003,310500,11,9,2,4
10,2003,310500,4,3,1,6
11,2003,310500,2,2,0,2
12,2003,310500,6,6,0,1
1,2004,310500,4,3,1,3
2,2004,310500,4,3,1,0
3,2004,310500,7,3,4,0
4,2004,310500,9,8,1,3
5,2004,310500,8,7,1,8
6,2004,310500,14,11,3,1
7,2004,310500,9,7,2,6
8,2004,310500,10,7,3,2
9,2004,310500,3,2,1,3
10,2004,310500,5,5,0,5
11,2004,310500,5,5,0,1
12,2004,310500,7,3,4,2
1,2005,310500,1,1,0,0
2,2005,310500,3,3,0,1
3,2005,310500,6,6,0,0
4,2005,310500,5,3,2,3
5,2005,310500,5,3,2,0
6,2005,310500,6,3,3,7
7,2005,310500,12,6,6,0
8,2005,310500,5,4,1,3
9,2005,310500,8,5,3,0
10,2005,310500,5,4,1,3
11,2005,310500,4,1,3,7
12,2005,310500,2,2,0,1
1,2006,310500,7,4,3,0
2,2006,310500,5,3,2,0
3,2006,310500,2,0,2,2
4,2006,310500,4,3,1,3
5,2006,310500,4,0,4,2
6,2006,310500,5,4,1,3
7,2006,310500,11,5,6,0
8,2006,310500,4,2,2,0
9,2006,310500,6,3,3,1
10,2006,310500,6,5,1,0
11,2006,310500,7,6,1,1
12,2006,310500,6,5,1,0
1,2007,310500,6,6,0,2
2,2007,310500,2,1,1,3
3,2007,310500,5,4,1,1
4,2007,310500,6,5,1,1
5,2007,310500,7,6,1,0
6,2007,310500,6,5,1,3
7,2007,310500,13,13,0,3
8,2007,310500,8,7,1,4
9,2007,310500,8,4,4,2
10,2007,310500,5,5,0,0
11,2007,310500,4,4,0,1
12,2007,310500,5,4,1,2
1,2008,310500,3,1,2,4
2,2008,310500,3,3,0,2
3,2008,310500,2,2,0,1
4,2008,310500,4,3,1,0
5,2008,310500,3,1,2,1
6,2008,310500,10,9,1,1
7,2008,310500,2,2,0,1
8,2008,310500,2,1,1,1
9,2008,310500,1,1,0,2
10,2008,310500,5,4,1,1
11,2008,310500,5,3,2,0
12,2008,310500,3,3,0,0
1,2009,310500,3,2,1,0
2,2009,310500,5,5,0,1
3,2009,310500,4,3,1,1
4,2009,310500,2,2,0,3
5,2009,310500,7,4,3,4
6,2009,310500,3,1,2,2
7,2009,310500,5,5,0,2
8,2009,310500,8,7,1,0
9,2009,310500,6,2,4,2
10,2009,310500,4,2,2,4
11,2009,310500,4,3,1,0
12,2009,310500,2,2,0,1
1,2010,310500,2,0,2,0
2,2010,310500,6,4,2,0
3,2010,310500,5,4,1,2
4,2010,310500,7,5,2,0
5,2010,310500,4,3,1,1
6,2010,310500,6,5,1,1
7,2010,310500,5,4,1,2
8,2010,310500,3,2,1,0
9,2010,310500,7,5,2,2
10,2010,310500,4,3,1,1
11,2010,310500,2,1,1,1
12,2010,310500,2,1,1,1
1,2011,310500,3,2,1,4
2,2011,310500,1,1,0,0
1,1999,841600,10,7,3,13
2,1999,841600,14,11,3,7
3,1999,841600,7,7,0,11
4,1999,841600,16,10,6,2
5,1999,841600,9,8,1,2
6,1999,841600,15,13,2,6
7,1999,841600,12,7,5,12
8,1999,841600,8,7,1,9
9,1999,841600,15,12,3,12
10,1999,841600,14,11,3,18
11,1999,841600,12,8,4,6
12,1999,841600,7,6,1,5
1,2000,841600,6,3,3,6
2,2000,841600,11,5,6,5
3,2000,841600,5,4,1,8
4,2000,841600,8,8,0,2
5,2000,841600,6,5,1,9
6,2000,841600,8,5,3,5
7,2000,841600,11,8,3,6
8,2000,841600,13,10,3,5
9,2000,841600,12,10,2,8
10,2000,841600,5,3,2,13
11,2000,841600,9,7,2,4
12,2000,841600,11,8,3,1
1,2001,841600,10,9,1,4
2,2001,841600,3,3,0,7
3,2001,841600,13,9,4,3
4,2001,841600,11,6,5,7
5,2001,841600,9,6,3,8
6,2001,841600,11,8,3,6
7,2001,841600,12,10,2,7
8,2001,841600,9,8,1,11
9,2001,841600,11,8,3,7
10,2001,841600,13,7,6,4
11,2001,841600,12,9,3,8
12,2001,841600,6,5,1,0
1,2002,841600,11,7,4,2
2,2002,841600,11,8,3,7
3,2002,841600,8,5,3,6
4,2002,841600,16,11,5,14
5,2002,841600,8,6,2,10
6,2002,841600,10,5,5,6
7,2002,841600,9,6,3,6
8,2002,841600,12,12,0,5
9,2002,841600,12,8,4,4
10,2002,841600,12,10,2,5
11,2002,841600,10,8,2,15
12,2002,841600,3,3,0,9
1,2003,841600,9,8,1,11
2,2003,841600,7,4,3,8
3,2003,841600,13,10,3,6
4,2003,841600,9,6,3,6
5,2003,841600,7,3,4,6
6,2003,841600,11,11,0,7
7,2003,841600,9,9,0,11
8,2003,841600,9,7,2,16
9,2003,841600,7,4,3,5
10,2003,841600,7,7,0,8
11,2003,841600,8,4,4,9
12,2003,841600,15,14,1,3
1,2004,841600,9,8,1,6
2,2004,841600,2,2,0,9
3,2004,841600,10,9,1,10
4,2004,841600,7,7,0,15
5,2004,841600,3,1,2,8
6,2004,841600,9,6,3,7
7,2004,841600,8,6,2,6
8,2004,841600,7,3,4,6
9,2004,841600,10,6,4,4
10,2004,841600,4,2,2,4
11,2004,841600,10,9,1,16
12,2004,841600,8,8,0,2
1,2005,841600,7,4,3,6
2,2005,841600,9,5,4,6
3,2005,841600,2,1,1,7
4,2005,841600,8,7,1,5
5,2005,841600,13,13,0,17
6,2005,841600,14,13,1,7
7,2005,841600,16,14,2,10
8,2005,841600,7,2,5,11
9,2005,841600,7,7,0,2
10,2005,841600,16,15,1,3
11,2005,841600,8,8,0,9
12,2005,841600,4,4,0,2
1,2006,841600,4,4,0,3
2,2006,841600,2,2,0,6
3,2006,841600,6,4,2,11
4,2006,841600,7,6,1,3
5,2006,841600,12,12,0,4
6,2006,841600,5,3,2,4
7,2006,841600,4,3,1,10
8,2006,841600,7,6,1,5
9,2006,841600,5,1,4,12
10,2006,841600,3,2,1,3
11,2006,841600,7,6,1,9
12,2006,841600,7,6,1,3
1,2007,841600,5,5,0,7
2,2007,841600,4,2,2,3
3,2007,841600,9,8,1,4
4,2007,841600,8,7,1,2
5,2007,841600,8,6,2,8
6,2007,841600,8,4,4,3
7,2007,841600,10,9,1,3
8,2007,841600,11,9,2,2
9,2007,841600,8,7,1,4
10,2007,841600,10,7,3,7
11,2007,841600,10,9,1,4
12,2007,841600,4,3,1,2
1,2008,841600,7,5,2,1
2,2008,841600,4,4,0,6
3,2008,841600,9,8,1,1
4,2008,841600,8,5,3,1
5,2008,841600,7,6,1,2
6,2008,841600,7,5,2,4
7,2008,841600,2,2,0,6
8,2008,841600,4,3,1,2
9,2008,841600,8,5,3,4
10,2008,841600,5,5,0,2
11,2008,841600,8,7,1,2
12,2008,841600,7,7,0,2
1,2009,841600,3,3,0,2
2,2009,841600,11,9,2,0
3,2009,841600,9,6,3,4
4,2009,841600,3,1,2,1
5,2009,841600,9,5,4,1
6,2009,841600,7,5,2,5
7,2009,841600,11,9,2,2
8,2009,841600,7,5,2,2
9,2009,841600,4,3,1,0
10,2009,841600,8,5,3,1
11,2009,841600,9,6,3,0
12,2009,841600,10,9,1,0
1,2010,841600,9,9,0,1
2,2010,841600,1,1,0,1
3,2010,841600,10,8,2,1
4,2010,841600,8,6,2,1
5,2010,841600,6,4,2,5
6,2010,841600,9,7,2,1
7,2010,841600,6,4,2,3
8,2010,841600,9,7,2,3
9,2010,841600,4,4,0,1
10,2010,841600,13,11,2,1
11,2010,841600,13,10,3,4
12,2010,841600,5,5,0,1
1,2011,841600,8,6,2,4
2,2011,841600,8,5,3,2
1,1999,310400,5,5,0,0
2,1999,310400,7,6,1,2
3,1999,310400,2,1,1,2
4,1999,310400,5,4,1,4
5,1999,310400,3,2,1,1
6,1999,310400,5,3,2,2
7,1999,310400,9,8,1,1
8,1999,310400,5,5,0,2
9,1999,310400,10,9,1,0
10,1999,310400,7,5,2,2
11,1999,310400,4,4,0,1
12,1999,310400,4,2,2,1
1,2000,310400,10,7,3,2
2,2000,310400,7,5,2,3
3,2000,310400,7,6,1,0
4,2000,310400,7,7,0,2
5,2000,310400,10,7,3,0
6,2000,310400,9,9,0,0
7,2000,310400,5,2,3,1
8,2000,310400,13,10,3,0
9,2000,310400,5,4,1,0
10,2000,310400,10,9,1,0
11,2000,310400,3,3,0,2
12,2000,310400,5,5,0,0
1,2001,310400,2,1,1,1
2,2001,310400,5,3,2,2
3,2001,310400,3,3,0,2
4,2001,310400,3,1,2,4
5,2001,310400,9,6,3,0
6,2001,310400,2,1,1,3
7,2001,310400,5,3,2,1
8,2001,310400,5,4,1,4
9,2001,310400,8,7,1,2
10,2001,310400,6,6,0,0
11,2001,310400,4,2,2,1
12,2001,310400,6,5,1,0
1,2002,310400,4,4,0,1
2,2002,310400,5,5,0,0
3,2002,310400,1,1,0,1
4,2002,310400,2,2,0,1
5,2002,310400,3,2,1,2
6,2002,310400,8,3,5,0
7,2002,310400,11,9,2,2
8,2002,310400,6,4,2,0
9,2002,310400,5,3,2,0
10,2002,310400,6,4,2,1
11,2002,310400,7,6,1,1
12,2002,310400,1,1,0,0
1,2003,310400,4,4,0,0
2,2003,310400,7,5,2,0
3,2003,310400,4,3,1,1
4,2003,310400,7,6,1,1
5,2003,310400,2,1,1,1
6,2003,310400,4,4,0,2
7,2003,310400,5,3,2,3
8,2003,310400,8,7,1,3
9,2003,310400,5,5,0,1
10,2003,310400,7,7,0,1
11,2003,310400,5,4,1,1
12,2003,310400,5,4,1,0
1,2004,310400,3,2,1,1
2,2004,310400,3,3,0,1
3,2004,310400,5,5,0,2
4,2004,310400,6,6,0,3
5,2004,310400,4,2,2,3
6,2004,310400,2,2,0,1
7,2004,310400,6,5,1,2
8,2004,310400,8,7,1,4
9,2004,310400,5,3,2,1
10,2004,310400,6,5,1,0
11,2004,310400,2,1,1,0
12,2004,310400,5,3,2,0
1,2005,310400,7,5,2,0
2,2005,310400,4,3,1,0
3,2005,310400,2,2,0,0
4,2005,310400,4,4,0,3
5,2005,310400,4,3,1,0
6,2005,310400,4,2,2,1
7,2005,310400,3,3,0,0
8,2005,310400,7,6,1,0
9,2005,310400,4,3,1,0
10,2005,310400,3,2,1,0
11,2005,310400,7,6,1,2
12,2005,310400,1,1,0,1
1,2006,310400,3,1,2,0
2,2006,310400,5,5,0,1
3,2006,310400,6,6,0,0
4,2006,310400,2,1,1,2
5,2006,310400,9,9,0,2
6,2006,310400,4,3,1,0
7,2006,310400,12,12,0,0
8,2006,310400,7,6,1,0
9,2006,310400,3,3,0,0
10,2006,310400,2,2,0,2
11,2006,310400,5,3,2,0
12,2006,310400,4,4,0,1
1,2007,310400,5,5,0,0
2,2007,310400,6,6,0,1
3,2007,310400,3,3,0,0
4,2007,310400,3,3,0,4
5,2007,310400,10,7,3,1
6,2007,310400,9,9,0,4
7,2007,310400,5,4,1,1
8,2007,310400,12,12,0,3
9,2007,310400,5,5,0,0
10,2007,310400,3,2,1,1
11,2007,310400,5,4,1,0
12,2007,310400,5,5,0,0
1,2008,310400,3,3,0,1
2,2008,310400,1,0,1,0
3,2008,310400,4,4,0,2
4,2008,310400,6,5,1,0
5,2008,310400,12,9,3,2
6,2008,310400,1,1,0,1
7,2008,310400,5,2,3,0
8,2008,310400,3,1,2,1
9,2008,310400,2,2,0,1
10,2008,310400,0,0,0,0
11,2008,310400,1,1,0,0
12,2008,310400,6,5,1,1
1,2009,310400,4,4,0,0
2,2009,310400,1,1,0,0
3,2009,310400,1,1,0,1
4,2009,310400,2,2,0,2
5,2009,310400,2,2,0,0
6,2009,310400,4,2,2,0
7,2009,310400,6,5,1,2
8,2009,310400,8,7,1,3
9,2009,310400,4,3,1,0
10,2009,310400,5,4,1,1
11,2009,310400,2,2,0,1
12,2009,310400,5,4,1,3
1,2010,310400,6,6,0,1
2,2010,310400,2,2,0,0
3,2010,310400,4,4,0,1
4,2010,310400,4,3,1,0
5,2010,310400,3,2,1,0
6,2010,310400,3,2,1,1
7,2010,310400,9,7,2,3
8,2010,310400,4,3,1,0
9,2010,310400,4,3,1,1
10,2010,310400,1,0,1,3
11,2010,310400,4,4,0,1
12,2010,310400,9,8,1,1
1,2011,310400,3,3,0,4
2,2011,310400,0,0,0,0
1,1999,310300,6,6,0,2
2,1999,310300,7,6,1,2
3,1999,310300,15,11,4,5
4,1999,310300,10,9,1,4
5,1999,310300,9,5,4,0
6,1999,310300,7,4,3,0
7,1999,310300,10,6,4,1
8,1999,310300,10,10,0,1
9,1999,310300,9,4,5,4
10,1999,310300,11,9,2,2
11,1999,310300,8,7,1,1
12,1999,310300,4,4,0,0
1,2000,310300,7,5,2,1
2,2000,310300,8,7,1,0
3,2000,310300,9,7,2,1
4,2000,310300,12,11,1,7
5,2000,310300,13,11,2,2
6,2000,310300,15,15,0,1
7,2000,310300,14,11,3,2
8,2000,310300,20,18,2,4
9,2000,310300,20,16,4,0
10,2000,310300,7,6,1,1
11,2000,310300,8,7,1,2
12,2000,310300,7,4,3,0
1,2001,310300,10,9,1,0
2,2001,310300,13,11,2,1
3,2001,310300,3,3,0,0
4,2001,310300,4,3,1,2
5,2001,310300,7,6,1,1
6,2001,310300,6,6,0,1
7,2001,310300,9,5,4,1
8,2001,310300,6,6,0,0
9,2001,310300,14,10,4,4
10,2001,310300,12,11,1,3
11,2001,310300,11,7,4,0
12,2001,310300,9,8,1,1
1,2002,310300,10,10,0,1
2,2002,310300,9,7,2,4
3,2002,310300,8,5,3,3
4,2002,310300,13,9,4,6
5,2002,310300,14,11,3,0
6,2002,310300,11,9,2,1
7,2002,310300,14,13,1,2
8,2002,310300,6,2,4,0
9,2002,310300,10,10,0,1
10,2002,310300,8,8,0,0
11,2002,310300,13,13,0,0
12,2002,310300,7,6,1,1
1,2003,310300,11,10,1,1
2,2003,310300,7,2,5,0
3,2003,310300,10,8,2,1
4,2003,310300,10,6,4,6
5,2003,310300,15,12,3,1
6,2003,310300,8,7,1,1
7,2003,310300,11,9,2,3
8,2003,310300,8,6,2,1
9,2003,310300,13,7,6,1
10,2003,310300,8,8,0,1
11,2003,310300,10,9,1,3
12,2003,310300,10,10,0,0
1,2004,310300,10,10,0,0
2,2004,310300,6,5,1,3
3,2004,310300,6,5,1,4
4,2004,310300,3,3,0,0
5,2004,310300,7,7,0,2
6,2004,310300,8,5,3,1
7,2004,310300,9,8,1,1
8,2004,310300,8,8,0,2
9,2004,310300,14,12,2,3
10,2004,310300,14,12,2,4
11,2004,310300,3,2,1,0
12,2004,310300,15,14,1,1
1,2005,310300,15,14,1,0
2,2005,310300,4,4,0,1
3,2005,310300,7,6,1,1
4,2005,310300,8,6,2,1
5,2005,310300,5,4,1,1
6,2005,310300,6,6,0,2
7,2005,310300,7,7,0,4
8,2005,310300,8,7,1,5
9,2005,310300,5,5,0,2
10,2005,310300,7,5,2,0
11,2005,310300,5,4,1,1
12,2005,310300,9,9,0,0
1,2006,310300,8,8,0,1
2,2006,310300,8,8,0,1
3,2006,310300,4,4,0,1
4,2006,310300,8,7,1,1
5,2006,310300,8,7,1,0
6,2006,310300,19,17,2,3
7,2006,310300,20,20,0,2
8,2006,310300,10,10,0,0
9,2006,310300,18,17,1,0
10,2006,310300,16,14,2,0
11,2006,310300,8,8,0,1
12,2006,310300,12,11,1,2
1,2007,310300,13,11,2,0
2,2007,310300,12,11,1,0
3,2007,310300,11,10,1,1
4,2007,310300,9,9,0,0
5,2007,310300,11,11,0,3
6,2007,310300,11,10,1,1
7,2007,310300,13,11,2,0
8,2007,310300,18,15,3,1
9,2007,310300,8,8,0,2
10,2007,310300,7,6,1,1
11,2007,310300,9,9,0,1
12,2007,310300,6,6,0,0
1,2008,310300,8,5,3,0
2,2008,310300,7,4,3,0
3,2008,310300,5,5,0,0
4,2008,310300,11,8,3,0
5,2008,310300,10,9,1,0
6,2008,310300,7,6,1,1
7,2008,310300,7,6,1,3
8,2008,310300,21,21,0,1
9,2008,310300,15,14,1,1
10,2008,310300,11,10,1,1
11,2008,310300,7,5,2,0
12,2008,310300,7,7,0,0
1,2009,310300,9,7,2,1
2,2009,310300,4,4,0,2
3,2009,310300,4,3,1,3
4,2009,310300,2,2,0,3
5,2009,310300,3,2,1,0
6,2009,310300,6,6,0,1
7,2009,310300,11,10,1,4
8,2009,310300,13,11,2,1
9,2009,310300,9,8,1,1
10,2009,310300,7,6,1,1
11,2009,310300,5,3,2,0
12,2009,310300,8,8,0,2
1,2010,310300,7,7,0,0
2,2010,310300,6,6,0,0
3,2010,310300,9,9,0,5
4,2010,310300,6,5,1,4
5,2010,310300,5,5,0,4
6,2010,310300,10,10,0,1
7,2010,310300,10,9,1,2
8,2010,310300,6,6,0,2
9,2010,310300,8,8,0,2
10,2010,310300,12,11,1,3
11,2010,310300,5,5,0,2
12,2010,310300,17,13,4,2
1,2011,310300,7,6,1,1
2,2011,310300,5,5,0,2
1,1999,330200,18,17,1,4
2,1999,330200,14,13,1,5
3,1999,330200,18,14,4,6
4,1999,330200,17,15,2,4
5,1999,330200,25,25,0,9
6,1999,330200,16,16,0,2
7,1999,330200,26,20,6,1
8,1999,330200,37,33,4,1
9,1999,330200,27,25,2,1
10,1999,330200,21,21,0,2
11,1999,330200,13,13,0,1
12,1999,330200,8,8,0,1
1,2000,330200,10,10,0,0
2,2000,330200,11,11,0,2
3,2000,330200,15,12,3,3
4,2000,330200,13,12,1,1
5,2000,330200,23,22,1,2
6,2000,330200,12,11,1,2
7,2000,330200,11,9,2,3
8,2000,330200,13,13,0,1
9,2000,330200,19,19,0,0
10,2000,330200,22,21,1,4
11,2000,330200,26,25,1,3
12,2000,330200,7,7,0,1
1,2001,330200,11,11,0,3
2,2001,330200,7,7,0,1
3,2001,330200,13,12,1,3
4,2001,330200,11,11,0,5
5,2001,330200,16,15,1,1
6,2001,330200,9,9,0,2
7,2001,330200,13,12,1,2
8,2001,330200,23,21,2,2
9,2001,330200,16,16,0,2
10,2001,330200,12,12,0,0
11,2001,330200,12,12,0,2
12,2001,330200,6,6,0,0
1,2002,330200,10,10,0,0
2,2002,330200,7,7,0,0
3,2002,330200,9,9,0,0
4,2002,330200,14,13,1,3
5,2002,330200,11,11,0,0
6,2002,330200,18,18,0,1
7,2002,330200,10,10,0,0
8,2002,330200,10,10,0,1
9,2002,330200,6,6,0,0
10,2002,330200,10,10,0,1
11,2002,330200,12,12,0,1
12,2002,330200,9,9,0,1
1,2003,330200,16,15,1,3
2,2003,330200,11,11,0,0
3,2003,330200,15,15,0,0
4,2003,330200,7,7,0,1
5,2003,330200,10,9,1,3
6,2003,330200,8,7,1,2
7,2003,330200,14,13,1,0
8,2003,330200,10,9,1,1
9,2003,330200,22,21,1,1
10,2003,330200,13,12,1,0
11,2003,330200,7,7,0,1
12,2003,330200,5,5,0,0
1,2004,330200,6,4,2,1
2,2004,330200,2,2,0,0
3,2004,330200,10,9,1,0
4,2004,330200,7,7,0,1
5,2004,330200,11,11,0,0
6,2004,330200,10,10,0,1
7,2004,330200,13,13,0,3
8,2004,330200,11,11,0,1
9,2004,330200,13,11,2,0
10,2004,330200,11,11,0,0
11,2004,330200,12,12,0,1
12,2004,330200,19,19,0,0
1,2005,330200,15,13,2,0
2,2005,330200,4,4,0,1
3,2005,330200,5,5,0,0
4,2005,330200,10,10,0,0
5,2005,330200,17,16,1,0
6,2005,330200,9,9,0,0
7,2005,330200,18,18,0,0
8,2005,330200,15,15,0,1
9,2005,330200,10,10,0,0
10,2005,330200,7,7,0,1
11,2005,330200,13,13,0,0
12,2005,330200,10,10,0,0
1,2006,330200,5,5,0,0
2,2006,330200,11,11,0,0
3,2006,330200,12,11,1,1
4,2006,330200,15,14,1,2
5,2006,330200,6,6,0,1
6,2006,330200,11,11,0,0
7,2006,330200,12,12,0,0
8,2006,330200,7,7,0,0
9,2006,330200,17,17,0,4
10,2006,330200,12,11,1,0
11,2006,330200,16,16,0,0
12,2006,330200,11,11,0,0
1,2007,330200,6,6,0,0
2,2007,330200,5,5,0,0
3,2007,330200,12,11,1,1
4,2007,330200,6,5,1,1
5,2007,330200,14,14,0,0
6,2007,330200,11,11,0,1
7,2007,330200,16,16,0,1
8,2007,330200,9,9,0,0
9,2007,330200,13,12,1,1
10,2007,330200,13,12,1,1
11,2007,330200,9,9,0,0
12,2007,330200,7,7,0,1
1,2008,330200,10,10,0,1
2,2008,330200,5,5,0,2
3,2008,330200,7,6,1,0
4,2008,330200,3,3,0,1
5,2008,330200,12,11,1,1
6,2008,330200,8,8,0,1
7,2008,330200,11,10,1,0
8,2008,330200,14,14,0,1
9,2008,330200,11,11,0,1
10,2008,330200,5,5,0,1
11,2008,330200,12,10,2,0
12,2008,330200,7,7,0,1
1,2009,330200,3,3,0,1
2,2009,330200,6,6,0,1
3,2009,330200,5,4,1,0
4,2009,330200,10,8,2,0
5,2009,330200,9,8,1,1
6,2009,330200,9,9,0,0
7,2009,330200,9,9,0,0
8,2009,330200,14,14,0,0
9,2009,330200,17,17,0,1
10,2009,330200,14,14,0,0
11,2009,330200,7,7,0,0
12,2009,330200,10,10,0,0
1,2010,330200,7,7,0,1
2,2010,330200,6,6,0,0
3,2010,330200,9,9,0,2
4,2010,330200,12,12,0,0
5,2010,330200,8,8,0,0
6,2010,330200,15,14,1,0
7,2010,330200,22,22,0,0
8,2010,330200,15,13,2,0
9,2010,330200,11,11,0,0
10,2010,330200,10,10,0,0
11,2010,330200,11,10,1,1
12,2010,330200,12,11,1,0
1,2011,330200,12,12,0,1
2,2011,330200,9,8,1,0
1,1999,292200,29,22,7,44
2,1999,292200,20,15,5,23
3,1999,292200,23,16,7,22
4,1999,292200,20,11,9,25
5,1999,292200,17,11,6,29
6,1999,292200,23,18,5,23
7,1999,292200,32,21,11,34
8,1999,292200,21,17,4,11
9,1999,292200,21,6,15,23
10,1999,292200,22,17,5,33
11,1999,292200,29,20,9,29
12,1999,292200,15,13,2,31
1,2000,292200,16,12,4,35
2,2000,292200,15,11,4,17
3,2000,292200,17,15,2,32
4,2000,292200,14,11,3,42
5,2000,292200,17,8,9,23
6,2000,292200,15,6,9,37
7,2000,292200,31,22,9,39
8,2000,292200,28,19,9,18
9,2000,292200,26,19,7,26
10,2000,292200,19,13,6,19
11,2000,292200,12,7,5,21
12,2000,292200,17,14,3,18
1,2001,292200,12,9,3,22
2,2001,292200,21,18,3,29
3,2001,292200,12,10,2,25
4,2001,292200,23,13,10,18
5,2001,292200,19,15,4,21
6,2001,292200,16,12,4,19
7,2001,292200,26,19,7,13
8,2001,292200,20,15,5,21
9,2001,292200,28,23,5,15
10,2001,292200,22,15,7,13
11,2001,292200,21,18,3,8
12,2001,292200,18,15,3,10
1,2002,292200,20,17,3,19
2,2002,292200,15,11,4,20
3,2002,292200,18,13,5,15
4,2002,292200,21,15,6,9
5,2002,292200,27,21,6,15
6,2002,292200,32,26,6,13
7,2002,292200,25,19,6,5
8,2002,292200,30,21,9,9
9,2002,292200,22,17,5,11
10,2002,292200,22,19,3,12
11,2002,292200,11,8,3,18
12,2002,292200,20,17,3,19
1,2003,292200,18,15,3,9
2,2003,292200,10,7,3,11
3,2003,292200,16,12,4,9
4,2003,292200,13,9,4,13
5,2003,292200,19,16,3,19
6,2003,292200,23,17,6,19
7,2003,292200,33,22,11,22
8,2003,292200,32,24,8,20
9,2003,292200,22,19,3,10
10,2003,292200,35,26,9,19
11,2003,292200,17,15,2,27
12,2003,292200,18,12,6,30
1,2004,292200,21,15,6,29
2,2004,292200,13,10,3,22
3,2004,292200,13,11,2,22
4,2004,292200,18,13,5,22
5,2004,292200,14,11,3,32
6,2004,292200,28,20,8,21
7,2004,292200,33,18,15,22
8,2004,292200,35,26,9,31
9,2004,292200,18,10,8,23
10,2004,292200,20,19,1,17
11,2004,292200,25,21,4,30
12,2004,292200,20,17,3,21
1,2005,292200,22,18,4,17
2,2005,292200,20,16,4,17
3,2005,292200,17,11,6,24
4,2005,292200,15,12,3,33
5,2005,292200,22,17,5,29
6,2005,292200,27,21,6,22
7,2005,292200,21,17,4,21
8,2005,292200,22,16,6,17
9,2005,292200,23,17,6,9
10,2005,292200,32,23,9,13
11,2005,292200,18,14,4,29
12,2005,292200,11,9,2,21
1,2006,292200,24,19,5,30
2,2006,292200,23,21,2,23
3,2006,292200,22,15,7,26
4,2006,292200,17,15,2,30
5,2006,292200,24,14,10,23
6,2006,292200,26,12,14,26
7,2006,292200,30,26,4,38
8,2006,292200,19,15,4,21
9,2006,292200,22,16,6,26
10,2006,292200,28,22,6,11
11,2006,292200,19,12,7,6
12,2006,292200,23,16,7,22
1,2007,292200,13,13,0,11
2,2007,292200,18,15,3,16
3,2007,292200,21,15,6,25
4,2007,292200,35,24,11,13
5,2007,292200,16,14,2,9
6,2007,292200,22,19,3,15
7,2007,292200,18,12,6,17
8,2007,292200,23,17,6,20
9,2007,292200,25,17,8,24
10,2007,292200,24,18,6,7
11,2007,292200,24,21,3,13
12,2007,292200,13,11,2,8
1,2008,292200,21,14,7,16
2,2008,292200,19,15,4,14
3,2008,292200,12,10,2,24
4,2008,292200,21,16,5,7
5,2008,292200,36,30,6,14
6,2008,292200,33,25,8,7
7,2008,292200,33,23,10,7
8,2008,292200,27,20,7,8
9,2008,292200,28,23,5,4
10,2008,292200,26,23,3,10
11,2008,292200,23,18,5,16
12,2008,292200,12,8,4,8
1,2009,292200,14,13,1,11
2,2009,292200,9,7,2,21
3,2009,292200,20,14,6,10
4,2009,292200,12,9,3,13
5,2009,292200,20,12,8,10
6,2009,292200,27,22,5,7
7,2009,292200,25,21,4,8
8,2009,292200,35,27,8,7
9,2009,292200,23,17,6,8
10,2009,292200,29,24,5,11
11,2009,292200,27,23,4,6
12,2009,292200,23,18,5,8
1,2010,292200,21,16,5,11
2,2010,292200,18,13,5,8
3,2010,292200,28,22,6,15
4,2010,292200,23,15,8,12
5,2010,292200,23,19,4,14
6,2010,292200,22,17,5,5
7,2010,292200,32,23,9,9
8,2010,292200,26,19,7,24
9,2010,292200,25,18,7,6
10,2010,292200,22,21,1,11
11,2010,292200,27,24,3,13
12,2010,292200,22,17,5,7
1,2011,292200,19,16,3,10
2,2011,292200,8,8,0,14
1,1999,843100,7,6,1,8
2,1999,843100,9,5,4,7
3,1999,843100,16,10,6,3
4,1999,843100,19,17,2,6
5,1999,843100,14,9,5,2
6,1999,843100,13,9,4,3
7,1999,843100,10,8,2,1
8,1999,843100,17,12,5,6
9,1999,843100,19,14,5,4
10,1999,843100,17,13,4,7
11,1999,843100,9,6,3,5
12,1999,843100,8,7,1,3
1,2000,843100,11,10,1,4
2,2000,843100,10,5,5,6
3,2000,843100,17,12,5,5
4,2000,843100,26,22,4,4
5,2000,843100,14,8,6,5
6,2000,843100,13,10,3,6
7,2000,843100,18,18,0,1
8,2000,843100,15,8,7,3
9,2000,843100,13,12,1,1
10,2000,843100,17,14,3,5
11,2000,843100,16,11,5,4
12,2000,843100,9,8,1,1
1,2001,843100,9,7,2,2
2,2001,843100,15,13,2,0
3,2001,843100,9,6,3,5
4,2001,843100,18,11,7,6
5,2001,843100,18,13,5,3
6,2001,843100,18,15,3,7
7,2001,843100,15,11,4,1
8,2001,843100,15,13,2,10
9,2001,843100,13,10,3,2
10,2001,843100,8,5,3,2
11,2001,843100,19,14,5,2
12,2001,843100,14,10,4,4
1,2002,843100,16,12,4,2
2,2002,843100,15,10,5,5
3,2002,843100,21,16,5,3
4,2002,843100,13,10,3,13
5,2002,843100,15,12,3,1
6,2002,843100,11,9,2,1
7,2002,843100,9,4,5,4
8,2002,843100,17,14,3,20
9,2002,843100,16,13,3,4
10,2002,843100,18,15,3,7
11,2002,843100,13,11,2,5
12,2002,843100,8,4,4,4
1,2003,843100,11,8,3,7
2,2003,843100,14,9,5,10
3,2003,843100,13,11,2,5
4,2003,843100,8,8,0,5
5,2003,843100,13,7,6,1
6,2003,843100,17,11,6,7
7,2003,843100,20,17,3,15
8,2003,843100,22,19,3,14
9,2003,843100,14,10,4,2
10,2003,843100,27,22,5,9
11,2003,843100,18,17,1,6
12,2003,843100,14,14,0,16
1,2004,843100,9,7,2,11
2,2004,843100,13,10,3,14
3,2004,843100,16,15,1,8
4,2004,843100,18,16,2,8
5,2004,843100,18,13,5,9
6,2004,843100,20,15,5,7
7,2004,843100,15,9,6,7
8,2004,843100,27,17,10,2
9,2004,843100,14,13,1,7
10,2004,843100,17,16,1,6
11,2004,843100,13,11,2,9
12,2004,843100,10,6,4,3
1,2005,843100,14,10,4,11
2,2005,843100,13,10,3,26
3,2005,843100,12,10,2,12
4,2005,843100,14,4,10,18
5,2005,843100,17,13,4,8
6,2005,843100,7,7,0,5
7,2005,843100,20,15,5,16
8,2005,843100,10,8,2,11
9,2005,843100,14,12,2,14
10,2005,843100,12,8,4,6
11,2005,843100,10,10,0,10
12,2005,843100,15,14,1,4
1,2006,843100,10,6,4,7
2,2006,843100,10,9,1,9
3,2006,843100,10,9,1,20
4,2006,843100,12,10,2,11
5,2006,843100,15,12,3,9
6,2006,843100,10,10,0,17
7,2006,843100,14,8,6,24
8,2006,843100,9,6,3,18
9,2006,843100,15,12,3,20
10,2006,843100,12,11,1,7
11,2006,843100,14,12,2,15
12,2006,843100,10,9,1,8
1,2007,843100,9,8,1,15
2,2007,843100,9,7,2,3
3,2007,843100,14,12,2,5
4,2007,843100,7,5,2,16
5,2007,843100,17,11,6,5
6,2007,843100,6,6,0,9
7,2007,843100,17,15,2,7
8,2007,843100,19,18,1,9
9,2007,843100,9,8,1,12
10,2007,843100,13,8,5,12
11,2007,843100,10,8,2,8
12,2007,843100,4,4,0,7
1,2008,843100,18,12,6,6
2,2008,843100,6,5,1,6
3,2008,843100,8,6,2,3
4,2008,843100,15,13,2,9
5,2008,843100,15,11,4,7
6,2008,843100,9,5,4,10
7,2008,843100,13,9,4,15
8,2008,843100,19,13,6,13
9,2008,843100,22,18,4,5
10,2008,843100,16,12,4,5
11,2008,843100,8,5,3,5
12,2008,843100,10,9,1,3
1,2009,843100,10,5,5,6
2,2009,843100,4,4,0,3
3,2009,843100,11,7,4,3
4,2009,843100,7,6,1,3
5,2009,843100,12,12,0,7
6,2009,843100,16,14,2,2
7,2009,843100,12,11,1,2
8,2009,843100,13,10,3,4
9,2009,843100,10,9,1,2
10,2009,843100,14,10,4,4
11,2009,843100,10,10,0,2
12,2009,843100,4,4,0,4
1,2010,843100,11,10,1,3
2,2010,843100,10,9,1,8
3,2010,843100,12,10,2,5
4,2010,843100,10,8,2,1
5,2010,843100,12,10,2,2
6,2010,843100,12,11,1,0
7,2010,843100,13,10,3,7
8,2010,843100,22,17,5,5
9,2010,843100,11,11,0,8
10,2010,843100,14,11,3,3
11,2010,843100,17,13,4,5
12,2010,843100,6,5,1,2
1,2011,843100,17,17,0,9
2,2011,843100,9,6,3,0
1,1999,291600,1,0,1,2
2,1999,291600,5,5,0,2
3,1999,291600,10,8,2,4
4,1999,291600,5,2,3,8
5,1999,291600,2,2,0,5
6,1999,291600,9,7,2,5
7,1999,291600,6,5,1,3
8,1999,291600,5,4,1,6
9,1999,291600,4,4,0,0
10,1999,291600,5,4,1,0
11,1999,291600,3,3,0,4
12,1999,291600,3,3,0,6
1,2000,291600,2,2,0,3
2,2000,291600,1,1,0,5
3,2000,291600,4,3,1,7
4,2000,291600,1,1,0,4
5,2000,291600,6,3,3,4
6,2000,291600,4,3,1,2
7,2000,291600,7,7,0,9
8,2000,291600,8,5,3,4
9,2000,291600,2,2,0,2
10,2000,291600,4,2,2,0
11,2000,291600,5,4,1,1
12,2000,291600,2,1,1,1
1,2001,291600,4,4,0,1
2,2001,291600,0,0,0,17
3,2001,291600,1,1,0,0
4,2001,291600,7,7,0,2
5,2001,291600,2,1,1,0
6,2001,291600,6,5,1,1
7,2001,291600,4,4,0,0
8,2001,291600,3,3,0,0
9,2001,291600,1,0,1,1
10,2001,291600,4,3,1,0
11,2001,291600,2,2,0,0
12,2001,291600,6,5,1,2
1,2002,291600,3,2,1,0
2,2002,291600,2,2,0,0
3,2002,291600,5,3,2,0
4,2002,291600,5,5,0,0
5,2002,291600,2,2,0,1
6,2002,291600,3,2,1,1
7,2002,291600,10,6,4,0
8,2002,291600,5,2,3,0
9,2002,291600,5,3,2,0
10,2002,291600,1,1,0,1
11,2002,291600,3,2,1,0
12,2002,291600,2,2,0,0
1,2003,291600,3,2,1,0
2,2003,291600,1,1,0,0
3,2003,291600,6,5,1,0
4,2003,291600,5,4,1,0
5,2003,291600,9,9,0,0
6,2003,291600,6,4,2,0
7,2003,291600,8,8,0,0
8,2003,291600,8,7,1,0
9,2003,291600,3,2,1,1
10,2003,291600,4,4,0,0
11,2003,291600,4,1,3,0
12,2003,291600,1,1,0,1
1,2004,291600,2,1,1,0
2,2004,291600,3,3,0,0
3,2004,291600,1,1,0,0
4,2004,291600,3,3,0,0
5,2004,291600,1,1,0,3
6,2004,291600,2,2,0,1
7,2004,291600,1,1,0,2
8,2004,291600,4,4,0,0
9,2004,291600,3,1,2,1
10,2004,291600,4,4,0,2
11,2004,291600,2,2,0,1
12,2004,291600,6,5,1,0
1,2005,291600,3,3,0,0
2,2005,291600,0,0,0,0
3,2005,291600,2,2,0,0
4,2005,291600,1,0,1,2
5,2005,291600,4,2,2,0
6,2005,291600,4,2,2,2
7,2005,291600,4,4,0,1
8,2005,291600,4,4,0,2
9,2005,291600,5,4,1,3
10,2005,291600,4,2,2,1
11,2005,291600,1,1,0,0
12,2005,291600,3,2,1,0
1,2006,291600,3,1,2,0
2,2006,291600,0,0,0,0
3,2006,291600,1,1,0,0
4,2006,291600,2,1,1,0
5,2006,291600,5,5,0,0
6,2006,291600,3,2,1,3
7,2006,291600,6,5,1,0
8,2006,291600,2,2,0,0
9,2006,291600,3,3,0,1
10,2006,291600,2,1,1,1
11,2006,291600,1,1,0,1
12,2006,291600,1,1,0,0
1,2007,291600,1,1,0,0
2,2007,291600,1,1,0,0
3,2007,291600,4,3,1,0
4,2007,291600,1,1,0,0
5,2007,291600,2,1,1,0
6,2007,291600,3,2,1,1
7,2007,291600,1,1,0,0
8,2007,291600,6,6,0,2
9,2007,291600,2,1,1,0
10,2007,291600,0,0,0,3
11,2007,291600,4,4,0,0
12,2007,291600,1,1,0,0
1,2008,291600,4,2,2,1
2,2008,291600,1,1,0,1
3,2008,291600,6,5,1,0
4,2008,291600,6,3,3,3
5,2008,291600,4,2,2,7
6,2008,291600,6,5,1,1
7,2008,291600,8,6,2,0
8,2008,291600,2,2,0,1
9,2008,291600,4,3,1,2
10,2008,291600,4,3,1,0
11,2008,291600,4,1,3,0
12,2008,291600,2,0,2,1
1,2009,291600,5,4,1,1
2,2009,291600,1,1,0,0
3,2009,291600,0,0,0,0
4,2009,291600,4,3,1,2
5,2009,291600,4,3,1,1
6,2009,291600,3,3,0,3
7,2009,291600,3,3,0,1
8,2009,291600,2,2,0,1
9,2009,291600,4,2,2,0
10,2009,291600,5,5,0,0
11,2009,291600,5,3,2,0
12,2009,291600,2,2,0,1
1,2010,291600,1,1,0,1
2,2010,291600,2,2,0,1
3,2010,291600,3,2,1,1
4,2010,291600,2,2,0,1
5,2010,291600,2,2,0,0
6,2010,291600,4,3,1,0
7,2010,291600,7,7,0,1
8,2010,291600,2,2,0,0
9,2010,291600,2,1,1,0
10,2010,291600,3,3,0,0
11,2010,291600,2,2,0,0
12,2010,291600,2,2,0,0
1,2011,291600,0,0,0,0
2,2011,291600,1,1,0,0
1,1999,841500,17,9,8,19
2,1999,841500,20,14,6,22
3,1999,841500,29,18,11,13
4,1999,841500,19,15,4,15
5,1999,841500,29,20,9,5
6,1999,841500,23,17,6,13
7,1999,841500,24,21,3,15
8,1999,841500,23,17,6,6
9,1999,841500,27,22,5,14
10,1999,841500,31,22,9,8
11,1999,841500,18,11,7,17
12,1999,841500,16,13,3,31
1,2000,841500,36,28,8,37
2,2000,841500,22,15,7,29
3,2000,841500,22,13,9,29
4,2000,841500,30,18,12,13
5,2000,841500,27,24,3,27
6,2000,841500,25,15,10,20
7,2000,841500,28,20,8,23
8,2000,841500,28,17,11,15
9,2000,841500,23,16,7,27
10,2000,841500,15,12,3,28
11,2000,841500,19,13,6,16
12,2000,841500,15,10,5,22
1,2001,841500,15,11,4,21
2,2001,841500,18,14,4,13
3,2001,841500,24,12,12,7
4,2001,841500,28,17,11,8
5,2001,841500,28,16,12,4
6,2001,841500,26,15,11,7
7,2001,841500,31,21,10,12
8,2001,841500,23,18,5,21
9,2001,841500,30,23,7,14
10,2001,841500,31,25,6,12
11,2001,841500,33,27,6,4
12,2001,841500,28,23,5,17
1,2002,841500,27,25,2,15
2,2002,841500,9,7,2,5
3,2002,841500,30,26,4,7
4,2002,841500,23,17,6,19
5,2002,841500,29,22,7,15
6,2002,841500,24,19,5,9
7,2002,841500,30,25,5,11
8,2002,841500,24,14,10,13
9,2002,841500,15,14,1,16
10,2002,841500,34,29,5,12
11,2002,841500,22,18,4,26
12,2002,841500,24,21,3,36
1,2003,841500,13,10,3,19
2,2003,841500,16,13,3,12
3,2003,841500,12,9,3,7
4,2003,841500,25,19,6,11
5,2003,841500,19,14,5,12
6,2003,841500,23,17,6,12
7,2003,841500,24,14,10,26
8,2003,841500,28,21,7,40
9,2003,841500,21,15,6,14
10,2003,841500,28,21,7,19
11,2003,841500,28,24,4,25
12,2003,841500,20,19,1,24
1,2004,841500,23,18,5,33
2,2004,841500,21,19,2,19
3,2004,841500,29,25,4,15
4,2004,841500,20,14,6,9
5,2004,841500,27,20,7,20
6,2004,841500,18,12,6,29
7,2004,841500,24,15,9,24
8,2004,841500,32,24,8,30
9,2004,841500,27,22,5,28
10,2004,841500,29,23,6,18
11,2004,841500,18,16,2,42
12,2004,841500,20,16,4,26
1,2005,841500,23,18,5,14
2,2005,841500,24,20,4,17
3,2005,841500,24,20,4,10
4,2005,841500,21,19,2,17
5,2005,841500,14,12,2,18
6,2005,841500,34,19,15,14
7,2005,841500,17,14,3,31
8,2005,841500,18,15,3,10
9,2005,841500,19,12,7,17
10,2005,841500,15,14,1,18
11,2005,841500,26,15,11,30
12,2005,841500,18,15,3,23
1,2006,841500,17,14,3,13
2,2006,841500,20,16,4,38
3,2006,841500,20,13,7,38
4,2006,841500,24,20,4,28
5,2006,841500,23,19,4,14
6,2006,841500,21,16,5,25
7,2006,841500,23,16,7,16
8,2006,841500,18,14,4,14
9,2006,841500,17,14,3,13
10,2006,841500,27,19,8,10
11,2006,841500,20,18,2,16
12,2006,841500,24,18,6,11
1,2007,841500,26,22,4,13
2,2007,841500,12,12,0,25
3,2007,841500,19,17,2,11
4,2007,841500,21,13,8,12
5,2007,841500,24,19,5,10
6,2007,841500,20,17,3,24
7,2007,841500,19,16,3,8
8,2007,841500,29,21,8,14
9,2007,841500,26,19,7,17
10,2007,841500,19,17,2,3
11,2007,841500,25,22,3,7
12,2007,841500,19,18,1,9
1,2008,841500,11,7,4,11
2,2008,841500,14,13,1,3
3,2008,841500,15,13,2,11
4,2008,841500,17,12,5,7
5,2008,841500,17,15,2,14
6,2008,841500,26,23,3,4
7,2008,841500,31,21,10,15
8,2008,841500,35,29,6,3
9,2008,841500,27,20,7,13
10,2008,841500,20,14,6,13
11,2008,841500,19,13,6,14
12,2008,841500,22,21,1,9
1,2009,841500,18,17,1,7
2,2009,841500,12,11,1,4
3,2009,841500,16,12,4,7
4,2009,841500,13,8,5,15
5,2009,841500,22,16,6,8
6,2009,841500,16,13,3,5
7,2009,841500,24,23,1,9
8,2009,841500,19,13,6,24
9,2009,841500,19,17,2,5
10,2009,841500,24,21,3,4
11,2009,841500,27,21,6,2
12,2009,841500,17,16,1,8
1,2010,841500,12,10,2,4
2,2010,841500,14,11,3,16
3,2010,841500,20,17,3,23
4,2010,841500,11,10,1,18
5,2010,841500,32,26,6,5
6,2010,841500,26,22,4,8
7,2010,841500,25,19,6,7
8,2010,841500,20,15,5,11
9,2010,841500,23,21,2,9
10,2010,841500,19,11,8,14
11,2010,841500,15,13,2,8
12,2010,841500,17,15,2,21
1,2011,841500,22,20,2,11
2,2011,841500,15,12,3,27
1,1999,841900,110,104,6,7
2,1999,841900,84,82,2,8
3,1999,841900,117,112,5,15
4,1999,841900,128,126,2,15
5,1999,841900,119,115,4,9
6,1999,841900,96,90,6,6
7,1999,841900,110,105,5,3
8,1999,841900,151,143,8,10
9,1999,841900,100,94,6,13
10,1999,841900,111,103,8,5
11,1999,841900,100,98,2,5
12,1999,841900,103,103,0,7
1,2000,841900,84,83,1,7
2,2000,841900,84,79,5,9
3,2000,841900,104,103,1,9
4,2000,841900,106,102,4,10
5,2000,841900,109,106,3,8
6,2000,841900,102,99,3,18
7,2000,841900,130,124,6,18
8,2000,841900,130,126,4,20
9,2000,841900,132,129,3,14
10,2000,841900,128,125,3,8
11,2000,841900,77,73,4,17
12,2000,841900,68,65,3,6
1,2001,841900,79,76,3,8
2,2001,841900,72,69,3,12
3,2001,841900,57,54,3,6
4,2001,841900,63,57,6,3
5,2001,841900,66,61,5,9
6,2001,841900,61,61,0,6
7,2001,841900,90,85,5,14
8,2001,841900,98,93,5,11
9,2001,841900,99,98,1,3
10,2001,841900,88,84,4,13
11,2001,841900,80,79,1,7
12,2001,841900,76,75,1,4
1,2002,841900,75,73,2,9
2,2002,841900,57,54,3,9
3,2002,841900,76,75,1,5
4,2002,841900,64,62,2,7
5,2002,841900,64,61,3,5
6,2002,841900,104,98,6,2
7,2002,841900,93,89,4,4
8,2002,841900,78,72,6,3
9,2002,841900,74,74,0,5
10,2002,841900,58,58,0,7
11,2002,841900,53,53,0,4
12,2002,841900,69,68,1,3
1,2003,841900,55,52,3,7
2,2003,841900,46,42,4,9
3,2003,841900,67,65,2,5
4,2003,841900,75,72,3,9
5,2003,841900,63,63,0,2
6,2003,841900,93,92,1,7
7,2003,841900,94,91,3,4
8,2003,841900,104,99,5,12
9,2003,841900,82,79,3,6
10,2003,841900,69,67,2,6
11,2003,841900,73,71,2,3
12,2003,841900,71,66,5,4
1,2004,841900,50,50,0,3
2,2004,841900,60,57,3,3
3,2004,841900,57,54,3,3
4,2004,841900,41,41,0,5
5,2004,841900,63,61,2,0
6,2004,841900,71,69,2,1
7,2004,841900,77,74,3,4
8,2004,841900,64,62,2,2
9,2004,841900,71,71,0,2
10,2004,841900,54,52,2,4
11,2004,841900,61,60,1,2
12,2004,841900,48,44,4,1
1,2005,841900,48,47,1,1
2,2005,841900,38,36,2,6
3,2005,841900,39,38,1,2
4,2005,841900,47,45,2,3
5,2005,841900,55,53,2,0
6,2005,841900,48,47,1,0
7,2005,841900,63,59,4,2
8,2005,841900,67,66,1,4
9,2005,841900,48,47,1,9
10,2005,841900,71,70,1,0
11,2005,841900,55,53,2,1
12,2005,841900,45,43,2,2
1,2006,841900,51,50,1,2
2,2006,841900,48,46,2,1
3,2006,841900,53,52,1,1
4,2006,841900,58,57,1,4
5,2006,841900,52,49,3,2
6,2006,841900,67,66,1,0
7,2006,841900,44,43,1,2
8,2006,841900,47,45,2,4
9,2006,841900,54,53,1,1
10,2006,841900,72,71,1,0
11,2006,841900,46,42,4,0
12,2006,841900,38,38,0,1
1,2007,841900,41,39,2,0
2,2007,841900,39,38,1,0
3,2007,841900,34,29,5,3
4,2007,841900,49,47,2,1
5,2007,841900,47,47,0,1
6,2007,841900,54,51,3,3
7,2007,841900,64,60,4,0
8,2007,841900,59,59,0,3
9,2007,841900,54,53,1,3
10,2007,841900,61,60,1,2
11,2007,841900,49,46,3,1
12,2007,841900,56,55,1,3
1,2008,841900,40,39,1,2
2,2008,841900,45,45,0,0
3,2008,841900,61,60,1,1
4,2008,841900,46,43,3,1
5,2008,841900,52,52,0,5
6,2008,841900,72,70,2,5
7,2008,841900,87,86,1,2
8,2008,841900,63,62,1,2
9,2008,841900,63,63,0,4
10,2008,841900,71,65,6,0
11,2008,841900,72,68,4,2
12,2008,841900,59,57,2,4
1,2009,841900,58,55,3,3
2,2009,841900,59,58,1,6
3,2009,841900,62,59,3,7
4,2009,841900,56,53,3,7
5,2009,841900,60,58,2,7
6,2009,841900,60,57,3,3
7,2009,841900,87,83,4,3
8,2009,841900,75,70,5,3
9,2009,841900,89,86,3,4
10,2009,841900,85,83,2,5
11,2009,841900,85,85,0,5
12,2009,841900,72,69,3,1
1,2010,841900,63,63,0,5
2,2010,841900,49,49,0,2
3,2010,841900,68,65,3,5
4,2010,841900,56,55,1,4
5,2010,841900,87,87,0,3
6,2010,841900,51,48,3,5
7,2010,841900,70,68,2,5
8,2010,841900,71,70,1,2
9,2010,841900,75,71,4,7
10,2010,841900,73,73,0,8
11,2010,841900,72,70,2,8
12,2010,841900,46,46,0,2
1,2011,841900,53,51,2,2
2,2011,841900,35,35,0,2
1,1999,290900,21,12,9,32
2,1999,290900,34,23,11,47
3,1999,290900,19,14,5,47
4,1999,290900,22,18,4,30
5,1999,290900,33,25,8,38
6,1999,290900,48,31,17,45
7,1999,290900,41,29,12,27
8,1999,290900,38,27,11,30
9,1999,290900,43,28,15,21
10,1999,290900,30,20,10,24
11,1999,290900,29,22,7,23
12,1999,290900,24,15,9,26
1,2000,290900,26,20,6,29
2,2000,290900,21,13,8,19
3,2000,290900,37,31,6,21
4,2000,290900,29,24,5,30
5,2000,290900,33,25,8,33
6,2000,290900,40,35,5,24
7,2000,290900,50,32,18,30
8,2000,290900,49,35,14,24
9,2000,290900,38,28,10,22
10,2000,290900,28,18,10,47
11,2000,290900,20,14,6,36
12,2000,290900,27,23,4,17
1,2001,290900,36,25,11,19
2,2001,290900,19,15,4,26
3,2001,290900,20,15,5,27
4,2001,290900,28,16,12,33
5,2001,290900,28,20,8,36
6,2001,290900,38,17,21,35
7,2001,290900,37,21,16,30
8,2001,290900,37,29,8,25
9,2001,290900,38,30,8,39
10,2001,290900,27,19,8,26
11,2001,290900,36,25,11,26
12,2001,290900,35,29,6,19
1,2002,290900,22,12,10,21
2,2002,290900,17,12,5,32
3,2002,290900,33,24,9,17
4,2002,290900,24,17,7,16
5,2002,290900,34,22,12,28
6,2002,290900,33,22,11,9
7,2002,290900,33,20,13,37
8,2002,290900,27,16,11,35
9,2002,290900,32,24,8,27
10,2002,290900,25,18,7,61
11,2002,290900,29,17,12,35
12,2002,290900,29,22,7,72
1,2003,290900,31,22,9,49
2,2003,290900,21,18,3,60
3,2003,290900,19,14,5,39
4,2003,290900,36,25,11,36
5,2003,290900,32,23,9,51
6,2003,290900,21,17,4,25
7,2003,290900,37,26,11,41
8,2003,290900,32,25,7,32
9,2003,290900,31,23,8,39
10,2003,290900,31,28,3,33
11,2003,290900,29,25,4,42
12,2003,290900,15,11,4,31
1,2004,290900,16,15,1,41
2,2004,290900,30,20,10,15
3,2004,290900,17,16,1,19
4,2004,290900,44,32,12,9
5,2004,290900,29,26,3,18
6,2004,290900,36,27,9,25
7,2004,290900,31,24,7,20
8,2004,290900,32,25,7,15
9,2004,290900,28,21,7,21
10,2004,290900,29,23,6,20
11,2004,290900,22,18,4,27
12,2004,290900,31,27,4,24
1,2005,290900,25,18,7,21
2,2005,290900,13,10,3,16
3,2005,290900,29,24,5,21
4,2005,290900,29,22,7,18
5,2005,290900,36,28,8,25
6,2005,290900,34,25,9,30
7,2005,290900,30,21,9,48
8,2005,290900,26,15,11,29
9,2005,290900,17,12,5,21
10,2005,290900,26,21,5,28
11,2005,290900,24,19,5,53
12,2005,290900,20,17,3,22
1,2006,290900,15,12,3,11
2,2006,290900,19,18,1,10
3,2006,290900,16,16,0,19
4,2006,290900,24,18,6,36
5,2006,290900,22,22,0,17
6,2006,290900,31,20,11,24
7,2006,290900,43,27,16,27
8,2006,290900,40,27,13,41
9,2006,290900,21,20,1,11
10,2006,290900,39,34,5,25
11,2006,290900,26,18,8,20
12,2006,290900,31,23,8,12
1,2007,290900,27,26,1,20
2,2007,290900,17,15,2,14
3,2007,290900,28,24,4,14
4,2007,290900,35,31,4,17
5,2007,290900,28,24,4,12
6,2007,290900,26,16,10,11
7,2007,290900,37,27,10,14
8,2007,290900,35,30,5,26
9,2007,290900,41,34,7,28
10,2007,290900,26,23,3,15
11,2007,290900,28,22,6,15
12,2007,290900,16,11,5,20
1,2008,290900,31,26,5,31
2,2008,290900,30,25,5,6
3,2008,290900,33,27,6,15
4,2008,290900,33,26,7,24
5,2008,290900,34,28,6,15
6,2008,290900,30,28,2,14
7,2008,290900,44,33,11,10
8,2008,290900,38,33,5,22
9,2008,290900,40,34,6,17
10,2008,290900,27,17,10,41
11,2008,290900,29,22,7,35
12,2008,290900,16,12,4,15
1,2009,290900,20,18,2,20
2,2009,290900,25,16,9,15
3,2009,290900,31,23,8,29
4,2009,290900,28,23,5,22
5,2009,290900,29,20,9,27
6,2009,290900,30,17,13,26
7,2009,290900,29,20,9,10
8,2009,290900,37,26,11,14
9,2009,290900,44,35,9,11
10,2009,290900,28,21,7,19
11,2009,290900,35,28,7,17
12,2009,290900,33,26,7,19
1,2010,290900,23,21,2,14
2,2010,290900,22,17,5,14
3,2010,290900,34,30,4,22
4,2010,290900,30,25,5,16
5,2010,290900,44,34,10,20
6,2010,290900,32,27,5,11
7,2010,290900,33,26,7,26
8,2010,290900,33,28,5,20
9,2010,290900,24,22,2,20
10,2010,290900,31,29,2,20
11,2010,290900,27,22,5,24
12,2010,290900,17,15,2,15
1,2011,290900,20,14,6,15
2,2011,290900,10,9,1,17
1,1999,838700,43,34,9,61
2,1999,838700,42,34,8,44
3,1999,838700,43,35,8,48
4,1999,838700,39,23,16,31
5,1999,838700,44,30,14,26
6,1999,838700,44,28,16,21
7,1999,838700,40,21,19,42
8,1999,838700,42,30,12,37
9,1999,838700,29,19,10,46
10,1999,838700,44,26,18,35
11,1999,838700,32,28,4,21
12,1999,838700,38,25,13,21
1,2000,838700,37,30,7,29
2,2000,838700,42,30,12,48
3,2000,838700,54,34,20,37
4,2000,838700,39,27,12,39
5,2000,838700,48,29,19,39
6,2000,838700,43,29,14,44
7,2000,838700,57,42,15,71
8,2000,838700,61,40,21,49
9,2000,838700,49,34,15,64
10,2000,838700,38,27,11,77
11,2000,838700,41,31,10,47
12,2000,838700,28,21,7,40
1,2001,838700,31,24,7,53
2,2001,838700,41,29,12,67
3,2001,838700,51,35,16,43
4,2001,838700,38,25,13,45
5,2001,838700,40,26,14,50
6,2001,838700,35,28,7,24
7,2001,838700,46,26,20,30
8,2001,838700,47,28,19,33
9,2001,838700,50,38,12,25
10,2001,838700,53,41,12,36
11,2001,838700,38,29,9,30
12,2001,838700,43,37,6,42
1,2002,838700,35,22,13,40
2,2002,838700,33,22,11,53
3,2002,838700,38,23,15,57
4,2002,838700,33,26,7,32
5,2002,838700,34,19,15,35
6,2002,838700,46,29,17,33
7,2002,838700,37,22,15,41
8,2002,838700,38,31,7,26
9,2002,838700,45,31,14,30
10,2002,838700,49,37,12,51
11,2002,838700,33,28,5,41
12,2002,838700,36,27,9,51
1,2003,838700,31,27,4,42
2,2003,838700,24,16,8,26
3,2003,838700,32,21,11,25
4,2003,838700,37,27,10,43
5,2003,838700,50,37,13,33
6,2003,838700,44,29,15,28
7,2003,838700,56,42,14,35
8,2003,838700,47,38,9,41
9,2003,838700,46,36,10,27
10,2003,838700,50,40,10,29
11,2003,838700,38,30,8,24
12,2003,838700,43,38,5,38
1,2004,838700,45,37,8,36
2,2004,838700,37,29,8,37
3,2004,838700,42,37,5,43
4,2004,838700,36,27,9,70
5,2004,838700,29,26,3,44
6,2004,838700,42,33,9,50
7,2004,838700,43,30,13,34
8,2004,838700,39,34,5,33
9,2004,838700,39,27,12,54
10,2004,838700,32,27,5,44
11,2004,838700,34,27,7,45
12,2004,838700,29,23,6,31
1,2005,838700,27,19,8,56
2,2005,838700,27,16,11,49
3,2005,838700,32,24,8,83
4,2005,838700,48,33,15,50
5,2005,838700,38,32,6,78
6,2005,838700,36,27,9,52
7,2005,838700,46,33,13,52
8,2005,838700,53,37,16,44
9,2005,838700,27,22,5,42
10,2005,838700,30,22,8,95
11,2005,838700,42,31,11,67
12,2005,838700,35,29,6,61
1,2006,838700,34,27,7,48
2,2006,838700,21,19,2,42
3,2006,838700,24,16,8,47
4,2006,838700,38,25,13,56
5,2006,838700,37,27,10,72
6,2006,838700,34,26,8,64
7,2006,838700,45,31,14,94
8,2006,838700,33,26,7,101
9,2006,838700,36,22,14,68
10,2006,838700,32,20,12,49
11,2006,838700,28,22,6,48
12,2006,838700,42,34,8,87
1,2007,838700,30,21,9,87
2,2007,838700,20,15,5,65
3,2007,838700,39,29,10,70
4,2007,838700,30,22,8,45
5,2007,838700,46,35,11,52
6,2007,838700,49,38,11,29
7,2007,838700,45,35,10,64
8,2007,838700,34,25,9,55
9,2007,838700,25,19,6,51
10,2007,838700,42,32,10,56
11,2007,838700,37,28,9,44
12,2007,838700,22,19,3,48
1,2008,838700,29,20,9,49
2,2008,838700,29,21,8,28
3,2008,838700,35,23,12,53
4,2008,838700,50,39,11,27
5,2008,838700,41,29,12,44
6,2008,838700,50,33,17,26
7,2008,838700,67,56,11,41
8,2008,838700,55,43,12,51
9,2008,838700,55,42,13,67
10,2008,838700,38,32,6,34
11,2008,838700,34,25,9,57
12,2008,838700,28,19,9,41
1,2009,838700,29,25,4,36
2,2009,838700,24,16,8,55
3,2009,838700,27,22,5,46
4,2009,838700,35,28,7,32
5,2009,838700,33,25,8,25
6,2009,838700,26,18,8,46
7,2009,838700,41,27,14,59
8,2009,838700,47,34,13,59
9,2009,838700,50,39,11,54
10,2009,838700,39,34,5,73
11,2009,838700,29,20,9,53
12,2009,838700,46,36,10,51
1,2010,838700,33,26,7,50
2,2010,838700,28,22,6,48
3,2010,838700,45,31,14,45
4,2010,838700,54,36,18,52
5,2010,838700,51,41,10,61
6,2010,838700,44,37,7,31
7,2010,838700,44,35,9,49
8,2010,838700,40,26,14,58
9,2010,838700,28,22,6,39
10,2010,838700,46,34,12,64
11,2010,838700,37,28,9,59
12,2010,838700,32,28,4,47
1,2011,838700,30,26,4,57
2,2011,838700,25,21,4,45
1,1999,843300,32,28,4,13
2,1999,843300,29,24,5,24
3,1999,843300,26,22,4,57
4,1999,843300,18,17,1,45
5,1999,843300,30,21,9,44
6,1999,843300,30,29,1,34
7,1999,843300,51,37,14,40
8,1999,843300,36,26,10,30
9,1999,843300,25,18,7,32
10,1999,843300,28,21,7,46
11,1999,843300,23,21,2,35
12,1999,843300,13,12,1,35
1,2000,843300,17,12,5,25
2,2000,843300,20,15,5,44
3,2000,843300,16,13,3,64
4,2000,843300,12,11,1,77
5,2000,843300,16,13,3,34
6,2000,843300,27,23,4,66
7,2000,843300,16,13,3,72
8,2000,843300,16,11,5,56
9,2000,843300,20,18,2,25
10,2000,843300,26,22,4,20
11,2000,843300,17,16,1,27
12,2000,843300,17,9,8,12
1,2001,843300,14,11,3,60
2,2001,843300,10,8,2,58
3,2001,843300,9,7,2,44
4,2001,843300,17,14,3,65
5,2001,843300,26,22,4,59
6,2001,843300,25,12,13,30
7,2001,843300,32,20,12,40
8,2001,843300,13,9,4,50
9,2001,843300,20,18,2,34
10,2001,843300,20,15,5,55
11,2001,843300,20,18,2,42
12,2001,843300,15,11,4,21
1,2002,843300,18,13,5,39
2,2002,843300,15,14,1,17
3,2002,843300,15,8,7,27
4,2002,843300,11,8,3,14
5,2002,843300,12,6,6,12
6,2002,843300,11,4,7,10
7,2002,843300,25,19,6,26
8,2002,843300,18,15,3,11
9,2002,843300,23,16,7,19
10,2002,843300,23,22,1,7
11,2002,843300,16,13,3,17
12,2002,843300,13,9,4,16
1,2003,843300,10,9,1,11
2,2003,843300,17,16,1,4
3,2003,843300,20,19,1,36
4,2003,843300,16,14,2,9
5,2003,843300,25,22,3,13
6,2003,843300,22,16,6,7
7,2003,843300,38,30,8,9
8,2003,843300,32,25,7,20
9,2003,843300,15,12,3,25
10,2003,843300,18,14,4,28
11,2003,843300,16,13,3,23
12,2003,843300,9,7,2,31
1,2004,843300,10,6,4,27
2,2004,843300,10,7,3,44
3,2004,843300,15,12,3,47
4,2004,843300,18,14,4,31
5,2004,843300,18,15,3,31
6,2004,843300,15,14,1,13
7,2004,843300,17,16,1,17
8,2004,843300,20,17,3,25
9,2004,843300,17,15,2,37
10,2004,843300,10,9,1,45
11,2004,843300,9,7,2,53
12,2004,843300,16,14,2,38
1,2005,843300,7,7,0,28
2,2005,843300,8,6,2,64
3,2005,843300,10,10,0,31
4,2005,843300,18,14,4,15
5,2005,843300,19,17,2,28
6,2005,843300,23,17,6,18
7,2005,843300,28,22,6,11
8,2005,843300,12,11,1,41
9,2005,843300,20,18,2,24
10,2005,843300,10,9,1,5
11,2005,843300,19,16,3,4
12,2005,843300,16,12,4,1
1,2006,843300,14,10,4,6
2,2006,843300,11,9,2,6
3,2006,843300,15,13,2,2
4,2006,843300,9,9,0,6
5,2006,843300,8,6,2,5
6,2006,843300,15,15,0,8
7,2006,843300,15,14,1,8
8,2006,843300,18,17,1,9
9,2006,843300,16,14,2,9
10,2006,843300,22,20,2,8
11,2006,843300,14,13,1,3
12,2006,843300,9,8,1,3
1,2007,843300,12,9,3,6
2,2007,843300,9,9,0,3
3,2007,843300,12,9,3,3
4,2007,843300,11,7,4,7
5,2007,843300,10,9,1,7
6,2007,843300,14,14,0,2
7,2007,843300,17,17,0,5
8,2007,843300,14,12,2,6
9,2007,843300,8,6,2,6
10,2007,843300,20,17,3,6
11,2007,843300,13,12,1,5
12,2007,843300,16,13,3,8
1,2008,843300,7,6,1,3
2,2008,843300,7,6,1,4
3,2008,843300,12,10,2,4
4,2008,843300,12,11,1,2
5,2008,843300,11,11,0,0
6,2008,843300,12,8,4,2
7,2008,843300,13,11,2,2
8,2008,843300,9,8,1,3
9,2008,843300,19,12,7,2
10,2008,843300,9,8,1,1
11,2008,843300,12,10,2,6
12,2008,843300,12,11,1,2
1,2009,843300,17,12,5,17
2,2009,843300,11,10,1,5
3,2009,843300,16,11,5,7
4,2009,843300,7,7,0,5
5,2009,843300,12,10,2,10
6,2009,843300,8,4,4,4
7,2009,843300,16,12,4,5
8,2009,843300,16,14,2,6
9,2009,843300,13,12,1,4
10,2009,843300,9,7,2,6
11,2009,843300,17,14,3,1
12,2009,843300,12,10,2,5
1,2010,843300,13,12,1,5
2,2010,843300,9,9,0,3
3,2010,843300,17,15,2,4
4,2010,843300,17,14,3,5
5,2010,843300,17,17,0,2
6,2010,843300,6,3,3,5
7,2010,843300,15,15,0,6
8,2010,843300,17,15,2,8
9,2010,843300,12,11,1,8
10,2010,843300,10,9,1,13
11,2010,843300,12,10,2,5
12,2010,843300,14,13,1,10
1,2011,843300,17,14,3,4
2,2011,843300,6,3,3,3
1,1999,842900,49,44,5,26
2,1999,842900,57,41,16,41
3,1999,842900,63,47,16,34
4,1999,842900,51,38,13,40
5,1999,842900,84,68,16,29
6,1999,842900,79,65,14,27
7,1999,842900,98,75,23,29
8,1999,842900,71,58,13,31
9,1999,842900,75,54,21,44
10,1999,842900,71,60,11,49
11,1999,842900,52,40,12,68
12,1999,842900,57,49,8,77
1,2000,842900,50,38,12,102
2,2000,842900,47,32,15,71
3,2000,842900,45,33,12,37
4,2000,842900,43,29,14,42
5,2000,842900,55,37,18,53
6,2000,842900,57,40,17,36
7,2000,842900,60,40,20,50
8,2000,842900,73,52,21,62
9,2000,842900,67,55,12,75
10,2000,842900,74,54,20,78
11,2000,842900,64,43,21,73
12,2000,842900,44,28,16,87
1,2001,842900,30,17,13,131
2,2001,842900,35,25,10,74
3,2001,842900,43,33,10,92
4,2001,842900,58,33,25,62
5,2001,842900,42,29,13,48
6,2001,842900,44,30,14,45
7,2001,842900,42,27,15,20
8,2001,842900,55,41,14,24
9,2001,842900,56,42,14,48
10,2001,842900,46,30,16,45
11,2001,842900,43,32,11,30
12,2001,842900,49,34,15,17
1,2002,842900,40,31,9,39
2,2002,842900,36,31,5,38
3,2002,842900,45,34,11,35
4,2002,842900,54,42,12,26
5,2002,842900,41,29,12,15
6,2002,842900,48,37,11,26
7,2002,842900,75,58,17,21
8,2002,842900,76,57,19,15
9,2002,842900,61,48,13,18
10,2002,842900,81,68,13,25
11,2002,842900,63,54,9,30
12,2002,842900,60,52,8,40
1,2003,842900,42,35,7,41
2,2003,842900,55,47,8,39
3,2003,842900,63,53,10,35
4,2003,842900,69,54,15,44
5,2003,842900,69,54,15,43
6,2003,842900,58,44,14,24
7,2003,842900,84,71,13,25
8,2003,842900,78,65,13,21
9,2003,842900,104,91,13,45
10,2003,842900,82,63,19,39
11,2003,842900,64,53,11,46
12,2003,842900,55,46,9,24
1,2004,842900,52,49,3,79
2,2004,842900,32,29,3,64
3,2004,842900,67,57,10,67
4,2004,842900,55,45,10,80
5,2004,842900,58,51,7,42
6,2004,842900,65,54,11,25
7,2004,842900,76,66,10,34
8,2004,842900,75,57,18,23
9,2004,842900,79,63,16,33
10,2004,842900,75,65,10,24
11,2004,842900,52,42,10,33
12,2004,842900,65,52,13,35
1,2005,842900,54,43,11,47
2,2005,842900,39,30,9,37
3,2005,842900,52,40,12,58
4,2005,842900,56,46,10,46
5,2005,842900,60,40,20,62
6,2005,842900,53,38,15,37
7,2005,842900,49,35,14,30
8,2005,842900,70,56,14,40
9,2005,842900,49,42,7,33
10,2005,842900,55,47,8,38
11,2005,842900,54,47,7,43
12,2005,842900,41,37,4,41
1,2006,842900,46,39,7,28
2,2006,842900,25,21,4,65
3,2006,842900,42,36,6,43
4,2006,842900,32,28,4,47
5,2006,842900,51,43,8,39
6,2006,842900,45,36,9,36
7,2006,842900,48,39,9,49
8,2006,842900,33,26,7,41
9,2006,842900,52,38,14,46
10,2006,842900,62,46,16,59
11,2006,842900,41,36,5,44
12,2006,842900,31,24,7,36
1,2007,842900,27,23,4,29
2,2007,842900,18,15,3,29
3,2007,842900,36,30,6,30
4,2007,842900,40,37,3,31
5,2007,842900,51,44,7,20
6,2007,842900,39,36,3,17
7,2007,842900,53,46,7,29
8,2007,842900,49,43,6,25
9,2007,842900,32,25,7,18
10,2007,842900,33,29,4,18
11,2007,842900,26,23,3,14
12,2007,842900,37,32,5,12
1,2008,842900,24,24,0,10
2,2008,842900,24,24,0,8
3,2008,842900,26,19,7,16
4,2008,842900,34,26,8,21
5,2008,842900,30,22,8,13
6,2008,842900,35,27,8,8
7,2008,842900,37,33,4,13
8,2008,842900,46,40,6,12
9,2008,842900,38,33,5,12
10,2008,842900,47,39,8,12
11,2008,842900,21,20,1,14
12,2008,842900,33,28,5,12
1,2009,842900,12,9,3,14
2,2009,842900,20,17,3,13
3,2009,842900,32,29,3,16
4,2009,842900,32,30,2,10
5,2009,842900,32,29,3,12
6,2009,842900,39,36,3,8
7,2009,842900,32,28,4,11
8,2009,842900,35,26,9,6
9,2009,842900,31,26,5,12
10,2009,842900,34,29,5,11
11,2009,842900,17,13,4,13
12,2009,842900,19,14,5,4
1,2010,842900,21,17,4,10
2,2010,842900,14,10,4,8
3,2010,842900,36,29,7,12
4,2010,842900,37,28,9,5
5,2010,842900,37,35,2,13
6,2010,842900,30,24,6,21
7,2010,842900,26,25,1,4
8,2010,842900,27,25,2,7
9,2010,842900,29,25,4,14
10,2010,842900,32,26,6,8
11,2010,842900,21,16,5,12
12,2010,842900,21,18,3,9
1,2011,842900,12,11,1,13
2,2011,842900,11,10,1,11
1,1999,291200,21,16,5,17
2,1999,291200,12,8,4,28
3,1999,291200,21,15,6,28
4,1999,291200,23,18,5,10
5,1999,291200,31,26,5,8
6,1999,291200,33,26,7,14
7,1999,291200,28,24,4,26
8,1999,291200,25,17,8,20
9,1999,291200,23,12,11,23
10,1999,291200,30,19,11,21
11,1999,291200,22,20,2,23
12,1999,291200,21,18,3,18
1,2000,291200,22,16,6,23
2,2000,291200,23,21,2,27
3,2000,291200,29,20,9,26
4,2000,291200,23,17,6,37
5,2000,291200,24,17,7,19
6,2000,291200,39,25,14,22
7,2000,291200,33,29,4,9
8,2000,291200,28,19,9,19
9,2000,291200,27,19,8,21
10,2000,291200,30,19,11,32
11,2000,291200,21,14,7,25
12,2000,291200,31,28,3,16
1,2001,291200,30,22,8,31
2,2001,291200,25,21,4,22
3,2001,291200,35,29,6,12
4,2001,291200,39,30,9,14
5,2001,291200,39,32,7,15
6,2001,291200,27,19,8,12
7,2001,291200,30,24,6,7
8,2001,291200,34,23,11,12
9,2001,291200,30,17,13,7
10,2001,291200,29,23,6,8
11,2001,291200,27,22,5,4
12,2001,291200,42,35,7,12
1,2002,291200,24,19,5,3
2,2002,291200,24,16,8,8
3,2002,291200,19,13,6,15
4,2002,291200,27,22,5,8
5,2002,291200,31,23,8,10
6,2002,291200,18,13,5,12
7,2002,291200,26,18,8,12
8,2002,291200,27,17,10,9
9,2002,291200,18,17,1,6
10,2002,291200,25,20,5,7
11,2002,291200,36,29,7,15
12,2002,291200,25,20,5,16
1,2003,291200,18,15,3,8
2,2003,291200,26,21,5,16
3,2003,291200,19,14,5,7
4,2003,291200,16,11,5,12
5,2003,291200,20,16,4,14
6,2003,291200,21,14,7,4
7,2003,291200,32,25,7,19
8,2003,291200,26,20,6,9
9,2003,291200,21,16,5,10
10,2003,291200,27,21,6,10
11,2003,291200,19,18,1,20
12,2003,291200,22,18,4,21
1,2004,291200,15,13,2,15
2,2004,291200,27,22,5,13
3,2004,291200,25,19,6,17
4,2004,291200,17,13,4,13
5,2004,291200,24,20,4,16
6,2004,291200,24,18,6,11
7,2004,291200,31,19,12,14
8,2004,291200,30,28,2,7
9,2004,291200,23,19,4,11
10,2004,291200,20,14,6,7
11,2004,291200,31,25,6,19
12,2004,291200,25,23,2,8
1,2005,291200,21,20,1,8
2,2005,291200,18,15,3,13
3,2005,291200,22,20,2,15
4,2005,291200,15,14,1,22
5,2005,291200,29,26,3,10
6,2005,291200,18,15,3,5
7,2005,291200,23,12,11,15
8,2005,291200,25,20,5,11
9,2005,291200,24,21,3,16
10,2005,291200,21,18,3,23
11,2005,291200,21,16,5,21
12,2005,291200,18,14,4,14
1,2006,291200,19,16,3,16
2,2006,291200,21,17,4,15
3,2006,291200,25,19,6,18
4,2006,291200,28,22,6,8
5,2006,291200,20,18,2,3
6,2006,291200,16,11,5,13
7,2006,291200,27,21,6,23
8,2006,291200,23,21,2,19
9,2006,291200,18,16,2,22
10,2006,291200,20,17,3,5
11,2006,291200,18,14,4,10
12,2006,291200,20,15,5,13
1,2007,291200,18,14,4,8
2,2007,291200,15,12,3,4
3,2007,291200,21,15,6,12
4,2007,291200,15,15,0,22
5,2007,291200,25,18,7,6
6,2007,291200,22,17,5,13
7,2007,291200,17,15,2,8
8,2007,291200,21,15,6,20
9,2007,291200,25,22,3,14
10,2007,291200,28,24,4,20
11,2007,291200,15,14,1,15
12,2007,291200,19,16,3,12
1,2008,291200,16,13,3,14
2,2008,291200,15,11,4,15
3,2008,291200,14,14,0,15
4,2008,291200,24,19,5,11
5,2008,291200,29,25,4,10
6,2008,291200,31,23,8,2
7,2008,291200,18,15,3,12
8,2008,291200,33,28,5,18
9,2008,291200,31,27,4,10
10,2008,291200,29,22,7,12
11,2008,291200,19,15,4,14
12,2008,291200,15,12,3,13
1,2009,291200,18,16,2,17
2,2009,291200,12,11,1,10
3,2009,291200,20,13,7,13
4,2009,291200,14,12,2,5
5,2009,291200,25,21,4,25
6,2009,291200,23,20,3,12
7,2009,291200,24,21,3,17
8,2009,291200,29,21,8,7
9,2009,291200,28,20,8,5
10,2009,291200,41,33,8,5
11,2009,291200,19,15,4,9
12,2009,291200,17,16,1,7
1,2010,291200,18,16,2,16
2,2010,291200,19,17,2,8
3,2010,291200,24,17,7,7
4,2010,291200,31,23,8,11
5,2010,291200,19,18,1,7
6,2010,291200,20,17,3,7
7,2010,291200,16,13,3,2
8,2010,291200,18,16,2,9
9,2010,291200,29,23,6,9
10,2010,291200,22,19,3,11
11,2010,291200,10,9,1,10
12,2010,291200,30,24,6,8
1,2011,291200,17,15,2,10
2,2011,291200,12,10,2,4
1,1999,283800,22,15,7,14
2,1999,283800,17,14,3,28
3,1999,283800,28,21,7,28
4,1999,283800,16,10,6,24
5,1999,283800,23,20,3,19
6,1999,283800,16,15,1,23
7,1999,283800,18,15,3,13
8,1999,283800,13,10,3,13
9,1999,283800,23,16,7,24
10,1999,283800,17,14,3,17
11,1999,283800,9,6,3,24
12,1999,283800,19,18,1,20
1,2000,283800,13,10,3,25
2,2000,283800,10,8,2,24
3,2000,283800,20,16,4,14
4,2000,283800,16,11,5,12
5,2000,283800,11,5,6,3
6,2000,283800,12,11,1,6
7,2000,283800,16,10,6,13
8,2000,283800,14,14,0,16
9,2000,283800,12,10,2,13
10,2000,283800,29,25,4,9
11,2000,283800,12,10,2,12
12,2000,283800,7,6,1,11
1,2001,283800,6,4,2,3
2,2001,283800,0,0,0,5
3,2001,283800,11,10,1,3
4,2001,283800,2,2,0,3
5,2001,283800,8,7,1,5
6,2001,283800,14,13,1,3
7,2001,283800,9,7,2,1
8,2001,283800,17,16,1,3
9,2001,283800,5,2,3,0
10,2001,283800,5,5,0,3
11,2001,283800,9,8,1,2
12,2001,283800,8,7,1,0
1,2002,283800,13,12,1,1
2,2002,283800,6,6,0,1
3,2002,283800,8,6,2,1
4,2002,283800,6,6,0,2
5,2002,283800,5,5,0,0
6,2002,283800,6,6,0,0
7,2002,283800,8,7,1,0
8,2002,283800,11,10,1,1
9,2002,283800,9,7,2,0
10,2002,283800,12,11,1,0
11,2002,283800,10,8,2,1
12,2002,283800,13,7,6,1
1,2003,283800,7,6,1,0
2,2003,283800,2,1,1,0
3,2003,283800,8,6,2,1
4,2003,283800,7,6,1,1
5,2003,283800,12,11,1,0
6,2003,283800,11,11,0,2
7,2003,283800,8,6,2,0
8,2003,283800,16,14,2,1
9,2003,283800,13,13,0,2
10,2003,283800,5,5,0,0
11,2003,283800,16,16,0,0
12,2003,283800,19,16,3,0
1,2004,283800,5,5,0,3
2,2004,283800,8,7,1,0
3,2004,283800,8,7,1,0
4,2004,283800,7,7,0,0
5,2004,283800,7,7,0,0
6,2004,283800,6,6,0,0
7,2004,283800,4,4,0,0
8,2004,283800,5,5,0,2
9,2004,283800,4,4,0,0
10,2004,283800,10,9,1,0
11,2004,283800,10,9,1,2
12,2004,283800,3,2,1,0
1,2005,283800,5,3,2,1
2,2005,283800,7,5,2,0
3,2005,283800,7,3,4,0
4,2005,283800,3,3,0,1
5,2005,283800,7,7,0,0
6,2005,283800,6,4,2,0
7,2005,283800,8,6,2,1
8,2005,283800,3,2,1,0
9,2005,283800,3,2,1,1
10,2005,283800,5,4,1,1
11,2005,283800,10,10,0,0
12,2005,283800,3,3,0,0
1,2006,283800,8,7,1,3
2,2006,283800,2,1,1,1
3,2006,283800,4,3,1,2
4,2006,283800,9,9,0,4
5,2006,283800,10,8,2,2
6,2006,283800,7,4,3,0
7,2006,283800,10,8,2,0
8,2006,283800,13,12,1,1
9,2006,283800,7,7,0,1
10,2006,283800,9,9,0,7
11,2006,283800,5,4,1,4
12,2006,283800,4,3,1,1
1,2007,283800,4,4,0,1
2,2007,283800,6,5,1,0
3,2007,283800,14,12,2,0
4,2007,283800,15,14,1,1
5,2007,283800,6,6,0,2
6,2007,283800,6,5,1,1
7,2007,283800,6,6,0,0
8,2007,283800,5,5,0,0
9,2007,283800,11,11,0,1
10,2007,283800,13,13,0,0
11,2007,283800,11,8,3,1
12,2007,283800,7,6,1,2
1,2008,283800,9,9,0,0
2,2008,283800,3,3,0,0
3,2008,283800,9,9,0,1
4,2008,283800,16,13,3,1
5,2008,283800,8,7,1,1
6,2008,283800,6,5,1,1
7,2008,283800,6,5,1,1
8,2008,283800,5,4,1,0
9,2008,283800,5,5,0,1
10,2008,283800,9,9,0,1
11,2008,283800,8,7,1,1
12,2008,283800,2,2,0,0
1,2009,283800,6,6,0,2
2,2009,283800,6,5,1,0
3,2009,283800,2,2,0,2
4,2009,283800,8,6,2,1
5,2009,283800,7,6,1,0
6,2009,283800,3,2,1,0
7,2009,283800,5,4,1,0
8,2009,283800,8,8,0,0
9,2009,283800,10,10,0,0
10,2009,283800,9,8,1,1
11,2009,283800,15,14,1,0
12,2009,283800,11,9,2,0
1,2010,283800,8,8,0,1
2,2010,283800,7,7,0,2
3,2010,283800,5,4,1,0
4,2010,283800,3,3,0,0
5,2010,283800,9,7,2,0
6,2010,283800,12,12,0,1
7,2010,283800,8,8,0,1
8,2010,283800,12,11,1,0
9,2010,283800,16,14,2,1
10,2010,283800,9,9,0,2
11,2010,283800,10,10,0,2
12,2010,283800,5,5,0,0
1,2011,283800,10,9,1,2
2,2011,283800,5,5,0,2
1,1999,831400,25,23,2,7
2,1999,831400,23,20,3,8
3,1999,831400,20,17,3,8
4,1999,831400,28,24,4,6
5,1999,831400,37,33,4,16
6,1999,831400,35,30,5,12
7,1999,831400,48,42,6,23
8,1999,831400,26,21,5,9
9,1999,831400,27,25,2,25
10,1999,831400,34,31,3,25
11,1999,831400,15,12,3,13
12,1999,831400,24,21,3,21
1,2000,831400,28,25,3,21
2,2000,831400,14,10,4,16
3,2000,831400,24,18,6,15
4,2000,831400,28,27,1,12
5,2000,831400,34,28,6,16
6,2000,831400,30,26,4,6
7,2000,831400,54,45,9,17
8,2000,831400,40,39,1,10
9,2000,831400,26,22,4,8
10,2000,831400,37,31,6,11
11,2000,831400,22,19,3,14
12,2000,831400,20,17,3,15
1,2001,831400,30,28,2,19
2,2001,831400,22,19,3,20
3,2001,831400,18,17,1,14
4,2001,831400,14,12,2,19
5,2001,831400,22,16,6,6
6,2001,831400,25,21,4,16
7,2001,831400,26,15,11,14
8,2001,831400,26,18,8,20
9,2001,831400,20,16,4,19
10,2001,831400,27,23,4,17
11,2001,831400,38,32,6,18
12,2001,831400,26,23,3,8
1,2002,831400,28,24,4,5
2,2002,831400,24,22,2,14
3,2002,831400,33,26,7,13
4,2002,831400,33,29,4,11
5,2002,831400,28,24,4,26
6,2002,831400,33,25,8,19
7,2002,831400,37,28,9,16
8,2002,831400,26,21,5,13
9,2002,831400,33,27,6,20
10,2002,831400,30,26,4,29
11,2002,831400,28,24,4,15
12,2002,831400,24,20,4,11
1,2003,831400,21,17,4,10
2,2003,831400,24,21,3,13
3,2003,831400,23,21,2,20
4,2003,831400,23,23,0,11
5,2003,831400,27,26,1,18
6,2003,831400,43,37,6,17
7,2003,831400,33,27,6,16
8,2003,831400,33,26,7,42
9,2003,831400,21,19,2,85
10,2003,831400,38,34,4,106
11,2003,831400,32,27,5,20
12,2003,831400,21,18,3,12
1,2004,831400,28,25,3,18
2,2004,831400,19,14,5,48
3,2004,831400,35,33,2,17
4,2004,831400,25,21,4,16
5,2004,831400,26,24,2,10
6,2004,831400,22,21,1,27
7,2004,831400,39,33,6,32
8,2004,831400,29,23,6,30
9,2004,831400,26,23,3,31
10,2004,831400,30,26,4,18
11,2004,831400,33,32,1,9
12,2004,831400,19,18,1,11
1,2005,831400,20,16,4,18
2,2005,831400,17,11,6,12
3,2005,831400,25,21,4,16
4,2005,831400,23,21,2,15
5,2005,831400,24,22,2,15
6,2005,831400,21,17,4,34
7,2005,831400,33,26,7,19
8,2005,831400,36,32,4,7
9,2005,831400,23,18,5,10
10,2005,831400,24,20,4,5
11,2005,831400,21,20,1,4
12,2005,831400,19,18,1,14
1,2006,831400,28,22,6,18
2,2006,831400,21,15,6,6
3,2006,831400,23,18,5,6
4,2006,831400,25,23,2,7
5,2006,831400,26,23,3,14
6,2006,831400,20,19,1,16
7,2006,831400,30,26,4,6
8,2006,831400,31,28,3,22
9,2006,831400,17,15,2,17
10,2006,831400,45,38,7,18
11,2006,831400,36,28,8,16
12,2006,831400,26,23,3,12
1,2007,831400,20,18,2,17
2,2007,831400,20,18,2,7
3,2007,831400,25,24,1,17
4,2007,831400,36,33,3,11
5,2007,831400,27,24,3,4
6,2007,831400,33,27,6,14
7,2007,831400,36,31,5,19
8,2007,831400,33,31,2,33
9,2007,831400,20,18,2,13
10,2007,831400,23,22,1,14
11,2007,831400,14,13,1,14
12,2007,831400,24,24,0,16
1,2008,831400,15,13,2,10
2,2008,831400,19,17,2,13
3,2008,831400,16,15,1,14
4,2008,831400,24,21,3,8
5,2008,831400,33,28,5,11
6,2008,831400,30,25,5,12
7,2008,831400,42,38,4,23
8,2008,831400,33,28,5,16
9,2008,831400,24,19,5,13
10,2008,831400,32,30,2,13
11,2008,831400,29,24,5,15
12,2008,831400,20,17,3,7
1,2009,831400,27,22,5,10
2,2009,831400,23,17,6,7
3,2009,831400,24,21,3,15
4,2009,831400,26,23,3,25
5,2009,831400,28,24,4,11
6,2009,831400,39,29,10,6
7,2009,831400,22,20,2,10
8,2009,831400,24,18,6,13
9,2009,831400,22,19,3,22
10,2009,831400,21,19,2,15
11,2009,831400,18,14,4,24
12,2009,831400,13,13,0,7
1,2010,831400,25,23,2,21
2,2010,831400,23,21,2,24
3,2010,831400,30,24,6,22
4,2010,831400,24,20,4,26
5,2010,831400,21,16,5,28
6,2010,831400,20,16,4,20
7,2010,831400,26,25,1,16
8,2010,831400,23,19,4,30
9,2010,831400,30,28,2,13
10,2010,831400,29,25,4,15
11,2010,831400,22,20,2,17
12,2010,831400,23,23,0,9
1,2011,831400,19,18,1,21
2,2011,831400,14,12,2,7
1,1999,843000,33,21,12,30
2,1999,843000,17,12,5,33
3,1999,843000,26,19,7,110
4,1999,843000,31,25,6,34
5,1999,843000,38,26,12,40
6,1999,843000,28,20,8,29
7,1999,843000,24,19,5,42
8,1999,843000,28,22,6,127
9,1999,843000,36,24,12,48
10,1999,843000,30,23,7,25
11,1999,843000,14,6,8,20
12,1999,843000,22,16,6,24
1,2000,843000,23,16,7,48
2,2000,843000,22,16,6,37
3,2000,843000,43,37,6,44
4,2000,843000,25,18,7,18
5,2000,843000,33,26,7,28
6,2000,843000,30,23,7,34
7,2000,843000,36,30,6,13
8,2000,843000,40,30,10,26
9,2000,843000,23,18,5,22
10,2000,843000,28,21,7,17
11,2000,843000,18,11,7,12
12,2000,843000,17,14,3,7
1,2001,843000,30,23,7,13
2,2001,843000,17,14,3,21
3,2001,843000,33,24,9,21
4,2001,843000,19,13,6,16
5,2001,843000,14,10,4,13
6,2001,843000,29,23,6,11
7,2001,843000,34,28,6,23
8,2001,843000,37,32,5,20
9,2001,843000,20,14,6,16
10,2001,843000,30,22,8,13
11,2001,843000,23,21,2,24
12,2001,843000,26,22,4,26
1,2002,843000,20,18,2,28
2,2002,843000,16,11,5,13
3,2002,843000,20,16,4,23
4,2002,843000,33,30,3,14
5,2002,843000,37,25,12,21
6,2002,843000,32,25,7,11
7,2002,843000,35,29,6,11
8,2002,843000,30,18,12,14
9,2002,843000,34,26,8,18
10,2002,843000,23,21,2,11
11,2002,843000,25,20,5,27
12,2002,843000,21,17,4,30
1,2003,843000,18,15,3,36
2,2003,843000,16,14,2,28
3,2003,843000,24,20,4,22
4,2003,843000,14,12,2,21
5,2003,843000,37,21,16,16
6,2003,843000,30,22,8,19
7,2003,843000,29,23,6,21
8,2003,843000,31,25,6,26
9,2003,843000,28,22,6,20
10,2003,843000,34,26,8,31
11,2003,843000,35,26,9,31
12,2003,843000,21,14,7,34
1,2004,843000,21,18,3,50
2,2004,843000,28,25,3,21
3,2004,843000,30,29,1,34
4,2004,843000,22,17,5,46
5,2004,843000,24,19,5,38
6,2004,843000,24,14,10,32
7,2004,843000,42,32,10,37
8,2004,843000,35,27,8,43
9,2004,843000,27,17,10,73
10,2004,843000,25,21,4,38
11,2004,843000,22,16,6,56
12,2004,843000,13,12,1,68
1,2005,843000,26,22,4,109
2,2005,843000,19,10,9,30
3,2005,843000,20,14,6,69
4,2005,843000,24,19,5,35
5,2005,843000,21,19,2,24
6,2005,843000,35,22,13,56
7,2005,843000,21,17,4,103
8,2005,843000,34,26,8,41
9,2005,843000,31,27,4,32
10,2005,843000,22,21,1,33
11,2005,843000,20,17,3,49
12,2005,843000,22,18,4,35
1,2006,843000,29,24,5,137
2,2006,843000,35,30,5,17
3,2006,843000,26,24,2,27
4,2006,843000,35,29,6,24
5,2006,843000,31,27,4,25
6,2006,843000,27,22,5,93
7,2006,843000,37,34,3,25
8,2006,843000,43,35,8,58
9,2006,843000,25,19,6,32
10,2006,843000,28,26,2,40
11,2006,843000,20,17,3,122
12,2006,843000,31,28,3,115
1,2007,843000,21,18,3,82
2,2007,843000,21,17,4,14
3,2007,843000,30,26,4,22
4,2007,843000,28,26,2,51
5,2007,843000,31,28,3,26
6,2007,843000,28,21,7,31
7,2007,843000,33,32,1,20
8,2007,843000,27,24,3,34
9,2007,843000,34,30,4,34
10,2007,843000,25,18,7,51
11,2007,843000,40,35,5,24
12,2007,843000,22,18,4,22
1,2008,843000,17,14,3,62
2,2008,843000,24,23,1,31
3,2008,843000,21,14,7,19
4,2008,843000,27,19,8,27
5,2008,843000,18,12,6,25
6,2008,843000,22,16,6,45
7,2008,843000,33,25,8,15
8,2008,843000,29,24,5,42
9,2008,843000,38,30,8,33
10,2008,843000,41,35,6,40
11,2008,843000,31,28,3,55
12,2008,843000,33,28,5,12
1,2009,843000,31,27,4,22
2,2009,843000,18,11,7,20
3,2009,843000,27,22,5,10
4,2009,843000,25,16,9,15
5,2009,843000,36,22,14,14
6,2009,843000,16,9,7,17
7,2009,843000,32,22,10,17
8,2009,843000,23,14,9,30
9,2009,843000,31,24,7,18
10,2009,843000,37,33,4,18
11,2009,843000,31,22,9,10
12,2009,843000,33,22,11,19
1,2010,843000,41,38,3,21
2,2010,843000,22,21,1,25
3,2010,843000,32,21,11,27
4,2010,843000,37,31,6,15
5,2010,843000,31,25,6,10
6,2010,843000,32,28,4,16
7,2010,843000,34,24,10,20
8,2010,843000,33,27,6,27
9,2010,843000,34,26,8,18
10,2010,843000,29,25,4,16
11,2010,843000,28,25,3,28
12,2010,843000,31,25,6,26
1,2011,843000,30,28,2,21
2,2011,843000,13,12,1,18
1,1999,838600,13,9,4,28
2,1999,838600,11,7,4,54
3,1999,838600,27,19,8,27
4,1999,838600,36,35,1,80
5,1999,838600,28,24,4,29
6,1999,838600,28,20,8,21
7,1999,838600,55,45,10,25
8,1999,838600,44,39,5,16
9,1999,838600,37,27,10,18
10,1999,838600,47,38,9,33
11,1999,838600,38,35,3,17
12,1999,838600,33,31,2,15
1,2000,838600,28,28,0,14
2,2000,838600,30,23,7,10
3,2000,838600,39,32,7,12
4,2000,838600,40,32,8,21
5,2000,838600,33,28,5,18
6,2000,838600,32,27,5,15
7,2000,838600,33,27,6,23
8,2000,838600,39,30,9,13
9,2000,838600,26,24,2,19
10,2000,838600,44,39,5,15
11,2000,838600,34,30,4,9
12,2000,838600,43,40,3,11
1,2001,838600,52,46,6,9
2,2001,838600,33,32,1,8
3,2001,838600,31,29,2,11
4,2001,838600,35,32,3,19
5,2001,838600,50,45,5,25
6,2001,838600,44,37,7,14
7,2001,838600,31,25,6,7
8,2001,838600,31,27,4,19
9,2001,838600,39,32,7,19
10,2001,838600,47,41,6,19
11,2001,838600,36,30,6,25
12,2001,838600,53,50,3,14
1,2002,838600,27,22,5,11
2,2002,838600,21,18,3,23
3,2002,838600,33,29,4,28
4,2002,838600,32,25,7,22
5,2002,838600,35,35,0,22
6,2002,838600,35,30,5,18
7,2002,838600,56,50,6,9
8,2002,838600,27,21,6,11
9,2002,838600,59,48,11,16
10,2002,838600,61,48,13,19
11,2002,838600,29,27,2,12
12,2002,838600,34,32,2,34
1,2003,838600,29,27,2,18
2,2003,838600,32,26,6,21
3,2003,838600,44,39,5,19
4,2003,838600,26,20,6,29
5,2003,838600,35,27,8,14
6,2003,838600,40,32,8,12
7,2003,838600,33,28,5,24
8,2003,838600,37,33,4,168
9,2003,838600,37,32,5,12
10,2003,838600,31,30,1,10
11,2003,838600,46,41,5,12
12,2003,838600,28,25,3,13
1,2004,838600,32,29,3,20
2,2004,838600,24,20,4,20
3,2004,838600,35,30,5,15
4,2004,838600,30,30,0,36
5,2004,838600,38,32,6,17
6,2004,838600,28,25,3,3
7,2004,838600,52,46,6,15
8,2004,838600,41,32,9,14
9,2004,838600,39,32,7,5
10,2004,838600,28,24,4,5
11,2004,838600,17,16,1,16
12,2004,838600,31,27,4,38
1,2005,838600,26,24,2,5
2,2005,838600,30,28,2,7
3,2005,838600,51,47,4,11
4,2005,838600,25,23,2,20
5,2005,838600,30,25,5,15
6,2005,838600,43,35,8,8
7,2005,838600,32,32,0,24
8,2005,838600,23,20,3,15
9,2005,838600,28,20,8,12
10,2005,838600,30,28,2,23
11,2005,838600,41,41,0,15
12,2005,838600,27,25,2,18
1,2006,838600,32,30,2,29
2,2006,838600,22,20,2,28
3,2006,838600,32,30,2,29
4,2006,838600,30,28,2,35
5,2006,838600,25,17,8,35
6,2006,838600,30,26,4,33
7,2006,838600,26,25,1,17
8,2006,838600,36,29,7,14
9,2006,838600,33,24,9,16
10,2006,838600,34,31,3,15
11,2006,838600,29,27,2,7
12,2006,838600,28,24,4,7
1,2007,838600,27,25,2,17
2,2007,838600,28,24,4,16
3,2007,838600,16,13,3,8
4,2007,838600,29,23,6,19
5,2007,838600,19,15,4,18
6,2007,838600,34,26,8,20
7,2007,838600,23,19,4,22
8,2007,838600,35,28,7,22
9,2007,838600,24,22,2,21
10,2007,838600,27,22,5,13
11,2007,838600,26,22,4,23
12,2007,838600,24,23,1,29
1,2008,838600,20,19,1,15
2,2008,838600,27,22,5,12
3,2008,838600,16,14,2,26
4,2008,838600,21,19,2,10
5,2008,838600,14,11,3,15
6,2008,838600,22,16,6,17
7,2008,838600,44,36,8,14
8,2008,838600,22,19,3,22
9,2008,838600,14,10,4,17
10,2008,838600,20,13,7,21
11,2008,838600,11,9,2,23
12,2008,838600,12,11,1,14
1,2009,838600,12,9,3,24
2,2009,838600,11,7,4,15
3,2009,838600,16,13,3,25
4,2009,838600,16,12,4,12
5,2009,838600,19,11,8,21
6,2009,838600,15,13,2,19
7,2009,838600,14,8,6,24
8,2009,838600,14,10,4,19
9,2009,838600,15,13,2,15
10,2009,838600,16,13,3,18
11,2009,838600,16,13,3,8
12,2009,838600,11,8,3,9
1,2010,838600,20,17,3,16
2,2010,838600,17,14,3,12
3,2010,838600,13,9,4,20
4,2010,838600,14,12,2,17
5,2010,838600,28,26,2,21
6,2010,838600,17,14,3,18
7,2010,838600,21,18,3,24
8,2010,838600,19,16,3,19
9,2010,838600,19,13,6,17
10,2010,838600,27,22,5,19
11,2010,838600,14,13,1,9
12,2010,838600,23,21,2,15
1,2011,838600,17,13,4,8
2,2011,838600,14,12,2,13
1,1999,283100,18,17,1,1
2,1999,283100,11,9,2,0
3,1999,283100,12,12,0,1
4,1999,283100,19,18,1,2
5,1999,283100,22,20,2,1
6,1999,283100,16,10,6,1
7,1999,283100,24,20,4,1
8,1999,283100,16,14,2,1
9,1999,283100,27,23,4,1
10,1999,283100,14,13,1,3
11,1999,283100,12,11,1,2
12,1999,283100,8,8,0,5
1,2000,283100,14,13,1,6
2,2000,283100,8,7,1,4
3,2000,283100,20,17,3,1
4,2000,283100,19,17,2,3
5,2000,283100,11,10,1,7
6,2000,283100,11,8,3,3
7,2000,283100,13,10,3,4
8,2000,283100,28,25,3,8
9,2000,283100,29,28,1,8
10,2000,283100,25,24,1,12
11,2000,283100,18,16,2,15
12,2000,283100,19,19,0,11
1,2001,283100,7,6,1,9
2,2001,283100,12,11,1,5
3,2001,283100,5,5,0,4
4,2001,283100,7,7,0,0
5,2001,283100,8,6,2,2
6,2001,283100,11,10,1,0
7,2001,283100,12,11,1,0
8,2001,283100,16,14,2,0
9,2001,283100,15,12,3,3
10,2001,283100,20,18,2,1
11,2001,283100,11,10,1,3
12,2001,283100,10,8,2,1
1,2002,283100,7,6,1,1
2,2002,283100,7,7,0,0
3,2002,283100,5,4,1,2
4,2002,283100,9,9,0,3
5,2002,283100,16,15,1,2
6,2002,283100,8,7,1,5
7,2002,283100,15,15,0,0
8,2002,283100,12,11,1,4
9,2002,283100,9,9,0,2
10,2002,283100,6,5,1,3
11,2002,283100,13,11,2,2
12,2002,283100,6,6,0,4
1,2003,283100,6,6,0,2
2,2003,283100,11,11,0,3
3,2003,283100,7,7,0,5
4,2003,283100,7,6,1,2
5,2003,283100,11,8,3,2
6,2003,283100,8,5,3,5
7,2003,283100,10,10,0,4
8,2003,283100,6,6,0,0
9,2003,283100,17,16,1,3
10,2003,283100,10,8,2,3
11,2003,283100,4,3,1,1
12,2003,283100,9,8,1,6
1,2004,283100,5,5,0,0
2,2004,283100,2,1,1,1
3,2004,283100,15,14,1,3
4,2004,283100,5,4,1,2
5,2004,283100,5,5,0,3
6,2004,283100,11,8,3,2
7,2004,283100,13,13,0,3
8,2004,283100,18,17,1,2
9,2004,283100,5,5,0,2
10,2004,283100,18,18,0,1
11,2004,283100,9,9,0,1
12,2004,283100,9,9,0,0
1,2005,283100,9,9,0,3
2,2005,283100,7,7,0,0
3,2005,283100,10,10,0,1
4,2005,283100,4,4,0,3
5,2005,283100,4,3,1,1
6,2005,283100,4,4,0,4
7,2005,283100,15,13,2,0
8,2005,283100,11,11,0,2
9,2005,283100,5,5,0,1
10,2005,283100,8,8,0,1
11,2005,283100,9,8,1,2
12,2005,283100,1,1,0,0
1,2006,283100,2,1,1,1
2,2006,283100,6,6,0,0
3,2006,283100,9,9,0,1
4,2006,283100,8,8,0,1
5,2006,283100,10,10,0,1
6,2006,283100,14,13,1,0
7,2006,283100,7,7,0,2
8,2006,283100,17,14,3,2
9,2006,283100,4,3,1,1
10,2006,283100,5,4,1,0
11,2006,283100,6,5,1,1
12,2006,283100,9,9,0,1
1,2007,283100,7,6,1,2
2,2007,283100,4,4,0,0
3,2007,283100,4,3,1,1
4,2007,283100,5,4,1,0
5,2007,283100,8,7,1,1
6,2007,283100,8,7,1,1
7,2007,283100,12,11,1,1
8,2007,283100,10,9,1,0
9,2007,283100,10,9,1,3
10,2007,283100,3,3,0,1
11,2007,283100,14,13,1,1
12,2007,283100,9,9,0,2
1,2008,283100,8,6,2,0
2,2008,283100,5,4,1,1
3,2008,283100,8,7,1,0
4,2008,283100,4,4,0,1
5,2008,283100,5,5,0,0
6,2008,283100,8,7,1,1
7,2008,283100,11,10,1,0
8,2008,283100,5,5,0,0
9,2008,283100,9,9,0,0
10,2008,283100,12,12,0,1
11,2008,283100,5,4,1,0
12,2008,283100,6,5,1,3
1,2009,283100,8,8,0,0
2,2009,283100,3,3,0,0
3,2009,283100,7,7,0,0
4,2009,283100,5,5,0,0
5,2009,283100,7,7,0,0
6,2009,283100,11,9,2,0
7,2009,283100,10,9,1,1
8,2009,283100,6,6,0,3
9,2009,283100,5,3,2,1
10,2009,283100,3,2,1,2
11,2009,283100,7,6,1,0
12,2009,283100,8,8,0,1
1,2010,283100,7,6,1,0
2,2010,283100,6,6,0,2
3,2010,283100,4,4,0,2
4,2010,283100,2,2,0,1
5,2010,283100,7,5,2,1
6,2010,283100,8,7,1,1
7,2010,283100,8,8,0,1
8,2010,283100,13,12,1,0
9,2010,283100,7,7,0,0
10,2010,283100,17,16,1,0
11,2010,283100,3,2,1,5
12,2010,283100,5,3,2,0
1,2011,283100,6,6,0,0
2,2011,283100,2,2,0,0
1,1999,833300,27,23,4,8
2,1999,833300,21,19,2,8
3,1999,833300,20,14,6,9
4,1999,833300,23,20,3,12
5,1999,833300,27,26,1,6
6,1999,833300,20,20,0,3
7,1999,833300,26,22,4,6
8,1999,833300,28,25,3,6
9,1999,833300,25,22,3,8
10,1999,833300,18,18,0,10
11,1999,833300,18,17,1,10
12,1999,833300,24,21,3,6
1,2000,833300,17,15,2,8
2,2000,833300,19,19,0,11
3,2000,833300,22,21,1,9
4,2000,833300,24,21,3,6
5,2000,833300,18,15,3,5
6,2000,833300,18,15,3,3
7,2000,833300,28,24,4,3
8,2000,833300,30,27,3,8
9,2000,833300,24,23,1,8
10,2000,833300,27,26,1,2
11,2000,833300,37,36,1,10
12,2000,833300,16,15,1,9
1,2001,833300,13,11,2,8
2,2001,833300,4,2,2,0
3,2001,833300,16,16,0,2
4,2001,833300,13,12,1,1
5,2001,833300,15,14,1,1
6,2001,833300,10,10,0,2
7,2001,833300,16,15,1,1
8,2001,833300,20,17,3,2
9,2001,833300,24,24,0,2
10,2001,833300,27,25,2,3
11,2001,833300,24,23,1,1
12,2001,833300,15,15,0,1
1,2002,833300,14,13,1,2
2,2002,833300,13,13,0,2
3,2002,833300,10,10,0,4
4,2002,833300,11,10,1,6
5,2002,833300,15,14,1,3
6,2002,833300,13,13,0,0
7,2002,833300,18,17,1,0
8,2002,833300,17,17,0,1
9,2002,833300,8,8,0,0
10,2002,833300,8,7,1,2
11,2002,833300,5,5,0,1
12,2002,833300,10,10,0,0
1,2003,833300,4,3,1,1
2,2003,833300,6,5,1,0
3,2003,833300,2,2,0,2
4,2003,833300,7,6,1,0
5,2003,833300,5,4,1,0
6,2003,833300,7,7,0,1
7,2003,833300,7,7,0,0
8,2003,833300,12,11,1,0
9,2003,833300,13,12,1,1
10,2003,833300,14,13,1,0
11,2003,833300,14,14,0,0
12,2003,833300,8,8,0,0
1,2004,833300,6,6,0,1
2,2004,833300,8,6,2,0
3,2004,833300,10,10,0,0
4,2004,833300,5,5,0,0
5,2004,833300,7,6,1,0
6,2004,833300,10,10,0,0
7,2004,833300,7,7,0,1
8,2004,833300,14,13,1,0
9,2004,833300,23,22,1,0
10,2004,833300,18,17,1,0
11,2004,833300,9,9,0,0
12,2004,833300,9,9,0,0
1,2005,833300,10,9,1,0
2,2005,833300,5,5,0,2
3,2005,833300,5,4,1,0
4,2005,833300,11,10,1,2
5,2005,833300,11,11,0,2
6,2005,833300,14,14,0,0
7,2005,833300,5,5,0,0
8,2005,833300,9,8,1,4
9,2005,833300,12,11,1,0
10,2005,833300,10,10,0,0
11,2005,833300,14,14,0,0
12,2005,833300,1,1,0,0
1,2006,833300,5,5,0,0
2,2006,833300,3,3,0,0
3,2006,833300,2,2,0,0
4,2006,833300,8,7,1,1
5,2006,833300,11,10,1,1
6,2006,833300,7,7,0,0
7,2006,833300,5,5,0,0
8,2006,833300,7,7,0,0
9,2006,833300,6,6,0,0
10,2006,833300,7,7,0,0
11,2006,833300,3,3,0,1
12,2006,833300,7,6,1,0
1,2007,833300,7,7,0,0
2,2007,833300,7,7,0,0
3,2007,833300,9,9,0,2
4,2007,833300,9,9,0,0
5,2007,833300,11,11,0,0
6,2007,833300,9,9,0,0
7,2007,833300,7,7,0,0
8,2007,833300,6,6,0,1
9,2007,833300,6,6,0,1
10,2007,833300,5,5,0,0
11,2007,833300,3,3,0,0
12,2007,833300,8,7,1,0
1,2008,833300,8,7,1,0
2,2008,833300,5,5,0,1
3,2008,833300,3,3,0,0
4,2008,833300,6,6,0,0
5,2008,833300,16,16,0,1
6,2008,833300,7,7,0,0
7,2008,833300,12,12,0,1
8,2008,833300,12,11,1,0
9,2008,833300,8,8,0,1
10,2008,833300,6,5,1,1
11,2008,833300,7,6,1,3
12,2008,833300,8,8,0,0
1,2009,833300,6,6,0,1
2,2009,833300,5,5,0,0
3,2009,833300,0,0,0,0
4,2009,833300,13,11,2,0
5,2009,833300,6,4,2,0
6,2009,833300,5,4,1,1
7,2009,833300,5,5,0,0
8,2009,833300,5,4,1,0
9,2009,833300,7,7,0,3
10,2009,833300,10,10,0,0
11,2009,833300,10,10,0,1
12,2009,833300,6,5,1,1
1,2010,833300,1,0,1,1
2,2010,833300,2,2,0,0
3,2010,833300,6,6,0,0
4,2010,833300,2,2,0,2
5,2010,833300,4,4,0,0
6,2010,833300,12,12,0,1
7,2010,833300,4,4,0,0
8,2010,833300,4,4,0,0
9,2010,833300,6,6,0,0
10,2010,833300,12,12,0,0
11,2010,833300,8,7,1,0
12,2010,833300,6,5,1,0
1,2011,833300,7,6,1,1
2,2011,833300,3,1,2,0
1,1999,838200,39,35,4,20
2,1999,838200,39,37,2,14
3,1999,838200,51,46,5,14
4,1999,838200,40,39,1,13
5,1999,838200,63,62,1,16
6,1999,838200,59,57,2,10
7,1999,838200,47,46,1,4
8,1999,838200,55,54,1,11
9,1999,838200,44,38,6,17
10,1999,838200,43,43,0,4
11,1999,838200,36,35,1,9
12,1999,838200,39,35,4,6
1,2000,838200,47,42,5,21
2,2000,838200,40,39,1,5
3,2000,838200,33,32,1,16
4,2000,838200,23,22,1,7
5,2000,838200,40,39,1,9
6,2000,838200,39,36,3,10
7,2000,838200,36,34,2,15
8,2000,838200,52,48,4,9
9,2000,838200,59,56,3,8
10,2000,838200,48,47,1,7
11,2000,838200,36,33,3,9
12,2000,838200,22,20,2,3
1,2001,838200,26,26,0,16
2,2001,838200,25,21,4,7
3,2001,838200,25,24,1,13
4,2001,838200,22,20,2,5
5,2001,838200,30,28,2,12
6,2001,838200,27,26,1,12
7,2001,838200,34,31,3,1
8,2001,838200,43,42,1,9
9,2001,838200,49,49,0,7
10,2001,838200,52,51,1,7
11,2001,838200,40,39,1,6
12,2001,838200,34,33,1,1
1,2002,838200,36,35,1,7
2,2002,838200,24,22,2,0
3,2002,838200,38,37,1,3
4,2002,838200,25,24,1,1
5,2002,838200,39,37,2,3
6,2002,838200,38,34,4,2
7,2002,838200,44,42,2,3
8,2002,838200,40,35,5,1
9,2002,838200,37,37,0,1
10,2002,838200,37,36,1,2
11,2002,838200,31,28,3,1
12,2002,838200,22,22,0,2
1,2003,838200,34,32,2,0
2,2003,838200,20,20,0,0
3,2003,838200,21,20,1,0
4,2003,838200,23,23,0,2
5,2003,838200,30,23,7,2
6,2003,838200,48,44,4,0
7,2003,838200,56,53,3,1
8,2003,838200,43,43,0,0
9,2003,838200,57,57,0,1
10,2003,838200,48,47,1,3
11,2003,838200,26,24,2,1
12,2003,838200,31,30,1,0
1,2004,838200,27,26,1,1
2,2004,838200,17,17,0,2
3,2004,838200,32,32,0,0
4,2004,838200,29,28,1,1
5,2004,838200,30,29,1,0
6,2004,838200,41,40,1,1
7,2004,838200,60,57,3,5
8,2004,838200,43,42,1,3
9,2004,838200,34,33,1,1
10,2004,838200,34,32,2,3
11,2004,838200,36,32,4,3
12,2004,838200,14,14,0,1
1,2005,838200,21,21,0,2
2,2005,838200,23,23,0,0
3,2005,838200,29,29,0,1
4,2005,838200,21,20,1,1
5,2005,838200,25,25,0,0
6,2005,838200,27,26,1,1
7,2005,838200,29,28,1,4
8,2005,838200,26,25,1,0
9,2005,838200,33,32,1,1
10,2005,838200,23,22,1,0
11,2005,838200,35,35,0,1
12,2005,838200,27,27,0,0
1,2006,838200,21,20,1,2
2,2006,838200,23,22,1,3
3,2006,838200,14,14,0,1
4,2006,838200,33,32,1,0
5,2006,838200,30,30,0,0
6,2006,838200,24,24,0,0
7,2006,838200,23,23,0,1
8,2006,838200,26,25,1,0
9,2006,838200,21,20,1,1
10,2006,838200,28,28,0,0
11,2006,838200,30,28,2,2
12,2006,838200,22,20,2,3
1,2007,838200,24,23,1,1
2,2007,838200,13,13,0,1
3,2007,838200,28,26,2,0
4,2007,838200,21,20,1,2
5,2007,838200,33,31,2,2
6,2007,838200,27,25,2,0
7,2007,838200,26,25,1,0
8,2007,838200,25,23,2,0
9,2007,838200,22,21,1,2
10,2007,838200,26,26,0,1
11,2007,838200,39,37,2,0
12,2007,838200,25,25,0,1
1,2008,838200,32,31,1,3
2,2008,838200,34,33,1,2
3,2008,838200,44,42,2,1
4,2008,838200,45,43,2,1
5,2008,838200,38,36,2,3
6,2008,838200,44,44,0,1
7,2008,838200,30,30,0,3
8,2008,838200,16,14,2,0
9,2008,838200,23,22,1,0
10,2008,838200,51,49,2,0
11,2008,838200,25,25,0,1
12,2008,838200,38,37,1,1
1,2009,838200,46,45,1,1
2,2009,838200,14,14,0,1
3,2009,838200,20,20,0,2
4,2009,838200,17,17,0,1
5,2009,838200,23,22,1,0
6,2009,838200,24,23,1,3
7,2009,838200,25,25,0,1
8,2009,838200,27,25,2,1
9,2009,838200,28,26,2,1
10,2009,838200,36,35,1,0
11,2009,838200,27,26,1,0
12,2009,838200,18,18,0,0
1,2010,838200,28,26,2,1
2,2010,838200,15,15,0,2
3,2010,838200,19,17,2,1
4,2010,838200,22,22,0,1
5,2010,838200,22,22,0,1
6,2010,838200,23,23,0,1
7,2010,838200,21,20,1,1
8,2010,838200,28,28,0,0
9,2010,838200,23,22,1,0
10,2010,838200,42,42,0,0
11,2010,838200,31,31,0,0
12,2010,838200,25,25,0,4
1,2011,838200,27,26,1,2
2,2011,838200,5,5,0,1
1,1999,282800,3,2,1,0
2,1999,282800,4,3,1,0
3,1999,282800,17,17,0,0
4,1999,282800,9,9,0,0
5,1999,282800,13,10,3,0
6,1999,282800,9,9,0,0
7,1999,282800,10,10,0,0
8,1999,282800,17,17,0,0
9,1999,282800,12,12,0,1
10,1999,282800,12,12,0,0
11,1999,282800,1,1,0,0
12,1999,282800,10,8,2,6
1,2000,282800,5,3,2,0
2,2000,282800,6,6,0,2
3,2000,282800,10,10,0,0
4,2000,282800,4,3,1,3
5,2000,282800,9,8,1,2
6,2000,282800,10,9,1,3
7,2000,282800,13,13,0,1
8,2000,282800,22,21,1,2
9,2000,282800,25,25,0,0
10,2000,282800,13,12,1,0
11,2000,282800,9,8,1,2
12,2000,282800,5,5,0,2
1,2001,282800,7,5,2,5
2,2001,282800,8,8,0,2
3,2001,282800,5,5,0,4
4,2001,282800,12,10,2,5
5,2001,282800,10,9,1,1
6,2001,282800,19,16,3,0
7,2001,282800,22,21,1,0
8,2001,282800,15,13,2,4
9,2001,282800,9,7,2,2
10,2001,282800,16,16,0,3
11,2001,282800,10,9,1,5
12,2001,282800,9,8,1,3
1,2002,282800,9,8,1,1
2,2002,282800,7,6,1,0
3,2002,282800,7,7,0,4
4,2002,282800,16,16,0,0
5,2002,282800,15,15,0,1
6,2002,282800,11,11,0,1
7,2002,282800,22,18,4,1
8,2002,282800,9,8,1,4
9,2002,282800,8,8,0,2
10,2002,282800,8,8,0,2
11,2002,282800,8,8,0,1
12,2002,282800,10,10,0,1
1,2003,282800,19,18,1,2
2,2003,282800,13,13,0,0
3,2003,282800,11,11,0,2
4,2003,282800,10,10,0,2
5,2003,282800,13,10,3,2
6,2003,282800,13,12,1,0
7,2003,282800,16,14,2,3
8,2003,282800,19,18,1,3
9,2003,282800,19,19,0,0
10,2003,282800,10,10,0,1
11,2003,282800,6,6,0,1
12,2003,282800,9,9,0,0
1,2004,282800,8,8,0,0
2,2004,282800,9,8,1,3
3,2004,282800,8,8,0,0
4,2004,282800,11,9,2,3
5,2004,282800,11,10,1,1
6,2004,282800,19,18,1,0
7,2004,282800,21,20,1,0
8,2004,282800,13,12,1,2
9,2004,282800,14,13,1,0
10,2004,282800,11,11,0,0
11,2004,282800,15,13,2,1
12,2004,282800,12,12,0,2
1,2005,282800,3,2,1,3
2,2005,282800,8,8,0,5
3,2005,282800,6,5,1,0
4,2005,282800,15,15,0,0
5,2005,282800,12,12,0,7
6,2005,282800,23,23,0,1
7,2005,282800,18,17,1,1
8,2005,282800,16,14,2,4
9,2005,282800,19,19,0,2
10,2005,282800,13,13,0,0
11,2005,282800,16,16,0,0
12,2005,282800,17,17,0,1
1,2006,282800,10,10,0,0
2,2006,282800,8,7,1,1
3,2006,282800,11,11,0,0
4,2006,282800,16,16,0,0
5,2006,282800,18,16,2,0
6,2006,282800,16,13,3,0
7,2006,282800,16,14,2,0
8,2006,282800,9,9,0,1
9,2006,282800,10,8,2,1
10,2006,282800,15,15,0,0
11,2006,282800,14,14,0,2
12,2006,282800,14,14,0,0
1,2007,282800,6,6,0,0
2,2007,282800,6,6,0,1
3,2007,282800,4,3,1,3
4,2007,282800,15,14,1,1
5,2007,282800,12,11,1,2
6,2007,282800,16,15,1,1
7,2007,282800,9,9,0,1
8,2007,282800,17,17,0,0
9,2007,282800,13,13,0,1
10,2007,282800,17,17,0,3
11,2007,282800,10,10,0,0
12,2007,282800,21,21,0,0
1,2008,282800,9,9,0,0
2,2008,282800,5,5,0,0
3,2008,282800,9,8,1,1
4,2008,282800,13,13,0,0
5,2008,282800,7,6,1,2
6,2008,282800,10,10,0,0
7,2008,282800,6,6,0,0
8,2008,282800,10,9,1,0
9,2008,282800,16,15,1,1
10,2008,282800,17,15,2,0
11,2008,282800,11,11,0,0
12,2008,282800,7,7,0,0
1,2009,282800,6,6,0,1
2,2009,282800,9,9,0,0
3,2009,282800,7,6,1,2
4,2009,282800,8,5,3,1
5,2009,282800,9,8,1,1
6,2009,282800,10,9,1,0
7,2009,282800,11,11,0,0
8,2009,282800,10,10,0,1
9,2009,282800,14,13,1,0
10,2009,282800,8,6,2,1
11,2009,282800,10,9,1,0
12,2009,282800,11,10,1,0
1,2010,282800,8,8,0,3
2,2010,282800,5,5,0,0
3,2010,282800,7,6,1,0
4,2010,282800,10,10,0,1
5,2010,282800,12,11,1,0
6,2010,282800,16,15,1,0
7,2010,282800,11,11,0,0
8,2010,282800,10,10,0,0
9,2010,282800,10,9,1,0
10,2010,282800,18,18,0,0
11,2010,282800,8,8,0,1
12,2010,282800,2,2,0,1
1,2011,282800,3,3,0,0
2,2011,282800,2,2,0,0
1,1999,320600,26,23,3,3
2,1999,320600,30,28,2,3
3,1999,320600,30,28,2,2
4,1999,320600,33,32,1,6
5,1999,320600,43,43,0,11
6,1999,320600,52,50,2,11
7,1999,320600,50,48,2,4
8,1999,320600,31,28,3,9
9,1999,320600,24,21,3,6
10,1999,320600,38,35,3,6
11,1999,320600,28,27,1,4
12,1999,320600,23,22,1,0
1,2000,320600,15,15,0,4
2,2000,320600,22,21,1,1
3,2000,320600,25,24,1,2
4,2000,320600,21,21,0,2
5,2000,320600,24,21,3,4
6,2000,320600,19,17,2,2
7,2000,320600,44,44,0,4
8,2000,320600,38,37,1,8
9,2000,320600,38,35,3,6
10,2000,320600,33,32,1,6
11,2000,320600,28,27,1,5
12,2000,320600,39,38,1,7
1,2001,320600,15,15,0,1
2,2001,320600,24,24,0,1
3,2001,320600,26,25,1,4
4,2001,320600,29,28,1,10
5,2001,320600,22,22,0,3
6,2001,320600,32,31,1,3
7,2001,320600,36,36,0,4
8,2001,320600,21,20,1,5
9,2001,320600,24,22,2,2
10,2001,320600,21,21,0,5
11,2001,320600,26,26,0,7
12,2001,320600,27,27,0,4
1,2002,320600,19,19,0,9
2,2002,320600,15,15,0,0
3,2002,320600,17,15,2,3
4,2002,320600,15,15,0,7
5,2002,320600,31,29,2,2
6,2002,320600,26,26,0,1
7,2002,320600,44,42,2,1
8,2002,320600,51,49,2,2
9,2002,320600,40,39,1,8
10,2002,320600,30,30,0,0
11,2002,320600,31,30,1,0
12,2002,320600,17,16,1,1
1,2003,320600,24,23,1,4
2,2003,320600,25,24,1,4
3,2003,320600,29,28,1,3
4,2003,320600,25,23,2,3
5,2003,320600,25,25,0,6
6,2003,320600,30,30,0,6
7,2003,320600,20,19,1,8
8,2003,320600,30,30,0,6
9,2003,320600,25,25,0,3
10,2003,320600,28,28,0,5
11,2003,320600,24,22,2,5
12,2003,320600,23,23,0,1
1,2004,320600,31,31,0,5
2,2004,320600,17,17,0,4
3,2004,320600,32,31,1,0
4,2004,320600,36,36,0,6
5,2004,320600,23,22,1,1
6,2004,320600,36,36,0,1
7,2004,320600,60,57,3,4
8,2004,320600,39,39,0,2
9,2004,320600,20,20,0,3
10,2004,320600,35,35,0,5
11,2004,320600,33,31,2,1
12,2004,320600,24,23,1,2
1,2005,320600,20,20,0,2
2,2005,320600,25,25,0,1
3,2005,320600,32,32,0,2
4,2005,320600,24,24,0,2
5,2005,320600,20,20,0,7
6,2005,320600,24,22,2,7
7,2005,320600,25,25,0,8
8,2005,320600,39,38,1,6
9,2005,320600,33,32,1,2
10,2005,320600,37,37,0,5
11,2005,320600,30,28,2,1
12,2005,320600,20,19,1,5
1,2006,320600,25,24,1,6
2,2006,320600,26,26,0,5
3,2006,320600,23,21,2,1
4,2006,320600,25,25,0,5
5,2006,320600,38,38,0,3
6,2006,320600,36,36,0,2
7,2006,320600,34,34,0,6
8,2006,320600,44,43,1,2
9,2006,320600,44,43,1,5
10,2006,320600,33,33,0,5
11,2006,320600,38,37,1,4
12,2006,320600,28,28,0,5
1,2007,320600,35,35,0,10
2,2007,320600,20,20,0,10
3,2007,320600,29,27,2,4
4,2007,320600,20,19,1,6
5,2007,320600,37,34,3,5
6,2007,320600,32,30,2,4
7,2007,320600,36,35,1,6
8,2007,320600,41,41,0,8
9,2007,320600,31,29,2,2
10,2007,320600,43,43,0,5
11,2007,320600,25,24,1,1
12,2007,320600,23,23,0,5
1,2008,320600,19,19,0,2
2,2008,320600,28,27,1,12
3,2008,320600,18,18,0,2
4,2008,320600,18,17,1,2
5,2008,320600,21,21,0,2
6,2008,320600,20,20,0,4
7,2008,320600,43,42,1,4
8,2008,320600,42,40,2,7
9,2008,320600,35,34,1,7
10,2008,320600,33,32,1,3
11,2008,320600,27,26,1,6
12,2008,320600,24,24,0,5
1,2009,320600,20,20,0,1
2,2009,320600,18,18,0,1
3,2009,320600,20,20,0,1
4,2009,320600,26,26,0,4
5,2009,320600,24,23,1,3
6,2009,320600,21,21,0,6
7,2009,320600,28,28,0,1
8,2009,320600,26,25,1,9
9,2009,320600,43,41,2,3
10,2009,320600,24,22,2,2
11,2009,320600,28,27,1,2
12,2009,320600,19,18,1,4
1,2010,320600,17,16,1,9
2,2010,320600,11,11,0,1
3,2010,320600,22,21,1,3
4,2010,320600,21,18,3,7
5,2010,320600,23,21,2,0
6,2010,320600,27,27,0,5
7,2010,320600,33,31,2,3
8,2010,320600,27,27,0,8
9,2010,320600,28,27,1,5
10,2010,320600,28,28,0,4
11,2010,320600,22,22,0,2
12,2010,320600,17,17,0,5
1,2011,320600,18,17,1,2
2,2011,320600,15,15,0,4
1,1999,283200,16,15,1,3
2,1999,283200,14,12,2,2
3,1999,283200,14,10,4,2
4,1999,283200,17,16,1,6
5,1999,283200,22,20,2,5
6,1999,283200,23,20,3,2
7,1999,283200,17,15,2,3
8,1999,283200,23,19,4,4
9,1999,283200,25,18,7,11
10,1999,283200,16,14,2,7
11,1999,283200,11,10,1,10
12,1999,283200,13,13,0,6
1,2000,283200,10,8,2,12
2,2000,283200,17,14,3,12
3,2000,283200,9,7,2,5
4,2000,283200,17,14,3,5
5,2000,283200,25,22,3,2
6,2000,283200,9,8,1,7
7,2000,283200,22,18,4,1
8,2000,283200,25,22,3,5
9,2000,283200,25,23,2,4
10,2000,283200,23,19,4,7
11,2000,283200,23,23,0,10
12,2000,283200,10,10,0,4
1,2001,283200,19,19,0,13
2,2001,283200,9,6,3,6
3,2001,283200,8,7,1,4
4,2001,283200,6,5,1,8
5,2001,283200,10,8,2,3
6,2001,283200,8,6,2,3
7,2001,283200,18,16,2,2
8,2001,283200,22,18,4,0
9,2001,283200,17,16,1,1
10,2001,283200,16,15,1,3
11,2001,283200,10,9,1,5
12,2001,283200,15,14,1,4
1,2002,283200,6,6,0,4
2,2002,283200,12,11,1,3
3,2002,283200,10,10,0,7
4,2002,283200,9,8,1,1
5,2002,283200,21,18,3,2
6,2002,283200,27,26,1,1
7,2002,283200,18,18,0,3
8,2002,283200,18,15,3,2
9,2002,283200,16,16,0,2
10,2002,283200,14,14,0,0
11,2002,283200,8,7,1,0
12,2002,283200,4,4,0,4
1,2003,283200,8,7,1,0
2,2003,283200,6,6,0,1
3,2003,283200,7,6,1,3
4,2003,283200,8,7,1,1
5,2003,283200,4,3,1,1
6,2003,283200,8,7,1,0
7,2003,283200,12,11,1,0
8,2003,283200,14,13,1,0
9,2003,283200,10,10,0,0
10,2003,283200,14,13,1,1
11,2003,283200,22,21,1,0
12,2003,283200,11,11,0,0
1,2004,283200,5,5,0,1
2,2004,283200,10,10,0,0
3,2004,283200,6,5,1,0
4,2004,283200,12,12,0,1
5,2004,283200,18,18,0,1
6,2004,283200,16,16,0,0
7,2004,283200,12,12,0,3
8,2004,283200,13,13,0,3
9,2004,283200,6,6,0,0
10,2004,283200,24,24,0,2
11,2004,283200,17,16,1,0
12,2004,283200,19,19,0,0
1,2005,283200,12,12,0,2
2,2005,283200,14,14,0,2
3,2005,283200,12,11,1,0
4,2005,283200,7,6,1,4
5,2005,283200,8,7,1,2
6,2005,283200,13,12,1,0
7,2005,283200,6,6,0,0
8,2005,283200,7,6,1,1
9,2005,283200,6,6,0,0
10,2005,283200,9,9,0,0
11,2005,283200,16,16,0,2
12,2005,283200,9,9,0,0
1,2006,283200,6,6,0,2
2,2006,283200,2,2,0,3
3,2006,283200,4,3,1,0
4,2006,283200,8,8,0,0
5,2006,283200,7,5,2,6
6,2006,283200,14,14,0,2
7,2006,283200,11,9,2,0
8,2006,283200,6,6,0,1
9,2006,283200,9,9,0,3
10,2006,283200,9,8,1,0
11,2006,283200,6,6,0,0
12,2006,283200,7,7,0,0
1,2007,283200,1,1,0,0
2,2007,283200,6,6,0,2
3,2007,283200,5,5,0,2
4,2007,283200,9,9,0,1
5,2007,283200,8,7,1,1
6,2007,283200,8,7,1,0
7,2007,283200,13,13,0,0
8,2007,283200,7,7,0,0
9,2007,283200,7,7,0,0
10,2007,283200,9,9,0,0
11,2007,283200,5,5,0,0
12,2007,283200,6,6,0,0
1,2008,283200,5,5,0,0
2,2008,283200,0,0,0,0
3,2008,283200,8,7,1,0
4,2008,283200,6,6,0,0
5,2008,283200,9,7,2,0
6,2008,283200,11,11,0,1
7,2008,283200,11,11,0,0
8,2008,283200,12,12,0,0
9,2008,283200,10,9,1,0
10,2008,283200,14,14,0,0
11,2008,283200,10,9,1,2
12,2008,283200,2,2,0,0
1,2009,283200,2,2,0,0
2,2009,283200,4,3,1,0
3,2009,283200,2,1,1,0
4,2009,283200,6,5,1,0
5,2009,283200,8,8,0,0
6,2009,283200,4,4,0,0
7,2009,283200,9,9,0,0
8,2009,283200,8,8,0,1
9,2009,283200,7,7,0,0
10,2009,283200,2,2,0,0
11,2009,283200,9,8,1,1
12,2009,283200,10,9,1,1
1,2010,283200,0,0,0,0
2,2010,283200,4,4,0,0
3,2010,283200,6,6,0,1
4,2010,283200,3,3,0,1
5,2010,283200,12,12,0,1
6,2010,283200,4,4,0,0
7,2010,283200,16,15,1,0
8,2010,283200,17,17,0,0
9,2010,283200,9,9,0,0
10,2010,283200,11,11,0,0
11,2010,283200,5,5,0,0
12,2010,283200,4,4,0,0
1,2011,283200,3,3,0,0
2,2011,283200,6,6,0,0
1,1999,839000,28,28,0,0
2,1999,839000,19,19,0,0
3,1999,839000,18,17,1,0
4,1999,839000,23,23,0,3
5,1999,839000,39,38,1,1
6,1999,839000,36,35,1,3
7,1999,839000,26,26,0,2
8,1999,839000,28,27,1,2
9,1999,839000,33,31,2,6
10,1999,839000,33,33,0,1
11,1999,839000,32,31,1,0
12,1999,839000,28,27,1,1
1,2000,839000,25,23,2,0
2,2000,839000,21,19,2,3
3,2000,839000,34,32,2,0
4,2000,839000,20,19,1,0
5,2000,839000,16,15,1,0
6,2000,839000,26,26,0,0
7,2000,839000,39,37,2,0
8,2000,839000,35,33,2,6
9,2000,839000,22,21,1,1
10,2000,839000,30,28,2,0
11,2000,839000,24,22,2,0
12,2000,839000,23,20,3,1
1,2001,839000,21,21,0,0
2,2001,839000,17,17,0,2
3,2001,839000,23,20,3,1
4,2001,839000,22,21,1,1
5,2001,839000,21,20,1,0
6,2001,839000,33,32,1,0
7,2001,839000,29,29,0,0
8,2001,839000,42,41,1,0
9,2001,839000,30,27,3,1
10,2001,839000,32,28,4,1
11,2001,839000,41,39,2,2
12,2001,839000,19,17,2,2
1,2002,839000,25,23,2,5
2,2002,839000,14,14,0,2
3,2002,839000,20,20,0,1
4,2002,839000,24,23,1,3
5,2002,839000,36,32,4,2
6,2002,839000,23,22,1,1
7,2002,839000,30,29,1,1
8,2002,839000,33,32,1,1
9,2002,839000,26,23,3,0
10,2002,839000,18,17,1,0
11,2002,839000,22,21,1,1
12,2002,839000,30,29,1,1
1,2003,839000,20,20,0,0
2,2003,839000,16,16,0,0
3,2003,839000,31,31,0,0
4,2003,839000,29,28,1,1
5,2003,839000,25,25,0,0
6,2003,839000,30,29,1,0
7,2003,839000,31,30,1,0
8,2003,839000,31,30,1,2
9,2003,839000,26,24,2,1
10,2003,839000,33,29,4,4
11,2003,839000,24,23,1,0
12,2003,839000,22,22,0,2
1,2004,839000,23,21,2,0
2,2004,839000,22,20,2,0
3,2004,839000,19,18,1,0
4,2004,839000,18,18,0,0
5,2004,839000,43,38,5,0
6,2004,839000,27,24,3,3
7,2004,839000,34,34,0,0
8,2004,839000,30,26,4,3
9,2004,839000,34,32,2,0
10,2004,839000,30,29,1,0
11,2004,839000,33,32,1,3
12,2004,839000,28,28,0,3
1,2005,839000,30,28,2,7
2,2005,839000,22,22,0,0
3,2005,839000,27,26,1,0
4,2005,839000,27,25,2,1
5,2005,839000,30,30,0,2
6,2005,839000,21,19,2,0
7,2005,839000,44,43,1,1
8,2005,839000,36,33,3,0
9,2005,839000,44,43,1,2
10,2005,839000,26,24,2,0
11,2005,839000,51,49,2,2
12,2005,839000,25,22,3,3
1,2006,839000,37,37,0,1
2,2006,839000,24,24,0,0
3,2006,839000,30,29,1,1
4,2006,839000,23,22,1,0
5,2006,839000,27,27,0,0
6,2006,839000,26,26,0,0
7,2006,839000,22,21,1,0
8,2006,839000,40,39,1,0
9,2006,839000,36,36,0,4
10,2006,839000,31,31,0,0
11,2006,839000,24,23,1,0
12,2006,839000,21,20,1,0
1,2007,839000,23,23,0,0
2,2007,839000,28,28,0,0
3,2007,839000,29,29,0,0
4,2007,839000,17,17,0,0
5,2007,839000,23,23,0,0
6,2007,839000,30,29,1,0
7,2007,839000,33,33,0,0
8,2007,839000,27,25,2,0
9,2007,839000,26,26,0,0
10,2007,839000,33,33,0,0
11,2007,839000,24,24,0,0
12,2007,839000,25,25,0,0
1,2008,839000,37,37,0,0
2,2008,839000,20,20,0,1
3,2008,839000,28,25,3,0
4,2008,839000,30,29,1,1
5,2008,839000,34,34,0,0
6,2008,839000,51,51,0,0
7,2008,839000,44,43,1,0
8,2008,839000,48,48,0,0
9,2008,839000,28,28,0,1
10,2008,839000,22,22,0,0
11,2008,839000,38,38,0,0
12,2008,839000,34,33,1,0
1,2009,839000,28,28,0,0
2,2009,839000,26,26,0,0
3,2009,839000,30,29,1,2
4,2009,839000,28,28,0,0
5,2009,839000,31,31,0,0
6,2009,839000,30,29,1,0
7,2009,839000,30,30,0,0
8,2009,839000,25,25,0,1
9,2009,839000,31,31,0,0
10,2009,839000,32,32,0,0
11,2009,839000,26,26,0,0
12,2009,839000,33,32,1,0
1,2010,839000,38,38,0,0
2,2010,839000,27,26,1,1
3,2010,839000,28,28,0,1
4,2010,839000,25,25,0,1
5,2010,839000,34,32,2,1
6,2010,839000,30,30,0,0
7,2010,839000,31,30,1,0
8,2010,839000,30,30,0,0
9,2010,839000,20,20,0,1
10,2010,839000,44,43,1,2
11,2010,839000,28,27,1,0
12,2010,839000,20,20,0,1
1,2011,839000,16,16,0,0
2,2011,839000,9,8,1,0
1,1999,282700,15,13,2,4
2,1999,282700,23,20,3,3
3,1999,282700,19,13,6,9
4,1999,282700,21,19,2,5
5,1999,282700,22,18,4,2
6,1999,282700,36,28,8,4
7,1999,282700,21,19,2,4
8,1999,282700,19,15,4,1
9,1999,282700,16,16,0,3
10,1999,282700,23,22,1,6
11,1999,282700,18,15,3,9
12,1999,282700,13,11,2,4
1,2000,282700,17,11,6,10
2,2000,282700,14,11,3,10
3,2000,282700,12,8,4,4
4,2000,282700,21,18,3,7
5,2000,282700,17,13,4,2
6,2000,282700,17,13,4,3
7,2000,282700,22,16,6,4
8,2000,282700,31,25,6,14
9,2000,282700,30,26,4,8
10,2000,282700,26,23,3,7
11,2000,282700,18,17,1,5
12,2000,282700,23,19,4,6
1,2001,282700,13,11,2,9
2,2001,282700,14,14,0,9
3,2001,282700,14,12,2,18
4,2001,282700,16,11,5,14
5,2001,282700,21,16,5,4
6,2001,282700,24,20,4,11
7,2001,282700,22,16,6,7
8,2001,282700,22,16,6,9
9,2001,282700,24,18,6,12
10,2001,282700,23,20,3,15
11,2001,282700,13,10,3,15
12,2001,282700,11,11,0,16
1,2002,282700,18,9,9,6
2,2002,282700,20,17,3,16
3,2002,282700,10,10,0,9
4,2002,282700,17,14,3,18
5,2002,282700,24,18,6,11
6,2002,282700,26,19,7,11
7,2002,282700,32,27,5,11
8,2002,282700,31,26,5,19
9,2002,282700,29,26,3,14
10,2002,282700,31,23,8,11
11,2002,282700,18,16,2,10
12,2002,282700,20,16,4,12
1,2003,282700,17,14,3,14
2,2003,282700,8,5,3,5
3,2003,282700,15,14,1,12
4,2003,282700,27,19,8,8
5,2003,282700,39,31,8,8
6,2003,282700,24,22,2,5
7,2003,282700,38,34,4,5
8,2003,282700,27,24,3,12
9,2003,282700,27,22,5,5
10,2003,282700,15,11,4,5
11,2003,282700,15,14,1,2
12,2003,282700,11,11,0,2
1,2004,282700,11,11,0,0
2,2004,282700,12,12,0,2
3,2004,282700,14,11,3,1
4,2004,282700,13,11,2,4
5,2004,282700,15,12,3,0
6,2004,282700,11,11,0,1
7,2004,282700,24,23,1,1
8,2004,282700,21,19,2,2
9,2004,282700,14,14,0,1
10,2004,282700,17,17,0,0
11,2004,282700,14,14,0,0
12,2004,282700,14,13,1,1
1,2005,282700,10,7,3,0
2,2005,282700,10,9,1,0
3,2005,282700,13,9,4,6
4,2005,282700,6,4,2,1
5,2005,282700,15,14,1,4
6,2005,282700,20,14,6,1
7,2005,282700,16,15,1,1
8,2005,282700,18,16,2,1
9,2005,282700,21,20,1,3
10,2005,282700,13,11,2,0
11,2005,282700,14,13,1,1
12,2005,282700,17,16,1,1
1,2006,282700,17,15,2,0
2,2006,282700,17,16,1,0
3,2006,282700,19,17,2,0
4,2006,282700,18,18,0,0
5,2006,282700,22,22,0,1
6,2006,282700,10,10,0,1
7,2006,282700,17,16,1,1
8,2006,282700,17,16,1,0
9,2006,282700,13,12,1,2
10,2006,282700,12,11,1,1
11,2006,282700,18,16,2,0
12,2006,282700,11,10,1,3
1,2007,282700,15,15,0,6
2,2007,282700,9,7,2,7
3,2007,282700,14,14,0,2
4,2007,282700,12,11,1,0
5,2007,282700,27,22,5,3
6,2007,282700,27,24,3,1
7,2007,282700,26,24,2,1
8,2007,282700,12,11,1,1
9,2007,282700,24,22,2,3
10,2007,282700,14,14,0,3
11,2007,282700,10,10,0,1
12,2007,282700,20,20,0,1
1,2008,282700,28,28,0,2
2,2008,282700,14,14,0,4
3,2008,282700,16,15,1,1
4,2008,282700,17,13,4,2
5,2008,282700,22,22,0,1
6,2008,282700,27,23,4,1
7,2008,282700,21,21,0,0
8,2008,282700,25,20,5,0
9,2008,282700,14,14,0,3
10,2008,282700,19,19,0,1
11,2008,282700,17,15,2,0
12,2008,282700,10,9,1,0
1,2009,282700,9,8,1,0
2,2009,282700,9,7,2,1
3,2009,282700,14,12,2,0
4,2009,282700,9,8,1,4
5,2009,282700,6,6,0,0
6,2009,282700,14,10,4,0
7,2009,282700,21,20,1,1
8,2009,282700,13,10,3,1
9,2009,282700,18,17,1,1
10,2009,282700,23,23,0,3
11,2009,282700,15,14,1,0
12,2009,282700,21,21,0,0
1,2010,282700,24,22,2,0
2,2010,282700,12,12,0,3
3,2010,282700,11,10,1,1
4,2010,282700,14,13,1,0
5,2010,282700,9,9,0,1
6,2010,282700,15,15,0,0
7,2010,282700,19,16,3,3
8,2010,282700,28,25,3,1
9,2010,282700,21,18,3,4
10,2010,282700,23,22,1,3
11,2010,282700,9,8,1,1
12,2010,282700,8,8,0,1
1,2011,282700,15,14,1,1
2,2011,282700,7,3,4,1
1,1999,261000,8,7,1,17
2,1999,261000,19,13,6,26
3,1999,261000,12,7,5,22
4,1999,261000,15,12,3,28
5,1999,261000,26,16,10,32
6,1999,261000,9,7,2,26
7,1999,261000,13,7,6,16
8,1999,261000,8,6,2,137
9,1999,261000,12,8,4,39
10,1999,261000,23,17,6,150
11,1999,261000,17,12,5,50
12,1999,261000,8,4,4,36
1,2000,261000,17,14,3,14
2,2000,261000,13,9,4,12
3,2000,261000,12,7,5,10
4,2000,261000,20,16,4,13
5,2000,261000,12,9,3,7
6,2000,261000,12,11,1,3
7,2000,261000,15,8,7,9
8,2000,261000,14,10,4,7
9,2000,261000,15,12,3,15
10,2000,261000,10,8,2,9
11,2000,261000,12,8,4,16
12,2000,261000,8,6,2,10
1,2001,261000,9,7,2,11
2,2001,261000,7,5,2,3
3,2001,261000,10,6,4,6
4,2001,261000,13,11,2,12
5,2001,261000,12,10,2,14
6,2001,261000,15,9,6,10
7,2001,261000,12,9,3,11
8,2001,261000,17,12,5,8
9,2001,261000,23,16,7,11
10,2001,261000,20,15,5,6
11,2001,261000,12,10,2,14
12,2001,261000,11,9,2,10
1,2002,261000,10,8,2,8
2,2002,261000,16,9,7,5
3,2002,261000,10,4,6,5
4,2002,261000,10,5,5,5
5,2002,261000,12,5,7,15
6,2002,261000,14,6,8,6
7,2002,261000,10,7,3,9
8,2002,261000,26,21,5,7
9,2002,261000,24,19,5,8
10,2002,261000,13,12,1,2
11,2002,261000,15,10,5,9
12,2002,261000,6,2,4,6
1,2003,261000,12,9,3,5
2,2003,261000,16,13,3,2
3,2003,261000,10,8,2,17
4,2003,261000,12,10,2,21
5,2003,261000,16,13,3,13
6,2003,261000,15,10,5,21
7,2003,261000,10,9,1,9
8,2003,261000,16,7,9,18
9,2003,261000,10,10,0,20
10,2003,261000,11,5,6,11
11,2003,261000,3,3,0,15
12,2003,261000,7,5,2,9
1,2004,261000,8,7,1,11
2,2004,261000,2,2,0,9
3,2004,261000,9,7,2,12
4,2004,261000,8,5,3,14
5,2004,261000,6,3,3,24
6,2004,261000,12,9,3,9
7,2004,261000,18,14,4,24
8,2004,261000,18,12,6,15
9,2004,261000,9,7,2,9
10,2004,261000,8,5,3,36
11,2004,261000,11,7,4,17
12,2004,261000,12,8,4,12
1,2005,261000,14,12,2,9
2,2005,261000,7,6,1,10
3,2005,261000,13,9,4,8
4,2005,261000,13,7,6,7
5,2005,261000,17,10,7,8
6,2005,261000,11,8,3,6
7,2005,261000,15,12,3,10
8,2005,261000,15,10,5,9
9,2005,261000,17,13,4,6
10,2005,261000,14,9,5,8
11,2005,261000,15,13,2,13
12,2005,261000,13,11,2,5
1,2006,261000,13,9,4,11
2,2006,261000,12,9,3,8
3,2006,261000,11,9,2,8
4,2006,261000,8,6,2,8
5,2006,261000,21,15,6,6
6,2006,261000,17,11,6,7
7,2006,261000,24,19,5,4
8,2006,261000,16,13,3,6
9,2006,261000,15,14,1,13
10,2006,261000,9,7,2,17
11,2006,261000,19,11,8,11
12,2006,261000,14,13,1,1
1,2007,261000,12,11,1,3
2,2007,261000,13,12,1,4
3,2007,261000,14,13,1,6
4,2007,261000,21,19,2,3
5,2007,261000,12,9,3,7
6,2007,261000,17,13,4,6
7,2007,261000,15,10,5,8
8,2007,261000,9,6,3,6
9,2007,261000,12,8,4,6
10,2007,261000,22,18,4,1
11,2007,261000,16,11,5,6
12,2007,261000,10,8,2,11
1,2008,261000,13,9,4,5
2,2008,261000,7,7,0,5
3,2008,261000,16,13,3,10
4,2008,261000,12,11,1,5
5,2008,261000,19,11,8,7
6,2008,261000,20,15,5,5
7,2008,261000,20,17,3,2
8,2008,261000,24,16,8,3
9,2008,261000,11,8,3,1
10,2008,261000,20,17,3,2
11,2008,261000,20,16,4,3
12,2008,261000,11,9,2,6
1,2009,261000,14,12,2,2
2,2009,261000,9,9,0,6
3,2009,261000,10,4,6,3
4,2009,261000,10,5,5,6
5,2009,261000,12,6,6,2
6,2009,261000,3,1,2,4
7,2009,261000,15,12,3,3
8,2009,261000,13,12,1,3
9,2009,261000,13,11,2,2
10,2009,261000,6,6,0,0
11,2009,261000,13,12,1,3
12,2009,261000,11,10,1,3
1,2010,261000,6,5,1,5
2,2010,261000,18,13,5,6
3,2010,261000,14,10,4,9
4,2010,261000,11,8,3,1
5,2010,261000,14,11,3,3
6,2010,261000,18,15,3,2
7,2010,261000,4,3,1,1
8,2010,261000,10,8,2,1
9,2010,261000,11,10,1,3
10,2010,261000,11,10,1,3
11,2010,261000,12,12,0,4
12,2010,261000,9,9,0,1
1,2011,261000,6,6,0,3
2,2011,261000,5,5,0,3
1,1999,260900,14,11,3,6
2,1999,260900,15,9,6,4
3,1999,260900,14,9,5,8
4,1999,260900,10,7,3,5
5,1999,260900,18,13,5,15
6,1999,260900,13,7,6,4
7,1999,260900,9,9,0,13
8,1999,260900,9,7,2,90
9,1999,260900,15,10,5,126
10,1999,260900,14,11,3,9
11,1999,260900,15,13,2,7
12,1999,260900,6,5,1,4
1,2000,260900,16,10,6,9
2,2000,260900,16,15,1,5
3,2000,260900,19,12,7,7
4,2000,260900,13,11,2,8
5,2000,260900,19,13,6,7
6,2000,260900,14,11,3,3
7,2000,260900,11,9,2,5
8,2000,260900,17,12,5,4
9,2000,260900,21,16,5,9
10,2000,260900,14,12,2,3
11,2000,260900,4,4,0,10
12,2000,260900,11,9,2,3
1,2001,260900,12,9,3,15
2,2001,260900,10,8,2,7
3,2001,260900,9,8,1,9
4,2001,260900,12,11,1,13
5,2001,260900,12,9,3,3
6,2001,260900,10,5,5,4
7,2001,260900,21,14,7,4
8,2001,260900,18,16,2,4
9,2001,260900,18,9,9,3
10,2001,260900,29,18,11,4
11,2001,260900,18,15,3,9
12,2001,260900,14,12,2,5
1,2002,260900,21,14,7,14
2,2002,260900,10,7,3,14
3,2002,260900,14,12,2,7
4,2002,260900,13,10,3,5
5,2002,260900,16,12,4,12
6,2002,260900,16,10,6,6
7,2002,260900,30,27,3,4
8,2002,260900,18,13,5,4
9,2002,260900,10,9,1,1
10,2002,260900,20,14,6,4
11,2002,260900,15,12,3,6
12,2002,260900,7,7,0,7
1,2003,260900,10,10,0,8
2,2003,260900,9,8,1,14
3,2003,260900,8,6,2,15
4,2003,260900,8,7,1,6
5,2003,260900,17,14,3,11
6,2003,260900,15,10,5,3
7,2003,260900,14,14,0,8
8,2003,260900,23,17,6,18
9,2003,260900,18,14,4,2
10,2003,260900,13,11,2,3
11,2003,260900,13,11,2,14
12,2003,260900,11,9,2,13
1,2004,260900,17,14,3,22
2,2004,260900,5,3,2,12
3,2004,260900,21,18,3,19
4,2004,260900,12,8,4,8
5,2004,260900,11,6,5,17
6,2004,260900,7,5,2,24
7,2004,260900,14,11,3,10
8,2004,260900,15,10,5,10
9,2004,260900,18,13,5,11
10,2004,260900,11,7,4,14
11,2004,260900,16,11,5,47
12,2004,260900,10,6,4,24
1,2005,260900,16,14,2,10
2,2005,260900,8,7,1,34
3,2005,260900,21,12,9,15
4,2005,260900,24,17,7,17
5,2005,260900,19,15,4,14
6,2005,260900,11,9,2,17
7,2005,260900,21,17,4,12
8,2005,260900,24,15,9,12
9,2005,260900,15,15,0,22
10,2005,260900,18,16,2,4
11,2005,260900,13,10,3,5
12,2005,260900,12,10,2,5
1,2006,260900,16,15,1,13
2,2006,260900,4,3,1,6
3,2006,260900,12,6,6,5
4,2006,260900,19,16,3,9
5,2006,260900,21,18,3,14
6,2006,260900,15,11,4,9
7,2006,260900,10,7,3,9
8,2006,260900,20,17,3,50
9,2006,260900,16,13,3,8
10,2006,260900,10,8,2,14
11,2006,260900,23,22,1,60
12,2006,260900,22,19,3,11
1,2007,260900,16,15,1,11
2,2007,260900,9,8,1,12
3,2007,260900,15,13,2,15
4,2007,260900,13,7,6,3
5,2007,260900,17,14,3,9
6,2007,260900,17,12,5,10
7,2007,260900,16,13,3,12
8,2007,260900,9,5,4,4
9,2007,260900,21,16,5,15
10,2007,260900,17,13,4,10
11,2007,260900,16,11,5,16
12,2007,260900,11,9,2,20
1,2008,260900,9,6,3,9
2,2008,260900,7,6,1,4
3,2008,260900,8,5,3,4
4,2008,260900,20,17,3,4
5,2008,260900,15,14,1,3
6,2008,260900,26,22,4,2
7,2008,260900,22,21,1,11
8,2008,260900,7,6,1,5
9,2008,260900,24,23,1,2
10,2008,260900,13,12,1,5
11,2008,260900,26,22,4,5
12,2008,260900,8,8,0,6
1,2009,260900,10,7,3,23
2,2009,260900,9,8,1,11
3,2009,260900,13,11,2,7
4,2009,260900,15,7,8,7
5,2009,260900,17,13,4,9
6,2009,260900,14,10,4,7
7,2009,260900,13,13,0,6
8,2009,260900,19,15,4,5
9,2009,260900,13,8,5,6
10,2009,260900,15,12,3,8
11,2009,260900,13,12,1,8
12,2009,260900,10,7,3,5
1,2010,260900,14,14,0,7
2,2010,260900,9,7,2,7
3,2010,260900,14,10,4,9
4,2010,260900,14,13,1,4
5,2010,260900,16,15,1,7
6,2010,260900,21,17,4,2
7,2010,260900,11,9,2,8
8,2010,260900,13,11,2,5
9,2010,260900,13,11,2,12
10,2010,260900,19,16,3,7
11,2010,260900,15,14,1,8
12,2010,260900,10,8,2,12
1,2011,260900,10,9,1,7
2,2011,260900,10,7,3,3
1,1999,270500,26,21,5,10
2,1999,270500,17,12,5,20
3,1999,270500,11,9,2,12
4,1999,270500,23,17,6,15
5,1999,270500,16,9,7,21
6,1999,270500,16,14,2,22
7,1999,270500,26,16,10,25
8,1999,270500,25,22,3,20
9,1999,270500,14,8,6,55
10,1999,270500,21,18,3,12
11,1999,270500,12,8,4,15
12,1999,270500,16,7,9,17
1,2000,270500,12,8,4,24
2,2000,270500,10,8,2,26
3,2000,270500,14,6,8,29
4,2000,270500,18,15,3,22
5,2000,270500,18,11,7,34
6,2000,270500,18,11,7,14
7,2000,270500,24,17,7,31
8,2000,270500,20,17,3,9
9,2000,270500,15,9,6,11
10,2000,270500,25,18,7,15
11,2000,270500,18,11,7,14
12,2000,270500,12,12,0,5
1,2001,270500,24,13,11,17
2,2001,270500,14,10,4,6
3,2001,270500,20,17,3,24
4,2001,270500,32,28,4,4
5,2001,270500,24,20,4,7
6,2001,270500,25,17,8,2
7,2001,270500,30,22,8,2
8,2001,270500,21,19,2,8
9,2001,270500,16,12,4,2
10,2001,270500,26,25,1,4
11,2001,270500,23,20,3,2
12,2001,270500,21,19,2,6
1,2002,270500,18,16,2,11
2,2002,270500,9,7,2,2
3,2002,270500,16,13,3,4
4,2002,270500,24,19,5,5
5,2002,270500,10,8,2,6
6,2002,270500,21,18,3,2
7,2002,270500,40,33,7,3
8,2002,270500,27,16,11,11
9,2002,270500,20,18,2,17
10,2002,270500,19,15,4,6
11,2002,270500,16,13,3,12
12,2002,270500,21,16,5,12
1,2003,270500,13,11,2,14
2,2003,270500,16,14,2,13
3,2003,270500,25,14,11,12
4,2003,270500,26,21,5,5
5,2003,270500,19,15,4,12
6,2003,270500,30,23,7,11
7,2003,270500,25,22,3,15
8,2003,270500,26,18,8,9
9,2003,270500,17,16,1,18
10,2003,270500,18,18,0,7
11,2003,270500,16,12,4,13
12,2003,270500,13,12,1,10
1,2004,270500,14,12,2,63
2,2004,270500,8,7,1,8
3,2004,270500,17,12,5,12
4,2004,270500,13,9,4,17
5,2004,270500,22,15,7,21
6,2004,270500,24,19,5,20
7,2004,270500,26,20,6,21
8,2004,270500,29,25,4,19
9,2004,270500,29,22,7,10
10,2004,270500,27,19,8,10
11,2004,270500,13,10,3,3
12,2004,270500,14,10,4,9
1,2005,270500,16,12,4,19
2,2005,270500,18,13,5,15
3,2005,270500,18,14,4,11
4,2005,270500,29,21,8,8
5,2005,270500,20,19,1,7
6,2005,270500,35,27,8,10
7,2005,270500,32,25,7,6
8,2005,270500,33,28,5,15
9,2005,270500,25,20,5,9
10,2005,270500,21,18,3,5
11,2005,270500,15,13,2,3
12,2005,270500,12,9,3,4
1,2006,270500,13,9,4,17
2,2006,270500,22,20,2,9
3,2006,270500,24,19,5,7
4,2006,270500,19,18,1,4
5,2006,270500,25,18,7,5
6,2006,270500,22,18,4,11
7,2006,270500,13,9,4,7
8,2006,270500,31,24,7,7
9,2006,270500,20,16,4,5
10,2006,270500,23,18,5,16
11,2006,270500,13,12,1,10
12,2006,270500,12,10,2,5
1,2007,270500,18,12,6,10
2,2007,270500,12,8,4,11
3,2007,270500,18,12,6,69
4,2007,270500,22,16,6,17
5,2007,270500,19,14,5,5
6,2007,270500,22,14,8,5
7,2007,270500,34,25,9,5
8,2007,270500,17,13,4,6
9,2007,270500,27,19,8,5
10,2007,270500,25,21,4,12
11,2007,270500,16,13,3,13
12,2007,270500,15,13,2,24
1,2008,270500,19,12,7,12
2,2008,270500,12,8,4,10
3,2008,270500,16,15,1,7
4,2008,270500,13,10,3,8
5,2008,270500,21,19,2,10
6,2008,270500,29,25,4,8
7,2008,270500,21,18,3,9
8,2008,270500,32,27,5,15
9,2008,270500,30,24,6,3
10,2008,270500,25,19,6,9
11,2008,270500,25,22,3,8
12,2008,270500,19,19,0,8
1,2009,270500,14,12,2,15
2,2009,270500,7,4,3,2
3,2009,270500,27,17,10,4
4,2009,270500,12,7,5,5
5,2009,270500,11,8,3,10
6,2009,270500,19,17,2,12
7,2009,270500,31,23,8,9
8,2009,270500,17,13,4,4
9,2009,270500,16,11,5,7
10,2009,270500,10,10,0,19
11,2009,270500,13,12,1,11
12,2009,270500,8,6,2,14
1,2010,270500,11,8,3,11
2,2010,270500,7,6,1,24
3,2010,270500,10,10,0,7
4,2010,270500,17,14,3,12
5,2010,270500,17,11,6,8
6,2010,270500,18,15,3,7
7,2010,270500,17,13,4,15
8,2010,270500,18,14,4,6
9,2010,270500,21,19,2,5
10,2010,270500,15,9,6,12
11,2010,270500,21,15,6,8
12,2010,270500,20,16,4,13
1,2011,270500,13,10,3,9
2,2011,270500,8,6,2,8
1,1999,837300,13,12,1,10
2,1999,837300,18,14,4,11
3,1999,837300,13,11,2,13
4,1999,837300,14,11,3,15
5,1999,837300,25,14,11,11
6,1999,837300,14,11,3,18
7,1999,837300,24,20,4,13
8,1999,837300,36,35,1,21
9,1999,837300,22,21,1,9
10,1999,837300,21,16,5,13
11,1999,837300,29,25,4,18
12,1999,837300,22,18,4,17
1,2000,837300,11,10,1,20
2,2000,837300,8,6,2,16
3,2000,837300,19,17,2,21
4,2000,837300,18,15,3,14
5,2000,837300,23,13,10,12
6,2000,837300,17,14,3,12
7,2000,837300,16,14,2,17
8,2000,837300,26,20,6,13
9,2000,837300,17,14,3,11
10,2000,837300,18,15,3,16
11,2000,837300,9,8,1,16
12,2000,837300,17,13,4,8
1,2001,837300,10,7,3,12
2,2001,837300,16,11,5,13
3,2001,837300,14,12,2,11
4,2001,837300,19,17,2,7
5,2001,837300,14,9,5,10
6,2001,837300,17,12,5,6
7,2001,837300,20,17,3,15
8,2001,837300,24,18,6,15
9,2001,837300,21,18,3,15
10,2001,837300,26,22,4,14
11,2001,837300,10,8,2,10
12,2001,837300,15,13,2,10
1,2002,837300,16,13,3,9
2,2002,837300,16,12,4,2
3,2002,837300,16,11,5,3
4,2002,837300,11,9,2,2
5,2002,837300,13,11,2,4
6,2002,837300,24,18,6,3
7,2002,837300,22,16,6,9
8,2002,837300,17,14,3,8
9,2002,837300,17,13,4,6
10,2002,837300,27,23,4,5
11,2002,837300,21,17,4,7
12,2002,837300,18,15,3,9
1,2003,837300,12,11,1,3
2,2003,837300,12,10,2,17
3,2003,837300,11,9,2,5
4,2003,837300,15,12,3,0
5,2003,837300,19,13,6,3
6,2003,837300,20,15,5,6
7,2003,837300,22,22,0,1
8,2003,837300,16,16,0,4
9,2003,837300,21,17,4,6
10,2003,837300,14,10,4,2
11,2003,837300,14,12,2,5
12,2003,837300,14,13,1,4
1,2004,837300,18,17,1,6
2,2004,837300,12,11,1,4
3,2004,837300,15,11,4,7
4,2004,837300,13,11,2,10
5,2004,837300,14,11,3,10
6,2004,837300,17,15,2,7
7,2004,837300,14,13,1,7
8,2004,837300,21,19,2,9
9,2004,837300,23,22,1,8
10,2004,837300,22,21,1,13
11,2004,837300,8,6,2,7
12,2004,837300,12,11,1,12
1,2005,837300,12,11,1,4
2,2005,837300,14,13,1,5
3,2005,837300,19,15,4,4
4,2005,837300,12,8,4,6
5,2005,837300,13,12,1,2
6,2005,837300,12,9,3,3
7,2005,837300,19,15,4,9
8,2005,837300,19,18,1,7
9,2005,837300,14,11,3,7
10,2005,837300,18,15,3,5
11,2005,837300,8,7,1,11
12,2005,837300,20,15,5,7
1,2006,837300,18,16,2,8
2,2006,837300,12,9,3,8
3,2006,837300,17,16,1,4
4,2006,837300,13,12,1,8
5,2006,837300,18,15,3,12
6,2006,837300,8,7,1,7
7,2006,837300,16,13,3,3
8,2006,837300,24,23,1,5
9,2006,837300,27,21,6,11
10,2006,837300,17,15,2,2
11,2006,837300,13,13,0,4
12,2006,837300,17,15,2,9
1,2007,837300,24,22,2,5
2,2007,837300,12,9,3,15
3,2007,837300,28,17,11,7
4,2007,837300,18,15,3,10
5,2007,837300,19,15,4,22
6,2007,837300,11,9,2,14
7,2007,837300,17,15,2,13
8,2007,837300,14,12,2,4
9,2007,837300,24,20,4,8
10,2007,837300,18,16,2,8
11,2007,837300,19,17,2,8
12,2007,837300,17,14,3,2
1,2008,837300,8,7,1,9
2,2008,837300,13,11,2,6
3,2008,837300,21,15,6,7
4,2008,837300,18,15,3,4
5,2008,837300,15,13,2,3
6,2008,837300,20,18,2,8
7,2008,837300,19,17,2,4
8,2008,837300,16,14,2,4
9,2008,837300,23,21,2,7
10,2008,837300,20,15,5,1
11,2008,837300,13,13,0,0
12,2008,837300,16,15,1,6
1,2009,837300,14,11,3,7
2,2009,837300,15,10,5,5
3,2009,837300,8,4,4,5
4,2009,837300,10,9,1,3
5,2009,837300,13,12,1,1
6,2009,837300,6,5,1,3
7,2009,837300,19,16,3,2
8,2009,837300,12,8,4,2
9,2009,837300,11,10,1,3
10,2009,837300,14,13,1,7
11,2009,837300,8,8,0,7
12,2009,837300,15,14,1,6
1,2010,837300,20,18,2,8
2,2010,837300,9,8,1,8
3,2010,837300,19,19,0,4
4,2010,837300,21,18,3,2
5,2010,837300,22,15,7,3
6,2010,837300,13,9,4,5
7,2010,837300,23,16,7,8
8,2010,837300,10,10,0,5
9,2010,837300,15,12,3,6
10,2010,837300,18,14,4,10
11,2010,837300,6,5,1,2
12,2010,837300,9,8,1,4
1,2011,837300,13,13,0,4
2,2011,837300,10,6,4,6
1,1999,271800,11,9,2,18
2,1999,271800,12,11,1,33
3,1999,271800,14,8,6,22
4,1999,271800,12,9,3,31
5,1999,271800,22,19,3,16
6,1999,271800,18,12,6,13
7,1999,271800,22,16,6,12
8,1999,271800,13,11,2,17
9,1999,271800,21,13,8,18
10,1999,271800,24,20,4,26
11,1999,271800,22,16,6,32
12,1999,271800,21,13,8,28
1,2000,271800,10,3,7,85
2,2000,271800,15,6,9,30
3,2000,271800,13,9,4,35
4,2000,271800,17,12,5,29
5,2000,271800,17,8,9,35
6,2000,271800,18,12,6,70
7,2000,271800,15,10,5,11
8,2000,271800,12,10,2,28
9,2000,271800,19,14,5,73
10,2000,271800,13,8,5,17
11,2000,271800,20,18,2,27
12,2000,271800,10,4,6,23
1,2001,271800,10,5,5,41
2,2001,271800,9,6,3,29
3,2001,271800,12,5,7,36
4,2001,271800,17,12,5,26
5,2001,271800,5,3,2,17
6,2001,271800,7,6,1,19
7,2001,271800,6,5,1,23
8,2001,271800,14,12,2,23
9,2001,271800,8,6,2,27
10,2001,271800,25,20,5,12
11,2001,271800,10,9,1,26
12,2001,271800,12,7,5,24
1,2002,271800,15,12,3,34
2,2002,271800,12,8,4,15
3,2002,271800,8,6,2,26
4,2002,271800,12,8,4,19
5,2002,271800,13,6,7,30
6,2002,271800,8,4,4,17
7,2002,271800,14,10,4,29
8,2002,271800,22,15,7,23
9,2002,271800,13,8,5,29
10,2002,271800,14,9,5,100
11,2002,271800,21,17,4,97
12,2002,271800,15,9,6,27
1,2003,271800,9,8,1,27
2,2003,271800,14,11,3,14
3,2003,271800,11,6,5,24
4,2003,271800,18,13,5,32
5,2003,271800,19,12,7,23
6,2003,271800,17,11,6,18
7,2003,271800,13,8,5,28
8,2003,271800,16,12,4,83
9,2003,271800,14,8,6,9
10,2003,271800,25,16,9,5
11,2003,271800,11,8,3,23
12,2003,271800,17,11,6,4
1,2004,271800,8,6,2,6
2,2004,271800,5,5,0,4
3,2004,271800,14,11,3,10
4,2004,271800,11,9,2,19
5,2004,271800,10,6,4,17
6,2004,271800,15,13,2,19
7,2004,271800,17,12,5,13
8,2004,271800,13,10,3,18
9,2004,271800,12,11,1,7
10,2004,271800,19,12,7,21
11,2004,271800,21,15,6,15
12,2004,271800,15,9,6,11
1,2005,271800,18,13,5,17
2,2005,271800,7,6,1,12
3,2005,271800,16,9,7,10
4,2005,271800,18,12,6,7
5,2005,271800,14,11,3,4
6,2005,271800,20,15,5,16
7,2005,271800,13,11,2,13
8,2005,271800,26,16,10,20
9,2005,271800,14,12,2,10
10,2005,271800,14,11,3,16
11,2005,271800,13,8,5,13
12,2005,271800,16,13,3,20
1,2006,271800,11,11,0,12
2,2006,271800,9,8,1,10
3,2006,271800,14,12,2,7
4,2006,271800,11,10,1,6
5,2006,271800,12,7,5,4
6,2006,271800,14,10,4,9
7,2006,271800,11,9,2,11
8,2006,271800,20,18,2,9
9,2006,271800,19,16,3,9
10,2006,271800,17,14,3,3
11,2006,271800,8,7,1,5
12,2006,271800,16,11,5,8
1,2007,271800,20,16,4,8
2,2007,271800,12,8,4,27
3,2007,271800,19,13,6,3
4,2007,271800,3,3,0,10
5,2007,271800,15,13,2,4
6,2007,271800,8,6,2,5
7,2007,271800,8,6,2,6
8,2007,271800,10,10,0,23
9,2007,271800,17,13,4,34
10,2007,271800,11,9,2,24
11,2007,271800,16,12,4,16
12,2007,271800,24,14,10,16
1,2008,271800,15,13,2,28
2,2008,271800,9,8,1,13
3,2008,271800,13,9,4,16
4,2008,271800,11,8,3,6
5,2008,271800,9,6,3,9
6,2008,271800,18,13,5,8
7,2008,271800,13,11,2,20
8,2008,271800,20,16,4,14
9,2008,271800,15,9,6,10
10,2008,271800,16,11,5,12
11,2008,271800,15,9,6,11
12,2008,271800,16,13,3,8
1,2009,271800,15,8,7,7
2,2009,271800,10,7,3,7
3,2009,271800,18,11,7,6
4,2009,271800,17,13,4,8
5,2009,271800,6,4,2,5
6,2009,271800,15,11,4,3
7,2009,271800,18,14,4,3
8,2009,271800,15,8,7,4
9,2009,271800,6,6,0,4
10,2009,271800,18,11,7,6
11,2009,271800,12,8,4,6
12,2009,271800,6,6,0,13
1,2010,271800,16,9,7,9
2,2010,271800,13,11,2,8
3,2010,271800,12,7,5,2
4,2010,271800,9,5,4,4
5,2010,271800,9,6,3,11
6,2010,271800,11,9,2,13
7,2010,271800,24,19,5,11
8,2010,271800,13,11,2,3
9,2010,271800,16,14,2,7
10,2010,271800,18,12,6,5
11,2010,271800,16,13,3,16
12,2010,271800,9,7,2,24
1,2011,271800,8,7,1,27
2,2011,271800,6,5,1,7
1,1999,837400,18,14,4,25
2,1999,837400,19,17,2,18
3,1999,837400,18,14,4,27
4,1999,837400,27,22,5,32
5,1999,837400,27,22,5,20
6,1999,837400,28,18,10,16
7,1999,837400,26,16,10,13
8,1999,837400,28,18,10,26
9,1999,837400,25,19,6,34
10,1999,837400,26,24,2,34
11,1999,837400,15,13,2,30
12,1999,837400,19,15,4,48
1,2000,837400,14,9,5,21
2,2000,837400,19,14,5,37
3,2000,837400,20,18,2,20
4,2000,837400,9,8,1,46
5,2000,837400,11,9,2,35
6,2000,837400,24,20,4,36
7,2000,837400,18,17,1,42
8,2000,837400,26,22,4,106
9,2000,837400,22,19,3,74
10,2000,837400,30,19,11,34
11,2000,837400,25,16,9,20
12,2000,837400,12,11,1,23
1,2001,837400,15,10,5,48
2,2001,837400,18,12,6,26
3,2001,837400,21,15,6,22
4,2001,837400,25,14,11,16
5,2001,837400,19,14,5,28
6,2001,837400,22,15,7,33
7,2001,837400,27,19,8,22
8,2001,837400,30,22,8,39
9,2001,837400,35,26,9,22
10,2001,837400,28,16,12,36
11,2001,837400,21,15,6,43
12,2001,837400,14,13,1,54
1,2002,837400,15,14,1,36
2,2002,837400,18,12,6,27
3,2002,837400,27,22,5,39
4,2002,837400,31,24,7,74
5,2002,837400,21,18,3,32
6,2002,837400,38,22,16,189
7,2002,837400,19,14,5,84
8,2002,837400,20,10,10,41
9,2002,837400,21,11,10,21
10,2002,837400,19,15,4,19
11,2002,837400,29,26,3,28
12,2002,837400,21,18,3,26
1,2003,837400,21,16,5,27
2,2003,837400,18,13,5,22
3,2003,837400,22,20,2,12
4,2003,837400,20,12,8,17
5,2003,837400,28,23,5,14
6,2003,837400,32,25,7,21
7,2003,837400,19,12,7,16
8,2003,837400,30,18,12,31
9,2003,837400,24,18,6,43
10,2003,837400,29,24,5,19
11,2003,837400,26,16,10,23
12,2003,837400,25,18,7,19
1,2004,837400,13,7,6,12
2,2004,837400,16,13,3,17
3,2004,837400,26,17,9,12
4,2004,837400,18,15,3,14
5,2004,837400,20,15,5,25
6,2004,837400,27,21,6,7
7,2004,837400,23,21,2,10
8,2004,837400,17,17,0,27
9,2004,837400,20,18,2,13
10,2004,837400,19,16,3,32
11,2004,837400,36,28,8,36
12,2004,837400,24,21,3,34
1,2005,837400,20,15,5,28
2,2005,837400,14,11,3,20
3,2005,837400,18,14,4,28
4,2005,837400,19,16,3,24
5,2005,837400,13,12,1,30
6,2005,837400,23,14,9,33
7,2005,837400,21,17,4,27
8,2005,837400,40,32,8,31
9,2005,837400,18,14,4,26
10,2005,837400,14,11,3,17
11,2005,837400,16,14,2,19
12,2005,837400,12,11,1,24
1,2006,837400,26,20,6,42
2,2006,837400,22,20,2,19
3,2006,837400,22,17,5,17
4,2006,837400,16,11,5,24
5,2006,837400,17,15,2,62
6,2006,837400,23,18,5,45
7,2006,837400,21,16,5,33
8,2006,837400,21,15,6,28
9,2006,837400,16,9,7,20
10,2006,837400,15,13,2,13
11,2006,837400,19,13,6,24
12,2006,837400,13,9,4,12
1,2007,837400,18,15,3,15
2,2007,837400,19,17,2,30
3,2007,837400,11,9,2,14
4,2007,837400,13,9,4,7
5,2007,837400,17,13,4,14
6,2007,837400,28,24,4,10
7,2007,837400,15,12,3,18
8,2007,837400,17,11,6,26
9,2007,837400,23,12,11,26
10,2007,837400,20,17,3,26
11,2007,837400,28,24,4,89
12,2007,837400,13,13,0,46
1,2008,837400,12,12,0,12
2,2008,837400,7,6,1,18
3,2008,837400,18,17,1,18
4,2008,837400,17,14,3,15
5,2008,837400,21,16,5,5
6,2008,837400,24,19,5,12
7,2008,837400,24,14,10,11
8,2008,837400,33,30,3,20
9,2008,837400,18,11,7,35
10,2008,837400,30,23,7,16
11,2008,837400,21,18,3,23
12,2008,837400,26,23,3,26
1,2009,837400,19,16,3,17
2,2009,837400,8,7,1,17
3,2009,837400,15,11,4,14
4,2009,837400,14,13,1,9
5,2009,837400,14,9,5,9
6,2009,837400,11,8,3,14
7,2009,837400,24,19,5,20
8,2009,837400,11,11,0,19
9,2009,837400,26,24,2,7
10,2009,837400,18,16,2,23
11,2009,837400,14,12,2,19
12,2009,837400,8,5,3,31
1,2010,837400,15,12,3,22
2,2010,837400,16,15,1,38
3,2010,837400,21,18,3,25
4,2010,837400,18,13,5,26
5,2010,837400,11,10,1,15
6,2010,837400,19,18,1,14
7,2010,837400,23,18,5,20
8,2010,837400,17,14,3,14
9,2010,837400,15,15,0,12
10,2010,837400,21,19,2,11
11,2010,837400,11,10,1,18
12,2010,837400,15,10,5,10
1,2011,837400,9,8,1,36
2,2011,837400,9,7,2,26
1,1999,271500,5,4,1,15
2,1999,271500,8,4,4,3
3,1999,271500,13,12,1,8
4,1999,271500,10,7,3,8
5,1999,271500,7,5,2,4
6,1999,271500,11,4,7,43
7,1999,271500,5,4,1,7
8,1999,271500,9,5,4,5
9,1999,271500,7,6,1,7
10,1999,271500,7,5,2,12
11,1999,271500,6,2,4,1
12,1999,271500,8,4,4,8
1,2000,271500,6,6,0,12
2,2000,271500,2,2,0,16
3,2000,271500,8,5,3,7
4,2000,271500,10,6,4,6
5,2000,271500,9,6,3,12
6,2000,271500,5,4,1,6
7,2000,271500,8,7,1,21
8,2000,271500,9,7,2,13
9,2000,271500,11,7,4,12
10,2000,271500,5,3,2,4
11,2000,271500,7,5,2,7
12,2000,271500,13,13,0,2
1,2001,271500,4,4,0,0
2,2001,271500,4,3,1,6
3,2001,271500,13,11,2,9
4,2001,271500,10,5,5,2
5,2001,271500,9,5,4,2
6,2001,271500,5,3,2,3
7,2001,271500,11,9,2,4
8,2001,271500,14,11,3,4
9,2001,271500,12,11,1,5
10,2001,271500,9,7,2,4
11,2001,271500,11,10,1,7
12,2001,271500,9,9,0,7
1,2002,271500,4,3,1,3
2,2002,271500,7,5,2,7
3,2002,271500,6,5,1,10
4,2002,271500,7,5,2,5
5,2002,271500,9,7,2,5
6,2002,271500,5,4,1,7
7,2002,271500,9,6,3,5
8,2002,271500,9,7,2,5
9,2002,271500,9,8,1,8
10,2002,271500,14,14,0,14
11,2002,271500,6,5,1,3
12,2002,271500,9,7,2,2
1,2003,271500,5,2,3,6
2,2003,271500,4,3,1,7
3,2003,271500,9,7,2,7
4,2003,271500,7,4,3,12
5,2003,271500,5,4,1,6
6,2003,271500,12,10,2,2
7,2003,271500,13,8,5,6
8,2003,271500,5,5,0,10
9,2003,271500,12,10,2,9
10,2003,271500,15,14,1,2
11,2003,271500,8,7,1,9
12,2003,271500,3,2,1,3
1,2004,271500,7,6,1,8
2,2004,271500,5,4,1,2
3,2004,271500,19,13,6,5
4,2004,271500,7,5,2,6
5,2004,271500,9,8,1,7
6,2004,271500,6,6,0,6
7,2004,271500,9,7,2,3
8,2004,271500,9,4,5,11
9,2004,271500,9,8,1,1
10,2004,271500,12,10,2,13
11,2004,271500,9,8,1,7
12,2004,271500,9,9,0,3
1,2005,271500,9,6,3,5
2,2005,271500,4,4,0,4
3,2005,271500,1,1,0,5
4,2005,271500,9,6,3,8
5,2005,271500,12,9,3,4
6,2005,271500,10,6,4,2
7,2005,271500,11,9,2,2
8,2005,271500,7,5,2,4
9,2005,271500,11,8,3,2
10,2005,271500,9,8,1,3
11,2005,271500,9,9,0,7
12,2005,271500,4,4,0,4
1,2006,271500,7,6,1,11
2,2006,271500,6,4,2,5
3,2006,271500,7,6,1,4
4,2006,271500,10,7,3,4
5,2006,271500,11,7,4,3
6,2006,271500,6,5,1,11
7,2006,271500,7,7,0,10
8,2006,271500,11,7,4,5
9,2006,271500,6,4,2,6
10,2006,271500,7,5,2,18
11,2006,271500,7,7,0,5
12,2006,271500,8,7,1,6
1,2007,271500,9,6,3,5
2,2007,271500,5,3,2,61
3,2007,271500,11,9,2,9
4,2007,271500,9,7,2,1
5,2007,271500,9,7,2,4
6,2007,271500,5,3,2,1
7,2007,271500,11,9,2,6
8,2007,271500,7,6,1,9
9,2007,271500,5,2,3,5
10,2007,271500,12,8,4,4
11,2007,271500,4,3,1,7
12,2007,271500,2,1,1,2
1,2008,271500,4,3,1,12
2,2008,271500,5,5,0,6
3,2008,271500,11,10,1,5
4,2008,271500,3,2,1,3
5,2008,271500,13,8,5,7
6,2008,271500,10,7,3,1
7,2008,271500,6,3,3,9
8,2008,271500,8,6,2,6
9,2008,271500,12,8,4,0
10,2008,271500,19,16,3,3
11,2008,271500,6,6,0,5
12,2008,271500,9,7,2,1
1,2009,271500,5,4,1,1
2,2009,271500,3,3,0,5
3,2009,271500,5,3,2,5
4,2009,271500,5,5,0,5
5,2009,271500,9,7,2,11
6,2009,271500,3,2,1,2
7,2009,271500,12,10,2,6
8,2009,271500,9,7,2,2
9,2009,271500,8,8,0,2
10,2009,271500,7,7,0,3
11,2009,271500,9,9,0,3
12,2009,271500,4,2,2,6
1,2010,271500,10,10,0,4
2,2010,271500,5,4,1,8
3,2010,271500,9,7,2,7
4,2010,271500,7,6,1,5
5,2010,271500,6,6,0,9
6,2010,271500,5,4,1,5
7,2010,271500,5,3,2,4
8,2010,271500,8,5,3,4
9,2010,271500,7,4,3,16
10,2010,271500,6,6,0,11
11,2010,271500,10,8,2,9
12,2010,271500,8,5,3,12
1,2011,271500,4,3,1,5
2,2011,271500,8,8,0,9
1,1999,252101,20,17,3,12
2,1999,252101,10,10,0,20
3,1999,252101,21,18,3,16
4,1999,252101,17,14,3,10
5,1999,252101,20,17,3,16
6,1999,252101,13,13,0,16
7,1999,252101,22,18,4,9
8,1999,252101,17,15,2,6
9,1999,252101,10,8,2,16
10,1999,252101,10,9,1,67
11,1999,252101,13,6,7,22
12,1999,252101,11,8,3,22
1,2000,252101,10,7,3,15
2,2000,252101,10,7,3,62
3,2000,252101,11,10,1,15
4,2000,252101,18,17,1,15
5,2000,252101,18,14,4,31
6,2000,252101,14,14,0,26
7,2000,252101,21,16,5,23
8,2000,252101,8,8,0,30
9,2000,252101,14,13,1,12
10,2000,252101,6,4,2,11
11,2000,252101,5,5,0,14
12,2000,252101,12,10,2,23
1,2001,252101,10,9,1,27
2,2001,252101,5,4,1,10
3,2001,252101,17,15,2,9
4,2001,252101,12,9,3,7
5,2001,252101,19,15,4,12
6,2001,252101,8,7,1,7
7,2001,252101,13,11,2,10
8,2001,252101,11,10,1,10
9,2001,252101,11,9,2,5
10,2001,252101,14,11,3,15
11,2001,252101,10,5,5,4
12,2001,252101,15,13,2,4
1,2002,252101,9,7,2,9
2,2002,252101,5,4,1,12
3,2002,252101,12,9,3,11
4,2002,252101,7,4,3,8
5,2002,252101,15,10,5,10
6,2002,252101,12,8,4,12
7,2002,252101,12,9,3,11
8,2002,252101,10,5,5,6
9,2002,252101,13,11,2,4
10,2002,252101,16,13,3,2
11,2002,252101,12,10,2,1
12,2002,252101,9,7,2,0
1,2003,252101,10,10,0,3
2,2003,252101,10,9,1,4
3,2003,252101,10,9,1,1
4,2003,252101,13,11,2,3
5,2003,252101,12,10,2,1
6,2003,252101,10,9,1,1
7,2003,252101,10,9,1,6
8,2003,252101,10,8,2,1
9,2003,252101,16,14,2,2
10,2003,252101,14,12,2,3
11,2003,252101,10,9,1,0
12,2003,252101,9,9,0,0
1,2004,252101,15,11,4,2
2,2004,252101,6,6,0,8
3,2004,252101,1,1,0,6
4,2004,252101,11,9,2,1
5,2004,252101,6,6,0,0
6,2004,252101,16,13,3,2
7,2004,252101,9,9,0,4
8,2004,252101,10,10,0,9
9,2004,252101,18,16,2,7
10,2004,252101,20,18,2,1
11,2004,252101,10,10,0,6
12,2004,252101,16,14,2,1
1,2005,252101,5,4,1,4
2,2005,252101,8,6,2,1
3,2005,252101,10,8,2,3
4,2005,252101,13,7,6,2
5,2005,252101,8,5,3,0
6,2005,252101,8,7,1,1
7,2005,252101,7,7,0,0
8,2005,252101,8,6,2,1
9,2005,252101,7,6,1,1
10,2005,252101,13,13,0,1
11,2005,252101,10,9,1,0
12,2005,252101,7,6,1,0
1,2006,252101,11,10,1,2
2,2006,252101,9,8,1,2
3,2006,252101,9,8,1,2
4,2006,252101,8,7,1,3
5,2006,252101,9,8,1,2
6,2006,252101,7,4,3,1
7,2006,252101,8,8,0,2
8,2006,252101,16,16,0,5
9,2006,252101,5,4,1,6
10,2006,252101,19,15,4,7
11,2006,252101,7,6,1,6
12,2006,252101,7,7,0,2
1,2007,252101,4,4,0,2
2,2007,252101,3,2,1,1
3,2007,252101,7,6,1,4
4,2007,252101,15,13,2,4
5,2007,252101,17,13,4,0
6,2007,252101,14,10,4,2
7,2007,252101,18,14,4,5
8,2007,252101,19,16,3,8
9,2007,252101,13,9,4,4
10,2007,252101,8,6,2,2
11,2007,252101,11,10,1,3
12,2007,252101,12,11,1,0
1,2008,252101,10,9,1,2
2,2008,252101,9,6,3,1
3,2008,252101,14,11,3,2
4,2008,252101,3,2,1,4
5,2008,252101,11,8,3,4
6,2008,252101,17,16,1,7
7,2008,252101,14,11,3,5
8,2008,252101,5,4,1,6
9,2008,252101,22,20,2,1
10,2008,252101,8,8,0,4
11,2008,252101,13,8,5,2
12,2008,252101,17,15,2,1
1,2009,252101,7,6,1,2
2,2009,252101,13,10,3,1
3,2009,252101,9,8,1,8
4,2009,252101,8,5,3,6
5,2009,252101,13,12,1,5
6,2009,252101,10,9,1,2
7,2009,252101,13,11,2,5
8,2009,252101,15,12,3,10
9,2009,252101,13,11,2,5
10,2009,252101,10,8,2,5
11,2009,252101,6,4,2,2
12,2009,252101,6,6,0,4
1,2010,252101,4,4,0,1
2,2010,252101,11,9,2,2
3,2010,252101,6,5,1,9
4,2010,252101,10,7,3,10
5,2010,252101,18,17,1,5
6,2010,252101,13,11,2,4
7,2010,252101,6,5,1,3
8,2010,252101,5,4,1,3
9,2010,252101,9,8,1,9
10,2010,252101,10,8,2,3
11,2010,252101,11,11,0,1
12,2010,252101,6,5,1,2
1,2011,252101,4,4,0,3
2,2011,252101,7,6,1,4
1,1999,832900,9,8,1,0
2,1999,832900,1,1,0,0
3,1999,832900,5,5,0,3
4,1999,832900,4,4,0,0
5,1999,832900,9,9,0,2
6,1999,832900,7,6,1,0
7,1999,832900,9,9,0,0
8,1999,832900,4,4,0,0
9,1999,832900,13,13,0,0
10,1999,832900,10,9,1,0
11,1999,832900,4,4,0,0
12,1999,832900,2,2,0,0
1,2000,832900,4,4,0,0
2,2000,832900,4,4,0,0
3,2000,832900,5,5,0,0
4,2000,832900,3,3,0,0
5,2000,832900,6,6,0,0
6,2000,832900,4,4,0,1
7,2000,832900,9,9,0,0
8,2000,832900,17,16,1,0
9,2000,832900,10,10,0,2
10,2000,832900,9,9,0,0
11,2000,832900,8,8,0,0
12,2000,832900,5,5,0,0
1,2001,832900,3,3,0,0
2,2001,832900,3,3,0,1
3,2001,832900,2,2,0,0
4,2001,832900,3,2,1,0
5,2001,832900,5,5,0,1
6,2001,832900,6,6,0,0
7,2001,832900,3,3,0,0
8,2001,832900,5,5,0,0
9,2001,832900,4,4,0,0
10,2001,832900,8,7,1,0
11,2001,832900,6,6,0,0
12,2001,832900,9,9,0,0
1,2002,832900,6,5,1,1
2,2002,832900,4,4,0,0
3,2002,832900,5,5,0,0
4,2002,832900,4,4,0,0
5,2002,832900,4,4,0,0
6,2002,832900,9,9,0,1
7,2002,832900,6,6,0,1
8,2002,832900,4,4,0,2
9,2002,832900,4,4,0,1
10,2002,832900,5,5,0,0
11,2002,832900,2,2,0,0
12,2002,832900,4,4,0,0
1,2003,832900,5,4,1,1
2,2003,832900,2,2,0,0
3,2003,832900,0,0,0,0
4,2003,832900,1,1,0,0
5,2003,832900,7,7,0,0
6,2003,832900,0,0,0,0
7,2003,832900,1,1,0,0
8,2003,832900,4,4,0,0
9,2003,832900,10,9,1,0
10,2003,832900,5,5,0,0
11,2003,832900,5,5,0,0
12,2003,832900,3,3,0,0
1,2004,832900,4,4,0,0
2,2004,832900,3,3,0,0
3,2004,832900,6,5,1,1
4,2004,832900,6,5,1,0
5,2004,832900,7,7,0,1
6,2004,832900,6,5,1,0
7,2004,832900,9,9,0,0
8,2004,832900,4,4,0,1
9,2004,832900,10,9,1,0
10,2004,832900,11,9,2,0
11,2004,832900,6,6,0,0
12,2004,832900,3,3,0,0
1,2005,832900,8,8,0,0
2,2005,832900,3,3,0,0
3,2005,832900,6,5,1,0
4,2005,832900,5,4,1,0
5,2005,832900,6,6,0,0
6,2005,832900,3,3,0,0
7,2005,832900,6,6,0,0
8,2005,832900,4,4,0,0
9,2005,832900,9,9,0,0
10,2005,832900,7,7,0,0
11,2005,832900,12,12,0,0
12,2005,832900,3,3,0,0
1,2006,832900,4,4,0,1
2,2006,832900,3,3,0,1
3,2006,832900,2,1,1,0
4,2006,832900,2,2,0,1
5,2006,832900,2,2,0,0
6,2006,832900,6,5,1,0
7,2006,832900,5,5,0,0
8,2006,832900,7,6,1,1
9,2006,832900,4,3,1,0
10,2006,832900,7,7,0,0
11,2006,832900,6,6,0,2
12,2006,832900,6,6,0,0
1,2007,832900,4,4,0,0
2,2007,832900,4,4,0,0
3,2007,832900,1,1,0,0
4,2007,832900,6,5,1,1
5,2007,832900,5,5,0,0
6,2007,832900,3,3,0,2
7,2007,832900,7,7,0,0
8,2007,832900,3,3,0,0
9,2007,832900,1,1,0,1
10,2007,832900,3,3,0,0
11,2007,832900,0,0,0,0
12,2007,832900,3,3,0,0
1,2008,832900,4,4,0,0
2,2008,832900,3,3,0,0
3,2008,832900,1,1,0,0
4,2008,832900,5,5,0,0
5,2008,832900,8,8,0,0
6,2008,832900,4,4,0,0
7,2008,832900,4,3,1,0
8,2008,832900,7,7,0,0
9,2008,832900,4,4,0,0
10,2008,832900,3,3,0,0
11,2008,832900,5,5,0,0
12,2008,832900,3,3,0,0
1,2009,832900,1,1,0,0
2,2009,832900,1,1,0,1
3,2009,832900,3,3,0,0
4,2009,832900,4,4,0,0
5,2009,832900,1,1,0,0
6,2009,832900,3,3,0,0
7,2009,832900,5,5,0,1
8,2009,832900,2,2,0,0
9,2009,832900,4,4,0,0
10,2009,832900,7,7,0,0
11,2009,832900,2,2,0,0
12,2009,832900,3,3,0,0
1,2010,832900,4,4,0,0
2,2010,832900,1,1,0,0
3,2010,832900,3,2,1,1
4,2010,832900,4,4,0,0
5,2010,832900,6,6,0,0
6,2010,832900,2,2,0,0
7,2010,832900,5,5,0,0
8,2010,832900,6,6,0,0
9,2010,832900,6,6,0,0
10,2010,832900,8,8,0,0
11,2010,832900,4,4,0,0
12,2010,832900,3,3,0,0
1,2011,832900,2,1,1,0
2,2011,832900,4,4,0,0
1,1999,252102,39,31,8,68
2,1999,252102,35,27,8,68
3,1999,252102,37,26,11,112
4,1999,252102,48,34,14,44
5,1999,252102,41,33,8,51
6,1999,252102,44,33,11,31
7,1999,252102,59,47,12,29
8,1999,252102,43,35,8,24
9,1999,252102,51,40,11,25
10,1999,252102,30,21,9,28
11,1999,252102,37,30,7,31
12,1999,252102,40,30,10,45
1,2000,252102,34,24,10,67
2,2000,252102,39,31,8,37
3,2000,252102,43,35,8,36
4,2000,252102,31,24,7,30
5,2000,252102,49,35,14,23
6,2000,252102,36,27,9,15
7,2000,252102,54,37,17,30
8,2000,252102,47,36,11,18
9,2000,252102,36,25,11,20
10,2000,252102,46,41,5,17
11,2000,252102,32,26,6,20
12,2000,252102,34,25,9,35
1,2001,252102,31,22,9,29
2,2001,252102,35,28,7,29
3,2001,252102,27,25,2,36
4,2001,252102,31,20,11,40
5,2001,252102,38,24,14,30
6,2001,252102,32,24,8,26
7,2001,252102,28,22,6,57
8,2001,252102,28,22,6,39
9,2001,252102,32,25,7,26
10,2001,252102,39,32,7,18
11,2001,252102,29,26,3,27
12,2001,252102,27,19,8,37
1,2002,252102,46,36,10,34
2,2002,252102,33,25,8,49
3,2002,252102,35,28,7,44
4,2002,252102,31,18,13,55
5,2002,252102,34,29,5,28
6,2002,252102,35,19,16,30
7,2002,252102,39,30,9,22
8,2002,252102,36,23,13,54
9,2002,252102,34,27,7,30
10,2002,252102,37,31,6,37
11,2002,252102,39,34,5,54
12,2002,252102,23,18,5,49
1,2003,252102,30,27,3,72
2,2003,252102,30,21,9,59
3,2003,252102,25,20,5,35
4,2003,252102,39,33,6,45
5,2003,252102,52,42,10,33
6,2003,252102,47,33,14,21
7,2003,252102,46,41,5,44
8,2003,252102,36,23,13,42
9,2003,252102,35,27,8,43
10,2003,252102,43,35,8,111
11,2003,252102,48,41,7,79
12,2003,252102,27,25,2,50
1,2004,252102,22,21,1,40
2,2004,252102,25,20,5,64
3,2004,252102,34,25,9,66
4,2004,252102,28,21,7,43
5,2004,252102,42,27,15,44
6,2004,252102,45,31,14,51
7,2004,252102,49,34,15,74
8,2004,252102,32,29,3,46
9,2004,252102,23,18,5,67
10,2004,252102,44,36,8,28
11,2004,252102,22,17,5,23
12,2004,252102,32,29,3,22
1,2005,252102,41,37,4,38
2,2005,252102,33,29,4,30
3,2005,252102,23,21,2,44
4,2005,252102,34,28,6,37
5,2005,252102,28,24,4,59
6,2005,252102,39,28,11,39
7,2005,252102,26,21,5,41
8,2005,252102,38,27,11,21
9,2005,252102,33,27,6,21
10,2005,252102,30,28,2,83
11,2005,252102,26,19,7,32
12,2005,252102,33,24,9,15
1,2006,252102,15,14,1,32
2,2006,252102,28,22,6,42
3,2006,252102,25,20,5,43
4,2006,252102,19,15,4,44
5,2006,252102,29,24,5,45
6,2006,252102,28,21,7,32
7,2006,252102,32,24,8,31
8,2006,252102,35,29,6,39
9,2006,252102,28,24,4,45
10,2006,252102,22,17,5,75
11,2006,252102,29,25,4,42
12,2006,252102,31,27,4,41
1,2007,252102,28,20,8,55
2,2007,252102,25,22,3,77
3,2007,252102,36,25,11,94
4,2007,252102,31,19,12,40
5,2007,252102,35,30,5,33
6,2007,252102,36,27,9,49
7,2007,252102,44,38,6,54
8,2007,252102,39,28,11,41
9,2007,252102,31,24,7,31
10,2007,252102,45,35,10,39
11,2007,252102,27,22,5,35
12,2007,252102,25,22,3,27
1,2008,252102,20,17,3,28
2,2008,252102,21,20,1,27
3,2008,252102,31,24,7,41
4,2008,252102,26,24,2,40
5,2008,252102,40,31,9,42
6,2008,252102,36,26,10,49
7,2008,252102,36,29,7,34
8,2008,252102,36,32,4,34
9,2008,252102,36,32,4,27
10,2008,252102,48,42,6,31
11,2008,252102,34,27,7,29
12,2008,252102,27,25,2,15
1,2009,252102,28,22,6,17
2,2009,252102,27,18,9,37
3,2009,252102,35,30,5,26
4,2009,252102,32,22,10,31
5,2009,252102,33,24,9,34
6,2009,252102,24,20,4,18
7,2009,252102,40,33,7,31
8,2009,252102,33,26,7,22
9,2009,252102,29,19,10,11
10,2009,252102,21,14,7,22
11,2009,252102,40,32,8,30
12,2009,252102,27,22,5,37
1,2010,252102,31,25,6,28
2,2010,252102,10,9,1,34
3,2010,252102,25,20,5,38
4,2010,252102,37,28,9,36
5,2010,252102,27,22,5,29
6,2010,252102,33,22,11,32
7,2010,252102,35,27,8,25
8,2010,252102,30,28,2,49
9,2010,252102,34,27,7,52
10,2010,252102,29,24,5,33
11,2010,252102,33,26,7,44
12,2010,252102,26,19,7,30
1,2011,252102,16,14,2,36
2,2011,252102,18,15,3,26
1,1999,252201,41,32,9,15
2,1999,252201,41,37,4,0
3,1999,252201,40,37,3,14
4,1999,252201,45,40,5,14
5,1999,252201,48,37,11,13
6,1999,252201,51,41,10,7
7,1999,252201,39,34,5,9
8,1999,252201,54,44,10,18
9,1999,252201,40,36,4,20
10,1999,252201,23,20,3,23
11,1999,252201,38,33,5,28
12,1999,252201,43,36,7,17
1,2000,252201,24,21,3,13
2,2000,252201,21,15,6,8
3,2000,252201,42,38,4,18
4,2000,252201,33,29,4,19
5,2000,252201,39,31,8,20
6,2000,252201,45,34,11,11
7,2000,252201,33,25,8,9
8,2000,252201,42,32,10,11
9,2000,252201,36,31,5,9
10,2000,252201,37,28,9,18
11,2000,252201,37,31,6,4
12,2000,252201,48,38,10,2
1,2001,252201,46,37,9,5
2,2001,252201,32,25,7,13
3,2001,252201,35,30,5,8
4,2001,252201,38,30,8,15
5,2001,252201,36,31,5,9
6,2001,252201,35,28,7,1
7,2001,252201,47,35,12,4
8,2001,252201,50,40,10,8
9,2001,252201,35,29,6,10
10,2001,252201,42,33,9,9
11,2001,252201,27,25,2,11
12,2001,252201,21,17,4,11
1,2002,252201,31,25,6,7
2,2002,252201,22,15,7,13
3,2002,252201,32,28,4,9
4,2002,252201,42,30,12,19
5,2002,252201,33,29,4,15
6,2002,252201,37,32,5,9
7,2002,252201,55,48,7,13
8,2002,252201,36,31,5,20
9,2002,252201,43,33,10,6
10,2002,252201,30,30,0,8
11,2002,252201,19,14,5,13
12,2002,252201,29,24,5,12
1,2003,252201,25,21,4,22
2,2003,252201,27,21,6,23
3,2003,252201,43,40,3,19
4,2003,252201,45,39,6,22
5,2003,252201,44,33,11,10
6,2003,252201,33,26,7,12
7,2003,252201,46,36,10,12
8,2003,252201,24,20,4,24
9,2003,252201,37,31,6,19
10,2003,252201,47,38,9,15
11,2003,252201,36,31,5,18
12,2003,252201,36,26,10,23
1,2004,252201,34,27,7,19
2,2004,252201,21,18,3,24
3,2004,252201,27,22,5,12
4,2004,252201,35,29,6,10
5,2004,252201,27,21,6,14
6,2004,252201,36,31,5,9
7,2004,252201,34,29,5,21
8,2004,252201,49,43,6,16
9,2004,252201,41,32,9,32
10,2004,252201,47,43,4,9
11,2004,252201,33,32,1,11
12,2004,252201,41,33,8,2
1,2005,252201,48,43,5,25
2,2005,252201,27,26,1,21
3,2005,252201,27,21,6,13
4,2005,252201,36,30,6,16
5,2005,252201,26,19,7,13
6,2005,252201,35,27,8,14
7,2005,252201,28,21,7,16
8,2005,252201,29,25,4,7
9,2005,252201,32,31,1,15
10,2005,252201,40,32,8,9
11,2005,252201,21,19,2,10
12,2005,252201,31,28,3,13
1,2006,252201,32,31,1,20
2,2006,252201,23,20,3,23
3,2006,252201,24,20,4,22
4,2006,252201,34,32,2,16
5,2006,252201,35,32,3,32
6,2006,252201,34,33,1,33
7,2006,252201,34,29,5,21
8,2006,252201,42,36,6,24
9,2006,252201,44,35,9,22
10,2006,252201,38,30,8,11
11,2006,252201,38,34,4,15
12,2006,252201,39,34,5,23
1,2007,252201,32,30,2,19
2,2007,252201,21,18,3,24
3,2007,252201,26,20,6,14
4,2007,252201,23,19,4,12
5,2007,252201,42,35,7,27
6,2007,252201,32,24,8,22
7,2007,252201,35,29,6,29
8,2007,252201,36,31,5,20
9,2007,252201,34,32,2,26
10,2007,252201,35,31,4,32
11,2007,252201,20,17,3,29
12,2007,252201,22,20,2,16
1,2008,252201,24,22,2,14
2,2008,252201,25,22,3,19
3,2008,252201,29,27,2,23
4,2008,252201,37,25,12,32
5,2008,252201,48,39,9,67
6,2008,252201,48,41,7,34
7,2008,252201,47,42,5,28
8,2008,252201,38,33,5,23
9,2008,252201,45,42,3,21
10,2008,252201,43,39,4,21
11,2008,252201,30,25,5,28
12,2008,252201,31,30,1,19
1,2009,252201,23,21,2,17
2,2009,252201,20,19,1,17
3,2009,252201,36,31,5,28
4,2009,252201,29,23,6,19
5,2009,252201,38,33,5,14
6,2009,252201,34,28,6,27
7,2009,252201,37,32,5,27
8,2009,252201,29,26,3,29
9,2009,252201,32,23,9,26
10,2009,252201,26,22,4,18
11,2009,252201,31,22,9,19
12,2009,252201,28,21,7,24
1,2010,252201,34,27,7,39
2,2010,252201,20,16,4,31
3,2010,252201,30,25,5,41
4,2010,252201,25,22,3,35
5,2010,252201,30,23,7,46
6,2010,252201,25,18,7,27
7,2010,252201,35,29,6,24
8,2010,252201,30,22,8,48
9,2010,252201,34,29,5,31
10,2010,252201,33,27,6,26
11,2010,252201,36,32,4,34
12,2010,252201,24,22,2,23
1,2011,252201,22,19,3,44
2,2011,252201,16,15,1,31
1,1999,252202,43,34,9,36
2,1999,252202,58,46,12,33
3,1999,252202,47,38,9,38
4,1999,252202,45,30,15,32
5,1999,252202,54,45,9,72
6,1999,252202,60,50,10,33
7,1999,252202,59,48,11,45
8,1999,252202,49,38,11,47
9,1999,252202,41,33,8,46
10,1999,252202,63,52,11,73
11,1999,252202,49,41,8,58
12,1999,252202,48,40,8,47
1,2000,252202,45,37,8,74
2,2000,252202,58,46,12,48
3,2000,252202,52,40,12,77
4,2000,252202,37,28,9,54
5,2000,252202,40,28,12,39
6,2000,252202,45,37,8,49
7,2000,252202,50,38,12,66
8,2000,252202,60,50,10,51
9,2000,252202,43,38,5,54
10,2000,252202,42,32,10,58
11,2000,252202,45,37,8,33
12,2000,252202,50,44,6,42
1,2001,252202,42,36,6,40
2,2001,252202,30,21,9,79
3,2001,252202,54,40,14,50
4,2001,252202,52,31,21,63
5,2001,252202,57,41,16,44
6,2001,252202,42,34,8,35
7,2001,252202,52,36,16,41
8,2001,252202,60,44,16,38
9,2001,252202,49,39,10,44
10,2001,252202,47,43,4,39
11,2001,252202,50,40,10,40
12,2001,252202,40,30,10,85
1,2002,252202,45,38,7,62
2,2002,252202,46,39,7,49
3,2002,252202,47,39,8,60
4,2002,252202,52,36,16,48
5,2002,252202,53,43,10,37
6,2002,252202,48,36,12,34
7,2002,252202,59,54,5,47
8,2002,252202,71,59,12,20
9,2002,252202,53,45,8,42
10,2002,252202,48,40,8,51
11,2002,252202,61,52,9,55
12,2002,252202,56,44,12,62
1,2003,252202,46,39,7,64
2,2003,252202,37,29,8,42
3,2003,252202,40,34,6,42
4,2003,252202,47,40,7,36
5,2003,252202,46,35,11,56
6,2003,252202,52,39,13,51
7,2003,252202,50,40,10,39
8,2003,252202,49,39,10,66
9,2003,252202,51,43,8,59
10,2003,252202,48,43,5,254
11,2003,252202,49,36,13,94
12,2003,252202,38,28,10,53
1,2004,252202,49,42,7,43
2,2004,252202,29,22,7,99
3,2004,252202,48,36,12,105
4,2004,252202,28,18,10,71
5,2004,252202,48,38,10,52
6,2004,252202,44,35,9,37
7,2004,252202,65,45,20,85
8,2004,252202,56,46,10,50
9,2004,252202,54,44,10,60
10,2004,252202,65,57,8,35
11,2004,252202,49,43,6,23
12,2004,252202,44,38,6,40
1,2005,252202,36,25,11,48
2,2005,252202,39,35,4,43
3,2005,252202,40,32,8,89
4,2005,252202,48,37,11,64
5,2005,252202,43,30,13,60
6,2005,252202,44,27,17,139
7,2005,252202,42,29,13,52
8,2005,252202,41,32,9,42
9,2005,252202,38,29,9,50
10,2005,252202,32,29,3,64
11,2005,252202,47,41,6,78
12,2005,252202,50,33,17,77
1,2006,252202,31,23,8,84
2,2006,252202,40,34,6,80
3,2006,252202,31,23,8,53
4,2006,252202,46,38,8,58
5,2006,252202,36,29,7,64
6,2006,252202,58,45,13,62
7,2006,252202,60,47,13,51
8,2006,252202,50,44,6,89
9,2006,252202,48,38,10,55
10,2006,252202,43,37,6,41
11,2006,252202,37,34,3,55
12,2006,252202,39,34,5,55
1,2007,252202,36,27,9,55
2,2007,252202,41,34,7,66
3,2007,252202,49,40,9,55
4,2007,252202,49,40,9,55
5,2007,252202,45,41,4,48
6,2007,252202,38,26,12,40
7,2007,252202,38,29,9,88
8,2007,252202,44,36,8,70
9,2007,252202,55,45,10,123
10,2007,252202,47,41,6,56
11,2007,252202,32,29,3,51
12,2007,252202,31,26,5,36
1,2008,252202,37,33,4,43
2,2008,252202,38,34,4,46
3,2008,252202,40,32,8,61
4,2008,252202,44,37,7,34
5,2008,252202,48,38,10,46
6,2008,252202,48,40,8,76
7,2008,252202,49,35,14,46
8,2008,252202,50,38,12,67
9,2008,252202,41,34,7,49
10,2008,252202,54,47,7,59
11,2008,252202,45,36,9,49
12,2008,252202,50,43,7,50
1,2009,252202,59,47,12,35
2,2009,252202,38,34,4,55
3,2009,252202,50,36,14,33
4,2009,252202,51,35,16,31
5,2009,252202,36,24,12,23
6,2009,252202,39,34,5,31
7,2009,252202,51,40,11,60
8,2009,252202,41,28,13,43
9,2009,252202,47,41,6,43
10,2009,252202,47,36,11,45
11,2009,252202,37,33,4,48
12,2009,252202,46,34,12,43
1,2010,252202,34,30,4,63
2,2010,252202,32,23,9,61
3,2010,252202,33,25,8,58
4,2010,252202,35,28,7,60
5,2010,252202,43,34,9,30
6,2010,252202,36,31,5,37
7,2010,252202,55,40,15,43
8,2010,252202,42,35,7,56
9,2010,252202,45,35,10,31
10,2010,252202,37,26,11,55
11,2010,252202,40,33,7,25
12,2010,252202,30,24,6,21
1,2011,252202,31,27,4,37
2,2011,252202,22,18,4,22
1,1999,260500,24,22,2,32
2,1999,260500,18,12,6,11
3,1999,260500,27,26,1,17
4,1999,260500,23,21,2,22
5,1999,260500,29,27,2,19
6,1999,260500,35,29,6,19
7,1999,260500,27,21,6,17
8,1999,260500,23,21,2,10
9,1999,260500,27,22,5,20
10,1999,260500,16,16,0,12
11,1999,260500,21,18,3,22
12,1999,260500,21,18,3,17
1,2000,260500,26,21,5,12
2,2000,260500,22,20,2,18
3,2000,260500,25,20,5,18
4,2000,260500,19,17,2,17
5,2000,260500,19,18,1,8
6,2000,260500,19,15,4,9
7,2000,260500,17,13,4,16
8,2000,260500,26,22,4,10
9,2000,260500,26,23,3,8
10,2000,260500,18,16,2,3
11,2000,260500,21,21,0,20
12,2000,260500,17,16,1,11
1,2001,260500,18,16,2,22
2,2001,260500,21,20,1,6
3,2001,260500,32,32,0,12
4,2001,260500,28,28,0,16
5,2001,260500,30,25,5,13
6,2001,260500,25,18,7,14
7,2001,260500,20,20,0,19
8,2001,260500,30,24,6,10
9,2001,260500,12,9,3,11
10,2001,260500,17,13,4,14
11,2001,260500,18,17,1,13
12,2001,260500,15,15,0,6
1,2002,260500,20,15,5,7
2,2002,260500,16,14,2,11
3,2002,260500,19,17,2,21
4,2002,260500,19,19,0,11
5,2002,260500,14,10,4,12
6,2002,260500,18,11,7,8
7,2002,260500,26,20,6,12
8,2002,260500,22,17,5,13
9,2002,260500,24,17,7,8
10,2002,260500,26,23,3,22
11,2002,260500,16,13,3,18
12,2002,260500,19,17,2,10
1,2003,260500,6,4,2,17
2,2003,260500,8,8,0,11
3,2003,260500,21,19,2,76
4,2003,260500,18,17,1,15
5,2003,260500,19,16,3,26
6,2003,260500,24,21,3,28
7,2003,260500,15,15,0,23
8,2003,260500,17,15,2,18
9,2003,260500,20,14,6,19
10,2003,260500,21,17,4,20
11,2003,260500,10,8,2,29
12,2003,260500,17,15,2,13
1,2004,260500,18,17,1,16
2,2004,260500,19,17,2,41
3,2004,260500,18,16,2,14
4,2004,260500,19,18,1,26
5,2004,260500,11,11,0,20
6,2004,260500,19,15,4,19
7,2004,260500,24,23,1,11
8,2004,260500,20,19,1,12
9,2004,260500,20,15,5,21
10,2004,260500,14,13,1,15
11,2004,260500,13,10,3,5
12,2004,260500,12,12,0,16
1,2005,260500,17,14,3,40
2,2005,260500,10,10,0,17
3,2005,260500,19,18,1,10
4,2005,260500,15,11,4,11
5,2005,260500,20,15,5,9
6,2005,260500,17,12,5,17
7,2005,260500,10,8,2,15
8,2005,260500,13,10,3,19
9,2005,260500,20,14,6,4
10,2005,260500,15,14,1,5
11,2005,260500,18,15,3,28
12,2005,260500,24,23,1,19
1,2006,260500,18,17,1,12
2,2006,260500,10,10,0,8
3,2006,260500,15,13,2,10
4,2006,260500,18,17,1,12
5,2006,260500,21,20,1,6
6,2006,260500,18,9,9,16
7,2006,260500,17,15,2,17
8,2006,260500,19,17,2,21
9,2006,260500,17,16,1,16
10,2006,260500,18,13,5,12
11,2006,260500,12,10,2,58
12,2006,260500,15,12,3,22
1,2007,260500,14,14,0,19
2,2007,260500,9,8,1,26
3,2007,260500,18,16,2,7
4,2007,260500,18,13,5,14
5,2007,260500,10,10,0,4
6,2007,260500,16,14,2,7
7,2007,260500,24,18,6,15
8,2007,260500,17,14,3,49
9,2007,260500,13,10,3,2
10,2007,260500,16,15,1,5
11,2007,260500,15,13,2,13
12,2007,260500,10,8,2,7
1,2008,260500,15,15,0,7
2,2008,260500,13,11,2,6
3,2008,260500,12,12,0,3
4,2008,260500,21,17,4,2
5,2008,260500,19,18,1,11
6,2008,260500,13,11,2,21
7,2008,260500,18,16,2,32
8,2008,260500,28,21,7,21
9,2008,260500,30,23,7,7
10,2008,260500,18,16,2,7
11,2008,260500,19,15,4,10
12,2008,260500,13,9,4,3
1,2009,260500,10,4,6,10
2,2009,260500,10,6,4,6
3,2009,260500,12,12,0,9
4,2009,260500,16,12,4,11
5,2009,260500,15,15,0,4
6,2009,260500,9,8,1,6
7,2009,260500,24,17,7,6
8,2009,260500,26,21,5,8
9,2009,260500,12,10,2,6
10,2009,260500,18,15,3,10
11,2009,260500,24,22,2,4
12,2009,260500,13,12,1,8
1,2010,260500,16,15,1,1
2,2010,260500,12,12,0,4
3,2010,260500,16,13,3,9
4,2010,260500,14,14,0,4
5,2010,260500,12,11,1,4
6,2010,260500,23,19,4,4
7,2010,260500,27,22,5,4
8,2010,260500,19,17,2,15
9,2010,260500,21,16,5,7
10,2010,260500,12,8,4,8
11,2010,260500,18,17,1,9
12,2010,260500,10,10,0,5
1,2011,260500,11,10,1,3
2,2011,260500,5,4,1,4
1,1999,260700,23,15,8,71
2,1999,260700,19,12,7,131
3,1999,260700,34,28,6,175
4,1999,260700,26,20,6,100
5,1999,260700,28,20,8,163
6,1999,260700,38,27,11,64
7,1999,260700,35,22,13,64
8,1999,260700,46,22,24,39
9,1999,260700,29,21,8,38
10,1999,260700,35,23,12,45
11,1999,260700,27,23,4,65
12,1999,260700,19,16,3,37
1,2000,260700,24,14,10,31
2,2000,260700,16,14,2,20
3,2000,260700,28,21,7,44
4,2000,260700,25,14,11,26
5,2000,260700,27,23,4,26
6,2000,260700,29,21,8,26
7,2000,260700,30,22,8,15
8,2000,260700,28,17,11,22
9,2000,260700,23,17,6,16
10,2000,260700,29,23,6,31
11,2000,260700,26,22,4,25
12,2000,260700,21,14,7,12
1,2001,260700,21,18,3,21
2,2001,260700,17,12,5,26
3,2001,260700,29,22,7,30
4,2001,260700,21,15,6,23
5,2001,260700,20,17,3,25
6,2001,260700,31,24,7,11
7,2001,260700,22,17,5,16
8,2001,260700,23,16,7,33
9,2001,260700,23,19,4,26
10,2001,260700,31,23,8,26
11,2001,260700,33,30,3,23
12,2001,260700,16,10,6,24
1,2002,260700,20,16,4,23
2,2002,260700,9,7,2,11
3,2002,260700,17,13,4,25
4,2002,260700,25,21,4,18
5,2002,260700,19,10,9,12
6,2002,260700,21,16,5,5
7,2002,260700,34,26,8,14
8,2002,260700,21,17,4,32
9,2002,260700,18,13,5,14
10,2002,260700,17,8,9,17
11,2002,260700,28,24,4,18
12,2002,260700,16,13,3,20
1,2003,260700,22,19,3,19
2,2003,260700,7,4,3,24
3,2003,260700,17,13,4,15
4,2003,260700,23,15,8,20
5,2003,260700,18,13,5,17
6,2003,260700,20,16,4,19
7,2003,260700,20,14,6,22
8,2003,260700,25,22,3,16
9,2003,260700,20,16,4,25
10,2003,260700,25,17,8,12
11,2003,260700,17,10,7,17
12,2003,260700,12,9,3,12
1,2004,260700,11,10,1,16
2,2004,260700,10,8,2,34
3,2004,260700,10,8,2,24
4,2004,260700,13,9,4,18
5,2004,260700,18,12,6,20
6,2004,260700,15,12,3,23
7,2004,260700,29,17,12,18
8,2004,260700,25,20,5,20
9,2004,260700,28,13,15,19
10,2004,260700,27,24,3,26
11,2004,260700,25,19,6,18
12,2004,260700,13,8,5,18
1,2005,260700,16,14,2,28
2,2005,260700,17,13,4,29
3,2005,260700,22,13,9,22
4,2005,260700,23,15,8,64
5,2005,260700,25,18,7,50
6,2005,260700,23,15,8,53
7,2005,260700,28,22,6,16
8,2005,260700,29,21,8,25
9,2005,260700,23,19,4,22
10,2005,260700,27,20,7,60
11,2005,260700,24,19,5,20
12,2005,260700,24,18,6,33
1,2006,260700,14,12,2,38
2,2006,260700,29,24,5,22
3,2006,260700,32,31,1,21
4,2006,260700,20,16,4,27
5,2006,260700,40,34,6,18
6,2006,260700,28,23,5,18
7,2006,260700,27,18,9,18
8,2006,260700,33,23,10,41
9,2006,260700,25,17,8,17
10,2006,260700,30,27,3,24
11,2006,260700,25,18,7,28
12,2006,260700,26,21,5,22
1,2007,260700,17,15,2,23
2,2007,260700,16,14,2,12
3,2007,260700,26,22,4,40
4,2007,260700,26,18,8,24
5,2007,260700,31,24,7,22
6,2007,260700,34,28,6,19
7,2007,260700,18,14,4,19
8,2007,260700,19,15,4,24
9,2007,260700,16,14,2,26
10,2007,260700,31,25,6,16
11,2007,260700,23,18,5,36
12,2007,260700,17,13,4,26
1,2008,260700,16,13,3,17
2,2008,260700,17,11,6,12
3,2008,260700,27,23,4,17
4,2008,260700,23,17,6,12
5,2008,260700,27,21,6,16
6,2008,260700,25,17,8,12
7,2008,260700,33,21,12,13
8,2008,260700,24,17,7,19
9,2008,260700,41,27,14,19
10,2008,260700,32,27,5,7
11,2008,260700,15,13,2,12
12,2008,260700,19,15,4,9
1,2009,260700,14,9,5,11
2,2009,260700,20,17,3,12
3,2009,260700,25,14,11,10
4,2009,260700,19,15,4,9
5,2009,260700,15,11,4,10
6,2009,260700,30,22,8,10
7,2009,260700,35,28,7,7
8,2009,260700,20,15,5,15
9,2009,260700,14,11,3,15
10,2009,260700,24,19,5,16
11,2009,260700,24,20,4,17
12,2009,260700,15,13,2,8
1,2010,260700,21,17,4,21
2,2010,260700,9,7,2,21
3,2010,260700,27,23,4,21
4,2010,260700,20,14,6,12
5,2010,260700,20,17,3,13
6,2010,260700,23,15,8,15
7,2010,260700,32,28,4,12
8,2010,260700,30,25,5,11
9,2010,260700,20,15,5,17
10,2010,260700,12,9,3,16
11,2010,260700,16,14,2,21
12,2010,260700,13,10,3,8
1,2011,260700,13,9,4,18
2,2011,260700,17,14,3,11
1,1999,260800,37,22,15,56
2,1999,260800,29,16,13,59
3,1999,260800,42,25,17,43
4,1999,260800,44,37,7,47
5,1999,260800,39,23,16,58
6,1999,260800,37,26,11,25
7,1999,260800,47,29,18,27
8,1999,260800,43,29,14,25
9,1999,260800,44,27,17,35
10,1999,260800,52,42,10,27
11,1999,260800,40,31,9,50
12,1999,260800,44,35,9,52
1,2000,260800,45,32,13,48
2,2000,260800,26,19,7,65
3,2000,260800,42,34,8,64
4,2000,260800,39,25,14,35
5,2000,260800,46,32,14,36
6,2000,260800,38,31,7,35
7,2000,260800,37,25,12,40
8,2000,260800,42,35,7,38
9,2000,260800,52,39,13,23
10,2000,260800,51,38,13,38
11,2000,260800,46,31,15,37
12,2000,260800,25,16,9,27
1,2001,260800,30,27,3,19
2,2001,260800,36,31,5,29
3,2001,260800,44,37,7,33
4,2001,260800,42,34,8,32
5,2001,260800,37,31,6,30
6,2001,260800,37,30,7,24
7,2001,260800,50,34,16,27
8,2001,260800,51,34,17,29
9,2001,260800,55,41,14,25
10,2001,260800,52,38,14,29
11,2001,260800,43,35,8,40
12,2001,260800,38,32,6,54
1,2002,260800,38,32,6,41
2,2002,260800,27,22,5,144
3,2002,260800,35,21,14,36
4,2002,260800,39,29,10,35
5,2002,260800,42,28,14,23
6,2002,260800,47,28,19,19
7,2002,260800,38,27,11,31
8,2002,260800,30,25,5,20
9,2002,260800,41,31,10,29
10,2002,260800,41,27,14,17
11,2002,260800,30,26,4,33
12,2002,260800,36,32,4,40
1,2003,260800,32,28,4,37
2,2003,260800,32,24,8,28
3,2003,260800,42,34,8,25
4,2003,260800,44,31,13,18
5,2003,260800,43,30,13,19
6,2003,260800,41,32,9,31
7,2003,260800,59,48,11,23
8,2003,260800,42,32,10,31
9,2003,260800,54,45,9,37
10,2003,260800,62,49,13,26
11,2003,260800,43,35,8,42
12,2003,260800,46,40,6,31
1,2004,260800,40,30,10,31
2,2004,260800,30,27,3,39
3,2004,260800,45,31,14,23
4,2004,260800,36,23,13,67
5,2004,260800,37,28,9,24
6,2004,260800,44,30,14,39
7,2004,260800,43,34,9,34
8,2004,260800,47,41,6,31
9,2004,260800,49,34,15,96
10,2004,260800,40,28,12,89
11,2004,260800,50,43,7,39
12,2004,260800,45,36,9,37
1,2005,260800,43,40,3,52
2,2005,260800,41,35,6,77
3,2005,260800,32,25,7,62
4,2005,260800,36,23,13,61
5,2005,260800,46,31,15,56
6,2005,260800,49,39,10,64
7,2005,260800,50,41,9,45
8,2005,260800,57,47,10,45
9,2005,260800,51,44,7,60
10,2005,260800,35,26,9,106
11,2005,260800,29,21,8,46
12,2005,260800,30,21,9,55
1,2006,260800,40,34,6,84
2,2006,260800,31,24,7,45
3,2006,260800,39,28,11,68
4,2006,260800,30,24,6,52
5,2006,260800,51,40,11,64
6,2006,260800,73,54,19,76
7,2006,260800,47,31,16,55
8,2006,260800,52,46,6,50
9,2006,260800,48,40,8,65
10,2006,260800,40,33,7,38
11,2006,260800,36,34,2,42
12,2006,260800,42,37,5,64
1,2007,260800,42,35,7,99
2,2007,260800,31,26,5,79
3,2007,260800,31,24,7,118
4,2007,260800,53,39,14,49
5,2007,260800,41,36,5,40
6,2007,260800,56,45,11,44
7,2007,260800,41,36,5,54
8,2007,260800,50,38,12,72
9,2007,260800,43,27,16,61
10,2007,260800,47,35,12,28
11,2007,260800,25,21,4,46
12,2007,260800,21,19,2,31
1,2008,260800,39,30,9,36
2,2008,260800,27,22,5,29
3,2008,260800,36,27,9,38
4,2008,260800,42,34,8,43
5,2008,260800,33,26,7,24
6,2008,260800,47,33,14,39
7,2008,260800,56,45,11,31
8,2008,260800,46,39,7,47
9,2008,260800,66,53,13,28
10,2008,260800,41,34,7,33
11,2008,260800,46,34,12,48
12,2008,260800,42,34,8,28
1,2009,260800,31,21,10,33
2,2009,260800,36,27,9,36
3,2009,260800,24,14,10,22
4,2009,260800,34,24,10,31
5,2009,260800,36,31,5,20
6,2009,260800,41,29,12,33
7,2009,260800,51,38,13,35
8,2009,260800,39,28,11,33
9,2009,260800,45,37,8,32
10,2009,260800,43,36,7,19
11,2009,260800,35,28,7,28
12,2009,260800,36,31,5,20
1,2010,260800,41,38,3,25
2,2010,260800,27,26,1,29
3,2010,260800,42,32,10,26
4,2010,260800,38,34,4,49
5,2010,260800,40,29,11,23
6,2010,260800,38,31,7,25
7,2010,260800,48,40,8,32
8,2010,260800,41,33,8,36
9,2010,260800,48,41,7,30
10,2010,260800,34,30,4,38
11,2010,260800,45,41,4,36
12,2010,260800,44,40,4,27
1,2011,260800,40,34,6,42
2,2011,260800,10,9,1,31
1,1999,260600,11,8,3,48
2,1999,260600,22,19,3,42
3,1999,260600,18,13,5,51
4,1999,260600,24,19,5,36
5,1999,260600,29,21,8,31
6,1999,260600,15,10,5,35
7,1999,260600,22,13,9,90
8,1999,260600,15,6,9,55
9,1999,260600,20,12,8,35
10,1999,260600,16,9,7,32
11,1999,260600,10,6,4,30
12,1999,260600,20,9,11,38
1,2000,260600,23,14,9,44
2,2000,260600,10,9,1,18
3,2000,260600,25,18,7,27
4,2000,260600,22,15,7,77
5,2000,260600,11,8,3,23
6,2000,260600,22,17,5,24
7,2000,260600,22,14,8,26
8,2000,260600,18,12,6,19
9,2000,260600,17,11,6,28
10,2000,260600,17,13,4,13
11,2000,260600,18,12,6,31
12,2000,260600,21,18,3,15
1,2001,260600,20,14,6,20
2,2001,260600,11,7,4,30
3,2001,260600,18,11,7,41
4,2001,260600,19,13,6,26
5,2001,260600,16,12,4,26
6,2001,260600,15,11,4,31
7,2001,260600,22,16,6,35
8,2001,260600,20,17,3,24
9,2001,260600,14,9,5,24
10,2001,260600,16,13,3,26
11,2001,260600,13,9,4,27
12,2001,260600,19,17,2,21
1,2002,260600,13,7,6,39
2,2002,260600,14,10,4,33
3,2002,260600,18,13,5,44
4,2002,260600,14,10,4,42
5,2002,260600,20,12,8,30
6,2002,260600,17,10,7,26
7,2002,260600,27,13,14,43
8,2002,260600,21,13,8,128
9,2002,260600,20,8,12,67
10,2002,260600,20,11,9,141
11,2002,260600,25,17,8,85
12,2002,260600,15,11,4,139
1,2003,260600,11,8,3,20
2,2003,260600,11,9,2,26
3,2003,260600,9,6,3,22
4,2003,260600,11,8,3,80
5,2003,260600,11,9,2,22
6,2003,260600,22,14,8,18
7,2003,260600,24,21,3,120
8,2003,260600,22,16,6,99
9,2003,260600,18,11,7,34
10,2003,260600,14,12,2,18
11,2003,260600,18,8,10,45
12,2003,260600,15,10,5,19
1,2004,260600,7,4,3,31
2,2004,260600,10,8,2,22
3,2004,260600,16,12,4,24
4,2004,260600,21,17,4,26
5,2004,260600,13,8,5,18
6,2004,260600,15,9,6,27
7,2004,260600,16,12,4,37
8,2004,260600,20,13,7,36
9,2004,260600,24,12,12,28
10,2004,260600,8,7,1,25
11,2004,260600,12,8,4,18
12,2004,260600,18,8,10,26
1,2005,260600,9,6,3,28
2,2005,260600,22,13,9,53
3,2005,260600,14,8,6,67
4,2005,260600,16,11,5,69
5,2005,260600,18,14,4,38
6,2005,260600,15,12,3,25
7,2005,260600,18,15,3,17
8,2005,260600,22,16,6,12
9,2005,260600,21,15,6,48
10,2005,260600,15,10,5,16
11,2005,260600,10,9,1,13
12,2005,260600,20,16,4,17
1,2006,260600,12,9,3,13
2,2006,260600,12,9,3,9
3,2006,260600,16,12,4,6
4,2006,260600,16,8,8,16
5,2006,260600,23,19,4,9
6,2006,260600,20,9,11,17
7,2006,260600,26,16,10,12
8,2006,260600,18,15,3,19
9,2006,260600,17,11,6,6
10,2006,260600,19,17,2,22
11,2006,260600,17,15,2,15
12,2006,260600,17,14,3,20
1,2007,260600,16,11,5,23
2,2007,260600,9,8,1,43
3,2007,260600,19,13,6,31
4,2007,260600,21,17,4,17
5,2007,260600,17,14,3,19
6,2007,260600,19,9,10,21
7,2007,260600,19,12,7,21
8,2007,260600,10,8,2,83
9,2007,260600,15,10,5,27
10,2007,260600,14,11,3,28
11,2007,260600,8,4,4,22
12,2007,260600,12,7,5,25
1,2008,260600,16,13,3,20
2,2008,260600,15,13,2,19
3,2008,260600,14,13,1,16
4,2008,260600,18,12,6,12
5,2008,260600,18,14,4,13
6,2008,260600,19,14,5,22
7,2008,260600,23,14,9,18
8,2008,260600,18,11,7,18
9,2008,260600,21,17,4,14
10,2008,260600,22,16,6,6
11,2008,260600,11,8,3,7
12,2008,260600,15,11,4,28
1,2009,260600,16,10,6,30
2,2009,260600,10,9,1,18
3,2009,260600,18,12,6,11
4,2009,260600,13,6,7,17
5,2009,260600,16,10,6,22
6,2009,260600,17,14,3,28
7,2009,260600,17,11,6,17
8,2009,260600,15,13,2,14
9,2009,260600,15,13,2,64
10,2009,260600,14,12,2,19
11,2009,260600,17,15,2,14
12,2009,260600,17,12,5,7
1,2010,260600,15,10,5,14
2,2010,260600,11,10,1,26
3,2010,260600,21,11,10,15
4,2010,260600,16,12,4,12
5,2010,260600,15,11,4,10
6,2010,260600,17,13,4,8
7,2010,260600,18,18,0,12
8,2010,260600,17,11,6,12
9,2010,260600,9,7,2,12
10,2010,260600,11,9,2,6
11,2010,260600,8,5,3,9
12,2010,260600,13,12,1,8
1,2011,260600,3,3,0,10
2,2011,260600,7,3,4,6
1,1999,271300,18,12,6,38
2,1999,271300,12,6,6,29
3,1999,271300,14,9,5,18
4,1999,271300,21,19,2,34
5,1999,271300,21,16,5,48
6,1999,271300,13,11,2,22
7,1999,271300,19,14,5,15
8,1999,271300,30,25,5,14
9,1999,271300,16,8,8,15
10,1999,271300,18,16,2,29
11,1999,271300,23,14,9,19
12,1999,271300,18,13,5,24
1,2000,271300,8,7,1,22
2,2000,271300,12,6,6,15
3,2000,271300,17,12,5,12
4,2000,271300,8,6,2,5
5,2000,271300,14,9,5,14
6,2000,271300,21,16,5,7
7,2000,271300,16,11,5,11
8,2000,271300,15,10,5,8
9,2000,271300,16,11,5,13
10,2000,271300,17,12,5,13
11,2000,271300,13,12,1,20
12,2000,271300,14,12,2,9
1,2001,271300,18,16,2,20
2,2001,271300,13,13,0,14
3,2001,271300,13,10,3,14
4,2001,271300,8,7,1,13
5,2001,271300,23,18,5,14
6,2001,271300,11,8,3,14
7,2001,271300,13,9,4,8
8,2001,271300,15,11,4,5
9,2001,271300,16,13,3,8
10,2001,271300,15,7,8,9
11,2001,271300,8,7,1,8
12,2001,271300,16,12,4,10
1,2002,271300,15,13,2,9
2,2002,271300,14,10,4,5
3,2002,271300,19,17,2,7
4,2002,271300,19,13,6,15
5,2002,271300,17,10,7,12
6,2002,271300,21,11,10,16
7,2002,271300,22,15,7,8
8,2002,271300,17,10,7,4
9,2002,271300,17,10,7,8
10,2002,271300,19,15,4,6
11,2002,271300,13,8,5,15
12,2002,271300,13,12,1,13
1,2003,271300,15,11,4,25
2,2003,271300,12,8,4,25
3,2003,271300,20,13,7,19
4,2003,271300,20,14,6,14
5,2003,271300,17,12,5,11
6,2003,271300,19,14,5,9
7,2003,271300,14,11,3,15
8,2003,271300,14,12,2,20
9,2003,271300,24,17,7,23
10,2003,271300,17,12,5,167
11,2003,271300,16,12,4,23
12,2003,271300,13,11,2,41
1,2004,271300,17,10,7,28
2,2004,271300,14,11,3,20
3,2004,271300,20,15,5,16
4,2004,271300,8,6,2,23
5,2004,271300,15,10,5,14
6,2004,271300,8,5,3,10
7,2004,271300,18,13,5,18
8,2004,271300,17,13,4,22
9,2004,271300,15,13,2,29
10,2004,271300,24,16,8,58
11,2004,271300,14,8,6,72
12,2004,271300,14,14,0,15
1,2005,271300,7,5,2,12
2,2005,271300,12,8,4,59
3,2005,271300,22,13,9,15
4,2005,271300,16,10,6,20
5,2005,271300,19,15,4,15
6,2005,271300,12,9,3,10
7,2005,271300,15,14,1,9
8,2005,271300,10,7,3,19
9,2005,271300,16,13,3,14
10,2005,271300,15,9,6,9
11,2005,271300,18,17,1,16
12,2005,271300,13,7,6,11
1,2006,271300,10,6,4,11
2,2006,271300,15,12,3,4
3,2006,271300,18,14,4,10
4,2006,271300,9,7,2,9
5,2006,271300,26,22,4,25
6,2006,271300,6,5,1,11
7,2006,271300,9,8,1,17
8,2006,271300,17,14,3,20
9,2006,271300,16,12,4,18
10,2006,271300,21,18,3,30
11,2006,271300,18,14,4,11
12,2006,271300,17,10,7,18
1,2007,271300,27,18,9,8
2,2007,271300,6,5,1,15
3,2007,271300,15,11,4,12
4,2007,271300,15,13,2,10
5,2007,271300,14,13,1,8
6,2007,271300,21,12,9,13
7,2007,271300,15,13,2,12
8,2007,271300,20,16,4,6
9,2007,271300,19,16,3,4
10,2007,271300,20,15,5,7
11,2007,271300,18,17,1,4
12,2007,271300,23,17,6,5
1,2008,271300,14,10,4,8
2,2008,271300,13,10,3,6
3,2008,271300,7,6,1,6
4,2008,271300,11,9,2,5
5,2008,271300,8,4,4,5
6,2008,271300,13,10,3,11
7,2008,271300,18,14,4,3
8,2008,271300,20,15,5,8
9,2008,271300,18,16,2,5
10,2008,271300,30,25,5,8
11,2008,271300,6,5,1,3
12,2008,271300,10,9,1,3
1,2009,271300,16,11,5,8
2,2009,271300,11,7,4,15
3,2009,271300,14,12,2,7
4,2009,271300,14,11,3,7
5,2009,271300,21,17,4,8
6,2009,271300,12,9,3,3
7,2009,271300,13,7,6,8
8,2009,271300,14,8,6,15
9,2009,271300,14,11,3,3
10,2009,271300,19,14,5,12
11,2009,271300,20,18,2,5
12,2009,271300,20,15,5,7
1,2010,271300,11,11,0,11
2,2010,271300,7,6,1,9
3,2010,271300,14,12,2,25
4,2010,271300,13,9,4,14
5,2010,271300,16,14,2,22
6,2010,271300,16,15,1,7
7,2010,271300,8,8,0,18
8,2010,271300,14,14,0,9
9,2010,271300,13,9,4,16
10,2010,271300,21,17,4,14
11,2010,271300,13,11,2,12
12,2010,271300,11,10,1,15
1,2011,271300,12,11,1,5
2,2011,271300,5,3,2,3
1,1999,271200,19,17,2,7
2,1999,271200,19,16,3,15
3,1999,271200,28,25,3,17
4,1999,271200,30,25,5,11
5,1999,271200,25,24,1,10
6,1999,271200,26,24,2,57
7,1999,271200,22,21,1,74
8,1999,271200,32,27,5,5
9,1999,271200,34,32,2,13
10,1999,271200,31,30,1,6
11,1999,271200,18,17,1,8
12,1999,271200,19,17,2,17
1,2000,271200,21,18,3,6
2,2000,271200,25,20,5,4
3,2000,271200,20,14,6,3
4,2000,271200,14,13,1,9
5,2000,271200,17,17,0,3
6,2000,271200,24,23,1,1
7,2000,271200,16,15,1,1
8,2000,271200,19,17,2,4
9,2000,271200,23,18,5,8
10,2000,271200,22,19,3,1
11,2000,271200,16,13,3,1
12,2000,271200,14,13,1,5
1,2001,271200,22,20,2,4
2,2001,271200,19,15,4,7
3,2001,271200,18,17,1,5
4,2001,271200,18,15,3,5
5,2001,271200,21,18,3,5
6,2001,271200,22,18,4,4
7,2001,271200,29,24,5,4
8,2001,271200,24,19,5,5
9,2001,271200,31,22,9,1
10,2001,271200,22,17,5,2
11,2001,271200,22,14,8,2
12,2001,271200,24,22,2,5
1,2002,271200,16,11,5,4
2,2002,271200,22,19,3,7
3,2002,271200,32,26,6,4
4,2002,271200,20,18,2,7
5,2002,271200,26,25,1,7
6,2002,271200,23,17,6,7
7,2002,271200,27,23,4,3
8,2002,271200,31,22,9,10
9,2002,271200,24,17,7,11
10,2002,271200,26,20,6,5
11,2002,271200,19,15,4,5
12,2002,271200,16,14,2,3
1,2003,271200,12,7,5,18
2,2003,271200,19,14,5,4
3,2003,271200,15,11,4,12
4,2003,271200,15,10,5,3
5,2003,271200,22,18,4,3
6,2003,271200,10,8,2,10
7,2003,271200,19,15,4,5
8,2003,271200,9,8,1,23
9,2003,271200,25,24,1,232
10,2003,271200,25,19,6,91
11,2003,271200,15,13,2,8
12,2003,271200,18,16,2,10
1,2004,271200,12,7,5,16
2,2004,271200,12,10,2,3
3,2004,271200,15,11,4,9
4,2004,271200,22,21,1,12
5,2004,271200,18,14,4,54
6,2004,271200,20,17,3,17
7,2004,271200,20,13,7,19
8,2004,271200,18,17,1,130
9,2004,271200,14,12,2,19
10,2004,271200,22,17,5,16
11,2004,271200,15,15,0,21
12,2004,271200,18,13,5,27
1,2005,271200,23,21,2,16
2,2005,271200,12,8,4,17
3,2005,271200,20,15,5,25
4,2005,271200,17,14,3,16
5,2005,271200,18,13,5,14
6,2005,271200,19,18,1,13
7,2005,271200,30,26,4,14
8,2005,271200,24,18,6,17
9,2005,271200,20,16,4,28
10,2005,271200,20,16,4,13
11,2005,271200,15,13,2,20
12,2005,271200,22,19,3,22
1,2006,271200,17,15,2,25
2,2006,271200,17,15,2,15
3,2006,271200,18,14,4,13
4,2006,271200,17,13,4,6
5,2006,271200,18,13,5,16
6,2006,271200,24,19,5,10
7,2006,271200,18,12,6,11
8,2006,271200,26,19,7,16
9,2006,271200,18,17,1,16
10,2006,271200,20,19,1,11
11,2006,271200,17,14,3,16
12,2006,271200,18,16,2,20
1,2007,271200,24,20,4,20
2,2007,271200,11,10,1,21
3,2007,271200,14,14,0,18
4,2007,271200,18,13,5,14
5,2007,271200,18,13,5,16
6,2007,271200,19,16,3,7
7,2007,271200,21,19,2,15
8,2007,271200,26,22,4,13
9,2007,271200,22,16,6,8
10,2007,271200,20,17,3,12
11,2007,271200,14,11,3,10
12,2007,271200,16,16,0,5
1,2008,271200,12,10,2,14
2,2008,271200,11,10,1,11
3,2008,271200,19,18,1,5
4,2008,271200,15,13,2,10
5,2008,271200,23,18,5,10
6,2008,271200,27,18,9,7
7,2008,271200,29,25,4,10
8,2008,271200,16,11,5,13
9,2008,271200,25,22,3,10
10,2008,271200,23,18,5,19
11,2008,271200,16,13,3,31
12,2008,271200,6,4,2,25
1,2009,271200,15,13,2,23
2,2009,271200,14,14,0,25
3,2009,271200,22,17,5,19
4,2009,271200,21,17,4,27
5,2009,271200,23,19,4,12
6,2009,271200,15,10,5,7
7,2009,271200,14,13,1,16
8,2009,271200,20,18,2,17
9,2009,271200,22,17,5,17
10,2009,271200,19,17,2,11
11,2009,271200,14,11,3,12
12,2009,271200,13,13,0,6
1,2010,271200,14,14,0,13
2,2010,271200,10,9,1,13
3,2010,271200,12,10,2,7
4,2010,271200,11,8,3,10
5,2010,271200,15,12,3,10
6,2010,271200,16,11,5,6
7,2010,271200,24,18,6,6
8,2010,271200,15,10,5,2
9,2010,271200,18,16,2,8
10,2010,271200,13,9,4,7
11,2010,271200,14,11,3,10
12,2010,271200,12,11,1,8
1,2011,271200,12,12,0,9
2,2011,271200,5,5,0,11
1,1999,320400,72,71,1,1
2,1999,320400,43,42,1,1
3,1999,320400,47,47,0,2
4,1999,320400,46,45,1,3
5,1999,320400,44,42,2,5
6,1999,320400,60,57,3,17
7,1999,320400,89,87,2,8
8,1999,320400,73,71,2,3
9,1999,320400,53,52,1,1
10,1999,320400,78,77,1,1
11,1999,320400,55,53,2,0
12,1999,320400,60,58,2,1
1,2000,320400,44,44,0,0
2,2000,320400,48,44,4,2
3,2000,320400,60,59,1,0
4,2000,320400,52,51,1,5
5,2000,320400,46,44,2,2
6,2000,320400,66,63,3,6
7,2000,320400,85,83,2,9
8,2000,320400,55,52,3,0
9,2000,320400,51,50,1,0
10,2000,320400,65,63,2,2
11,2000,320400,44,44,0,3
12,2000,320400,52,52,0,0
1,2001,320400,37,37,0,3
2,2001,320400,39,38,1,1
3,2001,320400,60,60,0,2
4,2001,320400,39,39,0,5
5,2001,320400,50,48,2,2
6,2001,320400,62,58,4,4
7,2001,320400,68,68,0,13
8,2001,320400,59,58,1,3
9,2001,320400,41,41,0,4
10,2001,320400,58,57,1,4
11,2001,320400,38,38,0,8
12,2001,320400,34,34,0,1
1,2002,320400,40,40,0,7
2,2002,320400,29,29,0,1
3,2002,320400,22,21,1,0
4,2002,320400,39,37,2,0
5,2002,320400,31,29,2,5
6,2002,320400,64,61,3,3
7,2002,320400,75,74,1,3
8,2002,320400,54,54,0,3
9,2002,320400,46,45,1,0
10,2002,320400,63,62,1,2
11,2002,320400,38,38,0,3
12,2002,320400,42,39,3,5
1,2003,320400,40,40,0,4
2,2003,320400,21,21,0,0
3,2003,320400,34,34,0,1
4,2003,320400,32,32,0,5
5,2003,320400,47,44,3,2
6,2003,320400,42,42,0,3
7,2003,320400,50,49,1,7
8,2003,320400,45,44,1,5
9,2003,320400,42,41,1,3
10,2003,320400,49,48,1,2
11,2003,320400,36,34,2,0
12,2003,320400,31,31,0,1
1,2004,320400,23,23,0,3
2,2004,320400,23,23,0,0
3,2004,320400,43,41,2,1
4,2004,320400,29,27,2,2
5,2004,320400,30,29,1,2
6,2004,320400,40,37,3,6
7,2004,320400,59,58,1,5
8,2004,320400,64,63,1,3
9,2004,320400,37,36,1,3
10,2004,320400,42,42,0,0
11,2004,320400,39,37,2,0
12,2004,320400,32,32,0,2
1,2005,320400,19,18,1,0
2,2005,320400,16,16,0,0
3,2005,320400,23,22,1,4
4,2005,320400,27,25,2,1
5,2005,320400,35,34,1,0
6,2005,320400,50,50,0,9
7,2005,320400,56,55,1,7
8,2005,320400,45,43,2,0
9,2005,320400,35,33,2,7
10,2005,320400,27,26,1,0
11,2005,320400,31,31,0,0
12,2005,320400,16,16,0,4
1,2006,320400,21,21,0,0
2,2006,320400,22,21,1,5
3,2006,320400,33,32,1,1
4,2006,320400,29,29,0,3
5,2006,320400,18,17,1,1
6,2006,320400,47,46,1,4
7,2006,320400,66,65,1,11
8,2006,320400,56,56,0,3
9,2006,320400,32,32,0,0
10,2006,320400,38,36,2,0
11,2006,320400,20,20,0,0
12,2006,320400,26,26,0,2
1,2007,320400,13,12,1,1
2,2007,320400,21,21,0,1
3,2007,320400,28,28,0,1
4,2007,320400,14,13,1,0
5,2007,320400,40,36,4,1
6,2007,320400,44,43,1,5
7,2007,320400,50,49,1,4
8,2007,320400,39,38,1,0
9,2007,320400,29,29,0,1
10,2007,320400,24,23,1,2
11,2007,320400,27,27,0,1
12,2007,320400,14,14,0,0
1,2008,320400,19,19,0,0
2,2008,320400,16,13,3,1
3,2008,320400,17,17,0,4
4,2008,320400,33,32,1,4
5,2008,320400,25,25,0,7
6,2008,320400,36,33,3,4
7,2008,320400,69,69,0,6
8,2008,320400,58,58,0,4
9,2008,320400,44,43,1,1
10,2008,320400,35,33,2,4
11,2008,320400,27,27,0,0
12,2008,320400,27,27,0,0
1,2009,320400,27,27,0,0
2,2009,320400,25,24,1,0
3,2009,320400,21,21,0,0
4,2009,320400,29,29,0,1
5,2009,320400,37,34,3,1
6,2009,320400,48,47,1,3
7,2009,320400,59,57,2,10
8,2009,320400,43,41,2,10
9,2009,320400,54,54,0,4
10,2009,320400,23,23,0,2
11,2009,320400,23,21,2,0
12,2009,320400,18,18,0,2
1,2010,320400,22,22,0,1
2,2010,320400,25,23,2,1
3,2010,320400,23,23,0,1
4,2010,320400,27,26,1,2
5,2010,320400,36,35,1,4
6,2010,320400,42,41,1,5
7,2010,320400,49,47,2,11
8,2010,320400,37,37,0,5
9,2010,320400,32,32,0,6
10,2010,320400,36,35,1,0
11,2010,320400,34,34,0,2
12,2010,320400,28,28,0,4
1,2011,320400,25,24,1,3
2,2011,320400,12,12,0,0
1,1999,271400,7,5,2,3
2,1999,271400,17,12,5,5
3,1999,271400,8,7,1,3
4,1999,271400,11,7,4,4
5,1999,271400,14,8,6,3
6,1999,271400,9,8,1,7
7,1999,271400,11,11,0,1
8,1999,271400,17,7,10,3
9,1999,271400,9,8,1,4
10,1999,271400,10,9,1,1
11,1999,271400,7,7,0,1
12,1999,271400,11,9,2,0
1,2000,271400,10,7,3,4
2,2000,271400,7,7,0,4
3,2000,271400,9,6,3,2
4,2000,271400,8,6,2,5
5,2000,271400,9,6,3,3
6,2000,271400,5,5,0,10
7,2000,271400,9,5,4,9
8,2000,271400,10,6,4,4
9,2000,271400,13,9,4,2
10,2000,271400,6,5,1,4
11,2000,271400,10,8,2,1
12,2000,271400,9,6,3,1
1,2001,271400,8,7,1,0
2,2001,271400,10,10,0,2
3,2001,271400,10,5,5,3
4,2001,271400,9,4,5,4
5,2001,271400,16,14,2,4
6,2001,271400,9,7,2,2
7,2001,271400,13,9,4,1
8,2001,271400,8,5,3,4
9,2001,271400,12,10,2,5
10,2001,271400,10,7,3,1
11,2001,271400,5,3,2,0
12,2001,271400,6,5,1,4
1,2002,271400,11,9,2,2
2,2002,271400,10,9,1,0
3,2002,271400,9,7,2,3
4,2002,271400,9,7,2,6
5,2002,271400,14,12,2,2
6,2002,271400,12,9,3,3
7,2002,271400,11,9,2,2
8,2002,271400,13,11,2,5
9,2002,271400,13,9,4,1
10,2002,271400,17,16,1,5
11,2002,271400,9,5,4,6
12,2002,271400,12,11,1,8
1,2003,271400,9,9,0,8
2,2003,271400,3,2,1,13
3,2003,271400,5,3,2,1
4,2003,271400,8,7,1,2
5,2003,271400,12,10,2,5
6,2003,271400,13,10,3,1
7,2003,271400,19,16,3,3
8,2003,271400,10,6,4,5
9,2003,271400,31,30,1,6
10,2003,271400,13,11,2,4
11,2003,271400,11,8,3,6
12,2003,271400,9,7,2,11
1,2004,271400,10,8,2,6
2,2004,271400,12,9,3,6
3,2004,271400,15,11,4,5
4,2004,271400,12,8,4,4
5,2004,271400,10,9,1,3
6,2004,271400,7,7,0,1
7,2004,271400,18,17,1,4
8,2004,271400,11,11,0,0
9,2004,271400,14,13,1,9
10,2004,271400,14,14,0,40
11,2004,271400,13,10,3,16
12,2004,271400,12,12,0,2
1,2005,271400,3,3,0,3
2,2005,271400,6,3,3,2
3,2005,271400,5,5,0,7
4,2005,271400,8,5,3,14
5,2005,271400,12,9,3,4
6,2005,271400,9,8,1,12
7,2005,271400,14,12,2,6
8,2005,271400,13,10,3,7
9,2005,271400,15,12,3,9
10,2005,271400,8,8,0,2
11,2005,271400,8,8,0,8
12,2005,271400,8,7,1,4
1,2006,271400,8,6,2,7
2,2006,271400,12,12,0,8
3,2006,271400,18,14,4,3
4,2006,271400,12,8,4,5
5,2006,271400,8,5,3,4
6,2006,271400,13,7,6,5
7,2006,271400,4,4,0,8
8,2006,271400,10,10,0,13
9,2006,271400,14,13,1,5
10,2006,271400,12,12,0,5
11,2006,271400,8,6,2,12
12,2006,271400,16,16,0,7
1,2007,271400,10,9,1,5
2,2007,271400,6,5,1,10
3,2007,271400,7,6,1,14
4,2007,271400,6,4,2,10
5,2007,271400,6,6,0,1
6,2007,271400,12,11,1,1
7,2007,271400,7,6,1,2
8,2007,271400,14,12,2,7
9,2007,271400,6,5,1,3
10,2007,271400,12,11,1,1
11,2007,271400,11,9,2,2
12,2007,271400,5,5,0,7
1,2008,271400,2,0,2,8
2,2008,271400,8,8,0,1
3,2008,271400,13,11,2,4
4,2008,271400,8,6,2,4
5,2008,271400,9,9,0,7
6,2008,271400,10,4,6,4
7,2008,271400,17,14,3,1
8,2008,271400,18,17,1,2
9,2008,271400,12,11,1,4
10,2008,271400,10,9,1,2
11,2008,271400,6,5,1,6
12,2008,271400,11,8,3,0
1,2009,271400,5,5,0,0
2,2009,271400,1,0,1,1
3,2009,271400,10,8,2,2
4,2009,271400,10,8,2,3
5,2009,271400,9,8,1,8
6,2009,271400,17,14,3,3
7,2009,271400,4,3,1,7
8,2009,271400,12,9,3,5
9,2009,271400,9,7,2,3
10,2009,271400,6,6,0,2
11,2009,271400,5,3,2,1
12,2009,271400,4,3,1,3
1,2010,271400,12,11,1,0
2,2010,271400,8,5,3,1
3,2010,271400,4,3,1,1
4,2010,271400,9,6,3,3
5,2010,271400,10,8,2,2
6,2010,271400,7,6,1,2
7,2010,271400,11,10,1,4
8,2010,271400,13,12,1,1
9,2010,271400,10,9,1,5
10,2010,271400,9,9,0,1
11,2010,271400,9,9,0,4
12,2010,271400,7,7,0,2
1,2011,271400,8,7,1,1
2,2011,271400,3,1,2,3
1,1999,839100,382,377,5,12
2,1999,839100,347,340,7,9
3,1999,839100,434,424,10,12
4,1999,839100,430,422,8,14
5,1999,839100,395,390,5,16
6,1999,839100,425,415,10,11
7,1999,839100,452,445,7,7
8,1999,839100,464,454,10,15
9,1999,839100,427,421,6,11
10,1999,839100,451,442,9,12
11,1999,839100,390,380,10,15
12,1999,839100,424,419,5,13
1,2000,839100,416,410,6,15
2,2000,839100,339,332,7,6
3,2000,839100,382,374,8,30
4,2000,839100,377,366,11,13
5,2000,839100,363,356,7,19
6,2000,839100,391,383,8,19
7,2000,839100,351,342,9,21
8,2000,839100,371,364,7,19
9,2000,839100,362,355,7,15
10,2000,839100,366,354,12,17
11,2000,839100,397,395,2,14
12,2000,839100,393,382,11,25
1,2001,839100,392,383,9,23
2,2001,839100,288,283,5,30
3,2001,839100,351,346,5,8
4,2001,839100,321,317,4,13
5,2001,839100,332,328,4,12
6,2001,839100,327,319,8,7
7,2001,839100,344,337,7,16
8,2001,839100,386,383,3,20
9,2001,839100,253,246,7,9
10,2001,839100,348,344,4,23
11,2001,839100,384,377,7,11
12,2001,839100,337,331,6,9
1,2002,839100,318,313,5,10
2,2002,839100,268,263,5,10
3,2002,839100,256,249,7,8
4,2002,839100,289,281,8,9
5,2002,839100,337,330,7,9
6,2002,839100,305,298,7,16
7,2002,839100,324,317,7,12
8,2002,839100,374,369,5,17
9,2002,839100,318,313,5,10
10,2002,839100,346,337,9,15
11,2002,839100,316,314,2,12
12,2002,839100,330,326,4,18
1,2003,839100,285,282,3,11
2,2003,839100,239,234,5,6
3,2003,839100,292,288,4,10
4,2003,839100,273,271,2,8
5,2003,839100,273,267,6,18
6,2003,839100,294,287,7,10
7,2003,839100,266,259,7,9
8,2003,839100,299,293,6,13
9,2003,839100,277,274,3,3
10,2003,839100,315,308,7,8
11,2003,839100,277,273,4,3
12,2003,839100,272,266,6,10
1,2004,839100,232,225,7,4
2,2004,839100,199,198,1,6
3,2004,839100,303,294,9,2
4,2004,839100,269,266,3,13
5,2004,839100,272,266,6,2
6,2004,839100,306,300,6,11
7,2004,839100,298,295,3,14
8,2004,839100,341,332,9,3
9,2004,839100,281,280,1,3
10,2004,839100,302,294,8,5
11,2004,839100,262,258,4,10
12,2004,839100,295,290,5,5
1,2005,839100,256,252,4,3
2,2005,839100,188,186,2,8
3,2005,839100,230,228,2,12
4,2005,839100,276,274,2,7
5,2005,839100,301,292,9,8
6,2005,839100,290,281,9,13
7,2005,839100,294,287,7,5
8,2005,839100,278,275,3,5
9,2005,839100,288,281,7,7
10,2005,839100,282,277,5,10
11,2005,839100,235,227,8,4
12,2005,839100,281,277,4,6
1,2006,839100,231,225,6,5
2,2006,839100,198,191,7,5
3,2006,839100,264,249,15,10
4,2006,839100,255,253,2,5
5,2006,839100,260,255,5,8
6,2006,839100,298,290,8,9
7,2006,839100,265,262,3,5
8,2006,839100,297,291,6,17
9,2006,839100,282,276,6,5
10,2006,839100,269,264,5,6
11,2006,839100,264,261,3,4
12,2006,839100,247,242,5,5
1,2007,839100,254,253,1,5
2,2007,839100,226,225,1,3
3,2007,839100,266,260,6,7
4,2007,839100,245,238,7,17
5,2007,839100,325,315,10,5
6,2007,839100,318,315,3,6
7,2007,839100,264,260,4,13
8,2007,839100,269,261,8,5
9,2007,839100,261,254,7,7
10,2007,839100,260,253,7,5
11,2007,839100,251,243,8,8
12,2007,839100,234,232,2,10
1,2008,839100,188,184,4,10
2,2008,839100,167,162,5,4
3,2008,839100,231,227,4,10
4,2008,839100,282,277,5,5
5,2008,839100,247,243,4,9
6,2008,839100,263,257,6,6
7,2008,839100,282,277,5,13
8,2008,839100,303,299,4,6
9,2008,839100,264,261,3,8
10,2008,839100,257,249,8,13
11,2008,839100,252,243,9,8
12,2008,839100,294,290,4,6
1,2009,839100,200,197,3,8
2,2009,839100,220,217,3,13
3,2009,839100,222,219,3,12
4,2009,839100,232,230,2,8
5,2009,839100,238,232,6,4
6,2009,839100,249,246,3,9
7,2009,839100,300,292,8,8
8,2009,839100,238,231,7,5
9,2009,839100,258,251,7,10
10,2009,839100,237,235,2,10
11,2009,839100,209,206,3,10
12,2009,839100,250,246,4,12
1,2010,839100,241,237,4,6
2,2010,839100,207,201,6,10
3,2010,839100,254,251,3,17
4,2010,839100,241,239,2,11
5,2010,839100,216,208,8,7
6,2010,839100,239,232,7,8
7,2010,839100,244,237,7,22
8,2010,839100,259,251,8,9
9,2010,839100,237,232,5,16
10,2010,839100,284,279,5,9
11,2010,839100,260,259,1,9
12,2010,839100,243,238,5,8
1,2011,839100,210,206,4,9
2,2011,839100,134,130,4,7
1,1999,838000,16,14,2,3
2,1999,838000,15,13,2,2
3,1999,838000,23,20,3,2
4,1999,838000,17,11,6,3
5,1999,838000,25,23,2,2
6,1999,838000,15,12,3,1
7,1999,838000,15,12,3,4
8,1999,838000,19,18,1,4
9,1999,838000,12,5,7,6
10,1999,838000,26,20,6,3
11,1999,838000,15,14,1,4
12,1999,838000,14,11,3,6
1,2000,838000,4,4,0,5
2,2000,838000,12,10,2,4
3,2000,838000,16,13,3,2
4,2000,838000,10,8,2,10
5,2000,838000,15,11,4,12
6,2000,838000,18,13,5,8
7,2000,838000,13,9,4,10
8,2000,838000,23,21,2,1
9,2000,838000,12,12,0,5
10,2000,838000,22,21,1,0
11,2000,838000,13,10,3,1
12,2000,838000,12,11,1,2
1,2001,838000,20,19,1,7
2,2001,838000,10,7,3,7
3,2001,838000,12,10,2,9
4,2001,838000,8,6,2,11
5,2001,838000,18,14,4,7
6,2001,838000,22,19,3,9
7,2001,838000,19,15,4,0
8,2001,838000,15,12,3,3
9,2001,838000,10,6,4,11
10,2001,838000,22,20,2,6
11,2001,838000,14,9,5,5
12,2001,838000,23,23,0,6
1,2002,838000,14,10,4,5
2,2002,838000,9,8,1,8
3,2002,838000,15,8,7,9
4,2002,838000,17,12,5,12
5,2002,838000,16,12,4,14
6,2002,838000,17,9,8,6
7,2002,838000,23,22,1,7
8,2002,838000,14,12,2,6
9,2002,838000,24,21,3,3
10,2002,838000,32,28,4,5
11,2002,838000,16,14,2,4
12,2002,838000,15,13,2,6
1,2003,838000,10,8,2,7
2,2003,838000,9,7,2,5
3,2003,838000,12,8,4,2
4,2003,838000,16,10,6,3
5,2003,838000,18,17,1,7
6,2003,838000,24,18,6,7
7,2003,838000,26,23,3,2
8,2003,838000,17,16,1,2
9,2003,838000,23,20,3,2
10,2003,838000,21,15,6,1
11,2003,838000,17,15,2,4
12,2003,838000,26,23,3,2
1,2004,838000,11,11,0,0
2,2004,838000,18,15,3,1
3,2004,838000,28,20,8,1
4,2004,838000,9,6,3,2
5,2004,838000,27,22,5,4
6,2004,838000,20,17,3,0
7,2004,838000,19,13,6,1
8,2004,838000,28,23,5,0
9,2004,838000,23,19,4,1
10,2004,838000,21,15,6,4
11,2004,838000,28,23,5,3
12,2004,838000,12,10,2,6
1,2005,838000,16,13,3,6
2,2005,838000,19,15,4,6
3,2005,838000,15,12,3,5
4,2005,838000,13,7,6,1
5,2005,838000,7,4,3,2
6,2005,838000,18,11,7,5
7,2005,838000,25,22,3,4
8,2005,838000,20,16,4,6
9,2005,838000,21,14,7,1
10,2005,838000,31,26,5,5
11,2005,838000,10,9,1,4
12,2005,838000,17,15,2,6
1,2006,838000,15,12,3,1
2,2006,838000,11,7,4,4
3,2006,838000,17,13,4,5
4,2006,838000,13,11,2,5
5,2006,838000,24,21,3,6
6,2006,838000,20,15,5,5
7,2006,838000,13,12,1,2
8,2006,838000,13,12,1,7
9,2006,838000,16,11,5,6
10,2006,838000,25,21,4,2
11,2006,838000,17,14,3,3
12,2006,838000,17,13,4,6
1,2007,838000,18,14,4,9
2,2007,838000,13,9,4,7
3,2007,838000,21,15,6,3
4,2007,838000,15,10,5,3
5,2007,838000,20,19,1,9
6,2007,838000,16,15,1,3
7,2007,838000,24,17,7,10
8,2007,838000,14,11,3,4
9,2007,838000,25,21,4,7
10,2007,838000,17,17,0,6
11,2007,838000,23,15,8,14
12,2007,838000,15,14,1,9
1,2008,838000,17,14,3,3
2,2008,838000,15,15,0,3
3,2008,838000,17,13,4,10
4,2008,838000,20,16,4,5
5,2008,838000,11,11,0,16
6,2008,838000,21,19,2,5
7,2008,838000,22,18,4,4
8,2008,838000,16,14,2,1
9,2008,838000,15,13,2,11
10,2008,838000,27,21,6,5
11,2008,838000,17,15,2,2
12,2008,838000,16,14,2,5
1,2009,838000,16,15,1,3
2,2009,838000,26,21,5,3
3,2009,838000,13,11,2,2
4,2009,838000,23,20,3,0
5,2009,838000,12,10,2,1
6,2009,838000,9,8,1,2
7,2009,838000,13,8,5,0
8,2009,838000,19,15,4,0
9,2009,838000,21,18,3,3
10,2009,838000,23,16,7,2
11,2009,838000,21,18,3,6
12,2009,838000,20,18,2,4
1,2010,838000,16,14,2,1
2,2010,838000,4,2,2,7
3,2010,838000,10,8,2,2
4,2010,838000,6,3,3,1
5,2010,838000,14,13,1,1
6,2010,838000,10,7,3,4
7,2010,838000,8,8,0,0
8,2010,838000,13,11,2,2
9,2010,838000,18,16,2,2
10,2010,838000,24,22,2,2
11,2010,838000,12,10,2,5
12,2010,838000,7,7,0,2
1,2011,838000,12,11,1,3
2,2011,838000,5,4,1,2
1,1999,837000,12,8,4,13
2,1999,837000,16,15,1,21
3,1999,837000,17,14,3,24
4,1999,837000,19,15,4,30
5,1999,837000,13,10,3,18
6,1999,837000,32,24,8,11
7,1999,837000,25,22,3,22
8,1999,837000,17,14,3,26
9,1999,837000,11,9,2,34
10,1999,837000,19,16,3,30
11,1999,837000,18,12,6,31
12,1999,837000,18,9,9,99
1,2000,837000,16,10,6,8
2,2000,837000,16,14,2,15
3,2000,837000,23,17,6,18
4,2000,837000,19,15,4,16
5,2000,837000,15,15,0,9
6,2000,837000,22,16,6,13
7,2000,837000,19,14,5,14
8,2000,837000,29,22,7,16
9,2000,837000,18,12,6,13
10,2000,837000,15,11,4,13
11,2000,837000,23,16,7,12
12,2000,837000,18,15,3,23
1,2001,837000,12,9,3,25
2,2001,837000,15,9,6,32
3,2001,837000,18,15,3,30
4,2001,837000,14,12,2,19
5,2001,837000,17,12,5,28
6,2001,837000,25,20,5,120
7,2001,837000,21,18,3,29
8,2001,837000,28,22,6,79
9,2001,837000,30,23,7,45
10,2001,837000,24,22,2,32
11,2001,837000,24,17,7,19
12,2001,837000,17,13,4,22
1,2002,837000,21,15,6,19
2,2002,837000,19,13,6,21
3,2002,837000,23,20,3,17
4,2002,837000,22,17,5,24
5,2002,837000,22,16,6,24
6,2002,837000,19,13,6,20
7,2002,837000,18,13,5,25
8,2002,837000,23,15,8,23
9,2002,837000,25,19,6,15
10,2002,837000,29,23,6,20
11,2002,837000,27,24,3,17
12,2002,837000,23,19,4,21
1,2003,837000,15,12,3,38
2,2003,837000,15,9,6,31
3,2003,837000,15,13,2,29
4,2003,837000,17,13,4,31
5,2003,837000,27,20,7,33
6,2003,837000,19,12,7,19
7,2003,837000,18,13,5,25
8,2003,837000,30,26,4,28
9,2003,837000,23,20,3,50
10,2003,837000,20,13,7,35
11,2003,837000,17,15,2,61
12,2003,837000,14,8,6,27
1,2004,837000,15,15,0,26
2,2004,837000,25,21,4,37
3,2004,837000,32,21,11,38
4,2004,837000,18,15,3,21
5,2004,837000,15,10,5,38
6,2004,837000,26,21,5,32
7,2004,837000,32,24,8,26
8,2004,837000,26,20,6,145
9,2004,837000,26,22,4,48
10,2004,837000,18,15,3,49
11,2004,837000,21,11,10,16
12,2004,837000,21,16,5,35
1,2005,837000,21,16,5,74
2,2005,837000,18,13,5,42
3,2005,837000,12,9,3,21
4,2005,837000,14,12,2,15
5,2005,837000,23,19,4,34
6,2005,837000,19,16,3,30
7,2005,837000,29,24,5,30
8,2005,837000,11,8,3,30
9,2005,837000,24,19,5,26
10,2005,837000,28,21,7,21
11,2005,837000,22,21,1,14
12,2005,837000,18,16,2,20
1,2006,837000,11,7,4,21
2,2006,837000,11,8,3,19
3,2006,837000,22,19,3,27
4,2006,837000,27,19,8,26
5,2006,837000,25,19,6,29
6,2006,837000,15,9,6,15
7,2006,837000,20,16,4,34
8,2006,837000,27,25,2,34
9,2006,837000,29,26,3,75
10,2006,837000,17,13,4,52
11,2006,837000,16,11,5,93
12,2006,837000,18,13,5,24
1,2007,837000,17,11,6,30
2,2007,837000,11,6,5,25
3,2007,837000,17,14,3,9
4,2007,837000,25,22,3,11
5,2007,837000,21,17,4,11
6,2007,837000,28,22,6,20
7,2007,837000,18,15,3,20
8,2007,837000,21,12,9,14
9,2007,837000,33,20,13,24
10,2007,837000,25,19,6,17
11,2007,837000,22,20,2,24
12,2007,837000,20,19,1,13
1,2008,837000,14,10,4,17
2,2008,837000,12,9,3,12
3,2008,837000,14,11,3,20
4,2008,837000,21,17,4,15
5,2008,837000,26,19,7,16
6,2008,837000,29,26,3,16
7,2008,837000,27,24,3,11
8,2008,837000,35,32,3,21
9,2008,837000,27,22,5,27
10,2008,837000,25,23,2,32
11,2008,837000,17,14,3,61
12,2008,837000,23,19,4,31
1,2009,837000,23,19,4,16
2,2009,837000,5,5,0,24
3,2009,837000,20,15,5,19
4,2009,837000,16,12,4,23
5,2009,837000,16,13,3,34
6,2009,837000,19,11,8,31
7,2009,837000,15,11,4,31
8,2009,837000,15,9,6,24
9,2009,837000,16,8,8,31
10,2009,837000,19,16,3,21
11,2009,837000,16,13,3,20
12,2009,837000,14,13,1,13
1,2010,837000,16,14,2,23
2,2010,837000,21,19,2,31
3,2010,837000,19,15,4,25
4,2010,837000,14,10,4,17
5,2010,837000,20,18,2,10
6,2010,837000,24,21,3,10
7,2010,837000,20,17,3,8
8,2010,837000,23,14,9,27
9,2010,837000,20,14,6,28
10,2010,837000,14,11,3,18
11,2010,837000,12,10,2,19
12,2010,837000,11,11,0,8
1,2011,837000,15,13,2,10
2,2011,837000,9,9,0,8
1,1999,838100,36,28,8,15
2,1999,838100,38,36,2,8
3,1999,838100,41,38,3,23
4,1999,838100,48,43,5,18
5,1999,838100,52,41,11,16
6,1999,838100,45,37,8,10
7,1999,838100,54,41,13,3
8,1999,838100,47,43,4,8
9,1999,838100,39,31,8,12
10,1999,838100,38,30,8,13
11,1999,838100,41,37,4,15
12,1999,838100,29,24,5,16
1,2000,838100,39,35,4,24
2,2000,838100,26,20,6,13
3,2000,838100,21,15,6,11
4,2000,838100,27,22,5,14
5,2000,838100,40,37,3,6
6,2000,838100,27,25,2,7
7,2000,838100,50,33,17,6
8,2000,838100,36,32,4,3
9,2000,838100,36,34,2,3
10,2000,838100,44,38,6,6
11,2000,838100,21,18,3,4
12,2000,838100,33,27,6,4
1,2001,838100,33,24,9,13
2,2001,838100,21,19,2,7
3,2001,838100,41,36,5,6
4,2001,838100,21,18,3,3
5,2001,838100,29,21,8,6
6,2001,838100,26,20,6,1
7,2001,838100,31,24,7,2
8,2001,838100,38,31,7,2
9,2001,838100,35,32,3,5
10,2001,838100,46,38,8,9
11,2001,838100,21,19,2,12
12,2001,838100,35,28,7,7
1,2002,838100,26,18,8,6
2,2002,838100,21,17,4,2
3,2002,838100,33,28,5,9
4,2002,838100,27,20,7,4
5,2002,838100,42,30,12,6
6,2002,838100,30,23,7,7
7,2002,838100,37,29,8,3
8,2002,838100,30,27,3,5
9,2002,838100,35,32,3,3
10,2002,838100,46,44,2,4
11,2002,838100,29,22,7,6
12,2002,838100,27,25,2,5
1,2003,838100,27,24,3,7
2,2003,838100,23,19,4,9
3,2003,838100,42,36,6,4
4,2003,838100,28,22,6,4
5,2003,838100,23,21,2,5
6,2003,838100,35,35,0,6
7,2003,838100,43,37,6,4
8,2003,838100,32,27,5,6
9,2003,838100,49,45,4,2
10,2003,838100,54,51,3,6
11,2003,838100,43,36,7,13
12,2003,838100,30,29,1,3
1,2004,838100,34,29,5,14
2,2004,838100,32,25,7,16
3,2004,838100,36,29,7,7
4,2004,838100,21,19,2,9
5,2004,838100,28,27,1,11
6,2004,838100,42,37,5,6
7,2004,838100,52,47,5,6
8,2004,838100,39,35,4,3
9,2004,838100,41,35,6,11
10,2004,838100,28,27,1,2
11,2004,838100,29,29,0,8
12,2004,838100,22,17,5,6
1,2005,838100,16,16,0,5
2,2005,838100,21,20,1,7
3,2005,838100,33,28,5,1
4,2005,838100,20,17,3,9
5,2005,838100,18,15,3,6
6,2005,838100,19,14,5,0
7,2005,838100,26,20,6,0
8,2005,838100,22,15,7,4
9,2005,838100,28,20,8,6
10,2005,838100,29,24,5,1
11,2005,838100,31,27,4,4
12,2005,838100,20,18,2,3
1,2006,838100,19,19,0,3
2,2006,838100,26,24,2,4
3,2006,838100,30,29,1,1
4,2006,838100,26,24,2,3
5,2006,838100,25,22,3,2
6,2006,838100,29,26,3,1
7,2006,838100,30,28,2,3
8,2006,838100,19,16,3,4
9,2006,838100,22,18,4,3
10,2006,838100,19,17,2,2
11,2006,838100,26,21,5,0
12,2006,838100,25,24,1,6
1,2007,838100,37,34,3,3
2,2007,838100,19,17,2,5
3,2007,838100,28,25,3,7
4,2007,838100,9,8,1,8
5,2007,838100,17,13,4,8
6,2007,838100,18,15,3,2
7,2007,838100,24,23,1,3
8,2007,838100,32,31,1,4
9,2007,838100,23,19,4,1
10,2007,838100,28,26,2,6
11,2007,838100,23,22,1,2
12,2007,838100,26,25,1,9
1,2008,838100,32,30,2,7
2,2008,838100,22,21,1,3
3,2008,838100,37,36,1,2
4,2008,838100,31,28,3,1
5,2008,838100,34,33,1,3
6,2008,838100,22,22,0,2
7,2008,838100,22,21,1,4
8,2008,838100,19,19,0,3
9,2008,838100,31,27,4,2
10,2008,838100,37,35,2,6
11,2008,838100,28,25,3,2
12,2008,838100,15,14,1,3
1,2009,838100,26,23,3,2
2,2009,838100,25,22,3,1
3,2009,838100,17,16,1,5
4,2009,838100,16,14,2,4
5,2009,838100,13,13,0,0
6,2009,838100,18,17,1,1
7,2009,838100,24,21,3,2
8,2009,838100,19,19,0,1
9,2009,838100,18,18,0,2
10,2009,838100,26,25,1,2
11,2009,838100,20,20,0,1
12,2009,838100,21,21,0,4
1,2010,838100,16,15,1,2
2,2010,838100,10,9,1,0
3,2010,838100,20,20,0,4
4,2010,838100,17,17,0,1
5,2010,838100,18,17,1,1
6,2010,838100,26,23,3,0
7,2010,838100,21,17,4,1
8,2010,838100,20,20,0,1
9,2010,838100,16,15,1,1
10,2010,838100,20,20,0,3
11,2010,838100,27,26,1,2
12,2010,838100,15,15,0,4
1,2011,838100,15,15,0,2
2,2011,838100,11,11,0,1
1,1999,280800,30,18,12,4
2,1999,280800,19,13,6,13
3,1999,280800,17,12,5,13
4,1999,280800,32,24,8,14
5,1999,280800,30,18,12,9
6,1999,280800,31,18,13,18
7,1999,280800,42,29,13,14
8,1999,280800,28,19,9,10
9,1999,280800,28,20,8,9
10,1999,280800,27,15,12,51
11,1999,280800,32,17,15,77
12,1999,280800,17,10,7,47
1,2000,280800,31,20,11,34
2,2000,280800,14,9,5,38
3,2000,280800,25,14,11,24
4,2000,280800,23,11,12,42
5,2000,280800,40,28,12,24
6,2000,280800,25,18,7,28
7,2000,280800,30,21,9,32
8,2000,280800,36,20,16,22
9,2000,280800,24,16,8,38
10,2000,280800,30,19,11,31
11,2000,280800,19,10,9,23
12,2000,280800,25,19,6,30
1,2001,280800,16,10,6,27
2,2001,280800,22,12,10,24
3,2001,280800,28,17,11,29
4,2001,280800,27,17,10,27
5,2001,280800,30,19,11,35
6,2001,280800,29,19,10,29
7,2001,280800,27,16,11,36
8,2001,280800,25,10,15,35
9,2001,280800,23,10,13,20
10,2001,280800,24,17,7,21
11,2001,280800,13,8,5,30
12,2001,280800,15,8,7,30
1,2002,280800,24,14,10,35
2,2002,280800,16,8,8,60
3,2002,280800,23,15,8,50
4,2002,280800,17,10,7,44
5,2002,280800,23,12,11,31
6,2002,280800,23,12,11,45
7,2002,280800,36,12,24,52
8,2002,280800,17,12,5,49
9,2002,280800,16,10,6,21
10,2002,280800,19,8,11,28
11,2002,280800,23,16,7,22
12,2002,280800,23,16,7,37
1,2003,280800,14,8,6,42
2,2003,280800,11,4,7,43
3,2003,280800,21,9,12,50
4,2003,280800,27,18,9,45
5,2003,280800,25,17,8,30
6,2003,280800,34,19,15,24
7,2003,280800,27,20,7,20
8,2003,280800,26,17,9,12
9,2003,280800,20,17,3,14
10,2003,280800,24,16,8,41
11,2003,280800,20,14,6,28
12,2003,280800,13,6,7,23
1,2004,280800,15,12,3,37
2,2004,280800,19,13,6,37
3,2004,280800,8,5,3,24
4,2004,280800,15,11,4,17
5,2004,280800,28,20,8,19
6,2004,280800,18,9,9,20
7,2004,280800,17,15,2,14
8,2004,280800,17,13,4,18
9,2004,280800,11,8,3,21
10,2004,280800,12,7,5,23
11,2004,280800,15,11,4,20
12,2004,280800,13,11,2,31
1,2005,280800,12,9,3,46
2,2005,280800,16,9,7,43
3,2005,280800,8,4,4,43
4,2005,280800,12,10,2,36
5,2005,280800,12,5,7,40
6,2005,280800,28,19,9,21
7,2005,280800,21,13,8,40
8,2005,280800,11,8,3,28
9,2005,280800,28,20,8,26
10,2005,280800,15,12,3,35
11,2005,280800,11,8,3,16
12,2005,280800,13,10,3,23
1,2006,280800,7,7,0,28
2,2006,280800,6,4,2,7
3,2006,280800,9,7,2,8
4,2006,280800,17,11,6,13
5,2006,280800,16,14,2,21
6,2006,280800,9,8,1,13
7,2006,280800,13,8,5,7
8,2006,280800,12,11,1,3
9,2006,280800,12,12,0,2
10,2006,280800,4,3,1,0
11,2006,280800,8,8,0,5
12,2006,280800,14,13,1,1
1,2007,280800,11,8,3,1
2,2007,280800,6,4,2,2
3,2007,280800,8,8,0,0
4,2007,280800,13,12,1,0
5,2007,280800,8,7,1,2
6,2007,280800,7,7,0,4
7,2007,280800,14,10,4,3
8,2007,280800,16,13,3,2
9,2007,280800,12,10,2,8
10,2007,280800,11,7,4,1
11,2007,280800,7,6,1,3
12,2007,280800,13,10,3,1
1,2008,280800,10,10,0,0
2,2008,280800,7,6,1,1
3,2008,280800,10,9,1,1
4,2008,280800,9,9,0,4
5,2008,280800,19,15,4,0
6,2008,280800,8,8,0,1
7,2008,280800,15,10,5,5
8,2008,280800,13,11,2,5
9,2008,280800,13,11,2,4
10,2008,280800,15,11,4,0
11,2008,280800,14,12,2,4
12,2008,280800,9,8,1,0
1,2009,280800,12,11,1,2
2,2009,280800,4,2,2,4
3,2009,280800,5,3,2,0
4,2009,280800,9,7,2,3
5,2009,280800,10,7,3,3
6,2009,280800,9,8,1,3
7,2009,280800,3,2,1,1
8,2009,280800,10,9,1,1
9,2009,280800,7,5,2,2
10,2009,280800,13,8,5,0
11,2009,280800,13,12,1,1
12,2009,280800,7,6,1,1
1,2010,280800,15,14,1,0
2,2010,280800,9,6,3,2
3,2010,280800,15,12,3,4
4,2010,280800,14,13,1,1
5,2010,280800,14,10,4,3
6,2010,280800,13,11,2,2
7,2010,280800,11,9,2,3
8,2010,280800,17,11,6,0
9,2010,280800,11,10,1,1
10,2010,280800,18,17,1,1
11,2010,280800,10,8,2,4
12,2010,280800,7,6,1,1
1,2011,280800,10,10,0,6
2,2011,280800,10,7,3,3
1,1999,280900,1,0,1,4
2,1999,280900,5,4,1,3
3,1999,280900,2,2,0,0
4,1999,280900,2,0,2,1
5,1999,280900,3,2,1,3
6,1999,280900,0,0,0,1
7,1999,280900,3,1,2,4
8,1999,280900,5,5,0,0
9,1999,280900,9,6,3,2
10,1999,280900,3,3,0,3
11,1999,280900,0,0,0,4
12,1999,280900,1,0,1,5
1,2000,280900,0,0,0,4
2,2000,280900,2,1,1,6
3,2000,280900,2,1,1,6
4,2000,280900,0,0,0,4
5,2000,280900,3,1,2,12
6,2000,280900,2,1,1,13
7,2000,280900,3,2,1,13
8,2000,280900,3,1,2,3
9,2000,280900,1,0,1,4
10,2000,280900,5,3,2,4
11,2000,280900,8,7,1,3
12,2000,280900,3,3,0,1
1,2001,280900,3,1,2,6
2,2001,280900,1,1,0,10
3,2001,280900,4,4,0,12
4,2001,280900,3,3,0,10
5,2001,280900,7,5,2,8
6,2001,280900,5,4,1,2
7,2001,280900,2,2,0,6
8,2001,280900,2,2,0,5
9,2001,280900,2,1,1,7
10,2001,280900,1,0,1,10
11,2001,280900,2,2,0,4
12,2001,280900,3,2,1,7
1,2002,280900,0,0,0,7
2,2002,280900,1,1,0,12
3,2002,280900,5,5,0,5
4,2002,280900,3,2,1,6
5,2002,280900,3,2,1,3
6,2002,280900,4,3,1,1
7,2002,280900,9,6,3,8
8,2002,280900,2,1,1,11
9,2002,280900,8,6,2,6
10,2002,280900,5,3,2,5
11,2002,280900,1,1,0,2
12,2002,280900,3,3,0,4
1,2003,280900,3,3,0,7
2,2003,280900,2,2,0,3
3,2003,280900,2,2,0,3
4,2003,280900,3,3,0,3
5,2003,280900,3,3,0,1
6,2003,280900,6,5,1,4
7,2003,280900,6,5,1,4
8,2003,280900,2,2,0,3
9,2003,280900,3,3,0,1
10,2003,280900,6,4,2,2
11,2003,280900,2,2,0,0
12,2003,280900,1,1,0,4
1,2004,280900,3,3,0,0
2,2004,280900,2,2,0,1
3,2004,280900,1,1,0,0
4,2004,280900,3,3,0,2
5,2004,280900,3,3,0,5
6,2004,280900,4,3,1,0
7,2004,280900,6,6,0,2
8,2004,280900,2,2,0,1
9,2004,280900,3,2,1,1
10,2004,280900,4,3,1,1
11,2004,280900,1,1,0,1
12,2004,280900,4,4,0,3
1,2005,280900,4,4,0,0
2,2005,280900,1,1,0,2
3,2005,280900,0,0,0,3
4,2005,280900,1,0,1,1
5,2005,280900,1,1,0,2
6,2005,280900,2,1,1,2
7,2005,280900,3,3,0,1
8,2005,280900,0,0,0,3
9,2005,280900,2,1,1,1
10,2005,280900,5,3,2,4
11,2005,280900,2,2,0,1
12,2005,280900,2,2,0,0
1,2006,280900,1,1,0,2
2,2006,280900,10,9,1,0
3,2006,280900,5,5,0,1
4,2006,280900,2,2,0,0
5,2006,280900,5,5,0,2
6,2006,280900,2,1,1,0
7,2006,280900,2,2,0,3
8,2006,280900,5,5,0,3
9,2006,280900,2,2,0,1
10,2006,280900,3,1,2,0
11,2006,280900,2,2,0,0
12,2006,280900,1,1,0,0
1,2007,280900,4,3,1,1
2,2007,280900,1,1,0,3
3,2007,280900,1,1,0,2
4,2007,280900,3,2,1,1
5,2007,280900,0,0,0,1
6,2007,280900,7,4,3,2
7,2007,280900,6,5,1,0
8,2007,280900,1,1,0,0
9,2007,280900,1,1,0,0
10,2007,280900,2,2,0,1
11,2007,280900,4,4,0,0
12,2007,280900,4,3,1,0
1,2008,280900,8,8,0,0
2,2008,280900,4,4,0,0
3,2008,280900,1,1,0,1
4,2008,280900,0,0,0,0
5,2008,280900,5,1,4,1
6,2008,280900,4,3,1,1
7,2008,280900,3,3,0,0
8,2008,280900,2,1,1,0
9,2008,280900,7,7,0,1
10,2008,280900,2,1,1,0
11,2008,280900,2,1,1,0
12,2008,280900,2,2,0,1
1,2009,280900,3,3,0,0
2,2009,280900,3,3,0,2
3,2009,280900,3,2,1,0
4,2009,280900,1,1,0,0
5,2009,280900,0,0,0,1
6,2009,280900,3,3,0,1
7,2009,280900,3,2,1,0
8,2009,280900,3,3,0,1
9,2009,280900,4,4,0,1
10,2009,280900,0,0,0,0
11,2009,280900,1,1,0,0
12,2009,280900,0,0,0,0
1,2010,280900,0,0,0,1
2,2010,280900,1,0,1,0
3,2010,280900,2,2,0,0
4,2010,280900,6,5,1,0
5,2010,280900,0,0,0,1
6,2010,280900,0,0,0,0
7,2010,280900,2,1,1,0
8,2010,280900,3,3,0,0
9,2010,280900,0,0,0,0
10,2010,280900,5,4,1,3
11,2010,280900,2,2,0,0
12,2010,280900,2,0,2,0
1,2011,280900,3,3,0,2
2,2011,280900,0,0,0,3
1,1999,833100,32,29,3,7
2,1999,833100,32,32,0,3
3,1999,833100,35,31,4,1
4,1999,833100,44,41,3,4
5,1999,833100,61,59,2,2
6,1999,833100,39,37,2,1
7,1999,833100,54,47,7,4
8,1999,833100,49,44,5,4
9,1999,833100,39,36,3,4
10,1999,833100,32,26,6,7
11,1999,833100,39,36,3,7
12,1999,833100,34,34,0,1
1,2000,833100,40,36,4,3
2,2000,833100,37,35,2,4
3,2000,833100,39,36,3,2
4,2000,833100,31,30,1,3
5,2000,833100,41,40,1,4
6,2000,833100,36,35,1,8
7,2000,833100,36,33,3,3
8,2000,833100,47,45,2,5
9,2000,833100,45,45,0,5
10,2000,833100,41,39,2,1
11,2000,833100,51,48,3,1
12,2000,833100,37,35,2,4
1,2001,833100,35,35,0,4
2,2001,833100,22,17,5,1
3,2001,833100,21,20,1,2
4,2001,833100,32,30,2,2
5,2001,833100,47,45,2,3
6,2001,833100,46,46,0,1
7,2001,833100,34,32,2,3
8,2001,833100,37,35,2,4
9,2001,833100,39,39,0,1
10,2001,833100,37,37,0,3
11,2001,833100,36,35,1,3
12,2001,833100,29,28,1,1
1,2002,833100,33,32,1,2
2,2002,833100,36,34,2,4
3,2002,833100,27,27,0,2
4,2002,833100,32,29,3,5
5,2002,833100,29,27,2,0
6,2002,833100,29,25,4,2
7,2002,833100,42,41,1,2
8,2002,833100,43,42,1,0
9,2002,833100,57,51,6,3
10,2002,833100,47,45,2,3
11,2002,833100,24,22,2,4
12,2002,833100,24,22,2,2
1,2003,833100,28,26,2,1
2,2003,833100,25,23,2,1
3,2003,833100,26,26,0,0
4,2003,833100,31,29,2,4
5,2003,833100,40,37,3,1
6,2003,833100,31,30,1,2
7,2003,833100,46,45,1,1
8,2003,833100,48,46,2,1
9,2003,833100,30,26,4,0
10,2003,833100,23,22,1,0
11,2003,833100,39,37,2,1
12,2003,833100,41,41,0,2
1,2004,833100,31,30,1,0
2,2004,833100,28,27,1,1
3,2004,833100,40,39,1,1
4,2004,833100,29,28,1,1
5,2004,833100,40,39,1,2
6,2004,833100,52,52,0,0
7,2004,833100,63,61,2,1
8,2004,833100,69,67,2,2
9,2004,833100,55,52,3,1
10,2004,833100,43,38,5,1
11,2004,833100,48,46,2,2
12,2004,833100,37,35,2,0
1,2005,833100,19,19,0,1
2,2005,833100,24,24,0,3
3,2005,833100,22,21,1,1
4,2005,833100,31,30,1,0
5,2005,833100,21,19,2,0
6,2005,833100,30,30,0,1
7,2005,833100,29,28,1,3
8,2005,833100,36,34,2,0
9,2005,833100,39,37,2,0
10,2005,833100,37,34,3,1
11,2005,833100,30,27,3,1
12,2005,833100,32,32,0,0
1,2006,833100,38,37,1,1
2,2006,833100,22,21,1,1
3,2006,833100,33,33,0,1
4,2006,833100,41,39,2,2
5,2006,833100,48,44,4,0
6,2006,833100,56,53,3,0
7,2006,833100,38,33,5,1
8,2006,833100,32,29,3,0
9,2006,833100,28,27,1,1
10,2006,833100,52,47,5,1
11,2006,833100,31,28,3,2
12,2006,833100,32,31,1,5
1,2007,833100,42,41,1,3
2,2007,833100,23,23,0,4
3,2007,833100,32,29,3,5
4,2007,833100,41,39,2,8
5,2007,833100,40,40,0,10
6,2007,833100,35,32,3,2
7,2007,833100,17,16,1,7
8,2007,833100,36,35,1,4
9,2007,833100,40,37,3,4
10,2007,833100,35,33,2,4
11,2007,833100,31,30,1,6
12,2007,833100,31,28,3,4
1,2008,833100,25,25,0,4
2,2008,833100,28,25,3,1
3,2008,833100,18,18,0,3
4,2008,833100,37,36,1,1
5,2008,833100,42,41,1,0
6,2008,833100,41,39,2,1
7,2008,833100,39,37,2,2
8,2008,833100,26,25,1,2
9,2008,833100,38,38,0,3
10,2008,833100,49,48,1,2
11,2008,833100,32,30,2,4
12,2008,833100,29,25,4,6
1,2009,833100,30,29,1,3
2,2009,833100,23,21,2,2
3,2009,833100,35,31,4,5
4,2009,833100,24,23,1,3
5,2009,833100,33,32,1,3
6,2009,833100,26,25,1,2
7,2009,833100,29,28,1,1
8,2009,833100,27,24,3,0
9,2009,833100,34,33,1,2
10,2009,833100,44,42,2,0
11,2009,833100,30,30,0,3
12,2009,833100,33,33,0,1
1,2010,833100,35,33,2,3
2,2010,833100,15,15,0,1
3,2010,833100,24,24,0,4
4,2010,833100,26,25,1,4
5,2010,833100,32,31,1,0
6,2010,833100,41,39,2,1
7,2010,833100,30,30,0,0
8,2010,833100,24,24,0,2
9,2010,833100,36,32,4,0
10,2010,833100,26,26,0,1
11,2010,833100,34,31,3,1
12,2010,833100,27,27,0,3
1,2011,833100,15,15,0,0
2,2011,833100,11,11,0,0
1,1999,281900,39,39,0,2
2,1999,281900,41,40,1,0
3,1999,281900,59,56,3,0
4,1999,281900,48,46,2,3
5,1999,281900,63,61,2,2
6,1999,281900,57,54,3,0
7,1999,281900,66,60,6,1
8,1999,281900,59,56,3,2
9,1999,281900,59,56,3,1
10,1999,281900,63,61,2,0
11,1999,281900,45,42,3,2
12,1999,281900,35,34,1,2
1,2000,281900,47,46,1,3
2,2000,281900,41,39,2,3
3,2000,281900,57,56,1,3
4,2000,281900,47,45,2,2
5,2000,281900,54,53,1,1
6,2000,281900,57,54,3,6
7,2000,281900,60,60,0,5
8,2000,281900,76,74,2,2
9,2000,281900,80,77,3,1
10,2000,281900,77,74,3,6
11,2000,281900,61,59,2,3
12,2000,281900,52,51,1,1
1,2001,281900,45,44,1,3
2,2001,281900,42,38,4,3
3,2001,281900,47,47,0,4
4,2001,281900,39,38,1,1
5,2001,281900,57,55,2,1
6,2001,281900,42,41,1,1
7,2001,281900,47,43,4,2
8,2001,281900,41,40,1,3
9,2001,281900,35,34,1,3
10,2001,281900,50,49,1,3
11,2001,281900,68,66,2,1
12,2001,281900,53,53,0,0
1,2002,281900,48,47,1,6
2,2002,281900,47,44,3,3
3,2002,281900,47,46,1,1
4,2002,281900,40,39,1,1
5,2002,281900,37,37,0,4
6,2002,281900,39,39,0,6
7,2002,281900,39,36,3,0
8,2002,281900,39,38,1,5
9,2002,281900,29,28,1,1
10,2002,281900,46,44,2,1
11,2002,281900,32,29,3,1
12,2002,281900,42,41,1,0
1,2003,281900,41,39,2,0
2,2003,281900,34,32,2,2
3,2003,281900,33,32,1,1
4,2003,281900,47,46,1,1
5,2003,281900,30,28,2,3
6,2003,281900,40,40,0,2
7,2003,281900,43,43,0,5
8,2003,281900,39,37,2,1
9,2003,281900,44,41,3,3
10,2003,281900,38,38,0,0
11,2003,281900,35,33,2,1
12,2003,281900,29,29,0,1
1,2004,281900,32,31,1,1
2,2004,281900,26,25,1,1
3,2004,281900,29,28,1,4
4,2004,281900,24,23,1,3
5,2004,281900,33,32,1,3
6,2004,281900,49,48,1,0
7,2004,281900,47,47,0,1
8,2004,281900,28,28,0,1
9,2004,281900,27,25,2,0
10,2004,281900,41,40,1,2
11,2004,281900,37,35,2,0
12,2004,281900,36,35,1,0
1,2005,281900,37,37,0,0
2,2005,281900,29,29,0,3
3,2005,281900,32,30,2,0
4,2005,281900,23,23,0,0
5,2005,281900,23,23,0,1
6,2005,281900,25,25,0,0
7,2005,281900,34,31,3,2
8,2005,281900,32,32,0,4
9,2005,281900,29,29,0,0
10,2005,281900,47,44,3,0
11,2005,281900,36,36,0,2
12,2005,281900,42,42,0,2
1,2006,281900,33,32,1,1
2,2006,281900,12,12,0,1
3,2006,281900,41,37,4,2
4,2006,281900,24,23,1,0
5,2006,281900,38,37,1,0
6,2006,281900,44,43,1,0
7,2006,281900,35,34,1,2
8,2006,281900,37,37,0,0
9,2006,281900,29,28,1,0
10,2006,281900,24,24,0,2
11,2006,281900,25,25,0,0
12,2006,281900,28,27,1,3
1,2007,281900,23,22,1,0
2,2007,281900,27,27,0,1
3,2007,281900,25,23,2,1
4,2007,281900,34,34,0,2
5,2007,281900,52,52,0,1
6,2007,281900,39,38,1,0
7,2007,281900,45,43,2,2
8,2007,281900,44,44,0,0
9,2007,281900,42,41,1,12
10,2007,281900,28,26,2,3
11,2007,281900,24,23,1,1
12,2007,281900,27,25,2,3
1,2008,281900,35,33,2,1
2,2008,281900,31,30,1,1
3,2008,281900,36,33,3,1
4,2008,281900,35,32,3,3
5,2008,281900,32,31,1,4
6,2008,281900,29,27,2,1
7,2008,281900,46,45,1,1
8,2008,281900,42,40,2,1
9,2008,281900,43,42,1,1
10,2008,281900,47,47,0,6
11,2008,281900,25,25,0,2
12,2008,281900,31,30,1,2
1,2009,281900,34,30,4,1
2,2009,281900,20,19,1,3
3,2009,281900,23,23,0,3
4,2009,281900,26,25,1,4
5,2009,281900,32,30,2,7
6,2009,281900,26,26,0,9
7,2009,281900,26,24,2,2
8,2009,281900,39,37,2,2
9,2009,281900,31,30,1,4
10,2009,281900,36,35,1,1
11,2009,281900,32,30,2,2
12,2009,281900,27,24,3,1
1,2010,281900,37,34,3,0
2,2010,281900,20,20,0,3
3,2010,281900,21,21,0,0
4,2010,281900,36,35,1,3
5,2010,281900,39,39,0,3
6,2010,281900,47,46,1,0
7,2010,281900,39,35,4,5
8,2010,281900,49,48,1,5
9,2010,281900,50,48,2,1
10,2010,281900,35,34,1,3
11,2010,281900,31,31,0,1
12,2010,281900,35,32,3,1
1,2011,281900,30,27,3,5
2,2011,281900,19,19,0,5
1,1999,252000,27,24,3,27
2,1999,252000,18,14,4,60
3,1999,252000,29,27,2,21
4,1999,252000,21,14,7,27
5,1999,252000,27,21,6,18
6,1999,252000,29,25,4,30
7,1999,252000,36,23,13,19
8,1999,252000,27,16,11,13
9,1999,252000,17,13,4,15
10,1999,252000,35,27,8,19
11,1999,252000,17,9,8,17
12,1999,252000,25,19,6,24
1,2000,252000,26,21,5,15
2,2000,252000,22,20,2,11
3,2000,252000,22,17,5,13
4,2000,252000,25,22,3,12
5,2000,252000,28,23,5,14
6,2000,252000,18,17,1,14
7,2000,252000,28,24,4,8
8,2000,252000,26,22,4,31
9,2000,252000,27,26,1,18
10,2000,252000,21,17,4,14
11,2000,252000,18,12,6,20
12,2000,252000,16,15,1,23
1,2001,252000,21,17,4,24
2,2001,252000,7,6,1,18
3,2001,252000,23,19,4,20
4,2001,252000,29,22,7,21
5,2001,252000,26,22,4,20
6,2001,252000,29,24,5,13
7,2001,252000,31,25,6,19
8,2001,252000,26,24,2,18
9,2001,252000,27,22,5,25
10,2001,252000,27,22,5,29
11,2001,252000,30,23,7,19
12,2001,252000,25,23,2,21
1,2002,252000,20,17,3,16
2,2002,252000,13,10,3,17
3,2002,252000,21,18,3,7
4,2002,252000,16,15,1,8
5,2002,252000,22,19,3,16
6,2002,252000,15,10,5,8
7,2002,252000,29,26,3,11
8,2002,252000,23,21,2,11
9,2002,252000,24,22,2,10
10,2002,252000,25,21,4,8
11,2002,252000,22,19,3,12
12,2002,252000,26,23,3,13
1,2003,252000,10,10,0,14
2,2003,252000,15,13,2,18
3,2003,252000,15,11,4,16
4,2003,252000,17,13,4,13
5,2003,252000,10,8,2,22
6,2003,252000,29,24,5,24
7,2003,252000,20,17,3,11
8,2003,252000,10,8,2,18
9,2003,252000,19,17,2,7
10,2003,252000,25,21,4,32
11,2003,252000,24,22,2,7
12,2003,252000,17,14,3,2
1,2004,252000,20,17,3,3
2,2004,252000,11,10,1,10
3,2004,252000,16,12,4,17
4,2004,252000,13,9,4,6
5,2004,252000,23,18,5,10
6,2004,252000,29,26,3,5
7,2004,252000,26,22,4,30
8,2004,252000,24,21,3,8
9,2004,252000,26,25,1,14
10,2004,252000,37,34,3,7
11,2004,252000,17,14,3,5
12,2004,252000,22,18,4,10
1,2005,252000,15,13,2,11
2,2005,252000,18,17,1,9
3,2005,252000,21,14,7,18
4,2005,252000,8,7,1,10
5,2005,252000,16,14,2,8
6,2005,252000,28,25,3,5
7,2005,252000,30,25,5,14
8,2005,252000,27,25,2,7
9,2005,252000,24,23,1,13
10,2005,252000,43,40,3,13
11,2005,252000,19,16,3,5
12,2005,252000,23,21,2,10
1,2006,252000,20,18,2,6
2,2006,252000,18,15,3,10
3,2006,252000,15,12,3,7
4,2006,252000,19,14,5,2
5,2006,252000,14,12,2,12
6,2006,252000,19,14,5,4
7,2006,252000,14,12,2,11
8,2006,252000,15,13,2,13
9,2006,252000,24,22,2,10
10,2006,252000,19,13,6,17
11,2006,252000,12,10,2,20
12,2006,252000,14,14,0,6
1,2007,252000,15,15,0,3
2,2007,252000,16,14,2,3
3,2007,252000,25,21,4,13
4,2007,252000,23,19,4,19
5,2007,252000,23,19,4,10
6,2007,252000,17,15,2,10
7,2007,252000,18,15,3,17
8,2007,252000,16,11,5,13
9,2007,252000,25,21,4,16
10,2007,252000,16,10,6,14
11,2007,252000,16,12,4,4
12,2007,252000,21,21,0,3
1,2008,252000,11,11,0,4
2,2008,252000,9,6,3,3
3,2008,252000,13,12,1,0
4,2008,252000,17,13,4,4
5,2008,252000,21,16,5,3
6,2008,252000,40,26,14,5
7,2008,252000,27,23,4,6
8,2008,252000,20,17,3,9
9,2008,252000,26,23,3,7
10,2008,252000,17,17,0,6
11,2008,252000,28,23,5,11
12,2008,252000,18,16,2,12
1,2009,252000,17,14,3,7
2,2009,252000,15,13,2,5
3,2009,252000,20,17,3,8
4,2009,252000,23,20,3,7
5,2009,252000,29,24,5,8
6,2009,252000,21,19,2,9
7,2009,252000,16,12,4,3
8,2009,252000,34,29,5,5
9,2009,252000,47,45,2,3
10,2009,252000,32,31,1,4
11,2009,252000,27,21,6,8
12,2009,252000,10,10,0,5
1,2010,252000,17,15,2,4
2,2010,252000,14,11,3,11
3,2010,252000,9,8,1,13
4,2010,252000,14,11,3,3
5,2010,252000,21,19,2,10
6,2010,252000,27,23,4,2
7,2010,252000,16,14,2,4
8,2010,252000,25,22,3,3
9,2010,252000,23,19,4,5
10,2010,252000,26,24,2,2
11,2010,252000,26,25,1,7
12,2010,252000,12,10,2,4
1,2011,252000,15,12,3,0
2,2011,252000,6,6,0,1
1,1999,251800,39,31,8,44
2,1999,251800,39,34,5,42
3,1999,251800,43,36,7,45
4,1999,251800,54,38,16,27
5,1999,251800,60,45,15,44
6,1999,251800,45,35,10,56
7,1999,251800,66,42,24,74
8,1999,251800,49,39,10,27
9,1999,251800,39,34,5,26
10,1999,251800,46,38,8,25
11,1999,251800,42,33,9,20
12,1999,251800,42,34,8,32
1,2000,251800,42,38,4,34
2,2000,251800,28,22,6,32
3,2000,251800,49,37,12,66
4,2000,251800,46,31,15,42
5,2000,251800,50,33,17,47
6,2000,251800,36,25,11,59
7,2000,251800,53,38,15,53
8,2000,251800,39,22,17,57
9,2000,251800,53,38,15,66
10,2000,251800,43,35,8,35
11,2000,251800,30,27,3,31
12,2000,251800,37,30,7,39
1,2001,251800,37,30,7,53
2,2001,251800,35,28,7,56
3,2001,251800,39,29,10,51
4,2001,251800,36,27,9,48
5,2001,251800,42,35,7,39
6,2001,251800,46,38,8,50
7,2001,251800,47,28,19,54
8,2001,251800,53,32,21,36
9,2001,251800,48,31,17,40
10,2001,251800,43,34,9,30
11,2001,251800,53,41,12,54
12,2001,251800,40,33,7,65
1,2002,251800,41,30,11,49
2,2002,251800,37,28,9,48
3,2002,251800,29,20,9,60
4,2002,251800,50,37,13,79
5,2002,251800,55,44,11,46
6,2002,251800,67,56,11,42
7,2002,251800,55,37,18,90
8,2002,251800,54,47,7,48
9,2002,251800,52,42,10,36
10,2002,251800,49,39,10,47
11,2002,251800,38,32,6,33
12,2002,251800,33,25,8,55
1,2003,251800,35,30,5,29
2,2003,251800,37,33,4,45
3,2003,251800,35,24,11,28
4,2003,251800,35,28,7,33
5,2003,251800,42,32,10,26
6,2003,251800,47,38,9,21
7,2003,251800,40,29,11,28
8,2003,251800,56,50,6,34
9,2003,251800,42,32,10,60
10,2003,251800,50,36,14,51
11,2003,251800,34,27,7,157
12,2003,251800,44,31,13,26
1,2004,251800,32,24,8,56
2,2004,251800,33,23,10,49
3,2004,251800,38,34,4,56
4,2004,251800,32,24,8,42
5,2004,251800,49,41,8,25
6,2004,251800,38,28,10,41
7,2004,251800,49,38,11,62
8,2004,251800,61,51,10,46
9,2004,251800,52,43,9,60
10,2004,251800,64,50,14,37
11,2004,251800,31,23,8,45
12,2004,251800,48,38,10,81
1,2005,251800,41,33,8,58
2,2005,251800,23,16,7,38
3,2005,251800,45,37,8,68
4,2005,251800,45,34,11,55
5,2005,251800,46,38,8,57
6,2005,251800,49,41,8,89
7,2005,251800,56,35,21,75
8,2005,251800,59,47,12,56
9,2005,251800,53,43,10,149
10,2005,251800,55,43,12,45
11,2005,251800,40,34,6,30
12,2005,251800,48,41,7,93
1,2006,251800,53,39,14,88
2,2006,251800,36,32,4,77
3,2006,251800,61,50,11,103
4,2006,251800,48,37,11,140
5,2006,251800,48,36,12,185
6,2006,251800,69,56,13,96
7,2006,251800,60,48,12,84
8,2006,251800,60,46,14,130
9,2006,251800,49,34,15,141
10,2006,251800,55,38,17,144
11,2006,251800,52,43,9,144
12,2006,251800,36,28,8,93
1,2007,251800,51,42,9,71
2,2007,251800,27,22,5,44
3,2007,251800,37,31,6,123
4,2007,251800,41,36,5,50
5,2007,251800,51,41,10,57
6,2007,251800,43,27,16,52
7,2007,251800,48,39,9,73
8,2007,251800,60,45,15,50
9,2007,251800,46,36,10,41
10,2007,251800,55,45,10,68
11,2007,251800,42,30,12,48
12,2007,251800,41,28,13,44
1,2008,251800,42,29,13,67
2,2008,251800,22,20,2,44
3,2008,251800,49,36,13,59
4,2008,251800,55,41,14,38
5,2008,251800,55,48,7,30
6,2008,251800,56,44,12,31
7,2008,251800,47,38,9,59
8,2008,251800,52,42,10,41
9,2008,251800,65,53,12,35
10,2008,251800,46,35,11,40
11,2008,251800,30,20,10,53
12,2008,251800,35,34,1,45
1,2009,251800,39,35,4,60
2,2009,251800,28,22,6,41
3,2009,251800,41,32,9,82
4,2009,251800,46,37,9,37
5,2009,251800,56,48,8,40
6,2009,251800,51,37,14,32
7,2009,251800,43,31,12,21
8,2009,251800,56,40,16,40
9,2009,251800,48,33,15,48
10,2009,251800,48,38,10,61
11,2009,251800,45,37,8,50
12,2009,251800,43,34,9,59
1,2010,251800,31,25,6,44
2,2010,251800,40,34,6,59
3,2010,251800,35,27,8,51
4,2010,251800,55,48,7,49
5,2010,251800,63,53,10,57
6,2010,251800,66,55,11,67
7,2010,251800,56,45,11,68
8,2010,251800,38,29,9,67
9,2010,251800,40,36,4,49
10,2010,251800,48,36,12,54
11,2010,251800,55,45,10,43
12,2010,251800,36,33,3,48
1,2011,251800,33,27,6,70
2,2011,251800,17,15,2,36
1,1999,260400,16,15,1,15
2,1999,260400,8,6,2,5
3,1999,260400,16,14,2,6
4,1999,260400,13,9,4,14
5,1999,260400,22,14,8,9
6,1999,260400,22,20,2,7
7,1999,260400,13,11,2,2
8,1999,260400,23,16,7,4
9,1999,260400,16,13,3,3
10,1999,260400,15,15,0,7
11,1999,260400,10,7,3,7
12,1999,260400,16,14,2,4
1,2000,260400,19,14,5,5
2,2000,260400,9,6,3,11
3,2000,260400,17,15,2,16
4,2000,260400,16,11,5,7
5,2000,260400,5,4,1,4
6,2000,260400,11,9,2,4
7,2000,260400,9,7,2,6
8,2000,260400,15,11,4,7
9,2000,260400,11,9,2,7
10,2000,260400,10,6,4,7
11,2000,260400,5,4,1,10
12,2000,260400,2,1,1,8
1,2001,260400,1,0,1,12
2,2001,260400,8,6,2,2
3,2001,260400,14,11,3,18
4,2001,260400,11,10,1,17
5,2001,260400,11,9,2,11
6,2001,260400,10,10,0,8
7,2001,260400,13,10,3,6
8,2001,260400,11,10,1,10
9,2001,260400,16,12,4,14
10,2001,260400,13,8,5,16
11,2001,260400,14,14,0,20
12,2001,260400,13,11,2,16
1,2002,260400,10,6,4,11
2,2002,260400,8,8,0,10
3,2002,260400,9,8,1,13
4,2002,260400,9,9,0,7
5,2002,260400,11,9,2,7
6,2002,260400,12,10,2,5
7,2002,260400,11,8,3,4
8,2002,260400,12,9,3,2
9,2002,260400,21,18,3,1
10,2002,260400,15,11,4,2
11,2002,260400,12,8,4,4
12,2002,260400,10,9,1,2
1,2003,260400,3,2,1,3
2,2003,260400,6,4,2,6
3,2003,260400,7,5,2,6
4,2003,260400,5,5,0,3
5,2003,260400,14,9,5,3
6,2003,260400,9,9,0,9
7,2003,260400,14,12,2,11
8,2003,260400,10,8,2,13
9,2003,260400,9,7,2,15
10,2003,260400,14,13,1,10
11,2003,260400,7,6,1,6
12,2003,260400,5,4,1,8
1,2004,260400,3,3,0,5
2,2004,260400,5,5,0,5
3,2004,260400,15,12,3,5
4,2004,260400,11,10,1,8
5,2004,260400,6,6,0,2
6,2004,260400,9,9,0,2
7,2004,260400,10,9,1,6
8,2004,260400,11,8,3,3
9,2004,260400,8,7,1,9
10,2004,260400,16,14,2,23
11,2004,260400,13,10,3,3
12,2004,260400,10,6,4,3
1,2005,260400,6,4,2,4
2,2005,260400,7,5,2,4
3,2005,260400,7,5,2,9
4,2005,260400,16,11,5,7
5,2005,260400,9,6,3,7
6,2005,260400,11,7,4,2
7,2005,260400,8,6,2,4
8,2005,260400,11,7,4,3
9,2005,260400,10,10,0,6
10,2005,260400,10,7,3,4
11,2005,260400,10,9,1,7
12,2005,260400,12,8,4,6
1,2006,260400,10,10,0,8
2,2006,260400,9,7,2,6
3,2006,260400,8,8,0,5
4,2006,260400,13,10,3,4
5,2006,260400,17,15,2,9
6,2006,260400,10,8,2,5
7,2006,260400,13,12,1,4
8,2006,260400,19,17,2,0
9,2006,260400,11,9,2,9
10,2006,260400,12,12,0,38
11,2006,260400,16,16,0,7
12,2006,260400,16,10,6,12
1,2007,260400,11,8,3,2
2,2007,260400,12,12,0,6
3,2007,260400,10,7,3,11
4,2007,260400,14,13,1,6
5,2007,260400,12,11,1,12
6,2007,260400,16,11,5,8
7,2007,260400,12,12,0,21
8,2007,260400,14,11,3,10
9,2007,260400,10,8,2,10
10,2007,260400,14,12,2,16
11,2007,260400,8,7,1,3
12,2007,260400,7,7,0,6
1,2008,260400,7,5,2,6
2,2008,260400,9,9,0,5
3,2008,260400,9,8,1,2
4,2008,260400,11,9,2,3
5,2008,260400,5,4,1,2
6,2008,260400,10,9,1,3
7,2008,260400,9,7,2,5
8,2008,260400,9,9,0,14
9,2008,260400,17,13,4,11
10,2008,260400,8,6,2,6
11,2008,260400,5,4,1,5
12,2008,260400,5,3,2,5
1,2009,260400,1,1,0,4
2,2009,260400,5,2,3,7
3,2009,260400,11,8,3,10
4,2009,260400,8,4,4,4
5,2009,260400,5,5,0,1
6,2009,260400,7,5,2,2
7,2009,260400,15,14,1,1
8,2009,260400,5,5,0,4
9,2009,260400,11,11,0,5
10,2009,260400,3,3,0,2
11,2009,260400,13,11,2,2
12,2009,260400,5,5,0,5
1,2010,260400,8,7,1,1
2,2010,260400,6,6,0,3
3,2010,260400,3,3,0,7
4,2010,260400,11,8,3,5
5,2010,260400,11,9,2,6
6,2010,260400,9,8,1,7
7,2010,260400,9,9,0,10
8,2010,260400,17,16,1,8
9,2010,260400,6,5,1,11
10,2010,260400,15,12,3,5
11,2010,260400,9,8,1,5
12,2010,260400,9,9,0,5
1,2011,260400,9,7,2,3
2,2011,260400,4,3,1,2
1,1999,260300,15,10,5,40
2,1999,260300,16,13,3,45
3,1999,260300,15,10,5,37
4,1999,260300,18,10,8,34
5,1999,260300,18,14,4,19
6,1999,260300,13,11,2,89
7,1999,260300,14,10,4,23
8,1999,260300,15,9,6,14
9,1999,260300,17,10,7,20
10,1999,260300,15,12,3,29
11,1999,260300,6,3,3,34
12,1999,260300,16,13,3,20
1,2000,260300,15,11,4,18
2,2000,260300,10,6,4,21
3,2000,260300,27,21,6,20
4,2000,260300,16,12,4,23
5,2000,260300,14,6,8,17
6,2000,260300,23,17,6,12
7,2000,260300,17,8,9,9
8,2000,260300,20,14,6,14
9,2000,260300,18,11,7,12
10,2000,260300,10,5,5,9
11,2000,260300,12,7,5,8
12,2000,260300,18,13,5,10
1,2001,260300,6,6,0,22
2,2001,260300,12,8,4,13
3,2001,260300,15,12,3,11
4,2001,260300,17,15,2,13
5,2001,260300,11,7,4,16
6,2001,260300,20,18,2,7
7,2001,260300,20,13,7,12
8,2001,260300,13,7,6,7
9,2001,260300,13,8,5,6
10,2001,260300,16,6,10,8
11,2001,260300,8,4,4,5
12,2001,260300,9,7,2,11
1,2002,260300,14,8,6,6
2,2002,260300,12,8,4,8
3,2002,260300,6,4,2,5
4,2002,260300,11,10,1,11
5,2002,260300,15,13,2,9
6,2002,260300,21,13,8,10
7,2002,260300,11,7,4,9
8,2002,260300,9,5,4,6
9,2002,260300,14,12,2,4
10,2002,260300,11,7,4,6
11,2002,260300,9,8,1,2
12,2002,260300,9,8,1,4
1,2003,260300,7,6,1,9
2,2003,260300,15,13,2,10
3,2003,260300,14,9,5,5
4,2003,260300,15,12,3,8
5,2003,260300,16,11,5,7
6,2003,260300,11,10,1,3
7,2003,260300,16,12,4,4
8,2003,260300,10,9,1,6
9,2003,260300,18,17,1,2
10,2003,260300,17,13,4,7
11,2003,260300,10,8,2,4
12,2003,260300,10,7,3,9
1,2004,260300,8,6,2,8
2,2004,260300,16,12,4,5
3,2004,260300,13,10,3,4
4,2004,260300,14,11,3,17
5,2004,260300,16,13,3,7
6,2004,260300,16,12,4,15
7,2004,260300,13,12,1,7
8,2004,260300,23,15,8,22
9,2004,260300,16,16,0,30
10,2004,260300,15,13,2,21
11,2004,260300,24,18,6,19
12,2004,260300,8,6,2,10
1,2005,260300,8,7,1,29
2,2005,260300,11,10,1,21
3,2005,260300,12,9,3,16
4,2005,260300,17,13,4,11
5,2005,260300,15,10,5,74
6,2005,260300,17,14,3,16
7,2005,260300,15,11,4,51
8,2005,260300,14,10,4,17
9,2005,260300,19,13,6,9
10,2005,260300,15,10,5,21
11,2005,260300,8,7,1,19
12,2005,260300,10,8,2,20
1,2006,260300,11,8,3,14
2,2006,260300,7,6,1,13
3,2006,260300,8,6,2,20
4,2006,260300,25,21,4,16
5,2006,260300,15,14,1,19
6,2006,260300,17,17,0,17
7,2006,260300,33,28,5,7
8,2006,260300,20,17,3,15
9,2006,260300,17,16,1,13
10,2006,260300,14,10,4,13
11,2006,260300,18,12,6,20
12,2006,260300,11,11,0,8
1,2007,260300,11,9,2,32
2,2007,260300,11,8,3,10
3,2007,260300,20,18,2,14
4,2007,260300,9,7,2,10
5,2007,260300,13,12,1,8
6,2007,260300,16,13,3,12
7,2007,260300,18,16,2,9
8,2007,260300,11,9,2,4
9,2007,260300,21,17,4,6
10,2007,260300,19,14,5,5
11,2007,260300,18,14,4,4
12,2007,260300,6,4,2,4
1,2008,260300,10,7,3,6
2,2008,260300,11,9,2,9
3,2008,260300,10,9,1,7
4,2008,260300,11,11,0,6
5,2008,260300,11,9,2,3
6,2008,260300,16,11,5,4
7,2008,260300,19,15,4,8
8,2008,260300,21,15,6,6
9,2008,260300,17,16,1,4
10,2008,260300,14,10,4,8
11,2008,260300,18,14,4,12
12,2008,260300,9,8,1,11
1,2009,260300,7,7,0,9
2,2009,260300,9,5,4,10
3,2009,260300,11,7,4,4
4,2009,260300,14,12,2,6
5,2009,260300,13,9,4,5
6,2009,260300,12,11,1,9
7,2009,260300,14,9,5,3
8,2009,260300,10,5,5,9
9,2009,260300,11,10,1,10
10,2009,260300,9,8,1,10
11,2009,260300,15,9,6,17
12,2009,260300,21,19,2,17
1,2010,260300,11,10,1,28
2,2010,260300,7,7,0,11
3,2010,260300,5,4,1,34
4,2010,260300,15,11,4,22
5,2010,260300,5,3,2,12
6,2010,260300,11,10,1,7
7,2010,260300,16,16,0,15
8,2010,260300,19,15,4,14
9,2010,260300,16,10,6,16
10,2010,260300,15,12,3,5
11,2010,260300,12,11,1,7
12,2010,260300,13,11,2,6
1,2011,260300,12,10,2,17
2,2011,260300,7,6,1,6
1,1999,260100,30,27,3,20
2,1999,260100,38,33,5,15
3,1999,260100,34,29,5,25
4,1999,260100,40,29,11,26
5,1999,260100,39,35,4,20
6,1999,260100,45,32,13,11
7,1999,260100,57,38,19,17
8,1999,260100,38,33,5,13
9,1999,260100,46,44,2,27
10,1999,260100,41,35,6,39
11,1999,260100,34,28,6,35
12,1999,260100,28,24,4,21
1,2000,260100,32,26,6,23
2,2000,260100,32,29,3,25
3,2000,260100,41,35,6,15
4,2000,260100,32,27,5,17
5,2000,260100,29,23,6,18
6,2000,260100,51,40,11,35
7,2000,260100,43,34,9,33
8,2000,260100,47,36,11,23
9,2000,260100,33,30,3,15
10,2000,260100,47,31,16,23
11,2000,260100,39,31,8,33
12,2000,260100,39,34,5,37
1,2001,260100,31,28,3,16
2,2001,260100,21,19,2,20
3,2001,260100,32,27,5,16
4,2001,260100,42,35,7,18
5,2001,260100,37,29,8,18
6,2001,260100,43,34,9,22
7,2001,260100,31,23,8,16
8,2001,260100,39,33,6,24
9,2001,260100,32,26,6,11
10,2001,260100,40,34,6,8
11,2001,260100,36,31,5,23
12,2001,260100,32,25,7,35
1,2002,260100,27,26,1,25
2,2002,260100,36,28,8,26
3,2002,260100,35,30,5,15
4,2002,260100,28,21,7,10
5,2002,260100,41,35,6,13
6,2002,260100,37,29,8,8
7,2002,260100,49,40,9,17
8,2002,260100,36,33,3,17
9,2002,260100,29,22,7,16
10,2002,260100,40,32,8,10
11,2002,260100,34,29,5,12
12,2002,260100,33,25,8,4
1,2003,260100,29,25,4,13
2,2003,260100,33,27,6,12
3,2003,260100,37,27,10,13
4,2003,260100,38,29,9,8
5,2003,260100,35,27,8,13
6,2003,260100,38,30,8,17
7,2003,260100,39,33,6,16
8,2003,260100,39,34,5,26
9,2003,260100,32,23,9,16
10,2003,260100,36,31,5,11
11,2003,260100,28,25,3,23
12,2003,260100,44,39,5,7
1,2004,260100,27,26,1,18
2,2004,260100,25,23,2,16
3,2004,260100,25,21,4,34
4,2004,260100,37,29,8,29
5,2004,260100,45,37,8,36
6,2004,260100,35,30,5,12
7,2004,260100,40,37,3,13
8,2004,260100,43,38,5,12
9,2004,260100,41,33,8,16
10,2004,260100,38,33,5,15
11,2004,260100,41,35,6,8
12,2004,260100,35,26,9,14
1,2005,260100,37,34,3,24
2,2005,260100,23,20,3,33
3,2005,260100,36,29,7,36
4,2005,260100,14,10,4,24
5,2005,260100,45,35,10,35
6,2005,260100,27,25,2,42
7,2005,260100,37,30,7,41
8,2005,260100,34,28,6,18
9,2005,260100,26,24,2,19
10,2005,260100,31,24,7,26
11,2005,260100,29,26,3,22
12,2005,260100,37,33,4,25
1,2006,260100,30,27,3,27
2,2006,260100,32,29,3,21
3,2006,260100,31,28,3,48
4,2006,260100,36,34,2,16
5,2006,260100,52,44,8,15
6,2006,260100,45,40,5,14
7,2006,260100,34,28,6,16
8,2006,260100,26,23,3,13
9,2006,260100,28,26,2,15
10,2006,260100,27,25,2,20
11,2006,260100,24,23,1,9
12,2006,260100,42,36,6,19
1,2007,260100,27,25,2,19
2,2007,260100,26,24,2,15
3,2007,260100,32,29,3,53
4,2007,260100,37,29,8,18
5,2007,260100,25,25,0,12
6,2007,260100,27,23,4,16
7,2007,260100,43,39,4,22
8,2007,260100,26,22,4,19
9,2007,260100,27,27,0,12
10,2007,260100,26,21,5,27
11,2007,260100,31,30,1,20
12,2007,260100,32,31,1,25
1,2008,260100,23,21,2,23
2,2008,260100,19,16,3,6
3,2008,260100,29,26,3,15
4,2008,260100,28,23,5,21
5,2008,260100,34,30,4,15
6,2008,260100,25,21,4,7
7,2008,260100,36,32,4,15
8,2008,260100,26,22,4,22
9,2008,260100,32,25,7,20
10,2008,260100,36,36,0,14
11,2008,260100,24,19,5,17
12,2008,260100,15,15,0,13
1,2009,260100,13,12,1,24
2,2009,260100,24,19,5,25
3,2009,260100,22,18,4,42
4,2009,260100,21,17,4,19
5,2009,260100,28,25,3,21
6,2009,260100,25,19,6,26
7,2009,260100,33,26,7,17
8,2009,260100,31,29,2,39
9,2009,260100,38,34,4,35
10,2009,260100,21,21,0,27
11,2009,260100,23,20,3,19
12,2009,260100,20,20,0,19
1,2010,260100,26,25,1,29
2,2010,260100,9,6,3,20
3,2010,260100,16,13,3,38
4,2010,260100,28,25,3,42
5,2010,260100,29,27,2,22
6,2010,260100,20,15,5,19
7,2010,260100,35,32,3,15
8,2010,260100,37,34,3,27
9,2010,260100,21,18,3,26
10,2010,260100,26,24,2,12
11,2010,260100,20,18,2,14
12,2010,260100,25,23,2,15
1,2011,260100,22,18,4,10
2,2011,260100,13,12,1,10
1,1999,836900,7,2,5,7
2,1999,836900,10,7,3,10
3,1999,836900,17,13,4,5
4,1999,836900,9,9,0,7
5,1999,836900,9,6,3,2
6,1999,836900,10,9,1,3
7,1999,836900,11,9,2,3
8,1999,836900,16,8,8,2
9,1999,836900,8,4,4,6
10,1999,836900,5,4,1,2
11,1999,836900,13,8,5,6
12,1999,836900,12,9,3,6
1,2000,836900,9,8,1,1
2,2000,836900,9,7,2,8
3,2000,836900,7,5,2,7
4,2000,836900,7,2,5,2
5,2000,836900,7,5,2,10
6,2000,836900,8,4,4,2
7,2000,836900,11,8,3,4
8,2000,836900,16,15,1,3
9,2000,836900,11,9,2,6
10,2000,836900,16,10,6,6
11,2000,836900,9,7,2,2
12,2000,836900,9,4,5,3
1,2001,836900,7,6,1,8
2,2001,836900,9,5,4,6
3,2001,836900,8,7,1,4
4,2001,836900,10,7,3,4
5,2001,836900,13,10,3,5
6,2001,836900,17,11,6,7
7,2001,836900,12,8,4,3
8,2001,836900,8,7,1,0
9,2001,836900,15,10,5,3
10,2001,836900,10,9,1,8
11,2001,836900,12,10,2,7
12,2001,836900,9,6,3,13
1,2002,836900,2,1,1,12
2,2002,836900,6,5,1,6
3,2002,836900,4,4,0,15
4,2002,836900,18,14,4,15
5,2002,836900,8,6,2,8
6,2002,836900,12,9,3,2
7,2002,836900,8,4,4,7
8,2002,836900,8,7,1,10
9,2002,836900,18,13,5,9
10,2002,836900,10,8,2,4
11,2002,836900,7,5,2,12
12,2002,836900,6,5,1,15
1,2003,836900,4,4,0,20
2,2003,836900,6,5,1,9
3,2003,836900,8,6,2,11
4,2003,836900,11,8,3,10
5,2003,836900,8,7,1,6
6,2003,836900,12,6,6,7
7,2003,836900,11,5,6,0
8,2003,836900,9,7,2,6
9,2003,836900,2,2,0,9
10,2003,836900,10,9,1,6
11,2003,836900,3,3,0,7
12,2003,836900,8,4,4,9
1,2004,836900,8,6,2,6
2,2004,836900,11,8,3,16
3,2004,836900,7,4,3,9
4,2004,836900,11,8,3,10
5,2004,836900,10,7,3,7
6,2004,836900,6,4,2,7
7,2004,836900,11,10,1,14
8,2004,836900,16,14,2,13
9,2004,836900,9,7,2,6
10,2004,836900,15,12,3,8
11,2004,836900,6,5,1,9
12,2004,836900,11,10,1,7
1,2005,836900,2,2,0,1
2,2005,836900,6,5,1,3
3,2005,836900,5,4,1,1
4,2005,836900,8,5,3,3
5,2005,836900,16,11,5,9
6,2005,836900,11,8,3,5
7,2005,836900,16,14,2,4
8,2005,836900,8,6,2,2
9,2005,836900,12,9,3,9
10,2005,836900,9,7,2,6
11,2005,836900,7,6,1,3
12,2005,836900,11,10,1,7
1,2006,836900,8,6,2,3
2,2006,836900,6,4,2,0
3,2006,836900,7,5,2,1
4,2006,836900,9,8,1,8
5,2006,836900,10,7,3,4
6,2006,836900,13,10,3,2
7,2006,836900,11,10,1,1
8,2006,836900,16,12,4,3
9,2006,836900,5,3,2,1
10,2006,836900,11,8,3,3
11,2006,836900,15,14,1,6
12,2006,836900,11,10,1,6
1,2007,836900,9,8,1,3
2,2007,836900,9,5,4,4
3,2007,836900,9,7,2,8
4,2007,836900,7,6,1,2
5,2007,836900,7,6,1,2
6,2007,836900,12,11,1,4
7,2007,836900,7,7,0,3
8,2007,836900,8,6,2,3
9,2007,836900,12,10,2,6
10,2007,836900,12,11,1,2
11,2007,836900,9,7,2,2
12,2007,836900,9,7,2,2
1,2008,836900,10,9,1,3
2,2008,836900,6,6,0,4
3,2008,836900,4,3,1,2
4,2008,836900,10,9,1,7
5,2008,836900,13,11,2,4
6,2008,836900,12,9,3,2
7,2008,836900,8,7,1,4
8,2008,836900,17,15,2,6
9,2008,836900,6,4,2,1
10,2008,836900,11,9,2,2
11,2008,836900,12,11,1,3
12,2008,836900,7,6,1,2
1,2009,836900,5,4,1,4
2,2009,836900,8,8,0,3
3,2009,836900,13,8,5,1
4,2009,836900,6,5,1,3
5,2009,836900,9,5,4,2
6,2009,836900,7,6,1,7
7,2009,836900,10,8,2,6
8,2009,836900,7,3,4,2
9,2009,836900,8,6,2,3
10,2009,836900,8,5,3,4
11,2009,836900,12,7,5,9
12,2009,836900,5,5,0,6
1,2010,836900,6,6,0,2
2,2010,836900,7,4,3,6
3,2010,836900,5,4,1,3
4,2010,836900,7,4,3,6
5,2010,836900,10,10,0,0
6,2010,836900,6,4,2,3
7,2010,836900,10,6,4,2
8,2010,836900,5,4,1,4
9,2010,836900,7,4,3,1
10,2010,836900,6,4,2,1
11,2010,836900,5,5,0,6
12,2010,836900,4,3,1,2
1,2011,836900,7,4,3,3
2,2011,836900,1,1,0,1
1,1999,837800,35,29,6,6
2,1999,837800,25,21,4,14
3,1999,837800,44,33,11,13
4,1999,837800,39,33,6,15
5,1999,837800,39,32,7,15
6,1999,837800,39,35,4,13
7,1999,837800,42,32,10,21
8,1999,837800,40,33,7,12
9,1999,837800,26,23,3,15
10,1999,837800,43,36,7,15
11,1999,837800,27,22,5,10
12,1999,837800,31,26,5,23
1,2000,837800,31,25,6,12
2,2000,837800,19,15,4,7
3,2000,837800,22,21,1,12
4,2000,837800,22,19,3,14
5,2000,837800,25,20,5,16
6,2000,837800,28,22,6,10
7,2000,837800,31,24,7,3
8,2000,837800,41,35,6,9
9,2000,837800,30,25,5,7
10,2000,837800,35,28,7,18
11,2000,837800,29,25,4,17
12,2000,837800,22,19,3,10
1,2001,837800,26,22,4,14
2,2001,837800,22,18,4,9
3,2001,837800,17,13,4,28
4,2001,837800,35,28,7,17
5,2001,837800,33,28,5,11
6,2001,837800,26,20,6,16
7,2001,837800,27,20,7,16
8,2001,837800,46,35,11,11
9,2001,837800,29,23,6,11
10,2001,837800,42,38,4,9
11,2001,837800,31,30,1,17
12,2001,837800,46,42,4,9
1,2002,837800,45,36,9,8
2,2002,837800,35,28,7,11
3,2002,837800,39,32,7,6
4,2002,837800,44,36,8,15
5,2002,837800,40,28,12,9
6,2002,837800,45,40,5,9
7,2002,837800,63,49,14,10
8,2002,837800,49,43,6,14
9,2002,837800,34,25,9,12
10,2002,837800,50,47,3,5
11,2002,837800,45,41,4,16
12,2002,837800,41,40,1,6
1,2003,837800,40,36,4,12
2,2003,837800,41,35,6,8
3,2003,837800,41,36,5,14
4,2003,837800,40,37,3,14
5,2003,837800,46,41,5,11
6,2003,837800,44,40,4,15
7,2003,837800,46,37,9,20
8,2003,837800,66,59,7,14
9,2003,837800,58,52,6,10
10,2003,837800,45,40,5,20
11,2003,837800,44,37,7,5
12,2003,837800,37,34,3,11
1,2004,837800,35,32,3,7
2,2004,837800,25,18,7,9
3,2004,837800,35,28,7,12
4,2004,837800,29,21,8,20
5,2004,837800,31,27,4,11
6,2004,837800,44,38,6,7
7,2004,837800,39,33,6,8
8,2004,837800,45,40,5,18
9,2004,837800,41,36,5,15
10,2004,837800,37,32,5,15
11,2004,837800,42,36,6,10
12,2004,837800,28,24,4,10
1,2005,837800,24,23,1,12
2,2005,837800,22,18,4,6
3,2005,837800,25,22,3,17
4,2005,837800,31,27,4,8
5,2005,837800,44,40,4,12
6,2005,837800,43,42,1,13
7,2005,837800,43,40,3,7
8,2005,837800,29,24,5,24
9,2005,837800,31,26,5,15
10,2005,837800,32,29,3,19
11,2005,837800,22,22,0,12
12,2005,837800,22,19,3,9
1,2006,837800,47,40,7,9
2,2006,837800,25,18,7,10
3,2006,837800,25,22,3,6
4,2006,837800,32,30,2,17
5,2006,837800,42,34,8,16
6,2006,837800,28,26,2,9
7,2006,837800,30,21,9,12
8,2006,837800,35,30,5,6
9,2006,837800,39,35,4,4
10,2006,837800,49,37,12,8
11,2006,837800,34,27,7,15
12,2006,837800,36,31,5,4
1,2007,837800,28,24,4,14
2,2007,837800,12,11,1,12
3,2007,837800,24,20,4,9
4,2007,837800,26,23,3,14
5,2007,837800,31,27,4,5
6,2007,837800,28,23,5,14
7,2007,837800,37,31,6,10
8,2007,837800,43,37,6,15
9,2007,837800,25,20,5,9
10,2007,837800,38,34,4,9
11,2007,837800,31,29,2,4
12,2007,837800,34,30,4,11
1,2008,837800,30,27,3,11
2,2008,837800,18,18,0,9
3,2008,837800,30,24,6,9
4,2008,837800,40,33,7,8
5,2008,837800,32,27,5,9
6,2008,837800,29,27,2,8
7,2008,837800,39,31,8,18
8,2008,837800,50,48,2,16
9,2008,837800,42,38,4,11
10,2008,837800,34,29,5,4
11,2008,837800,28,27,1,6
12,2008,837800,24,23,1,4
1,2009,837800,28,24,4,5
2,2009,837800,22,20,2,12
3,2009,837800,31,27,4,4
4,2009,837800,25,24,1,3
5,2009,837800,24,21,3,6
6,2009,837800,21,14,7,11
7,2009,837800,34,30,4,8
8,2009,837800,32,31,1,8
9,2009,837800,35,33,2,12
10,2009,837800,36,33,3,12
11,2009,837800,42,40,2,7
12,2009,837800,25,25,0,8
1,2010,837800,33,32,1,5
2,2010,837800,17,16,1,5
3,2010,837800,22,18,4,9
4,2010,837800,27,25,2,9
5,2010,837800,42,37,5,7
6,2010,837800,33,32,1,5
7,2010,837800,22,21,1,4
8,2010,837800,24,24,0,10
9,2010,837800,31,28,3,5
10,2010,837800,32,31,1,11
11,2010,837800,26,25,1,7
12,2010,837800,21,19,2,9
1,2011,837800,18,17,1,5
2,2011,837800,18,17,1,7
1,1999,833000,68,66,2,3
2,1999,833000,58,51,7,3
3,1999,833000,93,87,6,6
4,1999,833000,95,89,6,1
5,1999,833000,114,109,5,1
6,1999,833000,76,71,5,5
7,1999,833000,66,59,7,5
8,1999,833000,74,68,6,4
9,1999,833000,74,67,7,8
10,1999,833000,73,68,5,5
11,1999,833000,70,67,3,4
12,1999,833000,57,53,4,9
1,2000,833000,60,57,3,12
2,2000,833000,63,56,7,6
3,2000,833000,78,70,8,3
4,2000,833000,60,52,8,5
5,2000,833000,64,59,5,1
6,2000,833000,77,74,3,1
7,2000,833000,89,83,6,7
8,2000,833000,87,81,6,7
9,2000,833000,77,73,4,20
10,2000,833000,87,82,5,23
11,2000,833000,74,71,3,4
12,2000,833000,53,50,3,3
1,2001,833000,60,60,0,8
2,2001,833000,51,47,4,8
3,2001,833000,60,57,3,3
4,2001,833000,58,53,5,7
5,2001,833000,55,52,3,7
6,2001,833000,53,50,3,7
7,2001,833000,69,64,5,2
8,2001,833000,73,68,5,11
9,2001,833000,98,94,4,7
10,2001,833000,73,67,6,8
11,2001,833000,63,60,3,3
12,2001,833000,52,49,3,6
1,2002,833000,67,61,6,4
2,2002,833000,54,52,2,10
3,2002,833000,64,56,8,17
4,2002,833000,50,47,3,9
5,2002,833000,61,56,5,2
6,2002,833000,69,67,2,2
7,2002,833000,76,74,2,6
8,2002,833000,75,74,1,2
9,2002,833000,78,76,2,4
10,2002,833000,75,71,4,3
11,2002,833000,74,67,7,4
12,2002,833000,60,57,3,1
1,2003,833000,50,48,2,2
2,2003,833000,34,29,5,5
3,2003,833000,53,46,7,6
4,2003,833000,56,52,4,5
5,2003,833000,60,56,4,3
6,2003,833000,67,62,5,6
7,2003,833000,92,90,2,1
8,2003,833000,87,81,6,2
9,2003,833000,77,75,2,1
10,2003,833000,73,65,8,1
11,2003,833000,65,63,2,4
12,2003,833000,76,76,0,3
1,2004,833000,62,59,3,2
2,2004,833000,31,27,4,0
3,2004,833000,70,64,6,1
4,2004,833000,57,56,1,1
5,2004,833000,57,48,9,4
6,2004,833000,84,81,3,1
7,2004,833000,98,94,4,3
8,2004,833000,91,89,2,2
9,2004,833000,76,74,2,4
10,2004,833000,86,84,2,0
11,2004,833000,81,73,8,7
12,2004,833000,75,73,2,3
1,2005,833000,62,60,2,1
2,2005,833000,79,73,6,4
3,2005,833000,66,62,4,7
4,2005,833000,58,55,3,6
5,2005,833000,48,45,3,8
6,2005,833000,59,56,3,5
7,2005,833000,51,47,4,2
8,2005,833000,65,59,6,4
9,2005,833000,59,52,7,5
10,2005,833000,74,71,3,3
11,2005,833000,60,52,8,5
12,2005,833000,64,56,8,4
1,2006,833000,68,65,3,1
2,2006,833000,39,36,3,6
3,2006,833000,62,60,2,3
4,2006,833000,91,86,5,1
5,2006,833000,69,68,1,4
6,2006,833000,60,54,6,1
7,2006,833000,78,76,2,1
8,2006,833000,63,61,2,3
9,2006,833000,59,58,1,2
10,2006,833000,61,57,4,4
11,2006,833000,53,52,1,8
12,2006,833000,44,36,8,3
1,2007,833000,74,69,5,4
2,2007,833000,52,50,2,2
3,2007,833000,46,42,4,1
4,2007,833000,50,47,3,1
5,2007,833000,48,45,3,4
6,2007,833000,65,64,1,2
7,2007,833000,48,44,4,3
8,2007,833000,62,55,7,5
9,2007,833000,63,60,3,2
10,2007,833000,81,80,1,6
11,2007,833000,52,50,2,3
12,2007,833000,56,53,3,2
1,2008,833000,50,49,1,4
2,2008,833000,38,34,4,4
3,2008,833000,44,42,2,4
4,2008,833000,63,60,3,6
5,2008,833000,59,57,2,2
6,2008,833000,63,60,3,3
7,2008,833000,83,81,2,4
8,2008,833000,73,67,6,8
9,2008,833000,60,57,3,4
10,2008,833000,78,74,4,4
11,2008,833000,68,66,2,1
12,2008,833000,52,50,2,1
1,2009,833000,51,47,4,3
2,2009,833000,54,51,3,2
3,2009,833000,47,44,3,3
4,2009,833000,39,38,1,2
5,2009,833000,59,57,2,1
6,2009,833000,51,46,5,0
7,2009,833000,66,61,5,2
8,2009,833000,50,49,1,1
9,2009,833000,62,59,3,3
10,2009,833000,62,61,1,2
11,2009,833000,64,63,1,1
12,2009,833000,55,54,1,5
1,2010,833000,56,54,2,2
2,2010,833000,31,31,0,0
3,2010,833000,47,45,2,3
4,2010,833000,52,50,2,2
5,2010,833000,64,60,4,2
6,2010,833000,45,45,0,4
7,2010,833000,74,68,6,3
8,2010,833000,67,66,1,2
9,2010,833000,40,39,1,7
10,2010,833000,58,52,6,3
11,2010,833000,59,58,1,5
12,2010,833000,46,43,3,2
1,2011,833000,56,52,4,0
2,2011,833000,36,31,5,1
1,1999,836800,14,9,5,10
2,1999,836800,12,6,6,9
3,1999,836800,15,10,5,12
4,1999,836800,23,19,4,13
5,1999,836800,19,10,9,6
6,1999,836800,21,16,5,12
7,1999,836800,21,9,12,5
8,1999,836800,20,16,4,5
9,1999,836800,16,10,6,12
10,1999,836800,15,12,3,18
11,1999,836800,13,8,5,13
12,1999,836800,19,13,6,12
1,2000,836800,15,12,3,16
2,2000,836800,14,10,4,14
3,2000,836800,18,15,3,25
4,2000,836800,13,7,6,8
5,2000,836800,23,13,10,10
6,2000,836800,17,10,7,10
7,2000,836800,24,18,6,11
8,2000,836800,21,15,6,4
9,2000,836800,19,13,6,13
10,2000,836800,13,8,5,10
11,2000,836800,16,14,2,8
12,2000,836800,13,6,7,8
1,2001,836800,14,10,4,8
2,2001,836800,17,13,4,7
3,2001,836800,17,10,7,11
4,2001,836800,11,10,1,10
5,2001,836800,21,12,9,8
6,2001,836800,23,17,6,4
7,2001,836800,10,6,4,8
8,2001,836800,21,15,6,7
9,2001,836800,12,11,1,12
10,2001,836800,21,14,7,13
11,2001,836800,21,17,4,15
12,2001,836800,23,20,3,13
1,2002,836800,14,10,4,14
2,2002,836800,18,15,3,9
3,2002,836800,19,15,4,13
4,2002,836800,26,17,9,7
5,2002,836800,28,21,7,14
6,2002,836800,29,17,12,19
7,2002,836800,18,12,6,11
8,2002,836800,31,25,6,17
9,2002,836800,32,28,4,11
10,2002,836800,28,24,4,13
11,2002,836800,19,12,7,18
12,2002,836800,13,10,3,21
1,2003,836800,14,11,3,52
2,2003,836800,14,9,5,30
3,2003,836800,13,10,3,28
4,2003,836800,17,13,4,20
5,2003,836800,16,12,4,6
6,2003,836800,14,11,3,10
7,2003,836800,30,22,8,9
8,2003,836800,28,22,6,23
9,2003,836800,25,20,5,22
10,2003,836800,28,25,3,11
11,2003,836800,20,19,1,14
12,2003,836800,9,7,2,14
1,2004,836800,17,14,3,17
2,2004,836800,12,9,3,18
3,2004,836800,13,9,4,27
4,2004,836800,13,11,2,16
5,2004,836800,20,12,8,8
6,2004,836800,18,15,3,80
7,2004,836800,18,15,3,32
8,2004,836800,32,28,4,11
9,2004,836800,32,25,7,25
10,2004,836800,37,27,10,18
11,2004,836800,18,16,2,21
12,2004,836800,21,19,2,27
1,2005,836800,28,23,5,45
2,2005,836800,11,10,1,75
3,2005,836800,15,12,3,20
4,2005,836800,23,16,7,24
5,2005,836800,19,15,4,25
6,2005,836800,19,15,4,35
7,2005,836800,21,15,6,30
8,2005,836800,25,22,3,20
9,2005,836800,17,12,5,29
10,2005,836800,19,15,4,23
11,2005,836800,19,14,5,23
12,2005,836800,19,15,4,23
1,2006,836800,21,16,5,24
2,2006,836800,21,18,3,25
3,2006,836800,18,13,5,18
4,2006,836800,15,11,4,27
5,2006,836800,16,12,4,20
6,2006,836800,18,16,2,25
7,2006,836800,25,20,5,48
8,2006,836800,27,24,3,26
9,2006,836800,22,19,3,16
10,2006,836800,20,18,2,17
11,2006,836800,20,18,2,12
12,2006,836800,17,16,1,10
1,2007,836800,23,20,3,12
2,2007,836800,11,10,1,15
3,2007,836800,20,15,5,21
4,2007,836800,14,11,3,16
5,2007,836800,21,13,8,5
6,2007,836800,31,25,6,21
7,2007,836800,26,22,4,12
8,2007,836800,24,18,6,16
9,2007,836800,19,16,3,17
10,2007,836800,24,18,6,14
11,2007,836800,14,13,1,5
12,2007,836800,18,16,2,12
1,2008,836800,19,14,5,10
2,2008,836800,10,7,3,18
3,2008,836800,8,7,1,15
4,2008,836800,15,11,4,11
5,2008,836800,22,21,1,6
6,2008,836800,19,14,5,7
7,2008,836800,31,23,8,9
8,2008,836800,26,21,5,10
9,2008,836800,26,20,6,16
10,2008,836800,31,22,9,12
11,2008,836800,22,17,5,18
12,2008,836800,23,18,5,11
1,2009,836800,16,15,1,29
2,2009,836800,19,17,2,12
3,2009,836800,23,20,3,19
4,2009,836800,19,16,3,14
5,2009,836800,17,11,6,11
6,2009,836800,27,22,5,12
7,2009,836800,35,28,7,17
8,2009,836800,29,25,4,9
9,2009,836800,22,19,3,13
10,2009,836800,23,18,5,25
11,2009,836800,17,16,1,12
12,2009,836800,9,8,1,14
1,2010,836800,17,14,3,10
2,2010,836800,17,14,3,6
3,2010,836800,18,15,3,9
4,2010,836800,19,15,4,16
5,2010,836800,26,21,5,10
6,2010,836800,19,16,3,10
7,2010,836800,19,14,5,7
8,2010,836800,33,29,4,10
9,2010,836800,20,19,1,17
10,2010,836800,21,16,5,13
11,2010,836800,13,13,0,11
12,2010,836800,17,12,5,5
1,2011,836800,17,15,2,7
2,2011,836800,7,7,0,5
1,1999,280100,37,35,2,1
2,1999,280100,33,31,2,0
3,1999,280100,40,39,1,0
4,1999,280100,49,46,3,1
5,1999,280100,70,68,2,1
6,1999,280100,43,40,3,0
7,1999,280100,53,51,2,1
8,1999,280100,63,61,2,1
9,1999,280100,45,41,4,0
10,1999,280100,51,50,1,0
11,1999,280100,35,34,1,2
12,1999,280100,35,33,2,1
1,2000,280100,58,57,1,0
2,2000,280100,43,40,3,0
3,2000,280100,54,53,1,2
4,2000,280100,55,53,2,3
5,2000,280100,40,38,2,1
6,2000,280100,44,39,5,2
7,2000,280100,61,58,3,2
8,2000,280100,58,56,2,1
9,2000,280100,54,49,5,2
10,2000,280100,54,50,4,2
11,2000,280100,47,47,0,3
12,2000,280100,39,38,1,5
1,2001,280100,35,35,0,0
2,2001,280100,26,24,2,0
3,2001,280100,39,38,1,1
4,2001,280100,40,39,1,0
5,2001,280100,43,42,1,0
6,2001,280100,24,24,0,1
7,2001,280100,44,42,2,1
8,2001,280100,51,49,2,0
9,2001,280100,40,37,3,0
10,2001,280100,39,39,0,1
11,2001,280100,42,42,0,1
12,2001,280100,45,45,0,0
1,2002,280100,37,37,0,0
2,2002,280100,38,38,0,1
3,2002,280100,32,31,1,1
4,2002,280100,27,25,2,0
5,2002,280100,40,40,0,0
6,2002,280100,24,23,1,1
7,2002,280100,39,37,2,1
8,2002,280100,30,29,1,1
9,2002,280100,36,35,1,1
10,2002,280100,31,29,2,0
11,2002,280100,25,25,0,1
12,2002,280100,30,30,0,0
1,2003,280100,29,28,1,1
2,2003,280100,33,33,0,0
3,2003,280100,35,35,0,2
4,2003,280100,44,44,0,1
5,2003,280100,35,35,0,1
6,2003,280100,47,45,2,1
7,2003,280100,37,35,2,3
8,2003,280100,48,47,1,1
9,2003,280100,44,42,2,0
10,2003,280100,35,33,2,0
11,2003,280100,48,46,2,0
12,2003,280100,40,39,1,0
1,2004,280100,28,27,1,0
2,2004,280100,33,31,2,2
3,2004,280100,34,34,0,0
4,2004,280100,30,30,0,1
5,2004,280100,39,38,1,2
6,2004,280100,46,45,1,2
7,2004,280100,44,43,1,0
8,2004,280100,59,59,0,1
9,2004,280100,45,44,1,2
10,2004,280100,58,56,2,2
11,2004,280100,43,42,1,0
12,2004,280100,37,36,1,1
1,2005,280100,44,44,0,1
2,2005,280100,35,35,0,0
3,2005,280100,25,24,1,1
4,2005,280100,31,30,1,1
5,2005,280100,31,30,1,0
6,2005,280100,38,34,4,6
7,2005,280100,31,28,3,4
8,2005,280100,38,38,0,3
9,2005,280100,23,22,1,1
10,2005,280100,46,44,2,1
11,2005,280100,32,32,0,1
12,2005,280100,38,37,1,1
1,2006,280100,32,32,0,0
2,2006,280100,33,32,1,0
3,2006,280100,31,31,0,0
4,2006,280100,38,37,1,0
5,2006,280100,37,36,1,0
6,2006,280100,44,43,1,3
7,2006,280100,34,33,1,0
8,2006,280100,42,42,0,2
9,2006,280100,38,33,5,0
10,2006,280100,45,44,1,0
11,2006,280100,20,20,0,0
12,2006,280100,32,31,1,0
1,2007,280100,34,34,0,0
2,2007,280100,35,35,0,3
3,2007,280100,42,41,1,3
4,2007,280100,48,44,4,1
5,2007,280100,47,44,3,3
6,2007,280100,42,41,1,5
7,2007,280100,33,30,3,0
8,2007,280100,34,29,5,1
9,2007,280100,50,48,2,1
10,2007,280100,37,36,1,0
11,2007,280100,30,28,2,3
12,2007,280100,26,24,2,1
1,2008,280100,37,35,2,0
2,2008,280100,27,25,2,0
3,2008,280100,31,31,0,1
4,2008,280100,38,37,1,0
5,2008,280100,45,45,0,0
6,2008,280100,46,45,1,0
7,2008,280100,44,44,0,2
8,2008,280100,32,29,3,0
9,2008,280100,47,46,1,0
10,2008,280100,46,46,0,0
11,2008,280100,38,37,1,1
12,2008,280100,34,33,1,0
1,2009,280100,34,34,0,0
2,2009,280100,38,34,4,0
3,2009,280100,27,27,0,3
4,2009,280100,35,34,1,0
5,2009,280100,39,37,2,3
6,2009,280100,41,40,1,1
7,2009,280100,29,28,1,2
8,2009,280100,37,36,1,0
9,2009,280100,41,41,0,1
10,2009,280100,38,38,0,0
11,2009,280100,44,44,0,0
12,2009,280100,32,31,1,0
1,2010,280100,36,36,0,0
2,2010,280100,21,20,1,1
3,2010,280100,27,26,1,0
4,2010,280100,24,23,1,2
5,2010,280100,25,23,2,3
6,2010,280100,47,47,0,1
7,2010,280100,35,35,0,3
8,2010,280100,53,53,0,0
9,2010,280100,52,51,1,0
10,2010,280100,33,32,1,0
11,2010,280100,34,34,0,0
12,2010,280100,28,28,0,0
1,2011,280100,46,43,3,1
2,2011,280100,27,24,3,0
1,1999,260200,9,6,3,27
2,1999,260200,3,1,2,34
3,1999,260200,13,8,5,33
4,1999,260200,14,10,4,25
5,1999,260200,14,6,8,25
6,1999,260200,18,13,5,15
7,1999,260200,19,13,6,8
8,1999,260200,12,11,1,9
9,1999,260200,20,12,8,14
10,1999,260200,9,6,3,16
11,1999,260200,6,4,2,54
12,1999,260200,16,13,3,52
1,2000,260200,14,13,1,24
2,2000,260200,13,10,3,13
3,2000,260200,18,15,3,11
4,2000,260200,24,15,9,15
5,2000,260200,10,6,4,20
6,2000,260200,10,8,2,24
7,2000,260200,21,14,7,14
8,2000,260200,15,10,5,18
9,2000,260200,8,5,3,15
10,2000,260200,12,11,1,21
11,2000,260200,8,6,2,10
12,2000,260200,12,12,0,18
1,2001,260200,10,8,2,24
2,2001,260200,8,4,4,19
3,2001,260200,16,15,1,19
4,2001,260200,10,9,1,18
5,2001,260200,12,8,4,13
6,2001,260200,18,12,6,4
7,2001,260200,9,6,3,11
8,2001,260200,15,13,2,11
9,2001,260200,11,8,3,14
10,2001,260200,9,8,1,10
11,2001,260200,4,4,0,16
12,2001,260200,11,7,4,12
1,2002,260200,9,6,3,18
2,2002,260200,14,11,3,9
3,2002,260200,13,10,3,25
4,2002,260200,10,8,2,13
5,2002,260200,8,5,3,17
6,2002,260200,17,7,10,15
7,2002,260200,6,3,3,12
8,2002,260200,10,5,5,11
9,2002,260200,14,8,6,5
10,2002,260200,15,12,3,9
11,2002,260200,7,6,1,7
12,2002,260200,12,9,3,9
1,2003,260200,12,8,4,15
2,2003,260200,4,2,2,16
3,2003,260200,9,5,4,6
4,2003,260200,15,12,3,20
5,2003,260200,16,8,8,8
6,2003,260200,14,12,2,2
7,2003,260200,12,9,3,13
8,2003,260200,7,6,1,13
9,2003,260200,11,10,1,9
10,2003,260200,16,12,4,6
11,2003,260200,18,13,5,19
12,2003,260200,13,9,4,10
1,2004,260200,8,4,4,12
2,2004,260200,9,7,2,13
3,2004,260200,10,7,3,11
4,2004,260200,10,9,1,18
5,2004,260200,13,10,3,10
6,2004,260200,19,10,9,14
7,2004,260200,12,7,5,23
8,2004,260200,18,15,3,10
9,2004,260200,10,9,1,135
10,2004,260200,10,8,2,31
11,2004,260200,21,18,3,16
12,2004,260200,16,12,4,26
1,2005,260200,12,10,2,33
2,2005,260200,4,2,2,12
3,2005,260200,8,6,2,24
4,2005,260200,17,13,4,19
5,2005,260200,10,10,0,24
6,2005,260200,8,7,1,11
7,2005,260200,15,13,2,30
8,2005,260200,16,13,3,17
9,2005,260200,17,13,4,23
10,2005,260200,16,12,4,23
11,2005,260200,12,10,2,27
12,2005,260200,12,11,1,197
1,2006,260200,9,7,2,71
2,2006,260200,11,10,1,23
3,2006,260200,10,6,4,23
4,2006,260200,16,8,8,21
5,2006,260200,13,10,3,50
6,2006,260200,15,13,2,23
7,2006,260200,11,7,4,33
8,2006,260200,16,11,5,10
9,2006,260200,10,9,1,18
10,2006,260200,17,15,2,14
11,2006,260200,10,9,1,26
12,2006,260200,5,5,0,61
1,2007,260200,8,7,1,28
2,2007,260200,6,5,1,5
3,2007,260200,12,9,3,27
4,2007,260200,12,9,3,48
5,2007,260200,13,11,2,10
6,2007,260200,8,8,0,14
7,2007,260200,12,11,1,15
8,2007,260200,17,8,9,12
9,2007,260200,20,15,5,18
10,2007,260200,10,8,2,19
11,2007,260200,10,10,0,18
12,2007,260200,7,4,3,5
1,2008,260200,9,8,1,16
2,2008,260200,9,7,2,6
3,2008,260200,13,12,1,5
4,2008,260200,13,11,2,1
5,2008,260200,17,9,8,2
6,2008,260200,11,9,2,2
7,2008,260200,15,11,4,4
8,2008,260200,12,11,1,8
9,2008,260200,16,14,2,8
10,2008,260200,12,11,1,6
11,2008,260200,15,10,5,5
12,2008,260200,11,10,1,10
1,2009,260200,9,6,3,7
2,2009,260200,4,3,1,6
3,2009,260200,12,6,6,2
4,2009,260200,15,10,5,8
5,2009,260200,12,9,3,4
6,2009,260200,8,3,5,5
7,2009,260200,9,5,4,1
8,2009,260200,3,3,0,9
9,2009,260200,9,7,2,9
10,2009,260200,6,6,0,1
11,2009,260200,15,12,3,2
12,2009,260200,12,7,5,12
1,2010,260200,6,5,1,8
2,2010,260200,11,9,2,7
3,2010,260200,8,7,1,4
4,2010,260200,8,8,0,22
5,2010,260200,11,9,2,13
6,2010,260200,15,13,2,13
7,2010,260200,6,6,0,13
8,2010,260200,17,14,3,15
9,2010,260200,16,16,0,15
10,2010,260200,9,7,2,11
11,2010,260200,7,5,2,9
12,2010,260200,7,6,1,15
1,2011,260200,8,6,2,15
2,2011,260200,6,5,1,6
1,1999,251900,63,48,15,79
2,1999,251900,49,38,11,65
3,1999,251900,50,40,10,67
4,1999,251900,44,32,12,119
5,1999,251900,46,40,6,102
6,1999,251900,53,37,16,62
7,1999,251900,47,36,11,76
8,1999,251900,48,27,21,72
9,1999,251900,43,26,17,69
10,1999,251900,32,25,7,50
11,1999,251900,41,24,17,61
12,1999,251900,41,32,9,47
1,2000,251900,43,36,7,66
2,2000,251900,37,30,7,78
3,2000,251900,50,34,16,162
4,2000,251900,51,40,11,43
5,2000,251900,57,45,12,51
6,2000,251900,48,38,10,49
7,2000,251900,36,31,5,63
8,2000,251900,53,36,17,63
9,2000,251900,59,45,14,51
10,2000,251900,48,39,9,88
11,2000,251900,46,35,11,86
12,2000,251900,28,21,7,75
1,2001,251900,35,23,12,90
2,2001,251900,29,19,10,128
3,2001,251900,45,32,13,94
4,2001,251900,27,21,6,66
5,2001,251900,43,26,17,68
6,2001,251900,30,24,6,59
7,2001,251900,44,34,10,63
8,2001,251900,40,32,8,50
9,2001,251900,46,35,11,50
10,2001,251900,35,20,15,56
11,2001,251900,29,23,6,65
12,2001,251900,34,27,7,74
1,2002,251900,48,32,16,72
2,2002,251900,25,14,11,96
3,2002,251900,33,27,6,106
4,2002,251900,39,26,13,84
5,2002,251900,39,24,15,163
6,2002,251900,39,30,9,39
7,2002,251900,30,23,7,43
8,2002,251900,44,33,11,52
9,2002,251900,34,26,8,44
10,2002,251900,48,32,16,61
11,2002,251900,54,44,10,52
12,2002,251900,37,24,13,49
1,2003,251900,36,28,8,90
2,2003,251900,37,31,6,79
3,2003,251900,45,29,16,59
4,2003,251900,51,47,4,46
5,2003,251900,50,43,7,51
6,2003,251900,55,40,15,30
7,2003,251900,54,39,15,51
8,2003,251900,44,32,12,79
9,2003,251900,51,44,7,76
10,2003,251900,52,42,10,109
11,2003,251900,36,30,6,60
12,2003,251900,36,26,10,70
1,2004,251900,31,26,5,51
2,2004,251900,37,34,3,69
3,2004,251900,35,22,13,74
4,2004,251900,41,33,8,41
5,2004,251900,52,39,13,50
6,2004,251900,32,22,10,74
7,2004,251900,44,35,9,51
8,2004,251900,38,31,7,59
9,2004,251900,44,36,8,51
10,2004,251900,48,39,9,50
11,2004,251900,55,44,11,39
12,2004,251900,33,28,5,36
1,2005,251900,47,43,4,67
2,2005,251900,37,26,11,102
3,2005,251900,45,33,12,110
4,2005,251900,27,22,5,46
5,2005,251900,36,27,9,31
6,2005,251900,32,23,9,49
7,2005,251900,51,41,10,46
8,2005,251900,40,33,7,38
9,2005,251900,44,38,6,45
10,2005,251900,44,39,5,42
11,2005,251900,27,24,3,31
12,2005,251900,29,25,4,62
1,2006,251900,30,24,6,66
2,2006,251900,25,21,4,51
3,2006,251900,26,21,5,30
4,2006,251900,31,23,8,34
5,2006,251900,39,27,12,47
6,2006,251900,47,40,7,35
7,2006,251900,42,33,9,21
8,2006,251900,36,32,4,43
9,2006,251900,40,28,12,43
10,2006,251900,31,24,7,49
11,2006,251900,32,27,5,50
12,2006,251900,23,18,5,46
1,2007,251900,39,23,16,59
2,2007,251900,18,13,5,64
3,2007,251900,30,21,9,71
4,2007,251900,46,31,15,64
5,2007,251900,35,29,6,42
6,2007,251900,25,19,6,38
7,2007,251900,34,25,9,73
8,2007,251900,33,25,8,72
9,2007,251900,33,24,9,75
10,2007,251900,29,20,9,65
11,2007,251900,35,25,10,71
12,2007,251900,25,17,8,83
1,2008,251900,22,20,2,86
2,2008,251900,28,23,5,51
3,2008,251900,40,29,11,87
4,2008,251900,33,24,9,48
5,2008,251900,42,28,14,70
6,2008,251900,26,19,7,58
7,2008,251900,33,30,3,57
8,2008,251900,41,29,12,69
9,2008,251900,38,32,6,84
10,2008,251900,42,33,9,67
11,2008,251900,36,30,6,53
12,2008,251900,27,23,4,46
1,2009,251900,30,26,4,65
2,2009,251900,36,29,7,69
3,2009,251900,36,29,7,59
4,2009,251900,36,27,9,65
5,2009,251900,26,18,8,47
6,2009,251900,32,28,4,55
7,2009,251900,35,29,6,50
8,2009,251900,37,24,13,45
9,2009,251900,42,35,7,38
10,2009,251900,49,37,12,61
11,2009,251900,50,43,7,53
12,2009,251900,36,28,8,46
1,2010,251900,40,36,4,65
2,2010,251900,32,28,4,60
3,2010,251900,50,38,12,48
4,2010,251900,34,30,4,27
5,2010,251900,42,34,8,41
6,2010,251900,35,28,7,25
7,2010,251900,41,31,10,35
8,2010,251900,29,23,6,33
9,2010,251900,47,40,7,49
10,2010,251900,36,30,6,41
11,2010,251900,32,32,0,45
12,2010,251900,25,21,4,41
1,2011,251900,31,24,7,42
2,2011,251900,15,12,3,25
1,1999,837100,17,13,4,4
2,1999,837100,16,14,2,3
3,1999,837100,23,19,4,15
4,1999,837100,31,30,1,3
5,1999,837100,23,17,6,1
6,1999,837100,23,16,7,5
7,1999,837100,23,19,4,4
8,1999,837100,29,25,4,5
9,1999,837100,19,15,4,5
10,1999,837100,21,19,2,5
11,1999,837100,25,17,8,6
12,1999,837100,16,13,3,5
1,2000,837100,6,5,1,7
2,2000,837100,14,10,4,6
3,2000,837100,23,17,6,4
4,2000,837100,11,10,1,4
5,2000,837100,25,19,6,5
6,2000,837100,15,14,1,5
7,2000,837100,28,26,2,5
8,2000,837100,23,16,7,5
9,2000,837100,36,29,7,3
10,2000,837100,17,15,2,13
11,2000,837100,15,12,3,6
12,2000,837100,15,12,3,3
1,2001,837100,27,21,6,7
2,2001,837100,11,10,1,11
3,2001,837100,25,19,6,12
4,2001,837100,16,15,1,6
5,2001,837100,30,26,4,7
6,2001,837100,19,17,2,6
7,2001,837100,22,17,5,7
8,2001,837100,38,34,4,8
9,2001,837100,19,17,2,8
10,2001,837100,22,18,4,8
11,2001,837100,19,17,2,9
12,2001,837100,13,12,1,13
1,2002,837100,18,15,3,9
2,2002,837100,19,17,2,12
3,2002,837100,26,23,3,7
4,2002,837100,26,24,2,4
5,2002,837100,32,25,7,10
6,2002,837100,25,18,7,10
7,2002,837100,24,16,8,14
8,2002,837100,24,18,6,6
9,2002,837100,24,22,2,9
10,2002,837100,35,32,3,8
11,2002,837100,19,17,2,15
12,2002,837100,29,22,7,8
1,2003,837100,26,22,4,27
2,2003,837100,20,18,2,9
3,2003,837100,12,9,3,19
4,2003,837100,23,20,3,27
5,2003,837100,20,18,2,21
6,2003,837100,18,15,3,9
7,2003,837100,31,24,7,3
8,2003,837100,32,28,4,6
9,2003,837100,36,33,3,15
10,2003,837100,31,27,4,12
11,2003,837100,26,21,5,14
12,2003,837100,16,11,5,6
1,2004,837100,16,11,5,20
2,2004,837100,20,13,7,11
3,2004,837100,19,15,4,3
4,2004,837100,19,18,1,11
5,2004,837100,27,21,6,19
6,2004,837100,26,24,2,22
7,2004,837100,37,33,4,31
8,2004,837100,32,28,4,14
9,2004,837100,22,18,4,12
10,2004,837100,30,25,5,11
11,2004,837100,27,24,3,10
12,2004,837100,23,22,1,11
1,2005,837100,20,19,1,8
2,2005,837100,25,22,3,8
3,2005,837100,14,13,1,9
4,2005,837100,22,20,2,11
5,2005,837100,14,13,1,9
6,2005,837100,30,28,2,14
7,2005,837100,34,30,4,9
8,2005,837100,30,25,5,10
9,2005,837100,23,22,1,6
10,2005,837100,27,24,3,9
11,2005,837100,32,28,4,5
12,2005,837100,17,15,2,13
1,2006,837100,23,21,2,11
2,2006,837100,21,18,3,8
3,2006,837100,29,25,4,9
4,2006,837100,31,30,1,20
5,2006,837100,35,27,8,8
6,2006,837100,32,28,4,8
7,2006,837100,33,28,5,11
8,2006,837100,28,23,5,10
9,2006,837100,28,21,7,14
10,2006,837100,29,25,4,12
11,2006,837100,38,34,4,19
12,2006,837100,29,28,1,13
1,2007,837100,22,17,5,16
2,2007,837100,18,17,1,11
3,2007,837100,27,23,4,11
4,2007,837100,25,20,5,10
5,2007,837100,40,32,8,14
6,2007,837100,25,19,6,8
7,2007,837100,31,29,2,13
8,2007,837100,39,31,8,9
9,2007,837100,31,22,9,5
10,2007,837100,33,28,5,14
11,2007,837100,23,20,3,7
12,2007,837100,31,28,3,10
1,2008,837100,21,19,2,14
2,2008,837100,28,25,3,12
3,2008,837100,23,15,8,6
4,2008,837100,27,25,2,5
5,2008,837100,24,23,1,4
6,2008,837100,33,28,5,5
7,2008,837100,27,24,3,18
8,2008,837100,35,31,4,10
9,2008,837100,19,16,3,9
10,2008,837100,27,23,4,9
11,2008,837100,34,27,7,11
12,2008,837100,27,25,2,5
1,2009,837100,15,14,1,8
2,2009,837100,19,17,2,21
3,2009,837100,23,20,3,6
4,2009,837100,16,12,4,10
5,2009,837100,14,13,1,7
6,2009,837100,36,30,6,6
7,2009,837100,26,23,3,9
8,2009,837100,26,21,5,11
9,2009,837100,24,19,5,7
10,2009,837100,22,19,3,8
11,2009,837100,29,27,2,10
12,2009,837100,14,12,2,11
1,2010,837100,30,28,2,11
2,2010,837100,29,28,1,12
3,2010,837100,33,31,2,11
4,2010,837100,31,26,5,12
5,2010,837100,27,25,2,12
6,2010,837100,36,32,4,10
7,2010,837100,35,31,4,11
8,2010,837100,27,23,4,13
9,2010,837100,23,23,0,9
10,2010,837100,21,19,2,13
11,2010,837100,25,22,3,13
12,2010,837100,14,13,1,9
1,2011,837100,16,14,2,9
2,2011,837100,12,12,0,10
1,1999,320100,77,73,4,1
2,1999,320100,65,65,0,1
3,1999,320100,70,70,0,1
4,1999,320100,77,75,2,0
5,1999,320100,97,92,5,3
6,1999,320100,137,137,0,0
7,1999,320100,148,145,3,4
8,1999,320100,103,102,1,2
9,1999,320100,137,135,2,2
10,1999,320100,111,109,2,1
11,1999,320100,87,87,0,0
12,1999,320100,68,68,0,1
1,2000,320100,88,86,2,3
2,2000,320100,68,68,0,1
3,2000,320100,84,83,1,3
4,2000,320100,85,83,2,0
5,2000,320100,106,103,3,2
6,2000,320100,123,119,4,0
7,2000,320100,110,106,4,0
8,2000,320100,136,134,2,3
9,2000,320100,111,110,1,0
10,2000,320100,97,97,0,0
11,2000,320100,68,67,1,1
12,2000,320100,76,75,1,3
1,2001,320100,72,69,3,0
2,2001,320100,87,84,3,1
3,2001,320100,82,81,1,1
4,2001,320100,82,82,0,2
5,2001,320100,81,78,3,4
6,2001,320100,74,74,0,1
7,2001,320100,94,91,3,1
8,2001,320100,72,70,2,0
9,2001,320100,71,70,1,1
10,2001,320100,76,76,0,6
11,2001,320100,56,56,0,0
12,2001,320100,60,58,2,2
1,2002,320100,47,45,2,0
2,2002,320100,35,35,0,1
3,2002,320100,51,49,2,2
4,2002,320100,53,52,1,2
5,2002,320100,61,60,1,1
6,2002,320100,57,55,2,0
7,2002,320100,72,71,1,3
8,2002,320100,65,64,1,0
9,2002,320100,63,61,2,4
10,2002,320100,46,44,2,0
11,2002,320100,54,52,2,1
12,2002,320100,51,50,1,1
1,2003,320100,48,45,3,4
2,2003,320100,44,44,0,2
3,2003,320100,52,52,0,0
4,2003,320100,53,53,0,4
5,2003,320100,51,51,0,1
6,2003,320100,64,62,2,0
7,2003,320100,66,65,1,0
8,2003,320100,70,67,3,4
9,2003,320100,47,46,1,2
10,2003,320100,64,63,1,4
11,2003,320100,67,64,3,3
12,2003,320100,56,55,1,0
1,2004,320100,58,56,2,0
2,2004,320100,44,43,1,0
3,2004,320100,62,61,1,1
4,2004,320100,59,55,4,2
5,2004,320100,55,55,0,0
6,2004,320100,64,63,1,4
7,2004,320100,89,88,1,2
8,2004,320100,84,81,3,0
9,2004,320100,68,67,1,4
10,2004,320100,73,73,0,1
11,2004,320100,70,68,2,1
12,2004,320100,63,62,1,2
1,2005,320100,41,40,1,2
2,2005,320100,34,34,0,0
3,2005,320100,47,47,0,1
4,2005,320100,60,59,1,3
5,2005,320100,59,56,3,2
6,2005,320100,70,69,1,5
7,2005,320100,73,72,1,3
8,2005,320100,61,60,1,2
9,2005,320100,63,61,2,2
10,2005,320100,67,66,1,2
11,2005,320100,42,41,1,1
12,2005,320100,45,42,3,2
1,2006,320100,41,41,0,1
2,2006,320100,40,40,0,1
3,2006,320100,43,43,0,0
4,2006,320100,40,39,1,7
5,2006,320100,47,45,2,2
6,2006,320100,59,58,1,4
7,2006,320100,56,55,1,1
8,2006,320100,67,66,1,2
9,2006,320100,56,55,1,1
10,2006,320100,60,57,3,2
11,2006,320100,55,54,1,2
12,2006,320100,54,52,2,1
1,2007,320100,44,44,0,0
2,2007,320100,33,33,0,2
3,2007,320100,56,54,2,0
4,2007,320100,61,58,3,2
5,2007,320100,54,52,2,0
6,2007,320100,68,67,1,3
7,2007,320100,65,64,1,3
8,2007,320100,51,50,1,2
9,2007,320100,44,42,2,3
10,2007,320100,58,54,4,3
11,2007,320100,39,37,2,3
12,2007,320100,46,42,4,1
1,2008,320100,47,46,1,0
2,2008,320100,35,35,0,0
3,2008,320100,54,53,1,0
4,2008,320100,49,49,0,5
5,2008,320100,61,59,2,0
6,2008,320100,75,74,1,0
7,2008,320100,91,89,2,4
8,2008,320100,87,86,1,2
9,2008,320100,69,68,1,3
10,2008,320100,65,64,1,6
11,2008,320100,57,57,0,1
12,2008,320100,33,31,2,0
1,2009,320100,43,42,1,0
2,2009,320100,42,42,0,2
3,2009,320100,30,30,0,3
4,2009,320100,43,43,0,2
5,2009,320100,41,39,2,5
6,2009,320100,62,62,0,2
7,2009,320100,71,71,0,9
8,2009,320100,66,62,4,1
9,2009,320100,59,59,0,3
10,2009,320100,47,47,0,5
11,2009,320100,39,39,0,5
12,2009,320100,28,28,0,1
1,2010,320100,35,34,1,0
2,2010,320100,28,28,0,4
3,2010,320100,42,39,3,4
4,2010,320100,37,36,1,3
5,2010,320100,40,39,1,1
6,2010,320100,51,48,3,5
7,2010,320100,44,43,1,2
8,2010,320100,58,57,1,4
9,2010,320100,46,45,1,8
10,2010,320100,62,62,0,3
11,2010,320100,49,47,2,1
12,2010,320100,29,29,0,1
1,2011,320100,28,28,0,10
2,2011,320100,13,13,0,5
1,1999,280400,25,21,4,0
2,1999,280400,21,21,0,2
3,1999,280400,22,21,1,4
4,1999,280400,41,39,2,2
5,1999,280400,21,19,2,3
6,1999,280400,30,29,1,4
7,1999,280400,32,27,5,2
8,1999,280400,40,37,3,1
9,1999,280400,27,24,3,3
10,1999,280400,27,25,2,8
11,1999,280400,14,14,0,3
12,1999,280400,18,18,0,6
1,2000,280400,12,12,0,2
2,2000,280400,8,8,0,2
3,2000,280400,14,13,1,5
4,2000,280400,11,10,1,5
5,2000,280400,18,17,1,1
6,2000,280400,12,10,2,0
7,2000,280400,16,14,2,3
8,2000,280400,20,17,3,3
9,2000,280400,19,16,3,1
10,2000,280400,22,20,2,4
11,2000,280400,6,3,3,1
12,2000,280400,17,16,1,1
1,2001,280400,8,7,1,0
2,2001,280400,11,10,1,0
3,2001,280400,14,13,1,1
4,2001,280400,16,12,4,1
5,2001,280400,9,9,0,1
6,2001,280400,14,14,0,4
7,2001,280400,21,21,0,0
8,2001,280400,20,16,4,2
9,2001,280400,15,15,0,5
10,2001,280400,16,15,1,6
11,2001,280400,22,19,3,1
12,2001,280400,11,10,1,2
1,2002,280400,11,10,1,1
2,2002,280400,12,12,0,6
3,2002,280400,17,15,2,2
4,2002,280400,13,13,0,1
5,2002,280400,13,13,0,1
6,2002,280400,10,10,0,2
7,2002,280400,16,16,0,0
8,2002,280400,10,10,0,2
9,2002,280400,10,9,1,0
10,2002,280400,12,10,2,1
11,2002,280400,12,12,0,0
12,2002,280400,15,14,1,1
1,2003,280400,12,12,0,0
2,2003,280400,6,6,0,1
3,2003,280400,9,9,0,1
4,2003,280400,13,12,1,2
5,2003,280400,13,13,0,6
6,2003,280400,15,14,1,4
7,2003,280400,15,13,2,3
8,2003,280400,13,13,0,2
9,2003,280400,20,17,3,1
10,2003,280400,13,12,1,0
11,2003,280400,16,15,1,1
12,2003,280400,10,10,0,4
1,2004,280400,4,4,0,0
2,2004,280400,2,2,0,0
3,2004,280400,14,12,2,1
4,2004,280400,8,8,0,0
5,2004,280400,16,16,0,3
6,2004,280400,10,10,0,0
7,2004,280400,8,7,1,0
8,2004,280400,11,9,2,7
9,2004,280400,8,8,0,2
10,2004,280400,18,15,3,3
11,2004,280400,12,11,1,3
12,2004,280400,4,3,1,1
1,2005,280400,4,3,1,2
2,2005,280400,7,7,0,2
3,2005,280400,6,6,0,0
4,2005,280400,8,7,1,8
5,2005,280400,7,6,1,3
6,2005,280400,8,6,2,2
7,2005,280400,13,12,1,4
8,2005,280400,12,12,0,3
9,2005,280400,6,6,0,1
10,2005,280400,7,6,1,2
11,2005,280400,9,8,1,2
12,2005,280400,7,5,2,2
1,2006,280400,5,5,0,4
2,2006,280400,6,5,1,2
3,2006,280400,13,12,1,2
4,2006,280400,9,8,1,1
5,2006,280400,9,9,0,4
6,2006,280400,9,8,1,3
7,2006,280400,10,8,2,2
8,2006,280400,9,9,0,2
9,2006,280400,14,14,0,0
10,2006,280400,5,5,0,0
11,2006,280400,9,9,0,1
12,2006,280400,6,6,0,0
1,2007,280400,6,6,0,0
2,2007,280400,2,2,0,1
3,2007,280400,10,10,0,0
4,2007,280400,9,5,4,0
5,2007,280400,9,9,0,0
6,2007,280400,9,9,0,2
7,2007,280400,15,12,3,1
8,2007,280400,9,9,0,0
9,2007,280400,8,6,2,1
10,2007,280400,10,10,0,0
11,2007,280400,10,9,1,2
12,2007,280400,5,5,0,0
1,2008,280400,4,4,0,0
2,2008,280400,7,6,1,1
3,2008,280400,4,4,0,2
4,2008,280400,8,8,0,1
5,2008,280400,7,7,0,1
6,2008,280400,11,10,1,0
7,2008,280400,12,12,0,1
8,2008,280400,10,10,0,0
9,2008,280400,15,14,1,0
10,2008,280400,10,10,0,0
11,2008,280400,8,8,0,1
12,2008,280400,2,2,0,2
1,2009,280400,6,4,2,0
2,2009,280400,7,6,1,0
3,2009,280400,6,6,0,0
4,2009,280400,2,1,1,0
5,2009,280400,10,9,1,1
6,2009,280400,6,6,0,0
7,2009,280400,9,9,0,0
8,2009,280400,11,11,0,0
9,2009,280400,7,6,1,3
10,2009,280400,8,8,0,1
11,2009,280400,10,10,0,1
12,2009,280400,7,7,0,4
1,2010,280400,13,11,2,0
2,2010,280400,6,6,0,1
3,2010,280400,7,7,0,2
4,2010,280400,6,4,2,0
5,2010,280400,9,9,0,3
6,2010,280400,10,9,1,3
7,2010,280400,13,12,1,0
8,2010,280400,15,14,1,1
9,2010,280400,8,6,2,1
10,2010,280400,4,4,0,0
11,2010,280400,8,7,1,0
12,2010,280400,6,6,0,1
1,2011,280400,7,7,0,1
2,2011,280400,4,4,0,1
1,1999,251400,39,31,8,8
2,1999,251400,31,26,5,13
3,1999,251400,30,26,4,9
4,1999,251400,45,35,10,16
5,1999,251400,41,32,9,8
6,1999,251400,36,21,15,14
7,1999,251400,47,40,7,20
8,1999,251400,38,33,5,16
9,1999,251400,26,18,8,15
10,1999,251400,28,24,4,18
11,1999,251400,30,26,4,14
12,1999,251400,24,18,6,15
1,2000,251400,36,30,6,5
2,2000,251400,28,24,4,6
3,2000,251400,44,38,6,6
4,2000,251400,46,39,7,11
5,2000,251400,41,37,4,15
6,2000,251400,36,29,7,6
7,2000,251400,41,35,6,9
8,2000,251400,31,26,5,12
9,2000,251400,36,29,7,10
10,2000,251400,42,36,6,8
11,2000,251400,32,29,3,5
12,2000,251400,36,31,5,6
1,2001,251400,29,27,2,4
2,2001,251400,22,18,4,13
3,2001,251400,34,29,5,22
4,2001,251400,17,9,8,7
5,2001,251400,35,32,3,16
6,2001,251400,49,41,8,7
7,2001,251400,29,22,7,24
8,2001,251400,28,25,3,12
9,2001,251400,33,29,4,14
10,2001,251400,55,42,13,19
11,2001,251400,49,44,5,14
12,2001,251400,27,22,5,17
1,2002,251400,28,25,3,11
2,2002,251400,20,15,5,16
3,2002,251400,33,27,6,11
4,2002,251400,28,26,2,19
5,2002,251400,30,26,4,18
6,2002,251400,24,20,4,25
7,2002,251400,30,25,5,9
8,2002,251400,35,29,6,14
9,2002,251400,34,23,11,12
10,2002,251400,24,20,4,6
11,2002,251400,24,22,2,13
12,2002,251400,35,33,2,22
1,2003,251400,19,12,7,13
2,2003,251400,17,14,3,6
3,2003,251400,35,28,7,14
4,2003,251400,54,51,3,19
5,2003,251400,24,19,5,24
6,2003,251400,30,24,6,10
7,2003,251400,28,28,0,23
8,2003,251400,36,28,8,13
9,2003,251400,44,38,6,21
10,2003,251400,54,48,6,49
11,2003,251400,32,29,3,17
12,2003,251400,34,32,2,9
1,2004,251400,26,24,2,18
2,2004,251400,28,27,1,8
3,2004,251400,27,23,4,11
4,2004,251400,19,15,4,8
5,2004,251400,33,26,7,8
6,2004,251400,21,17,4,5
7,2004,251400,36,27,9,14
8,2004,251400,28,26,2,36
9,2004,251400,33,28,5,86
10,2004,251400,32,29,3,37
11,2004,251400,26,22,4,15
12,2004,251400,21,19,2,14
1,2005,251400,24,22,2,14
2,2005,251400,26,18,8,8
3,2005,251400,34,32,2,9
4,2005,251400,38,32,6,24
5,2005,251400,25,24,1,8
6,2005,251400,25,15,10,3
7,2005,251400,27,25,2,6
8,2005,251400,30,30,0,6
9,2005,251400,26,25,1,4
10,2005,251400,36,30,6,8
11,2005,251400,23,17,6,15
12,2005,251400,22,14,8,3
1,2006,251400,17,17,0,9
2,2006,251400,15,12,3,2
3,2006,251400,22,19,3,3
4,2006,251400,24,22,2,10
5,2006,251400,20,12,8,3
6,2006,251400,25,19,6,6
7,2006,251400,32,29,3,3
8,2006,251400,23,20,3,5
9,2006,251400,25,19,6,5
10,2006,251400,27,22,5,5
11,2006,251400,48,40,8,10
12,2006,251400,31,24,7,4
1,2007,251400,25,24,1,2
2,2007,251400,25,21,4,2
3,2007,251400,17,13,4,5
4,2007,251400,24,20,4,11
5,2007,251400,32,23,9,9
6,2007,251400,23,19,4,11
7,2007,251400,19,17,2,14
8,2007,251400,29,24,5,11
9,2007,251400,30,25,5,11
10,2007,251400,41,37,4,9
11,2007,251400,27,23,4,8
12,2007,251400,22,20,2,8
1,2008,251400,26,18,8,11
2,2008,251400,25,21,4,3
3,2008,251400,20,17,3,13
4,2008,251400,36,28,8,9
5,2008,251400,25,20,5,9
6,2008,251400,26,23,3,12
7,2008,251400,30,24,6,15
8,2008,251400,28,24,4,14
9,2008,251400,33,29,4,18
10,2008,251400,24,21,3,18
11,2008,251400,24,23,1,9
12,2008,251400,37,29,8,4
1,2009,251400,15,14,1,7
2,2009,251400,20,19,1,7
3,2009,251400,23,22,1,6
4,2009,251400,26,24,2,4
5,2009,251400,21,15,6,6
6,2009,251400,33,27,6,4
7,2009,251400,21,14,7,10
8,2009,251400,32,28,4,7
9,2009,251400,25,23,2,9
10,2009,251400,28,26,2,11
11,2009,251400,25,22,3,5
12,2009,251400,23,21,2,9
1,2010,251400,31,29,2,3
2,2010,251400,16,16,0,22
3,2010,251400,19,19,0,6
4,2010,251400,21,16,5,11
5,2010,251400,23,14,9,11
6,2010,251400,28,22,6,9
7,2010,251400,23,18,5,8
8,2010,251400,20,15,5,7
9,2010,251400,13,11,2,3
10,2010,251400,28,23,5,7
11,2010,251400,30,27,3,4
12,2010,251400,14,13,1,8
1,2011,251400,17,17,0,1
2,2011,251400,12,9,3,3
1,1999,081800,110,106,4,3
2,1999,081800,84,83,1,3
3,1999,081800,101,99,2,7
4,1999,081800,117,110,7,5
5,1999,081800,122,120,2,7
6,1999,081800,110,106,4,8
7,1999,081800,131,121,10,12
8,1999,081800,125,120,5,13
9,1999,081800,115,108,7,18
10,1999,081800,125,120,5,11
11,1999,081800,104,98,6,10
12,1999,081800,103,97,6,13
1,2000,081800,96,91,5,17
2,2000,081800,78,72,6,17
3,2000,081800,98,94,4,14
4,2000,081800,108,100,8,17
5,2000,081800,109,106,3,8
6,2000,081800,100,94,6,11
7,2000,081800,115,108,7,16
8,2000,081800,101,96,5,15
9,2000,081800,106,101,5,21
10,2000,081800,117,113,4,11
11,2000,081800,87,80,7,9
12,2000,081800,93,90,3,12
1,2001,081800,63,62,1,19
2,2001,081800,80,78,2,13
3,2001,081800,88,81,7,17
4,2001,081800,101,95,6,10
5,2001,081800,81,78,3,11
6,2001,081800,75,71,4,18
7,2001,081800,97,95,2,10
8,2001,081800,94,86,8,42
9,2001,081800,106,101,5,22
10,2001,081800,105,101,4,24
11,2001,081800,109,99,10,22
12,2001,081800,87,79,8,30
1,2002,081800,86,81,5,21
2,2002,081800,71,66,5,17
3,2002,081800,74,65,9,8
4,2002,081800,84,81,3,7
5,2002,081800,75,69,6,19
6,2002,081800,99,95,4,11
7,2002,081800,104,100,4,9
8,2002,081800,109,106,3,11
9,2002,081800,92,88,4,13
10,2002,081800,84,82,2,10
11,2002,081800,97,94,3,14
12,2002,081800,85,84,1,12
1,2003,081800,71,63,8,5
2,2003,081800,67,62,5,5
3,2003,081800,81,79,2,8
4,2003,081800,82,78,4,3
5,2003,081800,75,69,6,9
6,2003,081800,64,58,6,9
7,2003,081800,75,69,6,18
8,2003,081800,88,82,6,8
9,2003,081800,67,65,2,16
10,2003,081800,77,74,3,17
11,2003,081800,76,70,6,15
12,2003,081800,58,53,5,7
1,2004,081800,56,53,3,16
2,2004,081800,44,42,2,17
3,2004,081800,58,56,2,11
4,2004,081800,67,64,3,19
5,2004,081800,90,85,5,12
6,2004,081800,74,70,4,15
7,2004,081800,106,102,4,7
8,2004,081800,71,64,7,15
9,2004,081800,76,71,5,7
10,2004,081800,52,49,3,5
11,2004,081800,72,66,6,1
12,2004,081800,40,36,4,6
1,2005,081800,44,42,2,9
2,2005,081800,37,34,3,5
3,2005,081800,51,48,3,7
4,2005,081800,55,47,8,15
5,2005,081800,54,52,2,13
6,2005,081800,60,56,4,8
7,2005,081800,59,54,5,12
8,2005,081800,68,66,2,12
9,2005,081800,62,59,3,16
10,2005,081800,69,66,3,16
11,2005,081800,61,58,3,7
12,2005,081800,69,65,4,8
1,2006,081800,51,50,1,13
2,2006,081800,51,46,5,13
3,2006,081800,63,60,3,8
4,2006,081800,56,53,3,7
5,2006,081800,54,52,2,8
6,2006,081800,64,60,4,9
7,2006,081800,63,59,4,10
8,2006,081800,59,56,3,13
9,2006,081800,76,73,3,10
10,2006,081800,56,52,4,6
11,2006,081800,58,53,5,5
12,2006,081800,74,67,7,18
1,2007,081800,76,72,4,9
2,2007,081800,61,59,2,4
3,2007,081800,71,69,2,11
4,2007,081800,89,82,7,8
5,2007,081800,68,66,2,12
6,2007,081800,82,80,2,11
7,2007,081800,77,73,4,16
8,2007,081800,85,80,5,16
9,2007,081800,74,70,4,14
10,2007,081800,81,75,6,16
11,2007,081800,89,87,2,14
12,2007,081800,82,78,4,4
1,2008,081800,62,62,0,7
2,2008,081800,51,47,4,10
3,2008,081800,58,54,4,5
4,2008,081800,66,60,6,4
5,2008,081800,69,66,3,15
6,2008,081800,79,76,3,11
7,2008,081800,80,76,4,11
8,2008,081800,95,90,5,24
9,2008,081800,86,84,2,13
10,2008,081800,83,76,7,17
11,2008,081800,89,83,6,8
12,2008,081800,78,74,4,8
1,2009,081800,51,50,1,10
2,2009,081800,72,67,5,6
3,2009,081800,68,64,4,5
4,2009,081800,71,68,3,2
5,2009,081800,74,68,6,9
6,2009,081800,63,61,2,15
7,2009,081800,92,86,6,7
8,2009,081800,65,62,3,11
9,2009,081800,63,60,3,9
10,2009,081800,56,54,2,5
11,2009,081800,65,61,4,4
12,2009,081800,66,61,5,11
1,2010,081800,55,50,5,8
2,2010,081800,41,41,0,14
3,2010,081800,51,48,3,14
4,2010,081800,63,57,6,1
5,2010,081800,71,69,2,7
6,2010,081800,59,58,1,4
7,2010,081800,75,73,2,11
8,2010,081800,71,68,3,6
9,2010,081800,74,66,8,7
10,2010,081800,69,65,4,8
11,2010,081800,57,52,5,0
12,2010,081800,48,46,2,2
1,2011,081800,44,42,2,2
2,2011,081800,23,20,3,4
1,1999,081700,57,56,1,3
2,1999,081700,43,42,1,3
3,1999,081700,33,32,1,1
4,1999,081700,56,55,1,0
5,1999,081700,59,54,5,2
6,1999,081700,54,51,3,3
7,1999,081700,52,51,1,4
8,1999,081700,52,49,3,2
9,1999,081700,55,54,1,1
10,1999,081700,47,43,4,1
11,1999,081700,58,54,4,1
12,1999,081700,44,39,5,3
1,2000,081700,34,33,1,4
2,2000,081700,42,38,4,3
3,2000,081700,44,40,4,4
4,2000,081700,54,49,5,3
5,2000,081700,41,38,3,1
6,2000,081700,44,43,1,3
7,2000,081700,52,51,1,10
8,2000,081700,45,42,3,4
9,2000,081700,55,52,3,4
10,2000,081700,53,53,0,2
11,2000,081700,47,47,0,2
12,2000,081700,41,38,3,1
1,2001,081700,44,41,3,2
2,2001,081700,37,36,1,4
3,2001,081700,63,61,2,0
4,2001,081700,35,33,2,2
5,2001,081700,45,42,3,7
6,2001,081700,54,49,5,2
7,2001,081700,37,36,1,0
8,2001,081700,44,44,0,2
9,2001,081700,48,47,1,2
10,2001,081700,41,41,0,3
11,2001,081700,47,45,2,0
12,2001,081700,47,45,2,0
1,2002,081700,39,37,2,1
2,2002,081700,31,29,2,0
3,2002,081700,44,44,0,0
4,2002,081700,42,39,3,3
5,2002,081700,54,53,1,3
6,2002,081700,61,57,4,2
7,2002,081700,67,63,4,3
8,2002,081700,61,57,4,1
9,2002,081700,47,46,1,1
10,2002,081700,42,40,2,4
11,2002,081700,37,34,3,2
12,2002,081700,49,48,1,0
1,2003,081700,38,38,0,3
2,2003,081700,34,33,1,0
3,2003,081700,44,37,7,0
4,2003,081700,49,42,7,1
5,2003,081700,45,41,4,3
6,2003,081700,40,33,7,2
7,2003,081700,36,30,6,1
8,2003,081700,46,45,1,2
9,2003,081700,34,31,3,1
10,2003,081700,41,40,1,3
11,2003,081700,42,38,4,0
12,2003,081700,44,39,5,1
1,2004,081700,27,27,0,1
2,2004,081700,36,36,0,0
3,2004,081700,38,35,3,0
4,2004,081700,48,45,3,2
5,2004,081700,40,39,1,1
6,2004,081700,42,39,3,2
7,2004,081700,41,39,2,3
8,2004,081700,48,45,3,1
9,2004,081700,32,31,1,1
10,2004,081700,38,36,2,3
11,2004,081700,35,32,3,4
12,2004,081700,29,26,3,1
1,2005,081700,33,31,2,3
2,2005,081700,23,22,1,2
3,2005,081700,33,32,1,1
4,2005,081700,32,28,4,1
5,2005,081700,40,38,2,1
6,2005,081700,27,25,2,2
7,2005,081700,41,38,3,0
8,2005,081700,47,45,2,1
9,2005,081700,27,23,4,4
10,2005,081700,43,40,3,1
11,2005,081700,31,28,3,1
12,2005,081700,39,35,4,0
1,2006,081700,41,33,8,0
2,2006,081700,29,24,5,0
3,2006,081700,34,33,1,2
4,2006,081700,38,35,3,2
5,2006,081700,51,48,3,2
6,2006,081700,52,51,1,1
7,2006,081700,45,41,4,1
8,2006,081700,43,40,3,2
9,2006,081700,42,41,1,2
10,2006,081700,26,23,3,1
11,2006,081700,46,43,3,4
12,2006,081700,31,30,1,1
1,2007,081700,38,36,2,3
2,2007,081700,29,29,0,1
3,2007,081700,42,42,0,2
4,2007,081700,45,40,5,1
5,2007,081700,50,49,1,1
6,2007,081700,34,29,5,0
7,2007,081700,47,44,3,3
8,2007,081700,33,32,1,4
9,2007,081700,34,34,0,1
10,2007,081700,40,39,1,2
11,2007,081700,31,27,4,3
12,2007,081700,25,22,3,0
1,2008,081700,44,43,1,0
2,2008,081700,26,26,0,1
3,2008,081700,25,25,0,0
4,2008,081700,35,35,0,2
5,2008,081700,36,34,2,2
6,2008,081700,49,47,2,1
7,2008,081700,49,46,3,2
8,2008,081700,52,50,2,2
9,2008,081700,46,45,1,1
10,2008,081700,44,42,2,2
11,2008,081700,47,44,3,3
12,2008,081700,43,43,0,1
1,2009,081700,36,34,2,2
2,2009,081700,34,30,4,0
3,2009,081700,31,28,3,0
4,2009,081700,28,28,0,5
5,2009,081700,26,25,1,6
6,2009,081700,38,37,1,1
7,2009,081700,50,49,1,1
8,2009,081700,31,27,4,1
9,2009,081700,37,34,3,3
10,2009,081700,33,32,1,4
11,2009,081700,33,29,4,0
12,2009,081700,21,21,0,0
1,2010,081700,34,33,1,4
2,2010,081700,27,26,1,3
3,2010,081700,28,27,1,4
4,2010,081700,30,30,0,3
5,2010,081700,46,43,3,4
6,2010,081700,30,28,2,3
7,2010,081700,41,36,5,1
8,2010,081700,53,52,1,3
9,2010,081700,27,25,2,2
10,2010,081700,36,35,1,1
11,2010,081700,28,28,0,1
12,2010,081700,30,30,0,2
1,2011,081700,32,29,3,2
2,2011,081700,30,29,1,1
1,1999,251500,58,49,9,27
2,1999,251500,41,35,6,15
3,1999,251500,47,35,12,34
4,1999,251500,58,45,13,33
5,1999,251500,70,64,6,57
6,1999,251500,68,57,11,28
7,1999,251500,72,60,12,33
8,1999,251500,52,46,6,24
9,1999,251500,47,43,4,40
10,1999,251500,61,56,5,36
11,1999,251500,44,32,12,41
12,1999,251500,49,35,14,33
1,2000,251500,54,47,7,62
2,2000,251500,46,25,21,36
3,2000,251500,57,48,9,67
4,2000,251500,47,33,14,54
5,2000,251500,61,53,8,26
6,2000,251500,53,42,11,35
7,2000,251500,54,44,10,41
8,2000,251500,57,38,19,50
9,2000,251500,46,37,9,32
10,2000,251500,45,40,5,48
11,2000,251500,69,58,11,57
12,2000,251500,59,50,9,47
1,2001,251500,52,46,6,64
2,2001,251500,36,34,2,49
3,2001,251500,45,39,6,72
4,2001,251500,60,49,11,67
5,2001,251500,64,52,12,82
6,2001,251500,54,42,12,55
7,2001,251500,66,56,10,79
8,2001,251500,41,35,6,72
9,2001,251500,63,49,14,47
10,2001,251500,59,53,6,44
11,2001,251500,54,47,7,43
12,2001,251500,37,31,6,52
1,2002,251500,47,37,10,34
2,2002,251500,35,33,2,55
3,2002,251500,40,32,8,41
4,2002,251500,54,47,7,38
5,2002,251500,49,40,9,39
6,2002,251500,47,38,9,44
7,2002,251500,48,35,13,47
8,2002,251500,37,26,11,38
9,2002,251500,39,32,7,34
10,2002,251500,46,36,10,36
11,2002,251500,36,31,5,42
12,2002,251500,48,41,7,56
1,2003,251500,41,36,5,54
2,2003,251500,38,32,6,44
3,2003,251500,36,27,9,44
4,2003,251500,47,42,5,47
5,2003,251500,42,32,10,58
6,2003,251500,40,32,8,46
7,2003,251500,45,39,6,45
8,2003,251500,50,42,8,48
9,2003,251500,53,44,9,42
10,2003,251500,35,32,3,122
11,2003,251500,24,20,4,55
12,2003,251500,36,29,7,51
1,2004,251500,36,31,5,58
2,2004,251500,40,31,9,77
3,2004,251500,29,20,9,55
4,2004,251500,38,32,6,30
5,2004,251500,46,35,11,29
6,2004,251500,51,34,17,27
7,2004,251500,42,27,15,36
8,2004,251500,56,52,4,31
9,2004,251500,57,48,9,30
10,2004,251500,34,27,7,21
11,2004,251500,42,37,5,71
12,2004,251500,44,38,6,33
1,2005,251500,40,34,6,44
2,2005,251500,34,31,3,34
3,2005,251500,40,31,9,48
4,2005,251500,37,31,6,47
5,2005,251500,47,37,10,28
6,2005,251500,48,39,9,40
7,2005,251500,60,46,14,38
8,2005,251500,49,41,8,73
9,2005,251500,46,35,11,29
10,2005,251500,49,39,10,26
11,2005,251500,43,38,5,20
12,2005,251500,34,29,5,32
1,2006,251500,35,31,4,29
2,2006,251500,41,34,7,35
3,2006,251500,38,33,5,41
4,2006,251500,35,27,8,47
5,2006,251500,32,26,6,51
6,2006,251500,35,28,7,35
7,2006,251500,47,40,7,32
8,2006,251500,38,33,5,64
9,2006,251500,40,32,8,42
10,2006,251500,46,39,7,22
11,2006,251500,30,24,6,43
12,2006,251500,30,25,5,28
1,2007,251500,38,34,4,22
2,2007,251500,31,29,2,30
3,2007,251500,36,30,6,37
4,2007,251500,45,40,5,32
5,2007,251500,41,37,4,50
6,2007,251500,35,31,4,75
7,2007,251500,51,43,8,57
8,2007,251500,40,36,4,61
9,2007,251500,47,38,9,41
10,2007,251500,40,30,10,39
11,2007,251500,37,30,7,74
12,2007,251500,32,29,3,44
1,2008,251500,37,29,8,29
2,2008,251500,24,20,4,36
3,2008,251500,38,30,8,33
4,2008,251500,39,34,5,26
5,2008,251500,43,35,8,34
6,2008,251500,40,36,4,41
7,2008,251500,54,47,7,24
8,2008,251500,55,45,10,29
9,2008,251500,52,43,9,54
10,2008,251500,60,46,14,59
11,2008,251500,33,27,6,28
12,2008,251500,32,31,1,25
1,2009,251500,34,32,2,52
2,2009,251500,34,30,4,41
3,2009,251500,41,33,8,36
4,2009,251500,41,34,7,30
5,2009,251500,57,45,12,41
6,2009,251500,44,39,5,43
7,2009,251500,49,37,12,38
8,2009,251500,53,48,5,41
9,2009,251500,54,48,6,50
10,2009,251500,37,33,4,44
11,2009,251500,33,27,6,29
12,2009,251500,34,30,4,42
1,2010,251500,41,38,3,43
2,2010,251500,17,11,6,48
3,2010,251500,30,23,7,36
4,2010,251500,37,26,11,60
5,2010,251500,25,19,6,41
6,2010,251500,32,26,6,40
7,2010,251500,35,32,3,57
8,2010,251500,40,35,5,46
9,2010,251500,36,28,8,47
10,2010,251500,29,26,3,36
11,2010,251500,35,27,8,49
12,2010,251500,47,40,7,26
1,2011,251500,30,23,7,34
2,2011,251500,15,13,2,18
1,1999,081600,52,48,4,1
2,1999,081600,36,36,0,2
3,1999,081600,49,49,0,3
4,1999,081600,37,36,1,1
5,1999,081600,53,51,2,0
6,1999,081600,47,47,0,1
7,1999,081600,68,66,2,1
8,1999,081600,77,73,4,1
9,1999,081600,71,71,0,5
10,1999,081600,74,74,0,4
11,1999,081600,60,57,3,3
12,1999,081600,63,60,3,4
1,2000,081600,39,39,0,1
2,2000,081600,50,50,0,2
3,2000,081600,66,61,5,0
4,2000,081600,68,65,3,1
5,2000,081600,49,47,2,3
6,2000,081600,46,44,2,7
7,2000,081600,64,62,2,0
8,2000,081600,75,72,3,0
9,2000,081600,60,59,1,1
10,2000,081600,88,88,0,0
11,2000,081600,67,67,0,0
12,2000,081600,54,53,1,2
1,2001,081600,79,76,3,1
2,2001,081600,74,72,2,1
3,2001,081600,52,52,0,1
4,2001,081600,59,56,3,0
5,2001,081600,76,72,4,0
6,2001,081600,61,60,1,1
7,2001,081600,66,66,0,3
8,2001,081600,61,60,1,0
9,2001,081600,53,51,2,2
10,2001,081600,81,79,2,1
11,2001,081600,70,68,2,0
12,2001,081600,52,52,0,1
1,2002,081600,58,55,3,2
2,2002,081600,47,46,1,2
3,2002,081600,67,65,2,3
4,2002,081600,59,55,4,5
5,2002,081600,62,61,1,0
6,2002,081600,84,82,2,1
7,2002,081600,76,74,2,2
8,2002,081600,75,72,3,0
9,2002,081600,94,92,2,0
10,2002,081600,59,58,1,3
11,2002,081600,61,60,1,1
12,2002,081600,44,44,0,1
1,2003,081600,60,58,2,0
2,2003,081600,62,59,3,4
3,2003,081600,56,56,0,3
4,2003,081600,69,68,1,3
5,2003,081600,45,44,1,3
6,2003,081600,47,47,0,0
7,2003,081600,46,46,0,3
8,2003,081600,61,59,2,2
9,2003,081600,56,53,3,2
10,2003,081600,56,55,1,1
11,2003,081600,57,56,1,2
12,2003,081600,43,41,2,2
1,2004,081600,46,45,1,2
2,2004,081600,54,53,1,4
3,2004,081600,55,55,0,0
4,2004,081600,55,54,1,3
5,2004,081600,58,58,0,2
6,2004,081600,51,51,0,2
7,2004,081600,76,74,2,1
8,2004,081600,47,45,2,3
9,2004,081600,39,38,1,2
10,2004,081600,46,44,2,3
11,2004,081600,43,41,2,2
12,2004,081600,40,39,1,2
1,2005,081600,29,27,2,2
2,2005,081600,37,35,2,1
3,2005,081600,35,34,1,1
4,2005,081600,38,38,0,3
5,2005,081600,52,52,0,6
6,2005,081600,58,50,8,1
7,2005,081600,60,59,1,2
8,2005,081600,65,64,1,1
9,2005,081600,48,47,1,1
10,2005,081600,63,63,0,3
11,2005,081600,41,39,2,3
12,2005,081600,28,27,1,0
1,2006,081600,47,44,3,4
2,2006,081600,38,38,0,1
3,2006,081600,47,41,6,0
4,2006,081600,38,38,0,1
5,2006,081600,59,57,2,3
6,2006,081600,46,46,0,3
7,2006,081600,47,46,1,4
8,2006,081600,47,47,0,1
9,2006,081600,46,46,0,2
10,2006,081600,55,50,5,1
11,2006,081600,55,55,0,3
12,2006,081600,55,51,4,4
1,2007,081600,49,46,3,3
2,2007,081600,36,32,4,1
3,2007,081600,47,45,2,3
4,2007,081600,43,41,2,1
5,2007,081600,53,52,1,3
6,2007,081600,55,54,1,4
7,2007,081600,68,66,2,3
8,2007,081600,55,54,1,1
9,2007,081600,54,53,1,4
10,2007,081600,51,48,3,1
11,2007,081600,40,40,0,1
12,2007,081600,44,43,1,0
1,2008,081600,50,48,2,2
2,2008,081600,52,51,1,2
3,2008,081600,54,53,1,3
4,2008,081600,34,33,1,1
5,2008,081600,68,67,1,4
6,2008,081600,39,37,2,1
7,2008,081600,60,56,4,8
8,2008,081600,50,48,2,2
9,2008,081600,59,55,4,1
10,2008,081600,60,58,2,0
11,2008,081600,61,61,0,0
12,2008,081600,52,49,3,4
1,2009,081600,53,53,0,0
2,2009,081600,51,51,0,1
3,2009,081600,55,55,0,0
4,2009,081600,46,44,2,2
5,2009,081600,42,40,2,0
6,2009,081600,37,36,1,2
7,2009,081600,49,49,0,0
8,2009,081600,55,53,2,0
9,2009,081600,43,42,1,3
10,2009,081600,39,39,0,2
11,2009,081600,34,34,0,1
12,2009,081600,41,41,0,2
1,2010,081600,36,36,0,5
2,2010,081600,34,34,0,8
3,2010,081600,36,35,1,0
4,2010,081600,43,41,2,4
5,2010,081600,48,46,2,1
6,2010,081600,53,52,1,1
7,2010,081600,54,50,4,5
8,2010,081600,54,53,1,6
9,2010,081600,53,49,4,6
10,2010,081600,59,59,0,3
11,2010,081600,29,29,0,2
12,2010,081600,38,34,4,1
1,2011,081600,49,48,1,2
2,2011,081600,39,39,0,2
1,1999,251600,23,17,6,47
2,1999,251600,37,29,8,51
3,1999,251600,35,28,7,57
4,1999,251600,28,21,7,52
5,1999,251600,39,28,11,36
6,1999,251600,27,19,8,30
7,1999,251600,43,30,13,26
8,1999,251600,31,25,6,19
9,1999,251600,29,20,9,29
10,1999,251600,38,31,7,31
11,1999,251600,29,22,7,50
12,1999,251600,31,28,3,49
1,2000,251600,28,22,6,81
2,2000,251600,20,14,6,88
3,2000,251600,25,20,5,68
4,2000,251600,27,17,10,60
5,2000,251600,40,31,9,85
6,2000,251600,39,26,13,84
7,2000,251600,36,26,10,68
8,2000,251600,38,28,10,75
9,2000,251600,44,34,10,87
10,2000,251600,30,22,8,61
11,2000,251600,22,15,7,57
12,2000,251600,35,28,7,100
1,2001,251600,30,19,11,93
2,2001,251600,17,16,1,76
3,2001,251600,33,26,7,72
4,2001,251600,29,24,5,70
5,2001,251600,23,17,6,53
6,2001,251600,20,16,4,51
7,2001,251600,34,32,2,56
8,2001,251600,28,19,9,82
9,2001,251600,33,28,5,60
10,2001,251600,25,15,10,62
11,2001,251600,32,19,13,67
12,2001,251600,17,15,2,68
1,2002,251600,24,21,3,72
2,2002,251600,22,16,6,52
3,2002,251600,29,24,5,59
4,2002,251600,28,21,7,50
5,2002,251600,17,13,4,67
6,2002,251600,24,16,8,42
7,2002,251600,30,23,7,47
8,2002,251600,30,17,13,42
9,2002,251600,30,23,7,31
10,2002,251600,26,24,2,81
11,2002,251600,28,16,12,50
12,2002,251600,23,17,6,47
1,2003,251600,30,24,6,64
2,2003,251600,31,27,4,57
3,2003,251600,24,21,3,50
4,2003,251600,23,16,7,58
5,2003,251600,25,21,4,71
6,2003,251600,33,21,12,47
7,2003,251600,29,24,5,32
8,2003,251600,40,31,9,44
9,2003,251600,25,23,2,31
10,2003,251600,17,13,4,95
11,2003,251600,19,16,3,81
12,2003,251600,25,23,2,34
1,2004,251600,19,15,4,54
2,2004,251600,15,12,3,91
3,2004,251600,16,14,2,64
4,2004,251600,13,9,4,55
5,2004,251600,30,22,8,52
6,2004,251600,33,22,11,46
7,2004,251600,24,18,6,33
8,2004,251600,32,27,5,55
9,2004,251600,32,27,5,39
10,2004,251600,32,29,3,35
11,2004,251600,24,19,5,42
12,2004,251600,20,16,4,46
1,2005,251600,14,13,1,98
2,2005,251600,18,16,2,68
3,2005,251600,18,16,2,68
4,2005,251600,23,13,10,47
5,2005,251600,32,22,10,32
6,2005,251600,22,15,7,42
7,2005,251600,40,31,9,51
8,2005,251600,25,23,2,75
9,2005,251600,21,18,3,40
10,2005,251600,17,14,3,38
11,2005,251600,26,24,2,141
12,2005,251600,22,21,1,108
1,2006,251600,26,24,2,31
2,2006,251600,14,14,0,37
3,2006,251600,22,17,5,39
4,2006,251600,26,22,4,43
5,2006,251600,34,26,8,46
6,2006,251600,26,21,5,31
7,2006,251600,40,32,8,34
8,2006,251600,39,36,3,35
9,2006,251600,33,27,6,56
10,2006,251600,36,26,10,30
11,2006,251600,14,9,5,46
12,2006,251600,22,13,9,34
1,2007,251600,13,13,0,36
2,2007,251600,13,11,2,27
3,2007,251600,24,20,4,45
4,2007,251600,27,21,6,32
5,2007,251600,23,22,1,42
6,2007,251600,17,13,4,44
7,2007,251600,18,15,3,51
8,2007,251600,28,21,7,31
9,2007,251600,31,24,7,46
10,2007,251600,21,13,8,62
11,2007,251600,19,16,3,34
12,2007,251600,26,15,11,45
1,2008,251600,20,15,5,36
2,2008,251600,20,17,3,24
3,2008,251600,16,12,4,38
4,2008,251600,10,9,1,28
5,2008,251600,24,14,10,32
6,2008,251600,21,18,3,33
7,2008,251600,16,15,1,40
8,2008,251600,18,12,6,42
9,2008,251600,24,21,3,22
10,2008,251600,25,19,6,17
11,2008,251600,32,29,3,26
12,2008,251600,21,19,2,52
1,2009,251600,16,15,1,43
2,2009,251600,17,14,3,52
3,2009,251600,20,16,4,32
4,2009,251600,22,19,3,34
5,2009,251600,33,20,13,28
6,2009,251600,30,22,8,28
7,2009,251600,31,25,6,25
8,2009,251600,29,23,6,35
9,2009,251600,29,27,2,27
10,2009,251600,31,26,5,33
11,2009,251600,21,20,1,16
12,2009,251600,33,27,6,35
1,2010,251600,20,20,0,31
2,2010,251600,9,7,2,30
3,2010,251600,20,16,4,58
4,2010,251600,29,24,5,31
5,2010,251600,21,19,2,39
6,2010,251600,36,30,6,44
7,2010,251600,32,24,8,40
8,2010,251600,32,26,6,46
9,2010,251600,22,17,5,25
10,2010,251600,27,24,3,28
11,2010,251600,22,17,5,33
12,2010,251600,24,22,2,25
1,2011,251600,23,20,3,42
2,2011,251600,7,6,1,19
1,1999,842100,35,29,6,36
2,1999,842100,35,32,3,31
3,1999,842100,44,32,12,32
4,1999,842100,42,28,14,78
5,1999,842100,59,45,14,39
6,1999,842100,45,34,11,37
7,1999,842100,67,44,23,22
8,1999,842100,45,33,12,25
9,1999,842100,50,34,16,47
10,1999,842100,49,37,12,28
11,1999,842100,43,29,14,24
12,1999,842100,37,33,4,23
1,2000,842100,46,38,8,23
2,2000,842100,29,20,9,20
3,2000,842100,44,38,6,35
4,2000,842100,49,40,9,56
5,2000,842100,48,40,8,22
6,2000,842100,48,40,8,17
7,2000,842100,46,33,13,21
8,2000,842100,50,42,8,14
9,2000,842100,55,46,9,15
10,2000,842100,49,36,13,12
11,2000,842100,49,40,9,10
12,2000,842100,32,28,4,3
1,2001,842100,53,45,8,15
2,2001,842100,32,25,7,12
3,2001,842100,41,31,10,6
4,2001,842100,50,33,17,13
5,2001,842100,34,21,13,12
6,2001,842100,47,37,10,27
7,2001,842100,47,41,6,16
8,2001,842100,46,33,13,21
9,2001,842100,39,28,11,13
10,2001,842100,58,46,12,17
11,2001,842100,52,41,11,15
12,2001,842100,44,37,7,3
1,2002,842100,56,43,13,14
2,2002,842100,40,32,8,13
3,2002,842100,39,34,5,14
4,2002,842100,51,48,3,39
5,2002,842100,49,40,9,20
6,2002,842100,46,32,14,18
7,2002,842100,45,30,15,16
8,2002,842100,44,29,15,8
9,2002,842100,63,50,13,13
10,2002,842100,46,38,8,11
11,2002,842100,31,23,8,17
12,2002,842100,44,38,6,19
1,2003,842100,31,29,2,36
2,2003,842100,38,28,10,17
3,2003,842100,37,25,12,22
4,2003,842100,47,41,6,23
5,2003,842100,53,42,11,34
6,2003,842100,55,43,12,21
7,2003,842100,67,57,10,24
8,2003,842100,51,43,8,27
9,2003,842100,59,46,13,26
10,2003,842100,64,49,15,76
11,2003,842100,26,25,1,13
12,2003,842100,40,31,9,17
1,2004,842100,28,25,3,19
2,2004,842100,24,18,6,14
3,2004,842100,33,28,5,24
4,2004,842100,39,34,5,32
5,2004,842100,49,41,8,29
6,2004,842100,33,29,4,16
7,2004,842100,41,32,9,24
8,2004,842100,44,38,6,36
9,2004,842100,55,47,8,13
10,2004,842100,59,51,8,36
11,2004,842100,31,26,5,63
12,2004,842100,35,34,1,4
1,2005,842100,30,25,5,18
2,2005,842100,21,16,5,34
3,2005,842100,36,28,8,18
4,2005,842100,41,29,12,17
5,2005,842100,53,42,11,12
6,2005,842100,57,47,10,15
7,2005,842100,47,31,16,22
8,2005,842100,35,29,6,34
9,2005,842100,59,49,10,37
10,2005,842100,47,38,9,24
11,2005,842100,47,40,7,23
12,2005,842100,36,32,4,35
1,2006,842100,36,29,7,19
2,2006,842100,47,44,3,28
3,2006,842100,42,35,7,18
4,2006,842100,37,25,12,30
5,2006,842100,48,34,14,24
6,2006,842100,38,28,10,18
7,2006,842100,46,42,4,59
8,2006,842100,39,36,3,34
9,2006,842100,48,39,9,30
10,2006,842100,44,38,6,35
11,2006,842100,42,38,4,18
12,2006,842100,50,42,8,26
1,2007,842100,45,39,6,15
2,2007,842100,31,28,3,10
3,2007,842100,35,30,5,31
4,2007,842100,53,46,7,22
5,2007,842100,37,31,6,28
6,2007,842100,41,34,7,33
7,2007,842100,34,25,9,40
8,2007,842100,51,38,13,19
9,2007,842100,51,45,6,31
10,2007,842100,39,32,7,27
11,2007,842100,44,39,5,24
12,2007,842100,27,26,1,16
1,2008,842100,32,20,12,19
2,2008,842100,31,28,3,33
3,2008,842100,36,29,7,32
4,2008,842100,50,39,11,97
5,2008,842100,30,26,4,23
6,2008,842100,44,31,13,23
7,2008,842100,54,44,10,18
8,2008,842100,48,39,9,21
9,2008,842100,48,40,8,25
10,2008,842100,45,37,8,37
11,2008,842100,41,31,10,32
12,2008,842100,32,30,2,15
1,2009,842100,31,31,0,20
2,2009,842100,39,34,5,22
3,2009,842100,39,33,6,25
4,2009,842100,30,22,8,21
5,2009,842100,31,25,6,19
6,2009,842100,39,28,11,25
7,2009,842100,37,33,4,21
8,2009,842100,40,32,8,15
9,2009,842100,44,40,4,30
10,2009,842100,46,44,2,35
11,2009,842100,45,35,10,45
12,2009,842100,62,54,8,18
1,2010,842100,41,35,6,30
2,2010,842100,21,12,9,17
3,2010,842100,40,32,8,11
4,2010,842100,34,28,6,15
5,2010,842100,44,37,7,17
6,2010,842100,39,33,6,12
7,2010,842100,45,35,10,16
8,2010,842100,37,32,5,12
9,2010,842100,42,34,8,10
10,2010,842100,44,38,6,17
11,2010,842100,35,30,5,12
12,2010,842100,39,37,2,28
1,2011,842100,29,25,4,10
2,2011,842100,20,15,5,15
1,1999,251700,25,19,6,40
2,1999,251700,12,10,2,31
3,1999,251700,22,12,10,49
4,1999,251700,22,15,7,58
5,1999,251700,28,12,16,52
6,1999,251700,26,13,13,62
7,1999,251700,27,13,14,49
8,1999,251700,22,13,9,46
9,1999,251700,18,16,2,53
10,1999,251700,25,18,7,48
11,1999,251700,19,14,5,34
12,1999,251700,23,18,5,52
1,2000,251700,11,10,1,107
2,2000,251700,23,17,6,99
3,2000,251700,13,9,4,78
4,2000,251700,12,5,7,74
5,2000,251700,25,14,11,80
6,2000,251700,22,7,15,57
7,2000,251700,29,21,8,50
8,2000,251700,22,21,1,60
9,2000,251700,30,23,7,63
10,2000,251700,22,16,6,50
11,2000,251700,17,10,7,62
12,2000,251700,33,29,4,44
1,2001,251700,12,7,5,46
2,2001,251700,14,9,5,43
3,2001,251700,23,13,10,42
4,2001,251700,28,22,6,39
5,2001,251700,28,22,6,63
6,2001,251700,26,20,6,36
7,2001,251700,18,11,7,50
8,2001,251700,35,21,14,40
9,2001,251700,19,10,9,44
10,2001,251700,23,17,6,50
11,2001,251700,20,16,4,42
12,2001,251700,14,13,1,41
1,2002,251700,15,10,5,52
2,2002,251700,19,14,5,40
3,2002,251700,20,14,6,31
4,2002,251700,16,9,7,65
5,2002,251700,29,21,8,47
6,2002,251700,26,19,7,56
7,2002,251700,21,14,7,70
8,2002,251700,34,24,10,44
9,2002,251700,29,18,11,38
10,2002,251700,26,18,8,49
11,2002,251700,14,11,3,57
12,2002,251700,20,16,4,41
1,2003,251700,19,13,6,39
2,2003,251700,14,11,3,26
3,2003,251700,32,25,7,35
4,2003,251700,24,19,5,38
5,2003,251700,20,17,3,24
6,2003,251700,16,13,3,19
7,2003,251700,21,11,10,15
8,2003,251700,27,22,5,36
9,2003,251700,21,15,6,43
10,2003,251700,21,11,10,37
11,2003,251700,20,17,3,37
12,2003,251700,19,15,4,25
1,2004,251700,17,14,3,34
2,2004,251700,12,8,4,41
3,2004,251700,16,10,6,60
4,2004,251700,9,6,3,131
5,2004,251700,23,14,9,24
6,2004,251700,18,17,1,17
7,2004,251700,20,17,3,18
8,2004,251700,19,16,3,40
9,2004,251700,22,17,5,29
10,2004,251700,24,21,3,33
11,2004,251700,14,11,3,33
12,2004,251700,18,12,6,85
1,2005,251700,17,14,3,42
2,2005,251700,9,3,6,65
3,2005,251700,14,10,4,34
4,2005,251700,9,6,3,29
5,2005,251700,16,12,4,40
6,2005,251700,20,18,2,23
7,2005,251700,24,20,4,16
8,2005,251700,28,21,7,32
9,2005,251700,20,16,4,21
10,2005,251700,19,14,5,22
11,2005,251700,17,15,2,27
12,2005,251700,10,8,2,41
1,2006,251700,17,14,3,45
2,2006,251700,22,19,3,76
3,2006,251700,19,17,2,32
4,2006,251700,23,20,3,49
5,2006,251700,24,17,7,44
6,2006,251700,24,19,5,29
7,2006,251700,15,11,4,29
8,2006,251700,18,10,8,43
9,2006,251700,14,12,2,27
10,2006,251700,19,11,8,30
11,2006,251700,12,11,1,39
12,2006,251700,11,9,2,40
1,2007,251700,21,12,9,51
2,2007,251700,8,6,2,38
3,2007,251700,19,14,5,28
4,2007,251700,17,9,8,63
5,2007,251700,29,20,9,44
6,2007,251700,18,16,2,27
7,2007,251700,14,11,3,46
8,2007,251700,11,8,3,44
9,2007,251700,18,8,10,31
10,2007,251700,16,14,2,40
11,2007,251700,11,10,1,28
12,2007,251700,13,10,3,20
1,2008,251700,15,12,3,25
2,2008,251700,11,9,2,23
3,2008,251700,10,9,1,26
4,2008,251700,9,7,2,23
5,2008,251700,14,10,4,26
6,2008,251700,22,18,4,14
7,2008,251700,23,18,5,31
8,2008,251700,20,16,4,20
9,2008,251700,12,10,2,22
10,2008,251700,20,14,6,20
11,2008,251700,19,17,2,20
12,2008,251700,15,13,2,36
1,2009,251700,10,8,2,22
2,2009,251700,13,9,4,32
3,2009,251700,16,12,4,44
4,2009,251700,13,10,3,29
5,2009,251700,25,19,6,23
6,2009,251700,18,12,6,22
7,2009,251700,16,10,6,18
8,2009,251700,21,17,4,14
9,2009,251700,11,9,2,17
10,2009,251700,13,11,2,19
11,2009,251700,12,8,4,21
12,2009,251700,25,22,3,15
1,2010,251700,16,13,3,11
2,2010,251700,16,12,4,10
3,2010,251700,14,12,2,23
4,2010,251700,16,14,2,6
5,2010,251700,14,13,1,18
6,2010,251700,26,22,4,15
7,2010,251700,16,12,4,15
8,2010,251700,15,12,3,10
9,2010,251700,14,13,1,14
10,2010,251700,20,19,1,15
11,2010,251700,7,6,1,12
12,2010,251700,9,8,1,15
1,2011,251700,14,13,1,19
2,2011,251700,10,6,4,14
1,1999,231500,79,57,22,122
2,1999,231500,57,42,15,161
3,1999,231500,77,56,21,152
4,1999,231500,85,60,25,113
5,1999,231500,91,62,29,97
6,1999,231500,62,43,19,91
7,1999,231500,79,51,28,63
8,1999,231500,93,56,37,55
9,1999,231500,70,47,23,140
10,1999,231500,73,51,22,186
11,1999,231500,63,42,21,95
12,1999,231500,56,40,16,106
1,2000,231500,54,43,11,99
2,2000,231500,50,33,17,83
3,2000,231500,62,40,22,221
4,2000,231500,71,43,28,121
5,2000,231500,52,31,21,99
6,2000,231500,76,61,15,81
7,2000,231500,74,51,23,81
8,2000,231500,80,55,25,83
9,2000,231500,68,46,22,63
10,2000,231500,45,33,12,66
11,2000,231500,63,49,14,72
12,2000,231500,35,30,5,50
1,2001,231500,37,28,9,83
2,2001,231500,52,43,9,95
3,2001,231500,53,43,10,83
4,2001,231500,69,45,24,68
5,2001,231500,72,53,19,48
6,2001,231500,82,63,19,39
7,2001,231500,49,36,13,48
8,2001,231500,69,38,31,65
9,2001,231500,58,42,16,49
10,2001,231500,64,45,19,71
11,2001,231500,45,30,15,86
12,2001,231500,52,38,14,80
1,2002,231500,52,38,14,109
2,2002,231500,44,29,15,82
3,2002,231500,58,38,20,88
4,2002,231500,57,32,25,88
5,2002,231500,46,32,14,70
6,2002,231500,72,42,30,48
7,2002,231500,60,41,19,60
8,2002,231500,50,35,15,53
9,2002,231500,79,54,25,52
10,2002,231500,80,58,22,56
11,2002,231500,52,39,13,82
12,2002,231500,39,27,12,77
1,2003,231500,47,33,14,98
2,2003,231500,43,28,15,78
3,2003,231500,46,31,15,62
4,2003,231500,59,43,16,65
5,2003,231500,55,38,17,61
6,2003,231500,59,46,13,61
7,2003,231500,74,53,21,76
8,2003,231500,65,38,27,99
9,2003,231500,52,41,11,44
10,2003,231500,57,50,7,38
11,2003,231500,61,49,12,43
12,2003,231500,49,42,7,48
1,2004,231500,46,39,7,69
2,2004,231500,52,40,12,74
3,2004,231500,50,42,8,69
4,2004,231500,44,36,8,84
5,2004,231500,60,46,14,67
6,2004,231500,58,40,18,95
7,2004,231500,56,35,21,98
8,2004,231500,57,45,12,45
9,2004,231500,63,48,15,58
10,2004,231500,63,52,11,152
11,2004,231500,48,39,9,108
12,2004,231500,60,53,7,108
1,2005,231500,44,34,10,77
2,2005,231500,48,36,12,72
3,2005,231500,52,44,8,91
4,2005,231500,49,35,14,160
5,2005,231500,63,42,21,108
6,2005,231500,56,40,16,90
7,2005,231500,67,50,17,117
8,2005,231500,58,42,16,195
9,2005,231500,54,41,13,276
10,2005,231500,69,53,16,95
11,2005,231500,38,28,10,101
12,2005,231500,45,40,5,80
1,2006,231500,57,49,8,66
2,2006,231500,36,26,10,97
3,2006,231500,61,44,17,90
4,2006,231500,36,22,14,74
5,2006,231500,62,49,13,103
6,2006,231500,55,43,12,71
7,2006,231500,52,36,16,86
8,2006,231500,62,50,12,104
9,2006,231500,39,28,11,109
10,2006,231500,72,58,14,56
11,2006,231500,57,42,15,58
12,2006,231500,56,47,9,67
1,2007,231500,49,40,9,115
2,2007,231500,33,28,5,55
3,2007,231500,55,44,11,78
4,2007,231500,51,35,16,42
5,2007,231500,48,31,17,54
6,2007,231500,56,39,17,65
7,2007,231500,63,44,19,54
8,2007,231500,61,49,12,41
9,2007,231500,47,38,9,44
10,2007,231500,55,36,19,45
11,2007,231500,46,37,9,25
12,2007,231500,47,40,7,28
1,2008,231500,39,34,5,77
2,2008,231500,32,24,8,41
3,2008,231500,29,23,6,35
4,2008,231500,74,55,19,44
5,2008,231500,64,47,17,23
6,2008,231500,70,57,13,31
7,2008,231500,63,51,12,23
8,2008,231500,61,42,19,34
9,2008,231500,68,49,19,17
10,2008,231500,73,56,17,43
11,2008,231500,52,40,12,34
12,2008,231500,51,47,4,29
1,2009,231500,48,41,7,59
2,2009,231500,32,24,8,51
3,2009,231500,56,36,20,64
4,2009,231500,60,44,16,55
5,2009,231500,62,48,14,50
6,2009,231500,39,32,7,56
7,2009,231500,49,33,16,50
8,2009,231500,47,35,12,61
9,2009,231500,41,34,7,78
10,2009,231500,62,50,12,81
11,2009,231500,59,46,13,72
12,2009,231500,45,36,9,55
1,2010,231500,50,42,8,79
2,2010,231500,35,25,10,80
3,2010,231500,50,41,9,106
4,2010,231500,46,32,14,67
5,2010,231500,53,42,11,52
6,2010,231500,41,26,15,63
7,2010,231500,52,43,9,82
8,2010,231500,54,40,14,74
9,2010,231500,40,31,9,73
10,2010,231500,53,40,13,82
11,2010,231500,43,38,5,31
12,2010,231500,33,29,4,62
1,2011,231500,43,38,5,71
2,2011,231500,19,13,6,34
1,1999,836700,21,14,7,10
2,1999,836700,19,17,2,6
3,1999,836700,16,14,2,15
4,1999,836700,24,18,6,6
5,1999,836700,30,23,7,13
6,1999,836700,31,24,7,13
7,1999,836700,32,24,8,3
8,1999,836700,22,14,8,11
9,1999,836700,24,24,0,39
10,1999,836700,19,15,4,13
11,1999,836700,19,14,5,14
12,1999,836700,21,16,5,13
1,2000,836700,11,10,1,90
2,2000,836700,20,14,6,122
3,2000,836700,22,16,6,29
4,2000,836700,14,7,7,23
5,2000,836700,23,16,7,29
6,2000,836700,22,18,4,22
7,2000,836700,25,18,7,9
8,2000,836700,23,14,9,10
9,2000,836700,33,29,4,5
10,2000,836700,20,13,7,12
11,2000,836700,26,21,5,7
12,2000,836700,10,6,4,8
1,2001,836700,15,7,8,11
2,2001,836700,19,15,4,14
3,2001,836700,25,17,8,23
4,2001,836700,31,30,1,8
5,2001,836700,22,14,8,13
6,2001,836700,25,15,10,16
7,2001,836700,18,15,3,12
8,2001,836700,25,18,7,10
9,2001,836700,21,16,5,16
10,2001,836700,28,20,8,10
11,2001,836700,24,18,6,11
12,2001,836700,20,16,4,18
1,2002,836700,29,20,9,20
2,2002,836700,15,15,0,11
3,2002,836700,17,16,1,15
4,2002,836700,21,17,4,13
5,2002,836700,35,26,9,17
6,2002,836700,33,25,8,16
7,2002,836700,21,19,2,26
8,2002,836700,21,13,8,22
9,2002,836700,22,19,3,29
10,2002,836700,29,23,6,17
11,2002,836700,21,16,5,22
12,2002,836700,21,17,4,26
1,2003,836700,20,17,3,22
2,2003,836700,15,13,2,12
3,2003,836700,29,21,8,12
4,2003,836700,31,23,8,17
5,2003,836700,27,23,4,16
6,2003,836700,22,16,6,15
7,2003,836700,29,21,8,16
8,2003,836700,22,21,1,22
9,2003,836700,37,33,4,9
10,2003,836700,35,27,8,13
11,2003,836700,19,15,4,13
12,2003,836700,33,28,5,10
1,2004,836700,26,20,6,16
2,2004,836700,17,16,1,10
3,2004,836700,31,24,7,42
4,2004,836700,30,25,5,17
5,2004,836700,18,16,2,23
6,2004,836700,28,23,5,9
7,2004,836700,29,23,6,6
8,2004,836700,42,36,6,6
9,2004,836700,35,32,3,2
10,2004,836700,35,29,6,3
11,2004,836700,28,23,5,3
12,2004,836700,24,22,2,2
1,2005,836700,25,20,5,13
2,2005,836700,33,28,5,5
3,2005,836700,20,14,6,7
4,2005,836700,24,18,6,11
5,2005,836700,26,17,9,13
6,2005,836700,26,20,6,8
7,2005,836700,34,28,6,10
8,2005,836700,33,29,4,11
9,2005,836700,27,24,3,8
10,2005,836700,17,16,1,19
11,2005,836700,25,20,5,8
12,2005,836700,31,26,5,10
1,2006,836700,28,24,4,19
2,2006,836700,21,16,5,15
3,2006,836700,23,19,4,18
4,2006,836700,23,19,4,9
5,2006,836700,25,18,7,13
6,2006,836700,26,20,6,18
7,2006,836700,34,32,2,26
8,2006,836700,24,20,4,36
9,2006,836700,28,21,7,18
10,2006,836700,21,17,4,17
11,2006,836700,28,25,3,22
12,2006,836700,20,17,3,24
1,2007,836700,29,25,4,22
2,2007,836700,6,6,0,6
3,2007,836700,16,15,1,13
4,2007,836700,31,28,3,55
5,2007,836700,27,21,6,111
6,2007,836700,24,21,3,17
7,2007,836700,39,31,8,19
8,2007,836700,27,24,3,5
9,2007,836700,24,18,6,11
10,2007,836700,26,22,4,13
11,2007,836700,28,25,3,14
12,2007,836700,21,17,4,8
1,2008,836700,18,15,3,13
2,2008,836700,11,10,1,22
3,2008,836700,21,18,3,14
4,2008,836700,19,13,6,14
5,2008,836700,31,25,6,13
6,2008,836700,18,12,6,12
7,2008,836700,27,17,10,31
8,2008,836700,22,16,6,28
9,2008,836700,25,23,2,14
10,2008,836700,28,25,3,24
11,2008,836700,22,20,2,16
12,2008,836700,14,13,1,6
1,2009,836700,19,15,4,17
2,2009,836700,13,12,1,14
3,2009,836700,23,15,8,7
4,2009,836700,18,14,4,10
5,2009,836700,16,10,6,7
6,2009,836700,21,14,7,20
7,2009,836700,27,23,4,18
8,2009,836700,31,23,8,12
9,2009,836700,21,19,2,14
10,2009,836700,21,18,3,14
11,2009,836700,21,15,6,19
12,2009,836700,22,21,1,16
1,2010,836700,15,14,1,12
2,2010,836700,14,12,2,13
3,2010,836700,17,15,2,26
4,2010,836700,31,23,8,19
5,2010,836700,21,17,4,10
6,2010,836700,22,19,3,18
7,2010,836700,23,19,4,5
8,2010,836700,26,20,6,17
9,2010,836700,17,17,0,15
10,2010,836700,19,17,2,5
11,2010,836700,16,14,2,18
12,2010,836700,10,10,0,3
1,2011,836700,19,15,4,6
2,2011,836700,7,6,1,4
1,1999,242900,6,6,0,1
2,1999,242900,4,4,0,6
3,1999,242900,8,7,1,0
4,1999,242900,5,5,0,0
5,1999,242900,8,7,1,0
6,1999,242900,7,5,2,0
7,1999,242900,9,7,2,0
8,1999,242900,11,9,2,2
9,1999,242900,13,10,3,1
10,1999,242900,13,10,3,2
11,1999,242900,8,5,3,2
12,1999,242900,8,6,2,2
1,2000,242900,7,7,0,1
2,2000,242900,7,7,0,5
3,2000,242900,15,11,4,2
4,2000,242900,11,9,2,0
5,2000,242900,10,8,2,3
6,2000,242900,6,5,1,1
7,2000,242900,10,10,0,2
8,2000,242900,17,16,1,1
9,2000,242900,9,9,0,1
10,2000,242900,7,6,1,1
11,2000,242900,10,10,0,1
12,2000,242900,12,12,0,0
1,2001,242900,5,5,0,0
2,2001,242900,8,5,3,1
3,2001,242900,5,5,0,1
4,2001,242900,13,11,2,2
5,2001,242900,17,17,0,1
6,2001,242900,5,5,0,0
7,2001,242900,12,9,3,1
8,2001,242900,18,15,3,1
9,2001,242900,11,9,2,0
10,2001,242900,12,11,1,0
11,2001,242900,10,10,0,0
12,2001,242900,11,9,2,1
1,2002,242900,12,10,2,0
2,2002,242900,6,6,0,1
3,2002,242900,12,10,2,3
4,2002,242900,12,11,1,1
5,2002,242900,19,16,3,0
6,2002,242900,14,14,0,1
7,2002,242900,17,17,0,2
8,2002,242900,20,17,3,4
9,2002,242900,5,3,2,3
10,2002,242900,14,13,1,5
11,2002,242900,20,17,3,1
12,2002,242900,12,11,1,2
1,2003,242900,17,13,4,0
2,2003,242900,13,10,3,0
3,2003,242900,14,12,2,0
4,2003,242900,6,6,0,1
5,2003,242900,10,10,0,0
6,2003,242900,24,23,1,3
7,2003,242900,25,25,0,0
8,2003,242900,12,12,0,0
9,2003,242900,13,13,0,3
10,2003,242900,11,10,1,3
11,2003,242900,13,13,0,0
12,2003,242900,4,4,0,0
1,2004,242900,7,7,0,3
2,2004,242900,7,7,0,0
3,2004,242900,13,13,0,2
4,2004,242900,7,7,0,1
5,2004,242900,12,11,1,1
6,2004,242900,12,12,0,0
7,2004,242900,13,9,4,0
8,2004,242900,10,10,0,1
9,2004,242900,8,8,0,0
10,2004,242900,10,7,3,0
11,2004,242900,9,9,0,2
12,2004,242900,12,11,1,0
1,2005,242900,8,8,0,1
2,2005,242900,6,5,1,1
3,2005,242900,9,9,0,0
4,2005,242900,12,12,0,2
5,2005,242900,12,12,0,2
6,2005,242900,12,12,0,1
7,2005,242900,13,12,1,1
8,2005,242900,10,10,0,1
9,2005,242900,17,17,0,1
10,2005,242900,22,20,2,1
11,2005,242900,15,15,0,0
12,2005,242900,12,11,1,0
1,2006,242900,12,11,1,0
2,2006,242900,12,12,0,0
3,2006,242900,7,7,0,1
4,2006,242900,11,11,0,0
5,2006,242900,7,7,0,0
6,2006,242900,9,8,1,3
7,2006,242900,9,9,0,3
8,2006,242900,16,15,1,0
9,2006,242900,9,9,0,0
10,2006,242900,6,6,0,0
11,2006,242900,12,12,0,0
12,2006,242900,7,7,0,0
1,2007,242900,11,10,1,1
2,2007,242900,4,4,0,0
3,2007,242900,7,7,0,0
4,2007,242900,6,6,0,1
5,2007,242900,9,9,0,0
6,2007,242900,9,9,0,2
7,2007,242900,8,8,0,2
8,2007,242900,14,14,0,1
9,2007,242900,17,16,1,1
10,2007,242900,14,12,2,1
11,2007,242900,17,15,2,0
12,2007,242900,8,8,0,1
1,2008,242900,12,11,1,0
2,2008,242900,7,7,0,3
3,2008,242900,6,6,0,0
4,2008,242900,6,6,0,1
5,2008,242900,14,13,1,0
6,2008,242900,6,6,0,0
7,2008,242900,10,10,0,1
8,2008,242900,7,7,0,1
9,2008,242900,12,10,2,0
10,2008,242900,11,11,0,0
11,2008,242900,14,14,0,0
12,2008,242900,5,5,0,0
1,2009,242900,12,12,0,0
2,2009,242900,5,5,0,0
3,2009,242900,5,4,1,2
4,2009,242900,5,4,1,0
5,2009,242900,6,5,1,0
6,2009,242900,8,8,0,0
7,2009,242900,10,8,2,0
8,2009,242900,11,9,2,1
9,2009,242900,14,13,1,0
10,2009,242900,10,9,1,0
11,2009,242900,5,3,2,1
12,2009,242900,8,8,0,1
1,2010,242900,4,4,0,0
2,2010,242900,4,2,2,1
3,2010,242900,6,4,2,1
4,2010,242900,4,3,1,1
5,2010,242900,9,8,1,1
6,2010,242900,8,7,1,0
7,2010,242900,8,7,1,0
8,2010,242900,5,5,0,0
9,2010,242900,17,16,1,1
10,2010,242900,9,8,1,2
11,2010,242900,4,4,0,0
12,2010,242900,5,5,0,0
1,2011,242900,6,5,1,1
2,2011,242900,1,1,0,1
1,1999,243000,7,6,1,1
2,1999,243000,0,0,0,0
3,1999,243000,10,10,0,0
4,1999,243000,10,9,1,1
5,1999,243000,17,16,1,1
6,1999,243000,17,17,0,0
7,1999,243000,11,11,0,1
8,1999,243000,13,11,2,1
9,1999,243000,6,6,0,0
10,1999,243000,8,8,0,3
11,1999,243000,6,6,0,0
12,1999,243000,13,12,1,0
1,2000,243000,3,3,0,1
2,2000,243000,8,8,0,0
3,2000,243000,10,8,2,3
4,2000,243000,7,6,1,1
5,2000,243000,11,9,2,0
6,2000,243000,10,10,0,9
7,2000,243000,15,15,0,2
8,2000,243000,12,12,0,0
9,2000,243000,10,9,1,1
10,2000,243000,8,7,1,0
11,2000,243000,9,9,0,0
12,2000,243000,5,5,0,4
1,2001,243000,13,12,1,0
2,2001,243000,10,9,1,0
3,2001,243000,13,12,1,0
4,2001,243000,7,6,1,0
5,2001,243000,9,9,0,0
6,2001,243000,15,12,3,0
7,2001,243000,9,8,1,2
8,2001,243000,9,7,2,0
9,2001,243000,14,14,0,0
10,2001,243000,8,8,0,1
11,2001,243000,6,6,0,0
12,2001,243000,8,8,0,0
1,2002,243000,14,12,2,3
2,2002,243000,5,5,0,0
3,2002,243000,11,11,0,0
4,2002,243000,15,14,1,1
5,2002,243000,11,10,1,3
6,2002,243000,14,12,2,1
7,2002,243000,19,17,2,0
8,2002,243000,17,15,2,1
9,2002,243000,12,9,3,1
10,2002,243000,10,9,1,0
11,2002,243000,12,11,1,0
12,2002,243000,9,9,0,0
1,2003,243000,6,6,0,1
2,2003,243000,8,8,0,0
3,2003,243000,17,15,2,0
4,2003,243000,4,4,0,3
5,2003,243000,12,11,1,0
6,2003,243000,17,16,1,1
7,2003,243000,11,10,1,1
8,2003,243000,10,9,1,0
9,2003,243000,6,6,0,2
10,2003,243000,11,10,1,1
11,2003,243000,6,6,0,0
12,2003,243000,13,12,1,0
1,2004,243000,4,4,0,1
2,2004,243000,12,10,2,0
3,2004,243000,9,8,1,0
4,2004,243000,11,11,0,0
5,2004,243000,8,8,0,0
6,2004,243000,14,14,0,0
7,2004,243000,16,15,1,4
8,2004,243000,10,9,1,3
9,2004,243000,14,13,1,2
10,2004,243000,9,6,3,0
11,2004,243000,13,12,1,1
12,2004,243000,9,9,0,0
1,2005,243000,7,7,0,0
2,2005,243000,4,4,0,1
3,2005,243000,11,11,0,1
4,2005,243000,12,12,0,2
5,2005,243000,16,16,0,4
6,2005,243000,11,10,1,0
7,2005,243000,17,16,1,0
8,2005,243000,15,14,1,3
9,2005,243000,8,8,0,3
10,2005,243000,16,16,0,0
11,2005,243000,15,15,0,0
12,2005,243000,7,7,0,0
1,2006,243000,12,10,2,1
2,2006,243000,7,7,0,3
3,2006,243000,10,9,1,0
4,2006,243000,8,7,1,2
5,2006,243000,15,13,2,1
6,2006,243000,10,10,0,3
7,2006,243000,11,11,0,1
8,2006,243000,11,10,1,0
9,2006,243000,14,12,2,0
10,2006,243000,7,6,1,0
11,2006,243000,8,8,0,0
12,2006,243000,9,8,1,1
1,2007,243000,9,8,1,0
2,2007,243000,4,4,0,0
3,2007,243000,8,8,0,1
4,2007,243000,16,16,0,1
5,2007,243000,10,8,2,0
6,2007,243000,9,8,1,0
7,2007,243000,8,7,1,3
8,2007,243000,4,4,0,1
9,2007,243000,6,6,0,1
10,2007,243000,12,11,1,2
11,2007,243000,14,13,1,0
12,2007,243000,16,16,0,0
1,2008,243000,16,16,0,0
2,2008,243000,9,9,0,0
3,2008,243000,5,5,0,0
4,2008,243000,8,8,0,2
5,2008,243000,15,14,1,0
6,2008,243000,13,13,0,0
7,2008,243000,11,10,1,0
8,2008,243000,8,8,0,0
9,2008,243000,12,12,0,0
10,2008,243000,19,17,2,1
11,2008,243000,14,13,1,0
12,2008,243000,7,7,0,0
1,2009,243000,10,9,1,0
2,2009,243000,11,11,0,0
3,2009,243000,4,3,1,0
4,2009,243000,9,9,0,0
5,2009,243000,7,7,0,0
6,2009,243000,5,5,0,0
7,2009,243000,10,10,0,0
8,2009,243000,10,10,0,1
9,2009,243000,10,9,1,1
10,2009,243000,3,3,0,0
11,2009,243000,3,3,0,0
12,2009,243000,10,10,0,0
1,2010,243000,11,8,3,1
2,2010,243000,3,3,0,0
3,2010,243000,8,8,0,0
4,2010,243000,4,4,0,0
5,2010,243000,12,11,1,1
6,2010,243000,11,11,0,1
7,2010,243000,11,10,1,0
8,2010,243000,13,13,0,0
9,2010,243000,8,6,2,0
10,2010,243000,12,12,0,0
11,2010,243000,11,10,1,0
12,2010,243000,3,3,0,0
1,2011,243000,6,6,0,0
2,2011,243000,6,5,1,0
1,1999,081403,33,33,0,1
2,1999,081403,38,37,1,0
3,1999,081403,50,49,1,0
4,1999,081403,45,44,1,0
5,1999,081403,50,49,1,1
6,1999,081403,47,47,0,0
7,1999,081403,65,62,3,0
8,1999,081403,54,54,0,0
9,1999,081403,76,73,3,1
10,1999,081403,52,51,1,0
11,1999,081403,41,41,0,5
12,1999,081403,61,60,1,0
1,2000,081403,39,37,2,1
2,2000,081403,36,35,1,1
3,2000,081403,63,61,2,0
4,2000,081403,34,33,1,3
5,2000,081403,53,51,2,0
6,2000,081403,46,45,1,1
7,2000,081403,67,66,1,1
8,2000,081403,70,68,2,0
9,2000,081403,44,42,2,2
10,2000,081403,59,59,0,1
11,2000,081403,47,47,0,0
12,2000,081403,52,51,1,0
1,2001,081403,48,48,0,1
2,2001,081403,36,36,0,0
3,2001,081403,43,43,0,1
4,2001,081403,50,50,0,0
5,2001,081403,39,38,1,0
6,2001,081403,51,50,1,1
7,2001,081403,54,52,2,1
8,2001,081403,53,53,0,1
9,2001,081403,31,30,1,1
10,2001,081403,39,38,1,2
11,2001,081403,49,48,1,1
12,2001,081403,43,43,0,0
1,2002,081403,50,48,2,0
2,2002,081403,33,32,1,0
3,2002,081403,44,42,2,1
4,2002,081403,30,30,0,1
5,2002,081403,26,26,0,0
6,2002,081403,44,43,1,0
7,2002,081403,60,57,3,0
8,2002,081403,52,50,2,1
9,2002,081403,38,35,3,0
10,2002,081403,44,44,0,0
11,2002,081403,34,33,1,0
12,2002,081403,41,40,1,0
1,2003,081403,38,38,0,0
2,2003,081403,30,30,0,0
3,2003,081403,38,38,0,0
4,2003,081403,31,30,1,0
5,2003,081403,37,37,0,0
6,2003,081403,42,42,0,0
7,2003,081403,39,38,1,0
8,2003,081403,41,40,1,1
9,2003,081403,46,45,1,0
10,2003,081403,43,43,0,0
11,2003,081403,56,56,0,1
12,2003,081403,52,51,1,0
1,2004,081403,45,45,0,1
2,2004,081403,29,29,0,0
3,2004,081403,32,31,1,0
4,2004,081403,35,35,0,0
5,2004,081403,41,41,0,0
6,2004,081403,44,44,0,0
7,2004,081403,48,47,1,1
8,2004,081403,49,45,4,1
9,2004,081403,41,40,1,1
10,2004,081403,41,39,2,0
11,2004,081403,32,31,1,0
12,2004,081403,42,42,0,0
1,2005,081403,33,32,1,0
2,2005,081403,26,25,1,0
3,2005,081403,28,28,0,1
4,2005,081403,53,53,0,2
5,2005,081403,38,38,0,1
6,2005,081403,24,24,0,0
7,2005,081403,48,48,0,0
8,2005,081403,25,25,0,0
9,2005,081403,52,51,1,1
10,2005,081403,45,44,1,0
11,2005,081403,43,43,0,0
12,2005,081403,36,34,2,0
1,2006,081403,29,29,0,0
2,2006,081403,36,36,0,0
3,2006,081403,40,37,3,0
4,2006,081403,43,42,1,0
5,2006,081403,49,48,1,0
6,2006,081403,51,51,0,1
7,2006,081403,51,50,1,2
8,2006,081403,48,48,0,0
9,2006,081403,47,46,1,0
10,2006,081403,37,37,0,0
11,2006,081403,47,47,0,1
12,2006,081403,48,48,0,0
1,2007,081403,36,36,0,0
2,2007,081403,43,40,3,0
3,2007,081403,44,44,0,0
4,2007,081403,38,38,0,0
5,2007,081403,55,54,1,0
6,2007,081403,52,52,0,0
7,2007,081403,52,52,0,1
8,2007,081403,59,58,1,0
9,2007,081403,36,36,0,0
10,2007,081403,29,27,2,0
11,2007,081403,44,43,1,0
12,2007,081403,36,36,0,0
1,2008,081403,38,37,1,0
2,2008,081403,38,37,1,0
3,2008,081403,40,38,2,1
4,2008,081403,38,38,0,1
5,2008,081403,47,47,0,2
6,2008,081403,50,50,0,1
7,2008,081403,54,53,1,0
8,2008,081403,51,49,2,0
9,2008,081403,40,40,0,0
10,2008,081403,58,58,0,0
11,2008,081403,38,38,0,0
12,2008,081403,34,34,0,0
1,2009,081403,39,38,1,1
2,2009,081403,33,33,0,0
3,2009,081403,32,32,0,0
4,2009,081403,33,32,1,0
5,2009,081403,36,36,0,0
6,2009,081403,38,37,1,2
7,2009,081403,48,48,0,0
8,2009,081403,51,51,0,1
9,2009,081403,45,45,0,0
10,2009,081403,36,36,0,0
11,2009,081403,37,36,1,1
12,2009,081403,29,29,0,0
1,2010,081403,35,35,0,1
2,2010,081403,18,17,1,0
3,2010,081403,39,38,1,2
4,2010,081403,33,33,0,0
5,2010,081403,26,26,0,0
6,2010,081403,23,23,0,0
7,2010,081403,46,46,0,0
8,2010,081403,41,41,0,2
9,2010,081403,38,38,0,0
10,2010,081403,40,40,0,1
11,2010,081403,38,38,0,0
12,2010,081403,24,24,0,0
1,2011,081403,32,32,0,0
2,2011,081403,20,20,0,0
1,1999,842300,49,47,2,2
2,1999,842300,53,47,6,2
3,1999,842300,60,58,2,3
4,1999,842300,62,60,2,5
5,1999,842300,65,62,3,7
6,1999,842300,49,47,2,4
7,1999,842300,71,65,6,4
8,1999,842300,75,71,4,2
9,1999,842300,55,52,3,2
10,1999,842300,78,77,1,4
11,1999,842300,73,66,7,5
12,1999,842300,78,77,1,0
1,2000,842300,97,96,1,0
2,2000,842300,66,63,3,5
3,2000,842300,77,74,3,1
4,2000,842300,60,54,6,1
5,2000,842300,69,64,5,4
6,2000,842300,69,66,3,3
7,2000,842300,78,72,6,1
8,2000,842300,97,92,5,0
9,2000,842300,77,72,5,1
10,2000,842300,108,104,4,2
11,2000,842300,88,87,1,0
12,2000,842300,83,79,4,2
1,2001,842300,92,89,3,2
2,2001,842300,65,60,5,4
3,2001,842300,68,60,8,2
4,2001,842300,72,69,3,2
5,2001,842300,70,65,5,4
6,2001,842300,78,74,4,1
7,2001,842300,78,74,4,1
8,2001,842300,79,76,3,2
9,2001,842300,83,77,6,1
10,2001,842300,79,75,4,3
11,2001,842300,61,58,3,0
12,2001,842300,60,59,1,0
1,2002,842300,60,58,2,3
2,2002,842300,47,46,1,1
3,2002,842300,42,39,3,2
4,2002,842300,53,47,6,3
5,2002,842300,60,55,5,1
6,2002,842300,56,53,3,1
7,2002,842300,64,62,2,4
8,2002,842300,80,74,6,1
9,2002,842300,68,67,1,0
10,2002,842300,79,75,4,2
11,2002,842300,66,65,1,3
12,2002,842300,76,73,3,1
1,2003,842300,47,42,5,1
2,2003,842300,40,40,0,1
3,2003,842300,63,59,4,0
4,2003,842300,55,51,4,5
5,2003,842300,51,51,0,2
6,2003,842300,54,50,4,1
7,2003,842300,64,58,6,1
8,2003,842300,72,68,4,3
9,2003,842300,58,53,5,3
10,2003,842300,51,48,3,1
11,2003,842300,61,59,2,5
12,2003,842300,48,43,5,2
1,2004,842300,44,44,0,2
2,2004,842300,45,42,3,1
3,2004,842300,50,45,5,0
4,2004,842300,45,42,3,1
5,2004,842300,50,46,4,1
6,2004,842300,55,49,6,3
7,2004,842300,62,60,2,0
8,2004,842300,58,56,2,0
9,2004,842300,63,60,3,3
10,2004,842300,72,69,3,2
11,2004,842300,64,62,2,1
12,2004,842300,50,49,1,1
1,2005,842300,49,47,2,0
2,2005,842300,41,39,2,0
3,2005,842300,61,61,0,2
4,2005,842300,43,41,2,5
5,2005,842300,54,51,3,2
6,2005,842300,51,48,3,1
7,2005,842300,63,57,6,1
8,2005,842300,61,58,3,3
9,2005,842300,61,59,2,1
10,2005,842300,59,57,2,0
11,2005,842300,60,56,4,2
12,2005,842300,44,42,2,2
1,2006,842300,53,51,2,1
2,2006,842300,41,40,1,4
3,2006,842300,48,45,3,2
4,2006,842300,53,51,2,1
5,2006,842300,68,64,4,2
6,2006,842300,67,65,2,2
7,2006,842300,49,48,1,4
8,2006,842300,58,56,2,1
9,2006,842300,45,45,0,3
10,2006,842300,41,41,0,0
11,2006,842300,40,40,0,3
12,2006,842300,51,48,3,2
1,2007,842300,41,41,0,0
2,2007,842300,32,30,2,2
3,2007,842300,41,41,0,0
4,2007,842300,32,30,2,2
5,2007,842300,54,51,3,0
6,2007,842300,52,50,2,2
7,2007,842300,46,45,1,0
8,2007,842300,62,61,1,3
9,2007,842300,62,58,4,4
10,2007,842300,59,56,3,1
11,2007,842300,44,42,2,0
12,2007,842300,46,43,3,5
1,2008,842300,56,55,1,0
2,2008,842300,43,40,3,2
3,2008,842300,56,54,2,1
4,2008,842300,55,52,3,1
5,2008,842300,62,60,2,2
6,2008,842300,46,43,3,0
7,2008,842300,55,54,1,1
8,2008,842300,60,58,2,1
9,2008,842300,55,53,2,1
10,2008,842300,84,83,1,1
11,2008,842300,65,60,5,3
12,2008,842300,68,65,3,0
1,2009,842300,64,63,1,1
2,2009,842300,55,55,0,4
3,2009,842300,52,51,1,3
4,2009,842300,47,45,2,1
5,2009,842300,48,46,2,0
6,2009,842300,54,51,3,3
7,2009,842300,50,48,2,2
8,2009,842300,52,51,1,1
9,2009,842300,40,38,2,3
10,2009,842300,62,59,3,1
11,2009,842300,53,52,1,1
12,2009,842300,42,40,2,2
1,2010,842300,50,47,3,0
2,2010,842300,31,29,2,1
3,2010,842300,50,48,2,0
4,2010,842300,44,44,0,0
5,2010,842300,46,45,1,2
6,2010,842300,60,58,2,2
7,2010,842300,56,54,2,0
8,2010,842300,57,55,2,0
9,2010,842300,62,60,2,1
10,2010,842300,75,74,1,0
11,2010,842300,56,54,2,7
12,2010,842300,28,28,0,1
1,2011,842300,43,42,1,4
2,2011,842300,23,21,2,1
1,1999,243200,14,12,2,7
2,1999,243200,11,11,0,5
3,1999,243200,11,8,3,3
4,1999,243200,17,16,1,6
5,1999,243200,17,14,3,1
6,1999,243200,15,15,0,6
7,1999,243200,15,15,0,9
8,1999,243200,20,19,1,5
9,1999,243200,19,16,3,9
10,1999,243200,24,21,3,3
11,1999,243200,24,23,1,8
12,1999,243200,14,13,1,8
1,2000,243200,17,16,1,5
2,2000,243200,12,12,0,1
3,2000,243200,26,22,4,7
4,2000,243200,20,18,2,1
5,2000,243200,23,22,1,3
6,2000,243200,15,13,2,3
7,2000,243200,24,20,4,3
8,2000,243200,12,10,2,3
9,2000,243200,13,11,2,3
10,2000,243200,8,7,1,3
11,2000,243200,21,19,2,3
12,2000,243200,5,4,1,2
1,2001,243200,16,14,2,3
2,2001,243200,14,11,3,8
3,2001,243200,14,10,4,5
4,2001,243200,5,5,0,5
5,2001,243200,10,9,1,3
6,2001,243200,11,8,3,2
7,2001,243200,17,16,1,0
8,2001,243200,17,16,1,1
9,2001,243200,19,18,1,6
10,2001,243200,16,13,3,3
11,2001,243200,10,9,1,3
12,2001,243200,11,9,2,0
1,2002,243200,16,13,3,0
2,2002,243200,14,11,3,1
3,2002,243200,12,12,0,1
4,2002,243200,16,15,1,0
5,2002,243200,16,15,1,2
6,2002,243200,13,12,1,2
7,2002,243200,21,18,3,0
8,2002,243200,20,17,3,3
9,2002,243200,22,21,1,1
10,2002,243200,6,6,0,1
11,2002,243200,16,15,1,1
12,2002,243200,6,5,1,0
1,2003,243200,10,8,2,4
2,2003,243200,10,9,1,0
3,2003,243200,15,14,1,1
4,2003,243200,16,13,3,1
5,2003,243200,9,8,1,1
6,2003,243200,11,10,1,0
7,2003,243200,13,12,1,2
8,2003,243200,14,13,1,4
9,2003,243200,12,11,1,0
10,2003,243200,14,12,2,0
11,2003,243200,14,14,0,0
12,2003,243200,11,10,1,0
1,2004,243200,12,12,0,0
2,2004,243200,8,6,2,3
3,2004,243200,14,13,1,0
4,2004,243200,9,9,0,3
5,2004,243200,16,15,1,0
6,2004,243200,16,15,1,0
7,2004,243200,13,11,2,1
8,2004,243200,18,15,3,0
9,2004,243200,4,4,0,0
10,2004,243200,6,4,2,2
11,2004,243200,9,8,1,0
12,2004,243200,6,6,0,0
1,2005,243200,4,4,0,0
2,2005,243200,11,9,2,0
3,2005,243200,2,2,0,2
4,2005,243200,13,11,2,3
5,2005,243200,8,8,0,0
6,2005,243200,9,9,0,0
7,2005,243200,11,10,1,0
8,2005,243200,10,9,1,2
9,2005,243200,7,6,1,3
10,2005,243200,15,14,1,0
11,2005,243200,15,12,3,1
12,2005,243200,8,8,0,0
1,2006,243200,18,15,3,0
2,2006,243200,6,6,0,0
3,2006,243200,11,11,0,1
4,2006,243200,14,13,1,2
5,2006,243200,11,7,4,0
6,2006,243200,2,2,0,0
7,2006,243200,12,11,1,0
8,2006,243200,12,10,2,0
9,2006,243200,12,10,2,1
10,2006,243200,8,8,0,0
11,2006,243200,10,10,0,0
12,2006,243200,13,12,1,2
1,2007,243200,6,4,2,0
2,2007,243200,7,6,1,1
3,2007,243200,5,4,1,0
4,2007,243200,11,11,0,2
5,2007,243200,6,6,0,0
6,2007,243200,9,8,1,0
7,2007,243200,8,8,0,0
8,2007,243200,4,4,0,1
9,2007,243200,8,8,0,4
10,2007,243200,13,12,1,0
11,2007,243200,25,25,0,0
12,2007,243200,14,13,1,1
1,2008,243200,11,9,2,1
2,2008,243200,8,6,2,1
3,2008,243200,13,12,1,3
4,2008,243200,7,6,1,2
5,2008,243200,15,12,3,2
6,2008,243200,14,14,0,1
7,2008,243200,16,16,0,2
8,2008,243200,19,19,0,0
9,2008,243200,7,6,1,2
10,2008,243200,13,12,1,0
11,2008,243200,6,6,0,0
12,2008,243200,7,7,0,0
1,2009,243200,12,11,1,4
2,2009,243200,15,13,2,0
3,2009,243200,7,7,0,1
4,2009,243200,8,8,0,1
5,2009,243200,17,16,1,0
6,2009,243200,11,10,1,0
7,2009,243200,13,13,0,1
8,2009,243200,11,11,0,0
9,2009,243200,11,11,0,3
10,2009,243200,15,14,1,2
11,2009,243200,3,3,0,2
12,2009,243200,4,4,0,0
1,2010,243200,10,10,0,1
2,2010,243200,3,3,0,0
3,2010,243200,9,9,0,0
4,2010,243200,6,5,1,2
5,2010,243200,8,4,4,1
6,2010,243200,17,15,2,0
7,2010,243200,17,14,3,0
8,2010,243200,8,8,0,0
9,2010,243200,7,6,1,1
10,2010,243200,18,16,2,1
11,2010,243200,13,12,1,0
12,2010,243200,5,5,0,0
1,2011,243200,4,3,1,0
2,2011,243200,4,3,1,0
1,1999,081500,58,58,0,2
2,1999,081500,43,43,0,1
3,1999,081500,57,57,0,1
4,1999,081500,57,57,0,0
5,1999,081500,59,59,0,3
6,1999,081500,69,69,0,0
7,1999,081500,111,107,4,0
8,1999,081500,62,60,2,1
9,1999,081500,57,57,0,0
10,1999,081500,101,99,2,0
11,1999,081500,61,61,0,2
12,1999,081500,86,86,0,0
1,2000,081500,64,64,0,0
2,2000,081500,64,64,0,0
3,2000,081500,73,72,1,2
4,2000,081500,70,69,1,0
5,2000,081500,69,69,0,2
6,2000,081500,76,73,3,1
7,2000,081500,88,86,2,2
8,2000,081500,82,81,1,0
9,2000,081500,57,54,3,0
10,2000,081500,82,81,1,0
11,2000,081500,83,83,0,2
12,2000,081500,72,71,1,1
1,2001,081500,69,67,2,0
2,2001,081500,59,58,1,0
3,2001,081500,74,72,2,0
4,2001,081500,72,71,1,1
5,2001,081500,60,57,3,0
6,2001,081500,83,82,1,0
7,2001,081500,76,73,3,1
8,2001,081500,75,74,1,3
9,2001,081500,61,61,0,0
10,2001,081500,61,59,2,0
11,2001,081500,46,46,0,0
12,2001,081500,75,75,0,1
1,2002,081500,52,51,1,1
2,2002,081500,42,41,1,0
3,2002,081500,60,59,1,0
4,2002,081500,64,60,4,0
5,2002,081500,74,74,0,3
6,2002,081500,61,61,0,0
7,2002,081500,62,61,1,0
8,2002,081500,54,52,2,0
9,2002,081500,63,63,0,0
10,2002,081500,50,50,0,0
11,2002,081500,49,48,1,1
12,2002,081500,64,64,0,0
1,2003,081500,47,47,0,0
2,2003,081500,42,41,1,0
3,2003,081500,48,45,3,0
4,2003,081500,49,48,1,0
5,2003,081500,41,41,0,0
6,2003,081500,46,45,1,0
7,2003,081500,49,49,0,0
8,2003,081500,57,57,0,1
9,2003,081500,52,52,0,1
10,2003,081500,57,57,0,0
11,2003,081500,48,48,0,0
12,2003,081500,53,53,0,0
1,2004,081500,27,27,0,1
2,2004,081500,41,41,0,0
3,2004,081500,50,50,0,2
4,2004,081500,35,34,1,0
5,2004,081500,46,46,0,0
6,2004,081500,52,52,0,1
7,2004,081500,74,74,0,1
8,2004,081500,58,58,0,1
9,2004,081500,50,48,2,1
10,2004,081500,64,63,1,0
11,2004,081500,43,43,0,1
12,2004,081500,44,44,0,0
1,2005,081500,28,27,1,0
2,2005,081500,31,31,0,1
3,2005,081500,26,23,3,0
4,2005,081500,32,30,2,0
5,2005,081500,42,42,0,0
6,2005,081500,52,52,0,1
7,2005,081500,47,46,1,0
8,2005,081500,43,42,1,0
9,2005,081500,33,32,1,0
10,2005,081500,39,38,1,0
11,2005,081500,39,39,0,1
12,2005,081500,41,40,1,1
1,2006,081500,24,23,1,0
2,2006,081500,26,26,0,3
3,2006,081500,32,32,0,0
4,2006,081500,31,31,0,2
5,2006,081500,34,34,0,0
6,2006,081500,42,41,1,2
7,2006,081500,41,40,1,0
8,2006,081500,36,35,1,2
9,2006,081500,35,35,0,1
10,2006,081500,34,34,0,0
11,2006,081500,30,30,0,1
12,2006,081500,48,48,0,0
1,2007,081500,30,30,0,3
2,2007,081500,16,15,1,0
3,2007,081500,28,28,0,0
4,2007,081500,39,39,0,2
5,2007,081500,48,47,1,0
6,2007,081500,44,44,0,0
7,2007,081500,31,31,0,3
8,2007,081500,35,35,0,1
9,2007,081500,34,34,0,0
10,2007,081500,22,22,0,1
11,2007,081500,40,38,2,3
12,2007,081500,45,44,1,0
1,2008,081500,29,27,2,0
2,2008,081500,28,27,1,0
3,2008,081500,37,37,0,0
4,2008,081500,39,38,1,0
5,2008,081500,46,45,1,2
6,2008,081500,61,58,3,0
7,2008,081500,66,66,0,0
8,2008,081500,55,55,0,0
9,2008,081500,38,37,1,1
10,2008,081500,40,40,0,1
11,2008,081500,51,51,0,1
12,2008,081500,46,46,0,0
1,2009,081500,40,39,1,0
2,2009,081500,29,29,0,2
3,2009,081500,32,31,1,1
4,2009,081500,35,34,1,1
5,2009,081500,50,49,1,2
6,2009,081500,39,39,0,1
7,2009,081500,48,48,0,1
8,2009,081500,52,52,0,0
9,2009,081500,50,48,2,1
10,2009,081500,38,35,3,1
11,2009,081500,43,42,1,1
12,2009,081500,47,47,0,2
1,2010,081500,44,44,0,2
2,2010,081500,37,37,0,1
3,2010,081500,30,30,0,2
4,2010,081500,42,38,4,2
5,2010,081500,45,45,0,0
6,2010,081500,33,32,1,0
7,2010,081500,56,56,0,0
8,2010,081500,46,44,2,2
9,2010,081500,43,42,1,0
10,2010,081500,42,42,0,1
11,2010,081500,46,45,1,0
12,2010,081500,46,46,0,0
1,2011,081500,35,35,0,1
2,2011,081500,17,16,1,0
1,1999,243400,12,12,0,3
2,1999,243400,12,10,2,3
3,1999,243400,15,12,3,0
4,1999,243400,18,15,3,2
5,1999,243400,8,5,3,4
6,1999,243400,14,14,0,12
7,1999,243400,17,15,2,2
8,1999,243400,14,14,0,0
9,1999,243400,10,7,3,1
10,1999,243400,8,7,1,3
11,1999,243400,6,6,0,2
12,1999,243400,14,12,2,2
1,2000,243400,8,8,0,7
2,2000,243400,11,10,1,2
3,2000,243400,11,11,0,1
4,2000,243400,20,20,0,1
5,2000,243400,15,13,2,1
6,2000,243400,15,11,4,2
7,2000,243400,14,12,2,1
8,2000,243400,21,19,2,1
9,2000,243400,17,15,2,0
10,2000,243400,13,13,0,2
11,2000,243400,15,14,1,0
12,2000,243400,11,10,1,2
1,2001,243400,16,15,1,1
2,2001,243400,9,8,1,1
3,2001,243400,12,12,0,3
4,2001,243400,15,14,1,1
5,2001,243400,18,16,2,1
6,2001,243400,15,14,1,1
7,2001,243400,19,17,2,0
8,2001,243400,16,15,1,3
9,2001,243400,10,9,1,3
10,2001,243400,25,24,1,1
11,2001,243400,17,15,2,1
12,2001,243400,9,8,1,1
1,2002,243400,25,25,0,0
2,2002,243400,14,10,4,0
3,2002,243400,19,17,2,1
4,2002,243400,15,10,5,0
5,2002,243400,11,11,0,2
6,2002,243400,10,10,0,0
7,2002,243400,17,16,1,1
8,2002,243400,15,13,2,1
9,2002,243400,14,12,2,0
10,2002,243400,20,20,0,0
11,2002,243400,12,11,1,0
12,2002,243400,20,18,2,1
1,2003,243400,13,13,0,1
2,2003,243400,9,7,2,1
3,2003,243400,14,14,0,0
4,2003,243400,14,13,1,1
5,2003,243400,13,13,0,2
6,2003,243400,9,8,1,1
7,2003,243400,23,18,5,1
8,2003,243400,20,17,3,3
9,2003,243400,9,8,1,0
10,2003,243400,18,16,2,2
11,2003,243400,13,12,1,1
12,2003,243400,19,18,1,0
1,2004,243400,10,9,1,1
2,2004,243400,10,8,2,0
3,2004,243400,14,14,0,0
4,2004,243400,22,22,0,2
5,2004,243400,14,12,2,2
6,2004,243400,12,11,1,1
7,2004,243400,16,15,1,1
8,2004,243400,24,20,4,4
9,2004,243400,16,14,2,2
10,2004,243400,15,13,2,2
11,2004,243400,25,24,1,0
12,2004,243400,14,14,0,1
1,2005,243400,18,16,2,2
2,2005,243400,14,14,0,3
3,2005,243400,18,14,4,0
4,2005,243400,12,11,1,3
5,2005,243400,7,5,2,1
6,2005,243400,19,18,1,0
7,2005,243400,25,24,1,2
8,2005,243400,26,24,2,4
9,2005,243400,19,18,1,0
10,2005,243400,13,11,2,3
11,2005,243400,16,15,1,2
12,2005,243400,15,13,2,2
1,2006,243400,12,10,2,0
2,2006,243400,18,17,1,1
3,2006,243400,15,14,1,1
4,2006,243400,7,7,0,0
5,2006,243400,7,7,0,0
6,2006,243400,17,17,0,0
7,2006,243400,13,11,2,7
8,2006,243400,27,26,1,1
9,2006,243400,22,22,0,4
10,2006,243400,14,13,1,4
11,2006,243400,4,4,0,3
12,2006,243400,10,10,0,1
1,2007,243400,16,15,1,0
2,2007,243400,5,5,0,1
3,2007,243400,10,9,1,1
4,2007,243400,13,13,0,1
5,2007,243400,16,15,1,0
6,2007,243400,18,15,3,2
7,2007,243400,13,12,1,0
8,2007,243400,22,21,1,0
9,2007,243400,20,18,2,0
10,2007,243400,15,15,0,1
11,2007,243400,14,14,0,1
12,2007,243400,13,13,0,0
1,2008,243400,13,13,0,0
2,2008,243400,8,8,0,0
3,2008,243400,15,15,0,1
4,2008,243400,23,22,1,0
5,2008,243400,20,19,1,1
6,2008,243400,9,9,0,1
7,2008,243400,11,9,2,0
8,2008,243400,22,22,0,0
9,2008,243400,12,12,0,0
10,2008,243400,13,13,0,1
11,2008,243400,9,9,0,1
12,2008,243400,14,14,0,2
1,2009,243400,12,12,0,1
2,2009,243400,13,12,1,2
3,2009,243400,17,16,1,2
4,2009,243400,12,12,0,4
5,2009,243400,9,9,0,1
6,2009,243400,11,11,0,0
7,2009,243400,18,15,3,2
8,2009,243400,12,10,2,0
9,2009,243400,12,12,0,2
10,2009,243400,9,9,0,3
11,2009,243400,13,13,0,0
12,2009,243400,11,9,2,0
1,2010,243400,10,10,0,1
2,2010,243400,5,5,0,1
3,2010,243400,11,9,2,0
4,2010,243400,9,6,3,1
5,2010,243400,13,12,1,1
6,2010,243400,11,9,2,0
7,2010,243400,22,19,3,0
8,2010,243400,23,22,1,1
9,2010,243400,14,13,1,4
10,2010,243400,25,23,2,1
11,2010,243400,15,15,0,2
12,2010,243400,8,8,0,0
1,2011,243400,14,14,0,2
2,2011,243400,7,7,0,2
1,1999,243300,9,8,1,0
2,1999,243300,7,6,1,1
3,1999,243300,13,12,1,0
4,1999,243300,18,17,1,0
5,1999,243300,14,13,1,1
6,1999,243300,17,12,5,0
7,1999,243300,11,10,1,3
8,1999,243300,19,19,0,0
9,1999,243300,10,10,0,2
10,1999,243300,14,11,3,0
11,1999,243300,11,7,4,0
12,1999,243300,16,14,2,0
1,2000,243300,15,15,0,1
2,2000,243300,15,15,0,3
3,2000,243300,12,11,1,1
4,2000,243300,9,9,0,0
5,2000,243300,11,10,1,1
6,2000,243300,11,9,2,0
7,2000,243300,13,13,0,0
8,2000,243300,20,17,3,0
9,2000,243300,8,6,2,0
10,2000,243300,15,11,4,4
11,2000,243300,8,7,1,2
12,2000,243300,5,4,1,0
1,2001,243300,14,12,2,0
2,2001,243300,7,3,4,0
3,2001,243300,12,11,1,0
4,2001,243300,10,10,0,0
5,2001,243300,16,12,4,0
6,2001,243300,14,11,3,0
7,2001,243300,11,9,2,1
8,2001,243300,16,13,3,3
9,2001,243300,17,16,1,1
10,2001,243300,11,11,0,0
11,2001,243300,11,8,3,2
12,2001,243300,5,5,0,1
1,2002,243300,9,9,0,1
2,2002,243300,17,16,1,1
3,2002,243300,10,10,0,0
4,2002,243300,12,9,3,0
5,2002,243300,14,12,2,1
6,2002,243300,16,13,3,1
7,2002,243300,17,14,3,1
8,2002,243300,18,15,3,1
9,2002,243300,15,12,3,0
10,2002,243300,17,16,1,0
11,2002,243300,15,14,1,0
12,2002,243300,9,8,1,0
1,2003,243300,10,9,1,0
2,2003,243300,12,11,1,0
3,2003,243300,9,8,1,0
4,2003,243300,11,11,0,0
5,2003,243300,11,11,0,1
6,2003,243300,8,7,1,0
7,2003,243300,17,16,1,0
8,2003,243300,13,12,1,0
9,2003,243300,14,11,3,0
10,2003,243300,20,20,0,4
11,2003,243300,14,14,0,0
12,2003,243300,18,17,1,0
1,2004,243300,10,9,1,0
2,2004,243300,19,17,2,1
3,2004,243300,8,7,1,3
4,2004,243300,12,10,2,0
5,2004,243300,13,13,0,0
6,2004,243300,16,12,4,0
7,2004,243300,19,17,2,2
8,2004,243300,12,12,0,2
9,2004,243300,14,12,2,0
10,2004,243300,7,7,0,0
11,2004,243300,13,13,0,1
12,2004,243300,11,11,0,0
1,2005,243300,8,8,0,0
2,2005,243300,13,12,1,0
3,2005,243300,10,10,0,1
4,2005,243300,4,4,0,0
5,2005,243300,10,8,2,2
6,2005,243300,13,11,2,0
7,2005,243300,15,14,1,0
8,2005,243300,20,20,0,1
9,2005,243300,25,25,0,1
10,2005,243300,10,9,1,3
11,2005,243300,11,8,3,2
12,2005,243300,11,11,0,3
1,2006,243300,10,10,0,3
2,2006,243300,13,13,0,2
3,2006,243300,20,19,1,3
4,2006,243300,18,17,1,2
5,2006,243300,9,8,1,3
6,2006,243300,19,18,1,0
7,2006,243300,21,19,2,1
8,2006,243300,32,29,3,0
9,2006,243300,13,12,1,2
10,2006,243300,10,10,0,2
11,2006,243300,21,21,0,0
12,2006,243300,7,7,0,2
1,2007,243300,11,10,1,2
2,2007,243300,5,5,0,0
3,2007,243300,10,9,1,2
4,2007,243300,9,9,0,0
5,2007,243300,12,11,1,0
6,2007,243300,19,18,1,2
7,2007,243300,18,17,1,1
8,2007,243300,16,15,1,0
9,2007,243300,10,9,1,1
10,2007,243300,13,13,0,1
11,2007,243300,14,12,2,1
12,2007,243300,17,17,0,1
1,2008,243300,15,15,0,0
2,2008,243300,11,11,0,1
3,2008,243300,11,11,0,0
4,2008,243300,12,12,0,0
5,2008,243300,13,13,0,1
6,2008,243300,11,11,0,0
7,2008,243300,16,16,0,1
8,2008,243300,15,15,0,0
9,2008,243300,12,12,0,1
10,2008,243300,13,12,1,1
11,2008,243300,14,14,0,0
12,2008,243300,12,12,0,0
1,2009,243300,14,14,0,3
2,2009,243300,27,27,0,0
3,2009,243300,7,7,0,0
4,2009,243300,10,10,0,0
5,2009,243300,8,7,1,0
6,2009,243300,13,12,1,0
7,2009,243300,5,5,0,0
8,2009,243300,10,10,0,0
9,2009,243300,7,6,1,1
10,2009,243300,13,12,1,1
11,2009,243300,10,9,1,0
12,2009,243300,19,18,1,0
1,2010,243300,16,16,0,1
2,2010,243300,9,9,0,1
3,2010,243300,17,17,0,1
4,2010,243300,8,8,0,0
5,2010,243300,13,11,2,2
6,2010,243300,12,12,0,0
7,2010,243300,10,10,0,1
8,2010,243300,15,14,1,7
9,2010,243300,17,17,0,1
10,2010,243300,12,12,0,2
11,2010,243300,11,11,0,1
12,2010,243300,7,7,0,0
1,2011,243300,11,11,0,2
2,2011,243300,6,6,0,1
1,1999,243500,36,35,1,2
2,1999,243500,41,39,2,1
3,1999,243500,38,37,1,3
4,1999,243500,39,36,3,0
5,1999,243500,41,38,3,1
6,1999,243500,50,48,2,5
7,1999,243500,24,23,1,0
8,1999,243500,40,39,1,1
9,1999,243500,35,32,3,2
10,1999,243500,36,32,4,3
11,1999,243500,28,25,3,1
12,1999,243500,36,29,7,3
1,2000,243500,19,18,1,1
2,2000,243500,29,27,2,4
3,2000,243500,26,25,1,1
4,2000,243500,42,41,1,2
5,2000,243500,42,39,3,1
6,2000,243500,35,32,3,0
7,2000,243500,44,42,2,0
8,2000,243500,39,37,2,0
9,2000,243500,30,29,1,1
10,2000,243500,44,39,5,2
11,2000,243500,34,32,2,0
12,2000,243500,30,28,2,2
1,2001,243500,27,26,1,2
2,2001,243500,29,25,4,1
3,2001,243500,38,35,3,0
4,2001,243500,22,22,0,1
5,2001,243500,22,21,1,1
6,2001,243500,30,29,1,0
7,2001,243500,26,24,2,0
8,2001,243500,36,32,4,1
9,2001,243500,41,38,3,0
10,2001,243500,43,42,1,4
11,2001,243500,32,31,1,1
12,2001,243500,23,23,0,1
1,2002,243500,22,20,2,1
2,2002,243500,16,15,1,0
3,2002,243500,30,29,1,0
4,2002,243500,24,24,0,1
5,2002,243500,33,32,1,1
6,2002,243500,33,32,1,0
7,2002,243500,33,32,1,0
8,2002,243500,50,50,0,0
9,2002,243500,44,42,2,1
10,2002,243500,40,38,2,0
11,2002,243500,39,38,1,0
12,2002,243500,41,41,0,0
1,2003,243500,25,24,1,0
2,2003,243500,23,21,2,2
3,2003,243500,40,39,1,1
4,2003,243500,25,24,1,1
5,2003,243500,21,19,2,1
6,2003,243500,26,24,2,0
7,2003,243500,40,37,3,1
8,2003,243500,32,31,1,0
9,2003,243500,25,24,1,1
10,2003,243500,36,34,2,0
11,2003,243500,27,26,1,1
12,2003,243500,27,25,2,1
1,2004,243500,16,16,0,3
2,2004,243500,25,25,0,0
3,2004,243500,39,37,2,0
4,2004,243500,28,27,1,1
5,2004,243500,38,38,0,0
6,2004,243500,39,39,0,1
7,2004,243500,70,69,1,0
8,2004,243500,50,50,0,2
9,2004,243500,35,35,0,0
10,2004,243500,40,38,2,0
11,2004,243500,36,35,1,1
12,2004,243500,30,27,3,1
1,2005,243500,20,20,0,1
2,2005,243500,27,26,1,0
3,2005,243500,26,26,0,0
4,2005,243500,48,46,2,3
5,2005,243500,28,25,3,1
6,2005,243500,23,21,2,0
7,2005,243500,46,44,2,3
8,2005,243500,38,37,1,3
9,2005,243500,38,37,1,0
10,2005,243500,35,34,1,2
11,2005,243500,21,21,0,0
12,2005,243500,32,32,0,0
1,2006,243500,22,22,0,0
2,2006,243500,27,26,1,1
3,2006,243500,38,38,0,0
4,2006,243500,31,31,0,0
5,2006,243500,44,42,2,0
6,2006,243500,35,35,0,4
7,2006,243500,30,29,1,2
8,2006,243500,35,34,1,3
9,2006,243500,26,25,1,1
10,2006,243500,31,30,1,3
11,2006,243500,21,21,0,1
12,2006,243500,28,26,2,0
1,2007,243500,28,27,1,5
2,2007,243500,20,18,2,2
3,2007,243500,21,17,4,1
4,2007,243500,34,34,0,1
5,2007,243500,33,33,0,1
6,2007,243500,35,34,1,5
7,2007,243500,42,40,2,0
8,2007,243500,39,39,0,3
9,2007,243500,29,28,1,1
10,2007,243500,49,49,0,0
11,2007,243500,37,35,2,1
12,2007,243500,23,22,1,1
1,2008,243500,34,34,0,0
2,2008,243500,29,29,0,1
3,2008,243500,24,24,0,2
4,2008,243500,36,35,1,0
5,2008,243500,43,42,1,0
6,2008,243500,30,29,1,2
7,2008,243500,45,45,0,0
8,2008,243500,58,57,1,1
9,2008,243500,45,43,2,2
10,2008,243500,29,29,0,2
11,2008,243500,32,32,0,2
12,2008,243500,32,32,0,0
1,2009,243500,24,23,1,3
2,2009,243500,27,26,1,1
3,2009,243500,30,30,0,1
4,2009,243500,31,31,0,1
5,2009,243500,38,36,2,1
6,2009,243500,30,30,0,6
7,2009,243500,33,33,0,1
8,2009,243500,49,49,0,2
9,2009,243500,37,36,1,3
10,2009,243500,32,30,2,2
11,2009,243500,29,28,1,2
12,2009,243500,28,27,1,3
1,2010,243500,35,35,0,1
2,2010,243500,20,20,0,3
3,2010,243500,28,25,3,0
4,2010,243500,26,25,1,0
5,2010,243500,51,48,3,1
6,2010,243500,40,39,1,1
7,2010,243500,51,50,1,2
8,2010,243500,32,32,0,2
9,2010,243500,41,39,2,0
10,2010,243500,36,36,0,1
11,2010,243500,31,31,0,2
12,2010,243500,20,20,0,0
1,2011,243500,26,26,0,0
2,2011,243500,18,16,2,1
1,1999,242800,12,11,1,1
2,1999,242800,11,11,0,1
3,1999,242800,14,12,2,1
4,1999,242800,15,13,2,1
5,1999,242800,17,15,2,0
6,1999,242800,11,11,0,3
7,1999,242800,17,15,2,2
8,1999,242800,20,19,1,0
9,1999,242800,12,12,0,3
10,1999,242800,17,17,0,1
11,1999,242800,8,7,1,2
12,1999,242800,11,11,0,0
1,2000,242800,14,13,1,0
2,2000,242800,12,12,0,4
3,2000,242800,12,12,0,2
4,2000,242800,8,8,0,1
5,2000,242800,13,13,0,1
6,2000,242800,20,19,1,0
7,2000,242800,18,17,1,5
8,2000,242800,22,21,1,1
9,2000,242800,17,17,0,1
10,2000,242800,20,17,3,1
11,2000,242800,7,7,0,0
12,2000,242800,11,9,2,1
1,2001,242800,14,13,1,1
2,2001,242800,8,6,2,1
3,2001,242800,12,11,1,1
4,2001,242800,21,20,1,1
5,2001,242800,14,13,1,0
6,2001,242800,13,9,4,2
7,2001,242800,15,15,0,1
8,2001,242800,24,23,1,1
9,2001,242800,13,11,2,0
10,2001,242800,11,10,1,1
11,2001,242800,9,9,0,4
12,2001,242800,12,11,1,1
1,2002,242800,6,6,0,1
2,2002,242800,4,4,0,0
3,2002,242800,13,12,1,3
4,2002,242800,10,10,0,2
5,2002,242800,14,13,1,3
6,2002,242800,16,13,3,2
7,2002,242800,14,13,1,0
8,2002,242800,18,17,1,1
9,2002,242800,16,15,1,1
10,2002,242800,13,13,0,1
11,2002,242800,15,12,3,1
12,2002,242800,15,15,0,0
1,2003,242800,13,13,0,1
2,2003,242800,8,7,1,3
3,2003,242800,13,12,1,0
4,2003,242800,14,13,1,4
5,2003,242800,13,12,1,1
6,2003,242800,14,12,2,4
7,2003,242800,18,17,1,4
8,2003,242800,14,13,1,1
9,2003,242800,17,17,0,2
10,2003,242800,19,17,2,0
11,2003,242800,16,16,0,0
12,2003,242800,19,19,0,0
1,2004,242800,5,5,0,0
2,2004,242800,8,8,0,0
3,2004,242800,13,13,0,1
4,2004,242800,7,7,0,2
5,2004,242800,10,9,1,0
6,2004,242800,11,10,1,1
7,2004,242800,12,12,0,2
8,2004,242800,13,12,1,0
9,2004,242800,27,27,0,0
10,2004,242800,10,10,0,0
11,2004,242800,10,10,0,2
12,2004,242800,12,11,1,0
1,2005,242800,5,5,0,1
2,2005,242800,4,4,0,1
3,2005,242800,6,6,0,3
4,2005,242800,6,5,1,1
5,2005,242800,13,12,1,2
6,2005,242800,8,7,1,0
7,2005,242800,19,16,3,2
8,2005,242800,13,12,1,1
9,2005,242800,12,12,0,0
10,2005,242800,12,12,0,1
11,2005,242800,14,13,1,0
12,2005,242800,11,9,2,3
1,2006,242800,8,8,0,0
2,2006,242800,11,10,1,0
3,2006,242800,9,8,1,2
4,2006,242800,13,13,0,1
5,2006,242800,11,11,0,1
6,2006,242800,13,13,0,1
7,2006,242800,11,11,0,0
8,2006,242800,10,9,1,0
9,2006,242800,13,13,0,2
10,2006,242800,7,7,0,0
11,2006,242800,8,8,0,0
12,2006,242800,7,6,1,0
1,2007,242800,6,6,0,0
2,2007,242800,6,6,0,4
3,2007,242800,13,13,0,1
4,2007,242800,7,7,0,1
5,2007,242800,8,7,1,1
6,2007,242800,14,10,4,1
7,2007,242800,12,12,0,0
8,2007,242800,20,19,1,2
9,2007,242800,11,9,2,3
10,2007,242800,13,12,1,0
11,2007,242800,8,8,0,0
12,2007,242800,9,9,0,2
1,2008,242800,9,9,0,1
2,2008,242800,10,9,1,0
3,2008,242800,9,9,0,2
4,2008,242800,6,6,0,0
5,2008,242800,8,6,2,2
6,2008,242800,3,3,0,0
7,2008,242800,15,15,0,0
8,2008,242800,15,14,1,3
9,2008,242800,12,12,0,0
10,2008,242800,14,13,1,0
11,2008,242800,10,9,1,1
12,2008,242800,13,13,0,0
1,2009,242800,11,9,2,1
2,2009,242800,9,8,1,2
3,2009,242800,7,6,1,0
4,2009,242800,4,2,2,0
5,2009,242800,7,7,0,0
6,2009,242800,9,9,0,2
7,2009,242800,5,4,1,2
8,2009,242800,13,12,1,1
9,2009,242800,10,9,1,2
10,2009,242800,14,14,0,0
11,2009,242800,8,8,0,6
12,2009,242800,7,7,0,1
1,2010,242800,13,13,0,3
2,2010,242800,3,3,0,1
3,2010,242800,6,6,0,1
4,2010,242800,9,9,0,0
5,2010,242800,13,12,1,3
6,2010,242800,11,11,0,2
7,2010,242800,12,10,2,2
8,2010,242800,10,10,0,1
9,2010,242800,13,13,0,1
10,2010,242800,20,19,1,0
11,2010,242800,12,12,0,1
12,2010,242800,7,7,0,1
1,2011,242800,7,7,0,2
2,2011,242800,7,7,0,0
1,1999,243100,8,7,1,0
2,1999,243100,7,7,0,1
3,1999,243100,10,7,3,1
4,1999,243100,8,8,0,0
5,1999,243100,11,10,1,0
6,1999,243100,15,15,0,2
7,1999,243100,17,15,2,1
8,1999,243100,22,19,3,0
9,1999,243100,14,13,1,0
10,1999,243100,14,11,3,4
11,1999,243100,11,10,1,1
12,1999,243100,8,8,0,1
1,2000,243100,6,6,0,1
2,2000,243100,13,12,1,2
3,2000,243100,13,11,2,1
4,2000,243100,13,11,2,0
5,2000,243100,13,12,1,1
6,2000,243100,11,10,1,1
7,2000,243100,11,11,0,2
8,2000,243100,7,7,0,2
9,2000,243100,7,7,0,0
10,2000,243100,10,9,1,0
11,2000,243100,6,6,0,4
12,2000,243100,6,6,0,1
1,2001,243100,5,2,3,0
2,2001,243100,7,5,2,2
3,2001,243100,8,7,1,2
4,2001,243100,6,4,2,0
5,2001,243100,8,8,0,1
6,2001,243100,10,7,3,3
7,2001,243100,13,10,3,2
8,2001,243100,14,12,2,2
9,2001,243100,11,9,2,0
10,2001,243100,12,11,1,0
11,2001,243100,14,13,1,0
12,2001,243100,8,7,1,3
1,2002,243100,15,14,1,1
2,2002,243100,7,7,0,2
3,2002,243100,6,5,1,1
4,2002,243100,18,14,4,1
5,2002,243100,7,7,0,2
6,2002,243100,14,13,1,0
7,2002,243100,13,11,2,0
8,2002,243100,10,10,0,0
9,2002,243100,7,6,1,0
10,2002,243100,4,3,1,0
11,2002,243100,12,11,1,1
12,2002,243100,10,8,2,2
1,2003,243100,4,4,0,0
2,2003,243100,4,4,0,0
3,2003,243100,3,3,0,1
4,2003,243100,6,6,0,0
5,2003,243100,7,7,0,1
6,2003,243100,14,12,2,2
7,2003,243100,12,11,1,0
8,2003,243100,8,7,1,2
9,2003,243100,12,11,1,0
10,2003,243100,11,11,0,0
11,2003,243100,9,9,0,0
12,2003,243100,12,12,0,0
1,2004,243100,7,7,0,0
2,2004,243100,11,10,1,1
3,2004,243100,7,7,0,1
4,2004,243100,7,7,0,0
5,2004,243100,11,9,2,1
6,2004,243100,8,7,1,2
7,2004,243100,14,13,1,2
8,2004,243100,11,7,4,1
9,2004,243100,12,10,2,2
10,2004,243100,3,2,1,0
11,2004,243100,4,4,0,0
12,2004,243100,8,7,1,1
1,2005,243100,5,5,0,1
2,2005,243100,8,6,2,1
3,2005,243100,3,3,0,0
4,2005,243100,7,5,2,1
5,2005,243100,9,9,0,1
6,2005,243100,4,2,2,1
7,2005,243100,9,9,0,1
8,2005,243100,9,8,1,1
9,2005,243100,7,7,0,0
10,2005,243100,5,4,1,2
11,2005,243100,5,5,0,1
12,2005,243100,5,5,0,1
1,2006,243100,5,5,0,0
2,2006,243100,6,6,0,0
3,2006,243100,4,4,0,0
4,2006,243100,7,7,0,1
5,2006,243100,9,8,1,0
6,2006,243100,3,3,0,1
7,2006,243100,9,8,1,0
8,2006,243100,8,7,1,3
9,2006,243100,7,7,0,0
10,2006,243100,8,7,1,0
11,2006,243100,8,8,0,0
12,2006,243100,9,9,0,0
1,2007,243100,2,2,0,0
2,2007,243100,9,7,2,1
3,2007,243100,5,5,0,0
4,2007,243100,10,10,0,0
5,2007,243100,4,4,0,0
6,2007,243100,5,5,0,0
7,2007,243100,9,9,0,1
8,2007,243100,7,7,0,0
9,2007,243100,7,7,0,1
10,2007,243100,10,10,0,1
11,2007,243100,10,10,0,0
12,2007,243100,7,7,0,1
1,2008,243100,7,6,1,0
2,2008,243100,7,7,0,1
3,2008,243100,4,4,0,2
4,2008,243100,6,6,0,2
5,2008,243100,8,8,0,2
6,2008,243100,10,9,1,0
7,2008,243100,15,15,0,0
8,2008,243100,16,15,1,0
9,2008,243100,9,8,1,1
10,2008,243100,6,6,0,0
11,2008,243100,11,11,0,0
12,2008,243100,5,5,0,0
1,2009,243100,6,4,2,0
2,2009,243100,9,8,1,0
3,2009,243100,4,4,0,0
4,2009,243100,5,5,0,0
5,2009,243100,9,9,0,0
6,2009,243100,10,9,1,0
7,2009,243100,13,12,1,0
8,2009,243100,4,4,0,0
9,2009,243100,8,7,1,0
10,2009,243100,3,3,0,0
11,2009,243100,5,5,0,1
12,2009,243100,7,7,0,1
1,2010,243100,3,2,1,0
2,2010,243100,7,7,0,0
3,2010,243100,4,4,0,0
4,2010,243100,2,2,0,0
5,2010,243100,7,7,0,0
6,2010,243100,6,6,0,0
7,2010,243100,11,11,0,0
8,2010,243100,9,9,0,0
9,2010,243100,4,4,0,0
10,2010,243100,4,4,0,1
11,2010,243100,6,6,0,1
12,2010,243100,3,3,0,0
1,2011,243100,4,3,1,0
2,2011,243100,3,3,0,0
1,1999,081402,16,16,0,0
2,1999,081402,9,8,1,0
3,1999,081402,16,15,1,0
4,1999,081402,17,17,0,0
5,1999,081402,33,32,1,0
6,1999,081402,30,30,0,0
7,1999,081402,48,46,2,2
8,1999,081402,40,40,0,2
9,1999,081402,22,22,0,0
10,1999,081402,33,33,0,0
11,1999,081402,7,7,0,0
12,1999,081402,9,9,0,0
1,2000,081402,15,14,1,0
2,2000,081402,8,8,0,0
3,2000,081402,13,13,0,0
4,2000,081402,9,7,2,0
5,2000,081402,19,19,0,1
6,2000,081402,35,34,1,0
7,2000,081402,38,38,0,0
8,2000,081402,33,33,0,0
9,2000,081402,20,20,0,0
10,2000,081402,18,18,0,0
11,2000,081402,15,14,1,0
12,2000,081402,12,12,0,0
1,2001,081402,7,7,0,0
2,2001,081402,8,8,0,0
3,2001,081402,12,11,1,0
4,2001,081402,13,13,0,0
5,2001,081402,15,15,0,3
6,2001,081402,20,18,2,3
7,2001,081402,25,24,1,0
8,2001,081402,30,30,0,0
9,2001,081402,9,9,0,0
10,2001,081402,8,7,1,0
11,2001,081402,4,4,0,0
12,2001,081402,12,12,0,0
1,2002,081402,12,12,0,0
2,2002,081402,7,6,1,0
3,2002,081402,10,10,0,0
4,2002,081402,8,8,0,0
5,2002,081402,18,18,0,0
6,2002,081402,19,18,1,0
7,2002,081402,14,14,0,0
8,2002,081402,24,24,0,3
9,2002,081402,13,11,2,0
10,2002,081402,3,3,0,0
11,2002,081402,4,4,0,0
12,2002,081402,8,8,0,0
1,2003,081402,4,4,0,0
2,2003,081402,2,2,0,0
3,2003,081402,5,5,0,0
4,2003,081402,6,6,0,0
5,2003,081402,8,6,2,0
6,2003,081402,9,9,0,0
7,2003,081402,17,16,1,2
8,2003,081402,17,17,0,0
9,2003,081402,20,18,2,0
10,2003,081402,12,12,0,1
11,2003,081402,3,3,0,0
12,2003,081402,4,4,0,0
1,2004,081402,7,7,0,0
2,2004,081402,4,4,0,0
3,2004,081402,5,5,0,0
4,2004,081402,15,13,2,0
5,2004,081402,8,8,0,0
6,2004,081402,15,15,0,1
7,2004,081402,17,17,0,3
8,2004,081402,12,12,0,0
9,2004,081402,9,9,0,1
10,2004,081402,7,6,1,0
11,2004,081402,4,4,0,0
12,2004,081402,5,5,0,0
1,2005,081402,7,7,0,0
2,2005,081402,4,4,0,0
3,2005,081402,3,3,0,0
4,2005,081402,9,8,1,0
5,2005,081402,8,8,0,0
6,2005,081402,10,9,1,1
7,2005,081402,24,23,1,0
8,2005,081402,16,15,1,0
9,2005,081402,7,7,0,0
10,2005,081402,8,8,0,0
11,2005,081402,3,3,0,0
12,2005,081402,5,5,0,0
1,2006,081402,3,3,0,0
2,2006,081402,2,2,0,0
3,2006,081402,10,10,0,0
4,2006,081402,9,7,2,0
5,2006,081402,9,8,1,0
6,2006,081402,12,11,1,0
7,2006,081402,31,30,1,1
8,2006,081402,15,15,0,0
9,2006,081402,14,13,1,0
10,2006,081402,10,10,0,0
11,2006,081402,1,1,0,0
12,2006,081402,3,3,0,1
1,2007,081402,8,8,0,0
2,2007,081402,5,5,0,0
3,2007,081402,6,6,0,0
4,2007,081402,9,9,0,0
5,2007,081402,12,12,0,0
6,2007,081402,10,10,0,0
7,2007,081402,21,21,0,0
8,2007,081402,16,16,0,1
9,2007,081402,13,13,0,0
10,2007,081402,9,9,0,0
11,2007,081402,7,7,0,0
12,2007,081402,7,7,0,0
1,2008,081402,6,6,0,0
2,2008,081402,0,0,0,0
3,2008,081402,2,2,0,0
4,2008,081402,10,10,0,0
5,2008,081402,8,7,1,0
6,2008,081402,12,11,1,0
7,2008,081402,19,18,1,0
8,2008,081402,14,13,1,1
9,2008,081402,10,10,0,0
10,2008,081402,3,3,0,0
11,2008,081402,6,6,0,0
12,2008,081402,10,9,1,0
1,2009,081402,6,6,0,0
2,2009,081402,4,4,0,0
3,2009,081402,3,3,0,0
4,2009,081402,4,4,0,0
5,2009,081402,14,14,0,1
6,2009,081402,8,8,0,0
7,2009,081402,13,13,0,0
8,2009,081402,11,11,0,0
9,2009,081402,8,8,0,0
10,2009,081402,6,5,1,0
11,2009,081402,5,5,0,0
12,2009,081402,6,6,0,1
1,2010,081402,5,5,0,0
2,2010,081402,2,2,0,0
3,2010,081402,6,6,0,0
4,2010,081402,6,6,0,0
5,2010,081402,6,6,0,1
6,2010,081402,16,15,1,0
7,2010,081402,14,14,0,0
8,2010,081402,22,22,0,0
9,2010,081402,3,3,0,0
10,2010,081402,9,9,0,0
11,2010,081402,3,3,0,0
12,2010,081402,7,7,0,0
1,2011,081402,5,5,0,0
2,2011,081402,1,1,0,0
1,1999,081401,11,10,1,0
2,1999,081401,14,14,0,1
3,1999,081401,21,20,1,1
4,1999,081401,19,19,0,1
5,1999,081401,17,16,1,1
6,1999,081401,19,17,2,0
7,1999,081401,18,18,0,0
8,1999,081401,18,17,1,0
9,1999,081401,11,10,1,0
10,1999,081401,12,10,2,0
11,1999,081401,10,7,3,0
12,1999,081401,17,17,0,1
1,2000,081401,15,15,0,0
2,2000,081401,7,6,1,1
3,2000,081401,18,16,2,0
4,2000,081401,9,9,0,1
5,2000,081401,13,13,0,1
6,2000,081401,16,15,1,1
7,2000,081401,23,22,1,1
8,2000,081401,25,24,1,0
9,2000,081401,10,9,1,0
10,2000,081401,25,23,2,0
11,2000,081401,15,14,1,0
12,2000,081401,15,15,0,1
1,2001,081401,14,14,0,0
2,2001,081401,12,12,0,1
3,2001,081401,23,23,0,0
4,2001,081401,8,8,0,0
5,2001,081401,14,12,2,0
6,2001,081401,24,24,0,0
7,2001,081401,13,11,2,1
8,2001,081401,20,20,0,1
9,2001,081401,8,8,0,0
10,2001,081401,21,21,0,1
11,2001,081401,22,22,0,1
12,2001,081401,12,12,0,0
1,2002,081401,16,16,0,0
2,2002,081401,11,11,0,0
3,2002,081401,10,10,0,0
4,2002,081401,7,7,0,0
5,2002,081401,23,22,1,0
6,2002,081401,27,26,1,0
7,2002,081401,16,16,0,0
8,2002,081401,19,18,1,1
9,2002,081401,11,11,0,0
10,2002,081401,8,8,0,0
11,2002,081401,10,10,0,0
12,2002,081401,10,9,1,0
1,2003,081401,10,10,0,1
2,2003,081401,11,11,0,0
3,2003,081401,12,11,1,0
4,2003,081401,10,10,0,0
5,2003,081401,5,5,0,2
6,2003,081401,12,11,1,1
7,2003,081401,16,15,1,1
8,2003,081401,14,14,0,0
9,2003,081401,14,14,0,0
10,2003,081401,20,20,0,2
11,2003,081401,14,14,0,1
12,2003,081401,24,24,0,1
1,2004,081401,8,8,0,0
2,2004,081401,11,11,0,0
3,2004,081401,21,21,0,0
4,2004,081401,10,9,1,0
5,2004,081401,9,9,0,0
6,2004,081401,17,17,0,0
7,2004,081401,19,18,1,0
8,2004,081401,15,15,0,0
9,2004,081401,19,16,3,0
10,2004,081401,8,8,0,1
11,2004,081401,15,15,0,0
12,2004,081401,18,18,0,0
1,2005,081401,13,13,0,0
2,2005,081401,9,9,0,0
3,2005,081401,10,10,0,0
4,2005,081401,6,6,0,0
5,2005,081401,11,11,0,0
6,2005,081401,9,9,0,0
7,2005,081401,12,12,0,0
8,2005,081401,16,15,1,1
9,2005,081401,6,6,0,1
10,2005,081401,6,6,0,0
11,2005,081401,9,9,0,0
12,2005,081401,7,7,0,0
1,2006,081401,11,11,0,0
2,2006,081401,5,4,1,0
3,2006,081401,10,10,0,0
4,2006,081401,7,7,0,0
5,2006,081401,12,11,1,0
6,2006,081401,14,14,0,0
7,2006,081401,9,7,2,0
8,2006,081401,8,8,0,0
9,2006,081401,14,13,1,0
10,2006,081401,4,3,1,0
11,2006,081401,8,8,0,0
12,2006,081401,10,9,1,0
1,2007,081401,14,14,0,0
2,2007,081401,5,3,2,0
3,2007,081401,10,10,0,1
4,2007,081401,12,12,0,0
5,2007,081401,14,14,0,0
6,2007,081401,10,10,0,0
7,2007,081401,15,15,0,0
8,2007,081401,6,6,0,0
9,2007,081401,12,12,0,0
10,2007,081401,12,12,0,0
11,2007,081401,12,11,1,0
12,2007,081401,8,7,1,0
1,2008,081401,9,9,0,0
2,2008,081401,13,13,0,0
3,2008,081401,12,12,0,0
4,2008,081401,12,11,1,0
5,2008,081401,8,8,0,0
6,2008,081401,15,15,0,0
7,2008,081401,14,14,0,1
8,2008,081401,16,15,1,0
9,2008,081401,16,16,0,1
10,2008,081401,17,16,1,0
11,2008,081401,16,15,1,0
12,2008,081401,14,12,2,0
1,2009,081401,15,14,1,0
2,2009,081401,13,13,0,0
3,2009,081401,12,12,0,0
4,2009,081401,11,11,0,0
5,2009,081401,22,22,0,1
6,2009,081401,14,14,0,0
7,2009,081401,16,16,0,1
8,2009,081401,16,15,1,0
9,2009,081401,15,14,1,0
10,2009,081401,9,9,0,1
11,2009,081401,10,10,0,0
12,2009,081401,6,6,0,0
1,2010,081401,14,13,1,0
2,2010,081401,10,10,0,0
3,2010,081401,11,11,0,0
4,2010,081401,11,9,2,1
5,2010,081401,12,12,0,1
6,2010,081401,8,8,0,2
7,2010,081401,13,12,1,0
8,2010,081401,11,11,0,0
9,2010,081401,14,14,0,0
10,2010,081401,13,13,0,0
11,2010,081401,8,8,0,0
12,2010,081401,7,7,0,0
1,2011,081401,7,7,0,0
2,2011,081401,2,2,0,0
1,1999,251300,27,23,4,28
2,1999,251300,23,16,7,12
3,1999,251300,16,13,3,16
4,1999,251300,20,15,5,18
5,1999,251300,28,23,5,13
6,1999,251300,36,26,10,23
7,1999,251300,29,22,7,18
8,1999,251300,29,21,8,23
9,1999,251300,28,24,4,20
10,1999,251300,37,29,8,18
11,1999,251300,28,22,6,29
12,1999,251300,28,24,4,22
1,2000,251300,28,19,9,15
2,2000,251300,17,9,8,15
3,2000,251300,25,19,6,21
4,2000,251300,37,28,9,10
5,2000,251300,33,26,7,13
6,2000,251300,26,23,3,11
7,2000,251300,36,22,14,9
8,2000,251300,28,20,8,12
9,2000,251300,17,14,3,16
10,2000,251300,40,31,9,11
11,2000,251300,24,17,7,11
12,2000,251300,26,21,5,12
1,2001,251300,27,23,4,22
2,2001,251300,19,15,4,34
3,2001,251300,28,21,7,27
4,2001,251300,31,27,4,16
5,2001,251300,26,19,7,13
6,2001,251300,32,26,6,16
7,2001,251300,40,29,11,22
8,2001,251300,30,19,11,11
9,2001,251300,31,28,3,13
10,2001,251300,22,17,5,11
11,2001,251300,17,12,5,25
12,2001,251300,33,26,7,24
1,2002,251300,28,26,2,23
2,2002,251300,23,19,4,30
3,2002,251300,25,18,7,15
4,2002,251300,16,12,4,15
5,2002,251300,27,20,7,12
6,2002,251300,20,13,7,17
7,2002,251300,35,27,8,20
8,2002,251300,22,18,4,15
9,2002,251300,38,29,9,10
10,2002,251300,25,19,6,20
11,2002,251300,19,14,5,21
12,2002,251300,24,20,4,16
1,2003,251300,17,14,3,23
2,2003,251300,8,8,0,18
3,2003,251300,26,21,5,16
4,2003,251300,20,13,7,21
5,2003,251300,21,20,1,16
6,2003,251300,26,21,5,6
7,2003,251300,32,22,10,19
8,2003,251300,22,17,5,15
9,2003,251300,30,26,4,28
10,2003,251300,31,21,10,44
11,2003,251300,29,26,3,35
12,2003,251300,25,22,3,23
1,2004,251300,25,23,2,25
2,2004,251300,20,18,2,14
3,2004,251300,19,16,3,19
4,2004,251300,20,17,3,9
5,2004,251300,16,12,4,8
6,2004,251300,27,22,5,8
7,2004,251300,38,29,9,13
8,2004,251300,35,28,7,18
9,2004,251300,33,29,4,7
10,2004,251300,30,25,5,7
11,2004,251300,30,25,5,10
12,2004,251300,16,14,2,10
1,2005,251300,22,20,2,22
2,2005,251300,16,13,3,19
3,2005,251300,18,16,2,27
4,2005,251300,22,16,6,17
5,2005,251300,17,15,2,17
6,2005,251300,29,26,3,15
7,2005,251300,28,24,4,14
8,2005,251300,39,35,4,13
9,2005,251300,27,24,3,13
10,2005,251300,14,11,3,19
11,2005,251300,14,12,2,6
12,2005,251300,23,20,3,11
1,2006,251300,15,14,1,14
2,2006,251300,9,7,2,8
3,2006,251300,9,7,2,9
4,2006,251300,22,19,3,11
5,2006,251300,18,16,2,16
6,2006,251300,21,16,5,6
7,2006,251300,19,13,6,19
8,2006,251300,15,14,1,19
9,2006,251300,11,8,3,22
10,2006,251300,25,23,2,19
11,2006,251300,19,10,9,11
12,2006,251300,16,10,6,20
1,2007,251300,17,15,2,6
2,2007,251300,17,15,2,11
3,2007,251300,21,17,4,14
4,2007,251300,22,17,5,21
5,2007,251300,32,27,5,9
6,2007,251300,32,19,13,24
7,2007,251300,20,17,3,11
8,2007,251300,19,18,1,13
9,2007,251300,21,20,1,23
10,2007,251300,16,12,4,10
11,2007,251300,16,12,4,19
12,2007,251300,22,18,4,12
1,2008,251300,21,17,4,17
2,2008,251300,14,11,3,7
3,2008,251300,15,9,6,7
4,2008,251300,22,16,6,14
5,2008,251300,22,18,4,13
6,2008,251300,23,19,4,4
7,2008,251300,23,19,4,12
8,2008,251300,25,15,10,16
9,2008,251300,22,17,5,12
10,2008,251300,24,20,4,9
11,2008,251300,15,11,4,7
12,2008,251300,26,19,7,5
1,2009,251300,22,19,3,10
2,2009,251300,12,9,3,12
3,2009,251300,18,13,5,6
4,2009,251300,20,14,6,8
5,2009,251300,33,25,8,5
6,2009,251300,18,15,3,10
7,2009,251300,25,22,3,18
8,2009,251300,30,26,4,15
9,2009,251300,32,26,6,7
10,2009,251300,30,24,6,17
11,2009,251300,23,19,4,20
12,2009,251300,27,25,2,10
1,2010,251300,26,21,5,14
2,2010,251300,12,11,1,8
3,2010,251300,9,8,1,9
4,2010,251300,16,13,3,15
5,2010,251300,20,17,3,20
6,2010,251300,20,16,4,19
7,2010,251300,11,9,2,17
8,2010,251300,24,15,9,23
9,2010,251300,19,17,2,16
10,2010,251300,22,18,4,20
11,2010,251300,29,26,3,13
12,2010,251300,21,21,0,13
1,2011,251300,32,30,2,13
2,2011,251300,8,8,0,8
1,1999,251200,30,25,5,10
2,1999,251200,27,24,3,13
3,1999,251200,22,16,6,16
4,1999,251200,25,20,5,31
5,1999,251200,23,16,7,14
6,1999,251200,39,32,7,25
7,1999,251200,29,22,7,12
8,1999,251200,42,36,6,11
9,1999,251200,28,24,4,6
10,1999,251200,38,32,6,19
11,1999,251200,28,23,5,17
12,1999,251200,29,27,2,19
1,2000,251200,24,18,6,21
2,2000,251200,14,9,5,20
3,2000,251200,30,23,7,27
4,2000,251200,29,22,7,22
5,2000,251200,35,26,9,27
6,2000,251200,37,26,11,17
7,2000,251200,38,29,9,29
8,2000,251200,32,24,8,15
9,2000,251200,24,18,6,19
10,2000,251200,31,28,3,25
11,2000,251200,22,13,9,17
12,2000,251200,26,21,5,28
1,2001,251200,26,21,5,24
2,2001,251200,27,22,5,20
3,2001,251200,16,13,3,41
4,2001,251200,33,26,7,23
5,2001,251200,28,21,7,17
6,2001,251200,31,21,10,17
7,2001,251200,28,23,5,16
8,2001,251200,30,22,8,19
9,2001,251200,34,24,10,16
10,2001,251200,26,22,4,21
11,2001,251200,22,21,1,13
12,2001,251200,28,21,7,21
1,2002,251200,15,11,4,19
2,2002,251200,24,17,7,12
3,2002,251200,14,12,2,14
4,2002,251200,30,23,7,30
5,2002,251200,18,17,1,16
6,2002,251200,30,25,5,15
7,2002,251200,34,25,9,22
8,2002,251200,26,17,9,32
9,2002,251200,29,24,5,9
10,2002,251200,14,13,1,13
11,2002,251200,32,24,8,16
12,2002,251200,27,22,5,16
1,2003,251200,21,16,5,9
2,2003,251200,17,13,4,18
3,2003,251200,20,17,3,19
4,2003,251200,21,16,5,10
5,2003,251200,30,26,4,23
6,2003,251200,21,17,4,14
7,2003,251200,27,19,8,26
8,2003,251200,29,24,5,32
9,2003,251200,36,33,3,27
10,2003,251200,23,16,7,17
11,2003,251200,18,12,6,25
12,2003,251200,20,19,1,31
1,2004,251200,12,11,1,41
2,2004,251200,22,17,5,16
3,2004,251200,21,14,7,29
4,2004,251200,28,22,6,25
5,2004,251200,42,36,6,10
6,2004,251200,27,22,5,22
7,2004,251200,26,21,5,34
8,2004,251200,17,11,6,22
9,2004,251200,32,23,9,13
10,2004,251200,21,14,7,20
11,2004,251200,22,19,3,14
12,2004,251200,18,16,2,9
1,2005,251200,28,23,5,27
2,2005,251200,21,18,3,12
3,2005,251200,19,13,6,30
4,2005,251200,23,17,6,20
5,2005,251200,22,19,3,26
6,2005,251200,28,21,7,15
7,2005,251200,36,24,12,22
8,2005,251200,26,19,7,18
9,2005,251200,27,22,5,20
10,2005,251200,44,37,7,15
11,2005,251200,24,18,6,16
12,2005,251200,27,21,6,28
1,2006,251200,14,10,4,22
2,2006,251200,12,9,3,12
3,2006,251200,19,14,5,17
4,2006,251200,26,21,5,16
5,2006,251200,18,16,2,23
6,2006,251200,18,14,4,20
7,2006,251200,36,27,9,29
8,2006,251200,26,22,4,40
9,2006,251200,38,27,11,9
10,2006,251200,28,25,3,13
11,2006,251200,21,17,4,58
12,2006,251200,24,20,4,41
1,2007,251200,25,23,2,40
2,2007,251200,10,7,3,27
3,2007,251200,24,22,2,32
4,2007,251200,16,15,1,37
5,2007,251200,21,18,3,26
6,2007,251200,31,20,11,40
7,2007,251200,16,14,2,25
8,2007,251200,18,13,5,36
9,2007,251200,17,16,1,38
10,2007,251200,20,17,3,39
11,2007,251200,18,16,2,23
12,2007,251200,14,11,3,16
1,2008,251200,19,18,1,7
2,2008,251200,9,7,2,16
3,2008,251200,25,21,4,15
4,2008,251200,21,19,2,16
5,2008,251200,33,28,5,17
6,2008,251200,25,18,7,25
7,2008,251200,35,31,4,12
8,2008,251200,28,23,5,18
9,2008,251200,23,18,5,24
10,2008,251200,20,17,3,36
11,2008,251200,19,17,2,28
12,2008,251200,16,14,2,11
1,2009,251200,24,20,4,13
2,2009,251200,21,19,2,10
3,2009,251200,25,20,5,16
4,2009,251200,14,11,3,18
5,2009,251200,25,19,6,17
6,2009,251200,24,15,9,23
7,2009,251200,31,26,5,22
8,2009,251200,19,16,3,36
9,2009,251200,31,30,1,11
10,2009,251200,22,21,1,19
11,2009,251200,17,13,4,20
12,2009,251200,27,24,3,23
1,2010,251200,22,19,3,16
2,2010,251200,21,18,3,34
3,2010,251200,16,13,3,28
4,2010,251200,19,17,2,31
5,2010,251200,24,21,3,23
6,2010,251200,30,19,11,22
7,2010,251200,16,11,5,33
8,2010,251200,22,18,4,38
9,2010,251200,31,25,6,30
10,2010,251200,23,20,3,28
11,2010,251200,33,30,3,36
12,2010,251200,21,21,0,27
1,2011,251200,13,13,0,34
2,2011,251200,15,14,1,24
1,1999,251100,22,20,2,21
2,1999,251100,13,10,3,17
3,1999,251100,23,20,3,46
4,1999,251100,24,16,8,21
5,1999,251100,18,11,7,16
6,1999,251100,21,19,2,24
7,1999,251100,36,27,9,12
8,1999,251100,22,20,2,14
9,1999,251100,22,17,5,11
10,1999,251100,27,25,2,16
11,1999,251100,12,10,2,12
12,1999,251100,24,22,2,24
1,2000,251100,15,13,2,13
2,2000,251100,15,11,4,27
3,2000,251100,16,13,3,29
4,2000,251100,22,16,6,31
5,2000,251100,13,11,2,20
6,2000,251100,25,22,3,27
7,2000,251100,22,15,7,25
8,2000,251100,24,15,9,37
9,2000,251100,29,25,4,34
10,2000,251100,28,18,10,35
11,2000,251100,26,23,3,32
12,2000,251100,21,16,5,50
1,2001,251100,16,13,3,65
2,2001,251100,9,8,1,25
3,2001,251100,19,13,6,35
4,2001,251100,19,12,7,29
5,2001,251100,15,12,3,54
6,2001,251100,21,17,4,54
7,2001,251100,23,21,2,52
8,2001,251100,17,14,3,33
9,2001,251100,26,18,8,36
10,2001,251100,36,20,16,41
11,2001,251100,17,13,4,31
12,2001,251100,23,19,4,39
1,2002,251100,21,20,1,19
2,2002,251100,18,13,5,25
3,2002,251100,19,16,3,33
4,2002,251100,20,15,5,48
5,2002,251100,16,10,6,50
6,2002,251100,16,10,6,29
7,2002,251100,36,29,7,22
8,2002,251100,34,25,9,32
9,2002,251100,17,14,3,22
10,2002,251100,31,25,6,25
11,2002,251100,16,12,4,13
12,2002,251100,13,11,2,22
1,2003,251100,19,16,3,28
2,2003,251100,11,10,1,11
3,2003,251100,7,4,3,15
4,2003,251100,32,24,8,22
5,2003,251100,21,18,3,27
6,2003,251100,32,27,5,59
7,2003,251100,21,15,6,30
8,2003,251100,27,23,4,34
9,2003,251100,18,15,3,28
10,2003,251100,16,14,2,301
11,2003,251100,28,23,5,18
12,2003,251100,22,18,4,13
1,2004,251100,20,15,5,23
2,2004,251100,15,13,2,35
3,2004,251100,16,11,5,47
4,2004,251100,20,12,8,52
5,2004,251100,18,14,4,71
6,2004,251100,25,17,8,55
7,2004,251100,22,17,5,52
8,2004,251100,18,10,8,63
9,2004,251100,16,11,5,27
10,2004,251100,18,14,4,40
11,2004,251100,17,15,2,47
12,2004,251100,21,15,6,81
1,2005,251100,10,8,2,57
2,2005,251100,9,8,1,13
3,2005,251100,19,13,6,25
4,2005,251100,16,13,3,19
5,2005,251100,15,10,5,30
6,2005,251100,19,15,4,21
7,2005,251100,24,18,6,46
8,2005,251100,28,21,7,17
9,2005,251100,21,18,3,24
10,2005,251100,16,15,1,29
11,2005,251100,24,18,6,20
12,2005,251100,14,14,0,37
1,2006,251100,19,14,5,33
2,2006,251100,22,20,2,19
3,2006,251100,13,10,3,18
4,2006,251100,12,10,2,27
5,2006,251100,18,9,9,27
6,2006,251100,19,14,5,21
7,2006,251100,16,14,2,52
8,2006,251100,21,16,5,24
9,2006,251100,14,11,3,52
10,2006,251100,19,15,4,62
11,2006,251100,9,7,2,27
12,2006,251100,16,11,5,30
1,2007,251100,20,19,1,46
2,2007,251100,14,14,0,29
3,2007,251100,22,16,6,26
4,2007,251100,18,15,3,28
5,2007,251100,25,18,7,51
6,2007,251100,31,22,9,37
7,2007,251100,22,15,7,31
8,2007,251100,20,17,3,23
9,2007,251100,27,19,8,16
10,2007,251100,19,15,4,31
11,2007,251100,22,20,2,25
12,2007,251100,17,14,3,26
1,2008,251100,16,12,4,19
2,2008,251100,27,20,7,35
3,2008,251100,23,20,3,22
4,2008,251100,21,16,5,42
5,2008,251100,32,26,6,26
6,2008,251100,30,23,7,23
7,2008,251100,25,17,8,35
8,2008,251100,33,29,4,24
9,2008,251100,26,20,6,36
10,2008,251100,20,15,5,32
11,2008,251100,28,24,4,25
12,2008,251100,24,19,5,26
1,2009,251100,24,18,6,20
2,2009,251100,23,21,2,21
3,2009,251100,23,17,6,27
4,2009,251100,24,18,6,29
5,2009,251100,17,15,2,23
6,2009,251100,21,15,6,16
7,2009,251100,21,15,6,23
8,2009,251100,37,31,6,10
9,2009,251100,35,32,3,12
10,2009,251100,21,19,2,17
11,2009,251100,27,24,3,28
12,2009,251100,24,21,3,36
1,2010,251100,24,21,3,31
2,2010,251100,22,19,3,33
3,2010,251100,28,25,3,33
4,2010,251100,30,25,5,43
5,2010,251100,24,17,7,42
6,2010,251100,21,16,5,21
7,2010,251100,27,24,3,19
8,2010,251100,25,17,8,28
9,2010,251100,21,17,4,37
10,2010,251100,23,22,1,18
11,2010,251100,15,13,2,17
12,2010,251100,20,18,2,15
1,2011,251100,15,12,3,20
2,2011,251100,13,13,0,16
1,1999,251000,19,15,4,19
2,1999,251000,15,13,2,8
3,1999,251000,14,13,1,12
4,1999,251000,25,20,5,14
5,1999,251000,25,18,7,19
6,1999,251000,28,21,7,14
7,1999,251000,29,21,8,17
8,1999,251000,19,16,3,18
9,1999,251000,19,17,2,24
10,1999,251000,19,19,0,23
11,1999,251000,18,14,4,33
12,1999,251000,28,24,4,26
1,2000,251000,22,17,5,38
2,2000,251000,16,13,3,41
3,2000,251000,20,19,1,21
4,2000,251000,19,14,5,34
5,2000,251000,20,16,4,24
6,2000,251000,17,8,9,33
7,2000,251000,21,18,3,37
8,2000,251000,18,12,6,29
9,2000,251000,18,12,6,28
10,2000,251000,19,14,5,30
11,2000,251000,16,11,5,28
12,2000,251000,7,4,3,22
1,2001,251000,7,4,3,56
2,2001,251000,11,8,3,50
3,2001,251000,11,11,0,54
4,2001,251000,21,14,7,43
5,2001,251000,15,11,4,66
6,2001,251000,23,19,4,51
7,2001,251000,30,20,10,39
8,2001,251000,18,12,6,32
9,2001,251000,14,10,4,27
10,2001,251000,17,13,4,38
11,2001,251000,20,17,3,53
12,2001,251000,13,8,5,41
1,2002,251000,8,5,3,40
2,2002,251000,20,18,2,34
3,2002,251000,11,9,2,32
4,2002,251000,16,8,8,32
5,2002,251000,12,11,1,42
6,2002,251000,13,12,1,16
7,2002,251000,23,13,10,20
8,2002,251000,15,12,3,22
9,2002,251000,23,19,4,19
10,2002,251000,23,16,7,26
11,2002,251000,22,16,6,21
12,2002,251000,22,15,7,14
1,2003,251000,13,10,3,38
2,2003,251000,8,6,2,14
3,2003,251000,21,18,3,25
4,2003,251000,24,22,2,17
5,2003,251000,17,13,4,23
6,2003,251000,19,14,5,12
7,2003,251000,16,12,4,23
8,2003,251000,20,15,5,18
9,2003,251000,25,20,5,19
10,2003,251000,12,10,2,22
11,2003,251000,12,11,1,13
12,2003,251000,11,7,4,26
1,2004,251000,14,8,6,16
2,2004,251000,13,13,0,13
3,2004,251000,17,13,4,33
4,2004,251000,20,11,9,30
5,2004,251000,14,9,5,29
6,2004,251000,17,13,4,13
7,2004,251000,23,18,5,15
8,2004,251000,18,10,8,34
9,2004,251000,17,13,4,25
10,2004,251000,10,8,2,18
11,2004,251000,15,14,1,9
12,2004,251000,11,9,2,7
1,2005,251000,11,10,1,9
2,2005,251000,17,13,4,8
3,2005,251000,9,7,2,21
4,2005,251000,15,11,4,22
5,2005,251000,15,12,3,15
6,2005,251000,9,8,1,18
7,2005,251000,19,15,4,17
8,2005,251000,15,12,3,18
9,2005,251000,13,12,1,20
10,2005,251000,14,10,4,21
11,2005,251000,16,12,4,25
12,2005,251000,17,13,4,22
1,2006,251000,12,6,6,40
2,2006,251000,12,12,0,40
3,2006,251000,12,12,0,38
4,2006,251000,17,12,5,51
5,2006,251000,25,22,3,38
6,2006,251000,10,7,3,48
7,2006,251000,24,18,6,40
8,2006,251000,16,14,2,44
9,2006,251000,17,11,6,21
10,2006,251000,19,17,2,26
11,2006,251000,15,13,2,21
12,2006,251000,12,12,0,22
1,2007,251000,14,12,2,22
2,2007,251000,16,12,4,11
3,2007,251000,24,20,4,22
4,2007,251000,22,17,5,31
5,2007,251000,15,12,3,34
6,2007,251000,22,15,7,49
7,2007,251000,13,10,3,61
8,2007,251000,22,17,5,55
9,2007,251000,13,13,0,36
10,2007,251000,27,22,5,49
11,2007,251000,16,14,2,43
12,2007,251000,14,12,2,53
1,2008,251000,11,10,1,40
2,2008,251000,9,8,1,28
3,2008,251000,13,12,1,26
4,2008,251000,12,9,3,36
5,2008,251000,20,18,2,40
6,2008,251000,15,12,3,45
7,2008,251000,13,11,2,52
8,2008,251000,16,13,3,34
9,2008,251000,20,17,3,35
10,2008,251000,17,15,2,29
11,2008,251000,13,12,1,33
12,2008,251000,10,5,5,22
1,2009,251000,12,6,6,27
2,2009,251000,9,8,1,31
3,2009,251000,15,14,1,27
4,2009,251000,12,8,4,27
5,2009,251000,16,13,3,23
6,2009,251000,9,8,1,29
7,2009,251000,17,12,5,35
8,2009,251000,14,12,2,21
9,2009,251000,24,16,8,26
10,2009,251000,19,17,2,18
11,2009,251000,19,14,5,26
12,2009,251000,15,14,1,16
1,2010,251000,16,14,2,30
2,2010,251000,8,8,0,28
3,2010,251000,14,11,3,20
4,2010,251000,13,12,1,36
5,2010,251000,16,15,1,29
6,2010,251000,10,8,2,22
7,2010,251000,9,7,2,18
8,2010,251000,14,10,4,15
9,2010,251000,15,13,2,13
10,2010,251000,15,14,1,14
11,2010,251000,18,13,5,7
12,2010,251000,12,11,1,10
1,2011,251000,12,11,1,7
2,2011,251000,9,8,1,7
1,1999,231200,51,26,25,136
2,1999,231200,50,31,19,138
3,1999,231200,48,36,12,85
4,1999,231200,56,40,16,146
5,1999,231200,54,43,11,68
6,1999,231200,56,33,23,100
7,1999,231200,68,43,25,85
8,1999,231200,81,45,36,98
9,1999,231200,56,37,19,100
10,1999,231200,59,39,20,134
11,1999,231200,60,43,17,132
12,1999,231200,54,39,15,58
1,2000,231200,51,35,16,79
2,2000,231200,39,23,16,73
3,2000,231200,48,34,14,112
4,2000,231200,54,33,21,61
5,2000,231200,51,38,13,82
6,2000,231200,41,28,13,64
7,2000,231200,66,42,24,89
8,2000,231200,70,46,24,65
9,2000,231200,54,40,14,74
10,2000,231200,59,42,17,76
11,2000,231200,43,32,11,109
12,2000,231200,49,33,16,65
1,2001,231200,51,35,16,89
2,2001,231200,41,27,14,73
3,2001,231200,44,34,10,125
4,2001,231200,52,36,16,72
5,2001,231200,63,41,22,69
6,2001,231200,53,34,19,75
7,2001,231200,64,46,18,62
8,2001,231200,59,37,22,165
9,2001,231200,56,36,20,114
10,2001,231200,58,36,22,117
11,2001,231200,49,34,15,83
12,2001,231200,46,36,10,297
1,2002,231200,37,29,8,158
2,2002,231200,43,32,11,156
3,2002,231200,53,39,14,165
4,2002,231200,50,40,10,122
5,2002,231200,69,51,18,180
6,2002,231200,60,28,32,83
7,2002,231200,71,43,28,128
8,2002,231200,69,40,29,99
9,2002,231200,67,47,20,137
10,2002,231200,66,49,17,70
11,2002,231200,78,52,26,93
12,2002,231200,57,37,20,93
1,2003,231200,45,28,17,112
2,2003,231200,48,39,9,61
3,2003,231200,50,35,15,65
4,2003,231200,68,47,21,57
5,2003,231200,47,30,17,71
6,2003,231200,63,45,18,81
7,2003,231200,70,52,18,122
8,2003,231200,76,60,16,276
9,2003,231200,60,43,17,129
10,2003,231200,50,33,17,71
11,2003,231200,50,32,18,135
12,2003,231200,46,38,8,86
1,2004,231200,61,49,12,148
2,2004,231200,44,36,8,292
3,2004,231200,66,47,19,114
4,2004,231200,45,33,12,108
5,2004,231200,50,35,15,45
6,2004,231200,53,41,12,60
7,2004,231200,60,36,24,74
8,2004,231200,59,44,15,66
9,2004,231200,74,59,15,101
10,2004,231200,67,58,9,110
11,2004,231200,49,39,10,74
12,2004,231200,43,38,5,151
1,2005,231200,42,36,6,81
2,2005,231200,42,30,12,87
3,2005,231200,50,38,12,170
4,2005,231200,37,28,9,72
5,2005,231200,57,39,18,102
6,2005,231200,52,37,15,88
7,2005,231200,59,44,15,60
8,2005,231200,59,46,13,258
9,2005,231200,42,34,8,96
10,2005,231200,49,44,5,124
11,2005,231200,49,36,13,83
12,2005,231200,34,26,8,146
1,2006,231200,37,32,5,89
2,2006,231200,34,26,8,60
3,2006,231200,46,37,9,133
4,2006,231200,61,44,17,93
5,2006,231200,46,33,13,117
6,2006,231200,41,28,13,65
7,2006,231200,55,34,21,67
8,2006,231200,50,34,16,56
9,2006,231200,48,34,14,74
10,2006,231200,51,40,11,96
11,2006,231200,41,30,11,87
12,2006,231200,49,39,10,82
1,2007,231200,35,24,11,60
2,2007,231200,41,31,10,59
3,2007,231200,48,35,13,80
4,2007,231200,45,36,9,46
5,2007,231200,66,43,23,67
6,2007,231200,53,45,8,81
7,2007,231200,40,33,7,127
8,2007,231200,35,22,13,107
9,2007,231200,55,42,13,71
10,2007,231200,48,30,18,75
11,2007,231200,48,42,6,41
12,2007,231200,51,41,10,69
1,2008,231200,51,38,13,84
2,2008,231200,34,25,9,115
3,2008,231200,44,32,12,80
4,2008,231200,48,30,18,41
5,2008,231200,45,40,5,40
6,2008,231200,63,45,18,35
7,2008,231200,65,45,20,53
8,2008,231200,51,31,20,94
9,2008,231200,75,47,28,52
10,2008,231200,53,48,5,80
11,2008,231200,58,50,8,66
12,2008,231200,48,43,5,50
1,2009,231200,58,52,6,64
2,2009,231200,31,20,11,55
3,2009,231200,51,35,16,56
4,2009,231200,51,32,19,61
5,2009,231200,51,33,18,72
6,2009,231200,47,36,11,59
7,2009,231200,64,37,27,65
8,2009,231200,58,49,9,90
9,2009,231200,41,23,18,46
10,2009,231200,60,43,17,71
11,2009,231200,46,38,8,57
12,2009,231200,62,50,12,45
1,2010,231200,43,31,12,73
2,2010,231200,20,18,2,73
3,2010,231200,48,33,15,54
4,2010,231200,47,37,10,48
5,2010,231200,48,36,12,51
6,2010,231200,40,31,9,57
7,2010,231200,57,40,17,52
8,2010,231200,45,28,17,55
9,2010,231200,46,33,13,46
10,2010,231200,39,32,7,57
11,2010,231200,41,31,10,81
12,2010,231200,26,19,7,49
1,2011,231200,22,18,4,66
2,2011,231200,25,19,6,25
1,1999,836600,29,28,1,15
2,1999,836600,47,41,6,25
3,1999,836600,41,36,5,26
4,1999,836600,43,34,9,27
5,1999,836600,38,31,7,30
6,1999,836600,52,40,12,38
7,1999,836600,42,34,8,24
8,1999,836600,36,30,6,26
9,1999,836600,46,35,11,52
10,1999,836600,47,40,7,34
11,1999,836600,37,33,4,47
12,1999,836600,39,34,5,40
1,2000,836600,39,31,8,48
2,2000,836600,38,29,9,28
3,2000,836600,38,34,4,19
4,2000,836600,46,36,10,33
5,2000,836600,42,36,6,20
6,2000,836600,44,39,5,21
7,2000,836600,50,38,12,22
8,2000,836600,50,46,4,25
9,2000,836600,43,38,5,16
10,2000,836600,32,27,5,14
11,2000,836600,35,29,6,76
12,2000,836600,41,34,7,13
1,2001,836600,39,32,7,17
2,2001,836600,33,29,4,80
3,2001,836600,37,29,8,131
4,2001,836600,53,44,9,21
5,2001,836600,39,35,4,22
6,2001,836600,43,39,4,27
7,2001,836600,57,48,9,22
8,2001,836600,38,34,4,21
9,2001,836600,41,33,8,23
10,2001,836600,42,40,2,17
11,2001,836600,42,37,5,18
12,2001,836600,40,34,6,24
1,2002,836600,42,38,4,28
2,2002,836600,29,23,6,15
3,2002,836600,40,30,10,226
4,2002,836600,31,27,4,12
5,2002,836600,41,38,3,25
6,2002,836600,40,37,3,20
7,2002,836600,53,46,7,45
8,2002,836600,44,42,2,24
9,2002,836600,51,37,14,38
10,2002,836600,47,42,5,23
11,2002,836600,31,29,2,24
12,2002,836600,39,35,4,25
1,2003,836600,24,20,4,43
2,2003,836600,30,26,4,17
3,2003,836600,42,34,8,17
4,2003,836600,33,25,8,32
5,2003,836600,51,46,5,26
6,2003,836600,45,37,8,11
7,2003,836600,62,52,10,13
8,2003,836600,57,49,8,20
9,2003,836600,47,40,7,9
10,2003,836600,41,37,4,5
11,2003,836600,53,48,5,6
12,2003,836600,32,27,5,16
1,2004,836600,28,24,4,10
2,2004,836600,26,21,5,6
3,2004,836600,40,37,3,4
4,2004,836600,35,31,4,11
5,2004,836600,28,25,3,10
6,2004,836600,40,39,1,17
7,2004,836600,45,39,6,9
8,2004,836600,50,45,5,5
9,2004,836600,53,49,4,2
10,2004,836600,49,44,5,7
11,2004,836600,33,30,3,4
12,2004,836600,23,20,3,12
1,2005,836600,31,28,3,6
2,2005,836600,23,20,3,14
3,2005,836600,39,33,6,11
4,2005,836600,29,24,5,16
5,2005,836600,43,38,5,21
6,2005,836600,31,27,4,12
7,2005,836600,52,48,4,6
8,2005,836600,45,41,4,13
9,2005,836600,34,29,5,12
10,2005,836600,29,27,2,8
11,2005,836600,35,31,4,15
12,2005,836600,25,19,6,12
1,2006,836600,26,20,6,16
2,2006,836600,25,23,2,11
3,2006,836600,30,27,3,17
4,2006,836600,28,26,2,11
5,2006,836600,40,33,7,63
6,2006,836600,40,35,5,20
7,2006,836600,44,39,5,15
8,2006,836600,47,42,5,11
9,2006,836600,29,24,5,13
10,2006,836600,39,31,8,11
11,2006,836600,23,21,2,6
12,2006,836600,27,24,3,11
1,2007,836600,21,18,3,10
2,2007,836600,31,27,4,6
3,2007,836600,29,25,4,12
4,2007,836600,28,25,3,8
5,2007,836600,24,21,3,46
6,2007,836600,32,28,4,46
7,2007,836600,33,28,5,14
8,2007,836600,42,38,4,3
9,2007,836600,31,27,4,8
10,2007,836600,51,46,5,17
11,2007,836600,38,30,8,11
12,2007,836600,36,35,1,5
1,2008,836600,36,34,2,15
2,2008,836600,22,20,2,31
3,2008,836600,38,35,3,24
4,2008,836600,32,27,5,18
5,2008,836600,40,37,3,11
6,2008,836600,47,39,8,13
7,2008,836600,51,47,4,21
8,2008,836600,48,43,5,26
9,2008,836600,49,43,6,16
10,2008,836600,40,27,13,30
11,2008,836600,27,24,3,12
12,2008,836600,39,33,6,14
1,2009,836600,22,22,0,14
2,2009,836600,18,15,3,16
3,2009,836600,32,27,5,10
4,2009,836600,33,28,5,14
5,2009,836600,34,28,6,22
6,2009,836600,39,30,9,23
7,2009,836600,37,31,6,23
8,2009,836600,48,44,4,25
9,2009,836600,35,32,3,37
10,2009,836600,45,43,2,17
11,2009,836600,43,38,5,25
12,2009,836600,40,36,4,19
1,2010,836600,24,22,2,22
2,2010,836600,42,36,6,14
3,2010,836600,43,36,7,20
4,2010,836600,32,28,4,8
5,2010,836600,33,25,8,17
6,2010,836600,29,27,2,15
7,2010,836600,39,35,4,13
8,2010,836600,30,27,3,16
9,2010,836600,47,41,6,13
10,2010,836600,34,28,6,9
11,2010,836600,34,29,5,11
12,2010,836600,24,21,3,6
1,2011,836600,27,22,5,14
2,2011,836600,16,13,3,16
1,1999,081900,2,1,1,5
2,1999,081900,6,4,2,2
3,1999,081900,14,10,4,5
4,1999,081900,14,12,2,7
5,1999,081900,10,4,6,6
6,1999,081900,8,0,8,3
7,1999,081900,18,10,8,5
8,1999,081900,8,2,6,2
9,1999,081900,5,4,1,7
10,1999,081900,12,10,2,5
11,1999,081900,4,4,0,6
12,1999,081900,7,6,1,4
1,2000,081900,12,7,5,12
2,2000,081900,12,2,10,4
3,2000,081900,13,8,5,14
4,2000,081900,9,3,6,2
5,2000,081900,14,6,8,5
6,2000,081900,15,9,6,13
7,2000,081900,14,8,6,7
8,2000,081900,9,4,5,3
9,2000,081900,6,2,4,8
10,2000,081900,9,7,2,5
11,2000,081900,7,5,2,5
12,2000,081900,15,14,1,8
1,2001,081900,6,3,3,13
2,2001,081900,6,5,1,9
3,2001,081900,13,8,5,20
4,2001,081900,9,3,6,9
5,2001,081900,10,4,6,14
6,2001,081900,16,11,5,5
7,2001,081900,15,6,9,8
8,2001,081900,9,3,6,23
9,2001,081900,11,5,6,14
10,2001,081900,11,5,6,26
11,2001,081900,15,7,8,12
12,2001,081900,11,8,3,3
1,2002,081900,7,5,2,5
2,2002,081900,7,5,2,13
3,2002,081900,6,3,3,9
4,2002,081900,8,6,2,5
5,2002,081900,6,4,2,7
6,2002,081900,19,10,9,8
7,2002,081900,14,8,6,11
8,2002,081900,9,6,3,13
9,2002,081900,11,5,6,6
10,2002,081900,9,6,3,12
11,2002,081900,8,3,5,12
12,2002,081900,10,5,5,4
1,2003,081900,7,5,2,9
2,2003,081900,5,4,1,3
3,2003,081900,7,3,4,1
4,2003,081900,7,3,4,5
5,2003,081900,7,6,1,11
6,2003,081900,13,5,8,4
7,2003,081900,13,3,10,5
8,2003,081900,10,6,4,12
9,2003,081900,7,4,3,8
10,2003,081900,5,2,3,7
11,2003,081900,8,5,3,14
12,2003,081900,12,9,3,6
1,2004,081900,3,3,0,12
2,2004,081900,7,2,5,12
3,2004,081900,14,4,10,13
4,2004,081900,11,6,5,17
5,2004,081900,9,4,5,9
6,2004,081900,12,6,6,22
7,2004,081900,4,2,2,11
8,2004,081900,5,1,4,14
9,2004,081900,10,6,4,15
10,2004,081900,2,1,1,13
11,2004,081900,6,2,4,4
12,2004,081900,6,1,5,6
1,2005,081900,10,5,5,12
2,2005,081900,3,1,2,17
3,2005,081900,9,9,0,20
4,2005,081900,7,3,4,27
5,2005,081900,9,3,6,28
6,2005,081900,8,5,3,7
7,2005,081900,13,4,9,11
8,2005,081900,9,5,4,3
9,2005,081900,2,1,1,10
10,2005,081900,5,3,2,3
11,2005,081900,3,3,0,8
12,2005,081900,5,3,2,10
1,2006,081900,6,2,4,9
2,2006,081900,4,4,0,11
3,2006,081900,6,3,3,5
4,2006,081900,13,7,6,11
5,2006,081900,7,2,5,17
6,2006,081900,10,7,3,9
7,2006,081900,20,9,11,14
8,2006,081900,10,8,2,10
9,2006,081900,6,5,1,9
10,2006,081900,9,5,4,16
11,2006,081900,5,3,2,3
12,2006,081900,3,3,0,9
1,2007,081900,5,4,1,12
2,2007,081900,5,3,2,11
3,2007,081900,10,3,7,8
4,2007,081900,6,4,2,16
5,2007,081900,17,4,13,5
6,2007,081900,7,2,5,8
7,2007,081900,12,2,10,14
8,2007,081900,15,9,6,22
9,2007,081900,2,1,1,16
10,2007,081900,11,4,7,13
11,2007,081900,7,3,4,17
12,2007,081900,4,2,2,8
1,2008,081900,4,3,1,11
2,2008,081900,8,6,2,14
3,2008,081900,7,4,3,8
4,2008,081900,3,2,1,1
5,2008,081900,8,7,1,5
6,2008,081900,5,2,3,7
7,2008,081900,4,1,3,8
8,2008,081900,5,3,2,5
9,2008,081900,6,2,4,19
10,2008,081900,4,3,1,11
11,2008,081900,5,3,2,9
12,2008,081900,3,2,1,7
1,2009,081900,0,0,0,13
2,2009,081900,3,2,1,2
3,2009,081900,3,2,1,9
4,2009,081900,7,6,1,7
5,2009,081900,4,2,2,16
6,2009,081900,8,4,4,8
7,2009,081900,7,4,3,10
8,2009,081900,3,1,2,17
9,2009,081900,2,2,0,12
10,2009,081900,3,2,1,16
11,2009,081900,3,3,0,19
12,2009,081900,5,5,0,8
1,2010,081900,4,1,3,11
2,2010,081900,1,1,0,8
3,2010,081900,5,4,1,10
4,2010,081900,6,3,3,1
5,2010,081900,5,3,2,10
6,2010,081900,3,3,0,6
7,2010,081900,5,2,3,7
8,2010,081900,4,3,1,8
9,2010,081900,1,0,1,4
10,2010,081900,6,4,2,7
11,2010,081900,1,1,0,6
12,2010,081900,6,2,4,6
1,2011,081900,3,2,1,5
2,2011,081900,1,1,0,1
1,1999,242600,30,26,4,11
2,1999,242600,26,21,5,26
3,1999,242600,22,17,5,24
4,1999,242600,31,25,6,10
5,1999,242600,37,27,10,18
6,1999,242600,27,19,8,18
7,1999,242600,50,45,5,19
8,1999,242600,40,30,10,13
9,1999,242600,31,23,8,19
10,1999,242600,46,39,7,14
11,1999,242600,36,27,9,14
12,1999,242600,37,33,4,15
1,2000,242600,36,30,6,11
2,2000,242600,38,33,5,13
3,2000,242600,40,32,8,12
4,2000,242600,33,23,10,15
5,2000,242600,43,36,7,14
6,2000,242600,28,18,10,7
7,2000,242600,52,34,18,17
8,2000,242600,53,47,6,17
9,2000,242600,42,35,7,6
10,2000,242600,36,26,10,13
11,2000,242600,34,31,3,7
12,2000,242600,32,28,4,11
1,2001,242600,38,31,7,8
2,2001,242600,35,27,8,19
3,2001,242600,29,24,5,11
4,2001,242600,42,38,4,13
5,2001,242600,32,25,7,11
6,2001,242600,30,23,7,19
7,2001,242600,36,28,8,11
8,2001,242600,28,24,4,15
9,2001,242600,32,26,6,11
10,2001,242600,38,31,7,17
11,2001,242600,40,33,7,8
12,2001,242600,47,41,6,20
1,2002,242600,38,30,8,14
2,2002,242600,21,18,3,17
3,2002,242600,25,20,5,9
4,2002,242600,27,22,5,10
5,2002,242600,33,29,4,11
6,2002,242600,36,32,4,11
7,2002,242600,56,44,12,18
8,2002,242600,55,49,6,15
9,2002,242600,47,41,6,6
10,2002,242600,41,38,3,10
11,2002,242600,28,24,4,15
12,2002,242600,24,20,4,17
1,2003,242600,30,28,2,13
2,2003,242600,21,19,2,25
3,2003,242600,36,29,7,10
4,2003,242600,28,22,6,20
5,2003,242600,29,21,8,9
6,2003,242600,25,18,7,7
7,2003,242600,48,46,2,18
8,2003,242600,57,53,4,13
9,2003,242600,57,50,7,13
10,2003,242600,43,34,9,13
11,2003,242600,31,27,4,15
12,2003,242600,33,30,3,14
1,2004,242600,37,32,5,11
2,2004,242600,16,13,3,15
3,2004,242600,24,17,7,9
4,2004,242600,31,26,5,13
5,2004,242600,24,18,6,10
6,2004,242600,34,31,3,9
7,2004,242600,52,43,9,9
8,2004,242600,34,27,7,11
9,2004,242600,32,29,3,8
10,2004,242600,31,26,5,12
11,2004,242600,31,29,2,10
12,2004,242600,25,23,2,19
1,2005,242600,20,18,2,8
2,2005,242600,24,21,3,9
3,2005,242600,16,11,5,7
4,2005,242600,23,20,3,6
5,2005,242600,24,21,3,15
6,2005,242600,23,22,1,4
7,2005,242600,26,19,7,10
8,2005,242600,27,23,4,9
9,2005,242600,24,20,4,6
10,2005,242600,26,24,2,8
11,2005,242600,19,18,1,8
12,2005,242600,17,15,2,4
1,2006,242600,16,14,2,5
2,2006,242600,16,15,1,8
3,2006,242600,29,19,10,12
4,2006,242600,20,16,4,9
5,2006,242600,32,26,6,9
6,2006,242600,36,30,6,17
7,2006,242600,45,35,10,14
8,2006,242600,36,31,5,5
9,2006,242600,19,15,4,6
10,2006,242600,26,24,2,13
11,2006,242600,27,22,5,14
12,2006,242600,20,17,3,8
1,2007,242600,22,19,3,6
2,2007,242600,12,11,1,1
3,2007,242600,16,13,3,11
4,2007,242600,19,16,3,4
5,2007,242600,20,16,4,16
6,2007,242600,31,30,1,20
7,2007,242600,38,30,8,16
8,2007,242600,39,37,2,6
9,2007,242600,31,28,3,6
10,2007,242600,25,22,3,10
11,2007,242600,27,23,4,9
12,2007,242600,15,14,1,2
1,2008,242600,32,28,4,4
2,2008,242600,27,27,0,6
3,2008,242600,27,23,4,7
4,2008,242600,17,16,1,6
5,2008,242600,22,17,5,9
6,2008,242600,20,18,2,10
7,2008,242600,16,15,1,8
8,2008,242600,24,22,2,4
9,2008,242600,22,20,2,8
10,2008,242600,20,19,1,5
11,2008,242600,22,19,3,11
12,2008,242600,15,12,3,0
1,2009,242600,23,21,2,5
2,2009,242600,18,16,2,5
3,2009,242600,35,33,2,6
4,2009,242600,26,25,1,3
5,2009,242600,19,17,2,11
6,2009,242600,30,24,6,4
7,2009,242600,28,26,2,7
8,2009,242600,24,22,2,3
9,2009,242600,20,18,2,5
10,2009,242600,35,32,3,6
11,2009,242600,26,24,2,5
12,2009,242600,27,27,0,3
1,2010,242600,17,16,1,4
2,2010,242600,11,9,2,3
3,2010,242600,17,14,3,4
4,2010,242600,13,11,2,2
5,2010,242600,20,18,2,4
6,2010,242600,22,19,3,12
7,2010,242600,29,23,6,3
8,2010,242600,30,25,5,5
9,2010,242600,30,29,1,3
10,2010,242600,26,23,3,4
11,2010,242600,28,26,2,10
12,2010,242600,27,26,1,4
1,2011,242600,18,15,3,0
2,2011,242600,5,4,1,5
1,1999,242500,24,23,1,4
2,1999,242500,17,15,2,4
3,1999,242500,17,15,2,4
4,1999,242500,19,17,2,0
5,1999,242500,26,22,4,3
6,1999,242500,23,19,4,3
7,1999,242500,22,17,5,5
8,1999,242500,15,14,1,2
9,1999,242500,24,21,3,4
10,1999,242500,21,18,3,2
11,1999,242500,14,12,2,3
12,1999,242500,30,26,4,5
1,2000,242500,26,26,0,4
2,2000,242500,16,14,2,4
3,2000,242500,27,23,4,6
4,2000,242500,22,18,4,3
5,2000,242500,23,23,0,4
6,2000,242500,23,18,5,3
7,2000,242500,26,22,4,1
8,2000,242500,27,22,5,9
9,2000,242500,29,26,3,4
10,2000,242500,19,14,5,3
11,2000,242500,27,26,1,5
12,2000,242500,18,16,2,5
1,2001,242500,20,19,1,4
2,2001,242500,20,14,6,7
3,2001,242500,18,17,1,4
4,2001,242500,27,25,2,1
5,2001,242500,19,16,3,4
6,2001,242500,31,25,6,3
7,2001,242500,16,14,2,1
8,2001,242500,15,13,2,5
9,2001,242500,25,21,4,2
10,2001,242500,23,21,2,1
11,2001,242500,23,21,2,2
12,2001,242500,27,22,5,2
1,2002,242500,19,17,2,1
2,2002,242500,17,15,2,2
3,2002,242500,12,12,0,3
4,2002,242500,11,9,2,3
5,2002,242500,14,11,3,2
6,2002,242500,33,30,3,0
7,2002,242500,27,25,2,1
8,2002,242500,41,39,2,2
9,2002,242500,27,26,1,1
10,2002,242500,29,28,1,3
11,2002,242500,17,17,0,2
12,2002,242500,24,22,2,6
1,2003,242500,15,13,2,1
2,2003,242500,16,15,1,4
3,2003,242500,21,20,1,1
4,2003,242500,21,19,2,4
5,2003,242500,20,18,2,4
6,2003,242500,22,19,3,1
7,2003,242500,41,40,1,3
8,2003,242500,32,32,0,2
9,2003,242500,28,25,3,2
10,2003,242500,20,17,3,3
11,2003,242500,22,21,1,0
12,2003,242500,17,15,2,0
1,2004,242500,14,13,1,3
2,2004,242500,15,14,1,2
3,2004,242500,17,15,2,4
4,2004,242500,19,19,0,3
5,2004,242500,22,19,3,1
6,2004,242500,16,16,0,1
7,2004,242500,27,26,1,1
8,2004,242500,23,22,1,5
9,2004,242500,22,21,1,0
10,2004,242500,18,17,1,3
11,2004,242500,9,8,1,0
12,2004,242500,17,16,1,1
1,2005,242500,15,15,0,3
2,2005,242500,7,4,3,5
3,2005,242500,12,12,0,1
4,2005,242500,9,9,0,1
5,2005,242500,16,16,0,5
6,2005,242500,14,14,0,2
7,2005,242500,10,9,1,2
8,2005,242500,8,7,1,7
9,2005,242500,16,13,3,2
10,2005,242500,15,14,1,0
11,2005,242500,11,11,0,1
12,2005,242500,18,15,3,0
1,2006,242500,11,10,1,0
2,2006,242500,9,9,0,1
3,2006,242500,10,10,0,0
4,2006,242500,15,14,1,1
5,2006,242500,15,14,1,2
6,2006,242500,19,19,0,1
7,2006,242500,15,15,0,1
8,2006,242500,18,16,2,0
9,2006,242500,17,17,0,0
10,2006,242500,12,11,1,3
11,2006,242500,16,13,3,1
12,2006,242500,14,13,1,5
1,2007,242500,11,10,1,1
2,2007,242500,7,6,1,0
3,2007,242500,11,11,0,4
4,2007,242500,13,13,0,1
5,2007,242500,13,13,0,8
6,2007,242500,17,16,1,3
7,2007,242500,28,27,1,3
8,2007,242500,24,22,2,3
9,2007,242500,16,16,0,5
10,2007,242500,14,13,1,3
11,2007,242500,13,13,0,0
12,2007,242500,20,20,0,0
1,2008,242500,21,20,1,0
2,2008,242500,14,14,0,1
3,2008,242500,17,16,1,1
4,2008,242500,14,12,2,3
5,2008,242500,12,12,0,1
6,2008,242500,16,14,2,2
7,2008,242500,13,12,1,1
8,2008,242500,10,9,1,2
9,2008,242500,22,19,3,4
10,2008,242500,14,13,1,1
11,2008,242500,7,7,0,0
12,2008,242500,17,17,0,0
1,2009,242500,16,16,0,1
2,2009,242500,10,10,0,2
3,2009,242500,13,13,0,1
4,2009,242500,12,8,4,0
5,2009,242500,12,9,3,3
6,2009,242500,14,12,2,2
7,2009,242500,20,20,0,1
8,2009,242500,15,13,2,2
9,2009,242500,17,16,1,2
10,2009,242500,15,14,1,1
11,2009,242500,16,16,0,0
12,2009,242500,15,14,1,1
1,2010,242500,15,15,0,0
2,2010,242500,8,6,2,1
3,2010,242500,5,4,1,2
4,2010,242500,11,11,0,1
5,2010,242500,8,6,2,1
6,2010,242500,7,6,1,1
7,2010,242500,14,14,0,3
8,2010,242500,18,18,0,0
9,2010,242500,11,11,0,2
10,2010,242500,17,17,0,0
11,2010,242500,11,11,0,4
12,2010,242500,8,6,2,0
1,2011,242500,7,7,0,1
2,2011,242500,10,10,0,0
1,1999,242400,16,16,0,1
2,1999,242400,15,15,0,2
3,1999,242400,19,18,1,1
4,1999,242400,12,12,0,1
5,1999,242400,15,14,1,2
6,1999,242400,18,17,1,2
7,1999,242400,19,19,0,3
8,1999,242400,18,18,0,0
9,1999,242400,23,22,1,1
10,1999,242400,25,25,0,3
11,1999,242400,15,15,0,2
12,1999,242400,22,21,1,1
1,2000,242400,17,17,0,1
2,2000,242400,10,9,1,3
3,2000,242400,21,19,2,2
4,2000,242400,18,17,1,3
5,2000,242400,17,16,1,3
6,2000,242400,17,17,0,1
7,2000,242400,19,19,0,1
8,2000,242400,20,20,0,0
9,2000,242400,21,21,0,1
10,2000,242400,28,26,2,5
11,2000,242400,24,22,2,3
12,2000,242400,6,6,0,2
1,2001,242400,16,15,1,1
2,2001,242400,13,13,0,6
3,2001,242400,18,17,1,1
4,2001,242400,18,18,0,1
5,2001,242400,19,18,1,0
6,2001,242400,19,17,2,1
7,2001,242400,15,15,0,3
8,2001,242400,28,28,0,2
9,2001,242400,23,21,2,1
10,2001,242400,17,16,1,4
11,2001,242400,22,21,1,2
12,2001,242400,19,18,1,7
1,2002,242400,13,12,1,3
2,2002,242400,15,15,0,8
3,2002,242400,13,12,1,2
4,2002,242400,17,16,1,7
5,2002,242400,22,20,2,0
6,2002,242400,27,26,1,5
7,2002,242400,28,27,1,0
8,2002,242400,24,23,1,2
9,2002,242400,30,30,0,2
10,2002,242400,22,21,1,2
11,2002,242400,22,21,1,3
12,2002,242400,10,10,0,3
1,2003,242400,20,19,1,9
2,2003,242400,8,8,0,7
3,2003,242400,16,14,2,2
4,2003,242400,15,13,2,4
5,2003,242400,20,19,1,7
6,2003,242400,27,27,0,1
7,2003,242400,23,23,0,6
8,2003,242400,20,19,1,2
9,2003,242400,26,25,1,2
10,2003,242400,31,31,0,9
11,2003,242400,19,19,0,1
12,2003,242400,27,25,2,3
1,2004,242400,15,13,2,5
2,2004,242400,16,15,1,10
3,2004,242400,17,17,0,4
4,2004,242400,21,20,1,2
5,2004,242400,23,22,1,1
6,2004,242400,20,19,1,3
7,2004,242400,32,32,0,2
8,2004,242400,25,25,0,0
9,2004,242400,25,24,1,0
10,2004,242400,17,17,0,2
11,2004,242400,8,7,1,0
12,2004,242400,19,18,1,1
1,2005,242400,13,13,0,3
2,2005,242400,13,12,1,7
3,2005,242400,22,21,1,3
4,2005,242400,16,16,0,3
5,2005,242400,20,19,1,3
6,2005,242400,11,10,1,1
7,2005,242400,9,9,0,1
8,2005,242400,19,18,1,0
9,2005,242400,16,16,0,3
10,2005,242400,23,22,1,6
11,2005,242400,18,18,0,1
12,2005,242400,32,30,2,9
1,2006,242400,21,21,0,0
2,2006,242400,19,19,0,3
3,2006,242400,11,11,0,3
4,2006,242400,12,11,1,0
5,2006,242400,26,24,2,6
6,2006,242400,22,22,0,1
7,2006,242400,12,12,0,1
8,2006,242400,12,11,1,0
9,2006,242400,16,13,3,4
10,2006,242400,12,10,2,4
11,2006,242400,21,18,3,3
12,2006,242400,19,18,1,2
1,2007,242400,11,11,0,0
2,2007,242400,10,9,1,7
3,2007,242400,10,10,0,5
4,2007,242400,14,12,2,3
5,2007,242400,19,18,1,4
6,2007,242400,7,6,1,2
7,2007,242400,17,16,1,0
8,2007,242400,7,7,0,1
9,2007,242400,25,24,1,1
10,2007,242400,17,17,0,4
11,2007,242400,27,26,1,3
12,2007,242400,34,30,4,2
1,2008,242400,19,19,0,6
2,2008,242400,10,10,0,3
3,2008,242400,16,16,0,4
4,2008,242400,19,17,2,6
5,2008,242400,18,18,0,2
6,2008,242400,13,13,0,0
7,2008,242400,18,18,0,1
8,2008,242400,15,13,2,1
9,2008,242400,20,19,1,0
10,2008,242400,16,15,1,1
11,2008,242400,21,19,2,0
12,2008,242400,12,12,0,5
1,2009,242400,16,15,1,6
2,2009,242400,13,12,1,6
3,2009,242400,19,19,0,1
4,2009,242400,14,13,1,0
5,2009,242400,11,10,1,4
6,2009,242400,10,10,0,2
7,2009,242400,15,14,1,2
8,2009,242400,14,13,1,0
9,2009,242400,17,16,1,1
10,2009,242400,15,15,0,5
11,2009,242400,16,15,1,2
12,2009,242400,28,26,2,3
1,2010,242400,18,17,1,4
2,2010,242400,10,9,1,4
3,2010,242400,10,10,0,4
4,2010,242400,18,17,1,5
5,2010,242400,15,13,2,1
6,2010,242400,13,13,0,1
7,2010,242400,15,15,0,0
8,2010,242400,20,18,2,0
9,2010,242400,14,14,0,5
10,2010,242400,18,17,1,2
11,2010,242400,15,13,2,1
12,2010,242400,19,17,2,2
1,2011,242400,16,16,0,2
2,2011,242400,6,5,1,1
1,1999,242700,7,6,1,2
2,1999,242700,9,6,3,6
3,1999,242700,4,2,2,4
4,1999,242700,8,8,0,6
5,1999,242700,6,5,1,4
6,1999,242700,8,5,3,4
7,1999,242700,9,4,5,4
8,1999,242700,7,2,5,0
9,1999,242700,7,6,1,3
10,1999,242700,11,8,3,2
11,1999,242700,5,5,0,3
12,1999,242700,2,2,0,0
1,2000,242700,9,6,3,1
2,2000,242700,7,7,0,3
3,2000,242700,10,8,2,6
4,2000,242700,8,8,0,3
5,2000,242700,9,8,1,0
6,2000,242700,6,6,0,0
7,2000,242700,12,6,6,3
8,2000,242700,7,6,1,1
9,2000,242700,8,7,1,6
10,2000,242700,8,8,0,5
11,2000,242700,2,1,1,4
12,2000,242700,8,6,2,1
1,2001,242700,5,3,2,1
2,2001,242700,5,4,1,2
3,2001,242700,8,7,1,4
4,2001,242700,6,3,3,9
5,2001,242700,6,5,1,4
6,2001,242700,10,8,2,5
7,2001,242700,7,6,1,3
8,2001,242700,11,9,2,0
9,2001,242700,6,5,1,1
10,2001,242700,6,4,2,2
11,2001,242700,6,6,0,4
12,2001,242700,6,4,2,0
1,2002,242700,5,4,1,2
2,2002,242700,5,5,0,2
3,2002,242700,6,4,2,2
4,2002,242700,7,6,1,6
5,2002,242700,5,5,0,3
6,2002,242700,10,9,1,2
7,2002,242700,4,4,0,4
8,2002,242700,7,6,1,2
9,2002,242700,11,9,2,2
10,2002,242700,4,3,1,3
11,2002,242700,3,3,0,3
12,2002,242700,9,8,1,1
1,2003,242700,6,4,2,6
2,2003,242700,8,7,1,2
3,2003,242700,4,3,1,3
4,2003,242700,6,2,4,0
5,2003,242700,10,10,0,0
6,2003,242700,4,4,0,0
7,2003,242700,12,9,3,0
8,2003,242700,8,6,2,1
9,2003,242700,10,5,5,2
10,2003,242700,4,4,0,0
11,2003,242700,10,9,1,0
12,2003,242700,5,4,1,0
1,2004,242700,2,2,0,2
2,2004,242700,5,4,1,4
3,2004,242700,8,6,2,2
4,2004,242700,3,3,0,6
5,2004,242700,4,3,1,0
6,2004,242700,6,5,1,4
7,2004,242700,13,13,0,4
8,2004,242700,11,7,4,4
9,2004,242700,7,6,1,4
10,2004,242700,2,1,1,4
11,2004,242700,4,4,0,6
12,2004,242700,9,8,1,5
1,2005,242700,15,12,3,3
2,2005,242700,5,4,1,7
3,2005,242700,1,1,0,5
4,2005,242700,4,2,2,2
5,2005,242700,11,8,3,6
6,2005,242700,5,5,0,5
7,2005,242700,11,9,2,4
8,2005,242700,5,5,0,6
9,2005,242700,1,1,0,2
10,2005,242700,3,2,1,2
11,2005,242700,2,2,0,3
12,2005,242700,1,1,0,2
1,2006,242700,6,5,1,3
2,2006,242700,3,2,1,0
3,2006,242700,7,6,1,2
4,2006,242700,5,2,3,3
5,2006,242700,6,5,1,1
6,2006,242700,3,3,0,1
7,2006,242700,6,5,1,1
8,2006,242700,5,2,3,3
9,2006,242700,2,2,0,2
10,2006,242700,4,3,1,0
11,2006,242700,2,2,0,2
12,2006,242700,8,8,0,2
1,2007,242700,1,1,0,1
2,2007,242700,5,5,0,1
3,2007,242700,3,3,0,0
4,2007,242700,7,7,0,1
5,2007,242700,11,9,2,1
6,2007,242700,8,8,0,2
7,2007,242700,4,4,0,2
8,2007,242700,3,1,2,4
9,2007,242700,4,4,0,2
10,2007,242700,3,3,0,2
11,2007,242700,4,4,0,3
12,2007,242700,3,2,1,0
1,2008,242700,4,4,0,2
2,2008,242700,3,2,1,0
3,2008,242700,4,4,0,3
4,2008,242700,3,2,1,0
5,2008,242700,3,3,0,0
6,2008,242700,12,9,3,2
7,2008,242700,3,3,0,3
8,2008,242700,4,4,0,2
9,2008,242700,5,5,0,4
10,2008,242700,4,3,1,5
11,2008,242700,3,2,1,1
12,2008,242700,5,5,0,1
1,2009,242700,2,2,0,5
2,2009,242700,4,4,0,1
3,2009,242700,5,4,1,0
4,2009,242700,1,0,1,4
5,2009,242700,2,2,0,0
6,2009,242700,8,7,1,3
7,2009,242700,2,2,0,5
8,2009,242700,4,3,1,3
9,2009,242700,6,6,0,3
10,2009,242700,2,1,1,3
11,2009,242700,5,5,0,2
12,2009,242700,9,9,0,1
1,2010,242700,4,3,1,2
2,2010,242700,4,4,0,1
3,2010,242700,7,7,0,3
4,2010,242700,4,4,0,0
5,2010,242700,2,2,0,0
6,2010,242700,7,5,2,3
7,2010,242700,10,6,4,1
8,2010,242700,4,2,2,5
9,2010,242700,3,3,0,0
10,2010,242700,8,7,1,1
11,2010,242700,6,5,1,2
12,2010,242700,1,1,0,0
1,2011,242700,4,3,1,2
2,2011,242700,4,3,1,1
1,1999,242300,12,12,0,0
2,1999,242300,10,8,2,1
3,1999,242300,12,12,0,0
4,1999,242300,10,10,0,0
5,1999,242300,19,18,1,0
6,1999,242300,17,16,1,0
7,1999,242300,25,25,0,0
8,1999,242300,13,11,2,2
9,1999,242300,13,12,1,0
10,1999,242300,16,16,0,0
11,1999,242300,14,14,0,0
12,1999,242300,12,12,0,1
1,2000,242300,18,18,0,1
2,2000,242300,13,13,0,2
3,2000,242300,9,8,1,1
4,2000,242300,16,16,0,1
5,2000,242300,13,12,1,3
6,2000,242300,11,10,1,0
7,2000,242300,12,12,0,4
8,2000,242300,19,18,1,0
9,2000,242300,17,16,1,0
10,2000,242300,21,21,0,2
11,2000,242300,20,20,0,1
12,2000,242300,9,9,0,2
1,2001,242300,10,10,0,3
2,2001,242300,7,6,1,0
3,2001,242300,12,11,1,0
4,2001,242300,12,12,0,0
5,2001,242300,10,9,1,0
6,2001,242300,11,11,0,2
7,2001,242300,11,11,0,2
8,2001,242300,18,18,0,0
9,2001,242300,8,8,0,3
10,2001,242300,13,13,0,0
11,2001,242300,17,17,0,2
12,2001,242300,17,16,1,0
1,2002,242300,13,13,0,1
2,2002,242300,9,9,0,1
3,2002,242300,10,10,0,1
4,2002,242300,6,6,0,0
5,2002,242300,19,19,0,1
6,2002,242300,20,19,1,1
7,2002,242300,15,13,2,0
8,2002,242300,13,13,0,0
9,2002,242300,23,23,0,0
10,2002,242300,21,20,1,0
11,2002,242300,18,18,0,0
12,2002,242300,14,13,1,0
1,2003,242300,10,10,0,0
2,2003,242300,14,14,0,0
3,2003,242300,19,18,1,0
4,2003,242300,12,12,0,0
5,2003,242300,15,14,1,1
6,2003,242300,13,13,0,0
7,2003,242300,24,24,0,2
8,2003,242300,19,19,0,2
9,2003,242300,10,10,0,0
10,2003,242300,19,18,1,0
11,2003,242300,13,13,0,1
12,2003,242300,17,17,0,0
1,2004,242300,10,9,1,0
2,2004,242300,8,8,0,0
3,2004,242300,22,22,0,0
4,2004,242300,7,7,0,1
5,2004,242300,15,14,1,0
6,2004,242300,13,11,2,0
7,2004,242300,33,33,0,1
8,2004,242300,31,31,0,3
9,2004,242300,23,22,1,0
10,2004,242300,13,13,0,0
11,2004,242300,12,12,0,0
12,2004,242300,13,13,0,0
1,2005,242300,5,5,0,0
2,2005,242300,6,6,0,1
3,2005,242300,14,13,1,0
4,2005,242300,13,13,0,1
5,2005,242300,19,19,0,1
6,2005,242300,7,6,1,0
7,2005,242300,14,14,0,0
8,2005,242300,20,19,1,1
9,2005,242300,10,10,0,3
10,2005,242300,8,7,1,2
11,2005,242300,12,12,0,0
12,2005,242300,10,10,0,0
1,2006,242300,15,15,0,0
2,2006,242300,7,6,1,0
3,2006,242300,13,12,1,0
4,2006,242300,12,12,0,0
5,2006,242300,16,16,0,0
6,2006,242300,19,18,1,0
7,2006,242300,11,10,1,0
8,2006,242300,16,15,1,1
9,2006,242300,12,11,1,0
10,2006,242300,12,11,1,0
11,2006,242300,9,9,0,0
12,2006,242300,11,11,0,0
1,2007,242300,6,6,0,0
2,2007,242300,5,5,0,0
3,2007,242300,7,6,1,0
4,2007,242300,9,8,1,0
5,2007,242300,12,12,0,1
6,2007,242300,6,5,1,0
7,2007,242300,16,16,0,0
8,2007,242300,10,10,0,0
9,2007,242300,11,10,1,1
10,2007,242300,15,14,1,0
11,2007,242300,26,26,0,0
12,2007,242300,14,14,0,0
1,2008,242300,19,19,0,1
2,2008,242300,8,8,0,0
3,2008,242300,12,12,0,0
4,2008,242300,13,13,0,0
5,2008,242300,13,12,1,1
6,2008,242300,11,11,0,0
7,2008,242300,15,13,2,0
8,2008,242300,14,13,1,0
9,2008,242300,12,12,0,0
10,2008,242300,21,19,2,0
11,2008,242300,14,13,1,0
12,2008,242300,14,13,1,0
1,2009,242300,12,12,0,0
2,2009,242300,15,14,1,0
3,2009,242300,13,13,0,0
4,2009,242300,8,8,0,1
5,2009,242300,10,8,2,0
6,2009,242300,13,13,0,0
7,2009,242300,8,8,0,0
8,2009,242300,12,12,0,0
9,2009,242300,12,12,0,2
10,2009,242300,13,12,1,0
11,2009,242300,16,16,0,1
12,2009,242300,9,9,0,0
1,2010,242300,10,10,0,0
2,2010,242300,11,11,0,1
3,2010,242300,5,5,0,0
4,2010,242300,8,7,1,0
5,2010,242300,10,10,0,0
6,2010,242300,11,10,1,0
7,2010,242300,10,10,0,0
8,2010,242300,11,11,0,0
9,2010,242300,17,17,0,0
10,2010,242300,12,12,0,0
11,2010,242300,14,14,0,0
12,2010,242300,14,14,0,0
1,2011,242300,21,21,0,0
2,2011,242300,7,7,0,1
1,1999,242200,22,20,2,2
2,1999,242200,33,26,7,4
3,1999,242200,29,26,3,4
4,1999,242200,19,18,1,2
5,1999,242200,48,43,5,5
6,1999,242200,30,29,1,1
7,1999,242200,31,28,3,1
8,1999,242200,46,41,5,4
9,1999,242200,27,27,0,6
10,1999,242200,41,39,2,0
11,1999,242200,31,29,2,5
12,1999,242200,30,27,3,0
1,2000,242200,39,36,3,5
2,2000,242200,21,18,3,3
3,2000,242200,27,25,2,2
4,2000,242200,24,19,5,0
5,2000,242200,24,22,2,0
6,2000,242200,23,21,2,3
7,2000,242200,35,31,4,6
8,2000,242200,25,23,2,7
9,2000,242200,40,40,0,6
10,2000,242200,45,43,2,5
11,2000,242200,31,29,2,1
12,2000,242200,18,18,0,0
1,2001,242200,24,20,4,0
2,2001,242200,20,18,2,0
3,2001,242200,16,14,2,7
4,2001,242200,29,26,3,2
5,2001,242200,23,21,2,1
6,2001,242200,29,28,1,3
7,2001,242200,28,22,6,0
8,2001,242200,33,33,0,3
9,2001,242200,32,31,1,2
10,2001,242200,21,20,1,1
11,2001,242200,26,25,1,3
12,2001,242200,22,20,2,1
1,2002,242200,25,22,3,0
2,2002,242200,24,24,0,4
3,2002,242200,24,24,0,4
4,2002,242200,21,20,1,5
5,2002,242200,23,20,3,4
6,2002,242200,37,34,3,2
7,2002,242200,34,33,1,0
8,2002,242200,31,29,2,1
9,2002,242200,24,22,2,1
10,2002,242200,24,22,2,0
11,2002,242200,25,25,0,1
12,2002,242200,19,19,0,3
1,2003,242200,19,17,2,2
2,2003,242200,20,18,2,3
3,2003,242200,18,15,3,1
4,2003,242200,18,18,0,0
5,2003,242200,27,26,1,0
6,2003,242200,25,25,0,1
7,2003,242200,31,30,1,2
8,2003,242200,27,27,0,3
9,2003,242200,24,21,3,0
10,2003,242200,44,42,2,0
11,2003,242200,33,33,0,0
12,2003,242200,36,35,1,0
1,2004,242200,21,19,2,0
2,2004,242200,21,20,1,0
3,2004,242200,26,25,1,1
4,2004,242200,31,31,0,0
5,2004,242200,29,29,0,0
6,2004,242200,21,20,1,0
7,2004,242200,33,32,1,1
8,2004,242200,34,34,0,1
9,2004,242200,28,26,2,0
10,2004,242200,33,32,1,2
11,2004,242200,20,19,1,3
12,2004,242200,19,16,3,0
1,2005,242200,15,15,0,0
2,2005,242200,10,8,2,5
3,2005,242200,16,15,1,3
4,2005,242200,23,21,2,3
5,2005,242200,16,14,2,0
6,2005,242200,28,27,1,0
7,2005,242200,28,26,2,0
8,2005,242200,28,24,4,0
9,2005,242200,28,26,2,0
10,2005,242200,28,28,0,0
11,2005,242200,24,24,0,0
12,2005,242200,32,32,0,1
1,2006,242200,24,23,1,0
2,2006,242200,16,16,0,1
3,2006,242200,24,24,0,1
4,2006,242200,17,17,0,0
5,2006,242200,21,20,1,2
6,2006,242200,25,25,0,0
7,2006,242200,26,26,0,1
8,2006,242200,20,18,2,0
9,2006,242200,15,14,1,2
10,2006,242200,21,21,0,3
11,2006,242200,25,25,0,3
12,2006,242200,14,14,0,1
1,2007,242200,16,14,2,2
2,2007,242200,11,11,0,0
3,2007,242200,14,13,1,2
4,2007,242200,15,14,1,0
5,2007,242200,19,18,1,0
6,2007,242200,21,20,1,1
7,2007,242200,21,20,1,0
8,2007,242200,34,31,3,0
9,2007,242200,21,20,1,3
10,2007,242200,39,37,2,2
11,2007,242200,32,32,0,1
12,2007,242200,30,29,1,0
1,2008,242200,39,38,1,1
2,2008,242200,14,14,0,1
3,2008,242200,18,18,0,1
4,2008,242200,34,33,1,0
5,2008,242200,35,32,3,1
6,2008,242200,31,31,0,0
7,2008,242200,50,49,1,1
8,2008,242200,43,43,0,1
9,2008,242200,33,33,0,0
10,2008,242200,37,35,2,0
11,2008,242200,41,41,0,0
12,2008,242200,32,32,0,3
1,2009,242200,38,37,1,0
2,2009,242200,29,28,1,2
3,2009,242200,30,30,0,1
4,2009,242200,34,32,2,0
5,2009,242200,27,27,0,0
6,2009,242200,16,16,0,1
7,2009,242200,30,27,3,1
8,2009,242200,25,25,0,0
9,2009,242200,28,28,0,1
10,2009,242200,25,25,0,1
11,2009,242200,22,21,1,0
12,2009,242200,27,26,1,0
1,2010,242200,24,23,1,1
2,2010,242200,9,9,0,1
3,2010,242200,20,20,0,1
4,2010,242200,24,24,0,0
5,2010,242200,22,19,3,1
6,2010,242200,23,23,0,1
7,2010,242200,31,31,0,1
8,2010,242200,35,33,2,1
9,2010,242200,39,38,1,0
10,2010,242200,21,20,1,0
11,2010,242200,30,30,0,2
12,2010,242200,27,26,1,0
1,2011,242200,27,27,0,1
2,2011,242200,15,15,0,2
1,1999,242100,19,18,1,4
2,1999,242100,10,10,0,4
3,1999,242100,16,13,3,6
4,1999,242100,18,16,2,6
5,1999,242100,25,19,6,3
6,1999,242100,22,19,3,3
7,1999,242100,31,28,3,0
8,1999,242100,25,20,5,2
9,1999,242100,24,22,2,3
10,1999,242100,17,15,2,7
11,1999,242100,13,13,0,1
12,1999,242100,25,23,2,2
1,2000,242100,26,24,2,3
2,2000,242100,16,15,1,4
3,2000,242100,17,13,4,8
4,2000,242100,18,14,4,5
5,2000,242100,26,20,6,3
6,2000,242100,16,14,2,4
7,2000,242100,33,30,3,3
8,2000,242100,26,25,1,0
9,2000,242100,18,11,7,4
10,2000,242100,25,22,3,6
11,2000,242100,16,12,4,3
12,2000,242100,30,28,2,2
1,2001,242100,23,20,3,4
2,2001,242100,15,11,4,4
3,2001,242100,19,16,3,4
4,2001,242100,23,18,5,3
5,2001,242100,19,14,5,2
6,2001,242100,18,16,2,1
7,2001,242100,16,11,5,3
8,2001,242100,30,29,1,3
9,2001,242100,21,19,2,4
10,2001,242100,25,23,2,2
11,2001,242100,18,13,5,2
12,2001,242100,16,15,1,3
1,2002,242100,17,12,5,4
2,2002,242100,11,11,0,3
3,2002,242100,10,9,1,2
4,2002,242100,13,11,2,1
5,2002,242100,18,14,4,0
6,2002,242100,17,16,1,1
7,2002,242100,18,16,2,1
8,2002,242100,18,14,4,3
9,2002,242100,19,17,2,3
10,2002,242100,15,12,3,0
11,2002,242100,20,15,5,5
12,2002,242100,14,13,1,1
1,2003,242100,13,11,2,3
2,2003,242100,12,11,1,2
3,2003,242100,21,18,3,6
4,2003,242100,21,20,1,4
5,2003,242100,27,21,6,3
6,2003,242100,20,16,4,1
7,2003,242100,29,26,3,5
8,2003,242100,21,17,4,6
9,2003,242100,31,29,2,5
10,2003,242100,23,22,1,4
11,2003,242100,33,32,1,0
12,2003,242100,32,31,1,0
1,2004,242100,18,18,0,3
2,2004,242100,11,10,1,6
3,2004,242100,24,24,0,4
4,2004,242100,29,26,3,7
5,2004,242100,29,25,4,6
6,2004,242100,21,18,3,7
7,2004,242100,25,24,1,3
8,2004,242100,37,35,2,1
9,2004,242100,32,29,3,2
10,2004,242100,22,22,0,7
11,2004,242100,15,8,7,2
12,2004,242100,10,9,1,5
1,2005,242100,8,7,1,14
2,2005,242100,18,15,3,2
3,2005,242100,12,11,1,2
4,2005,242100,17,15,2,0
5,2005,242100,14,14,0,4
6,2005,242100,15,11,4,1
7,2005,242100,19,19,0,2
8,2005,242100,24,20,4,2
9,2005,242100,31,31,0,1
10,2005,242100,21,19,2,2
11,2005,242100,17,15,2,2
12,2005,242100,17,14,3,1
1,2006,242100,31,28,3,1
2,2006,242100,8,7,1,2
3,2006,242100,21,19,2,6
4,2006,242100,23,21,2,1
5,2006,242100,21,18,3,5
6,2006,242100,22,19,3,0
7,2006,242100,20,19,1,0
8,2006,242100,13,13,0,0
9,2006,242100,12,12,0,0
10,2006,242100,27,25,2,0
11,2006,242100,16,15,1,0
12,2006,242100,16,15,1,2
1,2007,242100,14,12,2,2
2,2007,242100,11,11,0,5
3,2007,242100,7,7,0,2
4,2007,242100,16,16,0,7
5,2007,242100,11,10,1,5
6,2007,242100,12,12,0,3
7,2007,242100,17,17,0,4
8,2007,242100,33,33,0,3
9,2007,242100,17,16,1,4
10,2007,242100,27,24,3,0
11,2007,242100,16,15,1,0
12,2007,242100,9,9,0,2
1,2008,242100,18,18,0,0
2,2008,242100,17,16,1,5
3,2008,242100,11,10,1,2
4,2008,242100,19,19,0,0
5,2008,242100,22,21,1,2
6,2008,242100,22,21,1,1
7,2008,242100,20,18,2,3
8,2008,242100,16,16,0,1
9,2008,242100,14,14,0,0
10,2008,242100,20,20,0,0
11,2008,242100,19,18,1,0
12,2008,242100,18,18,0,0
1,2009,242100,10,9,1,1
2,2009,242100,25,25,0,0
3,2009,242100,24,23,1,0
4,2009,242100,20,18,2,1
5,2009,242100,17,16,1,1
6,2009,242100,14,12,2,0
7,2009,242100,14,14,0,0
8,2009,242100,10,9,1,0
9,2009,242100,7,7,0,3
10,2009,242100,12,12,0,0
11,2009,242100,14,13,1,1
12,2009,242100,16,14,2,1
1,2010,242100,14,13,1,0
2,2010,242100,8,8,0,0
3,2010,242100,16,16,0,1
4,2010,242100,13,13,0,0
5,2010,242100,11,11,0,1
6,2010,242100,10,10,0,0
7,2010,242100,10,10,0,1
8,2010,242100,9,9,0,0
9,2010,242100,22,22,0,0
10,2010,242100,15,14,1,0
11,2010,242100,19,18,1,2
12,2010,242100,14,13,1,0
1,2011,242100,13,13,0,2
2,2011,242100,4,4,0,2
1,1999,242000,25,21,4,1
2,1999,242000,29,29,0,1
3,1999,242000,29,25,4,2
4,1999,242000,33,29,4,5
5,1999,242000,43,39,4,1
6,1999,242000,35,33,2,4
7,1999,242000,23,21,2,4
8,1999,242000,36,35,1,4
9,1999,242000,22,19,3,1
10,1999,242000,27,24,3,0
11,1999,242000,29,27,2,5
12,1999,242000,25,22,3,1
1,2000,242000,25,25,0,1
2,2000,242000,20,19,1,0
3,2000,242000,17,15,2,3
4,2000,242000,36,36,0,3
5,2000,242000,28,26,2,2
6,2000,242000,21,18,3,3
7,2000,242000,36,29,7,13
8,2000,242000,20,17,3,1
9,2000,242000,30,27,3,7
10,2000,242000,25,21,4,4
11,2000,242000,28,22,6,6
12,2000,242000,20,18,2,1
1,2001,242000,18,17,1,3
2,2001,242000,10,9,1,1
3,2001,242000,21,17,4,2
4,2001,242000,25,20,5,3
5,2001,242000,33,32,1,3
6,2001,242000,28,20,8,6
7,2001,242000,16,16,0,8
8,2001,242000,26,22,4,7
9,2001,242000,22,20,2,4
10,2001,242000,24,21,3,5
11,2001,242000,21,18,3,3
12,2001,242000,15,14,1,4
1,2002,242000,28,26,2,7
2,2002,242000,23,19,4,1
3,2002,242000,21,19,2,3
4,2002,242000,16,15,1,1
5,2002,242000,17,12,5,5
6,2002,242000,32,30,2,2
7,2002,242000,27,26,1,4
8,2002,242000,26,23,3,2
9,2002,242000,22,18,4,1
10,2002,242000,32,27,5,2
11,2002,242000,24,24,0,2
12,2002,242000,27,26,1,1
1,2003,242000,22,21,1,6
2,2003,242000,20,18,2,0
3,2003,242000,27,25,2,1
4,2003,242000,19,19,0,2
5,2003,242000,38,35,3,0
6,2003,242000,27,26,1,3
7,2003,242000,28,25,3,2
8,2003,242000,38,36,2,2
9,2003,242000,21,20,1,2
10,2003,242000,37,32,5,3
11,2003,242000,36,35,1,0
12,2003,242000,24,23,1,1
1,2004,242000,20,18,2,1
2,2004,242000,19,19,0,0
3,2004,242000,19,15,4,1
4,2004,242000,30,26,4,1
5,2004,242000,24,23,1,2
6,2004,242000,25,22,3,2
7,2004,242000,23,21,2,3
8,2004,242000,27,26,1,1
9,2004,242000,18,18,0,2
10,2004,242000,24,23,1,3
11,2004,242000,16,15,1,1
12,2004,242000,18,16,2,1
1,2005,242000,10,7,3,2
2,2005,242000,11,11,0,0
3,2005,242000,14,14,0,3
4,2005,242000,13,11,2,6
5,2005,242000,13,12,1,1
6,2005,242000,23,21,2,4
7,2005,242000,28,27,1,11
8,2005,242000,27,26,1,1
9,2005,242000,25,24,1,1
10,2005,242000,26,24,2,0
11,2005,242000,22,17,5,1
12,2005,242000,19,18,1,2
1,2006,242000,23,20,3,5
2,2006,242000,25,23,2,4
3,2006,242000,25,23,2,2
4,2006,242000,25,22,3,4
5,2006,242000,20,18,2,2
6,2006,242000,20,20,0,3
7,2006,242000,40,39,1,2
8,2006,242000,33,32,1,2
9,2006,242000,32,30,2,2
10,2006,242000,31,26,5,5
11,2006,242000,23,21,2,4
12,2006,242000,16,15,1,2
1,2007,242000,18,17,1,3
2,2007,242000,15,13,2,0
3,2007,242000,17,15,2,5
4,2007,242000,16,14,2,5
5,2007,242000,25,22,3,2
6,2007,242000,21,21,0,6
7,2007,242000,22,21,1,4
8,2007,242000,30,29,1,0
9,2007,242000,26,24,2,2
10,2007,242000,18,16,2,1
11,2007,242000,20,20,0,6
12,2007,242000,19,14,5,0
1,2008,242000,22,22,0,3
2,2008,242000,16,15,1,2
3,2008,242000,15,15,0,3
4,2008,242000,33,31,2,3
5,2008,242000,19,18,1,7
6,2008,242000,29,27,2,4
7,2008,242000,21,20,1,4
8,2008,242000,27,26,1,2
9,2008,242000,26,24,2,2
10,2008,242000,24,21,3,1
11,2008,242000,11,11,0,1
12,2008,242000,19,18,1,0
1,2009,242000,13,12,1,1
2,2009,242000,13,12,1,1
3,2009,242000,26,26,0,0
4,2009,242000,18,18,0,4
5,2009,242000,19,18,1,1
6,2009,242000,14,12,2,4
7,2009,242000,13,13,0,9
8,2009,242000,22,20,2,1
9,2009,242000,19,17,2,2
10,2009,242000,13,12,1,2
11,2009,242000,25,24,1,0
12,2009,242000,16,15,1,2
1,2010,242000,20,19,1,3
2,2010,242000,13,13,0,1
3,2010,242000,15,15,0,1
4,2010,242000,14,14,0,0
5,2010,242000,15,13,2,2
6,2010,242000,17,17,0,2
7,2010,242000,16,16,0,2
8,2010,242000,22,20,2,4
9,2010,242000,23,23,0,0
10,2010,242000,26,25,1,1
11,2010,242000,18,15,3,0
12,2010,242000,9,8,1,3
1,2011,242000,22,21,1,1
2,2011,242000,12,11,1,0
1,1999,081000,25,23,2,1
2,1999,081000,26,25,1,2
3,1999,081000,20,19,1,3
4,1999,081000,29,29,0,0
5,1999,081000,29,29,0,1
6,1999,081000,33,32,1,0
7,1999,081000,46,43,3,0
8,1999,081000,45,42,3,2
9,1999,081000,28,27,1,3
10,1999,081000,36,35,1,3
11,1999,081000,31,29,2,0
12,1999,081000,35,34,1,1
1,2000,081000,31,30,1,4
2,2000,081000,27,25,2,1
3,2000,081000,34,33,1,3
4,2000,081000,33,28,5,2
5,2000,081000,33,31,2,0
6,2000,081000,35,32,3,2
7,2000,081000,42,40,2,2
8,2000,081000,38,35,3,8
9,2000,081000,34,33,1,2
10,2000,081000,36,34,2,0
11,2000,081000,34,34,0,0
12,2000,081000,26,26,0,1
1,2001,081000,28,24,4,1
2,2001,081000,33,28,5,0
3,2001,081000,29,28,1,0
4,2001,081000,23,23,0,1
5,2001,081000,30,24,6,4
6,2001,081000,18,17,1,4
7,2001,081000,53,51,2,1
8,2001,081000,35,34,1,1
9,2001,081000,33,29,4,2
10,2001,081000,33,30,3,2
11,2001,081000,27,26,1,1
12,2001,081000,26,26,0,2
1,2002,081000,21,21,0,5
2,2002,081000,18,15,3,1
3,2002,081000,28,28,0,1
4,2002,081000,33,32,1,2
5,2002,081000,39,35,4,5
6,2002,081000,33,31,2,0
7,2002,081000,42,39,3,2
8,2002,081000,32,31,1,2
9,2002,081000,31,28,3,5
10,2002,081000,24,19,5,3
11,2002,081000,21,20,1,1
12,2002,081000,22,22,0,0
1,2003,081000,34,32,2,2
2,2003,081000,22,22,0,1
3,2003,081000,33,32,1,4
4,2003,081000,23,18,5,0
5,2003,081000,31,30,1,1
6,2003,081000,29,25,4,4
7,2003,081000,26,25,1,4
8,2003,081000,22,22,0,4
9,2003,081000,24,24,0,3
10,2003,081000,32,30,2,0
11,2003,081000,15,15,0,0
12,2003,081000,15,15,0,2
1,2004,081000,20,17,3,0
2,2004,081000,20,20,0,2
3,2004,081000,18,17,1,0
4,2004,081000,18,18,0,0
5,2004,081000,41,39,2,1
6,2004,081000,31,29,2,3
7,2004,081000,44,44,0,3
8,2004,081000,25,23,2,2
9,2004,081000,34,34,0,1
10,2004,081000,24,23,1,0
11,2004,081000,16,16,0,4
12,2004,081000,23,19,4,2
1,2005,081000,11,9,2,6
2,2005,081000,19,16,3,2
3,2005,081000,25,21,4,3
4,2005,081000,18,17,1,7
5,2005,081000,23,22,1,0
6,2005,081000,21,20,1,3
7,2005,081000,18,18,0,3
8,2005,081000,30,29,1,2
9,2005,081000,33,30,3,1
10,2005,081000,28,27,1,1
11,2005,081000,11,11,0,3
12,2005,081000,14,13,1,1
1,2006,081000,11,11,0,4
2,2006,081000,14,13,1,5
3,2006,081000,21,20,1,2
4,2006,081000,26,23,3,3
5,2006,081000,18,17,1,9
6,2006,081000,15,13,2,2
7,2006,081000,23,23,0,6
8,2006,081000,29,27,2,6
9,2006,081000,30,29,1,4
10,2006,081000,24,21,3,3
11,2006,081000,28,27,1,3
12,2006,081000,28,28,0,4
1,2007,081000,23,23,0,8
2,2007,081000,15,14,1,1
3,2007,081000,18,18,0,0
4,2007,081000,17,16,1,0
5,2007,081000,26,26,0,3
6,2007,081000,33,30,3,1
7,2007,081000,37,35,2,7
8,2007,081000,20,20,0,12
9,2007,081000,20,18,2,3
10,2007,081000,23,23,0,5
11,2007,081000,29,26,3,2
12,2007,081000,23,22,1,0
1,2008,081000,30,27,3,1
2,2008,081000,18,18,0,0
3,2008,081000,17,17,0,3
4,2008,081000,23,21,2,2
5,2008,081000,24,21,3,5
6,2008,081000,33,30,3,3
7,2008,081000,31,27,4,12
8,2008,081000,22,19,3,4
9,2008,081000,26,24,2,4
10,2008,081000,30,30,0,9
11,2008,081000,19,18,1,5
12,2008,081000,16,14,2,4
1,2009,081000,14,14,0,9
2,2009,081000,22,22,0,9
3,2009,081000,14,13,1,8
4,2009,081000,21,19,2,7
5,2009,081000,25,23,2,3
6,2009,081000,26,21,5,0
7,2009,081000,27,26,1,0
8,2009,081000,14,13,1,2
9,2009,081000,18,17,1,3
10,2009,081000,19,19,0,8
11,2009,081000,15,15,0,3
12,2009,081000,18,16,2,5
1,2010,081000,12,10,2,3
2,2010,081000,18,17,1,1
3,2010,081000,17,16,1,6
4,2010,081000,13,12,1,4
5,2010,081000,17,17,0,9
6,2010,081000,14,14,0,6
7,2010,081000,27,23,4,4
8,2010,081000,20,19,1,2
9,2010,081000,21,19,2,2
10,2010,081000,15,15,0,1
11,2010,081000,29,27,2,1
12,2010,081000,12,11,1,0
1,2011,081000,17,16,1,0
2,2011,081000,8,8,0,0
1,1999,081201,86,86,0,0
2,1999,081201,96,95,1,3
3,1999,081201,100,99,1,0
4,1999,081201,104,103,1,1
5,1999,081201,113,111,2,3
6,1999,081201,126,125,1,0
7,1999,081201,112,111,1,1
8,1999,081201,113,112,1,0
9,1999,081201,107,107,0,0
10,1999,081201,110,107,3,4
11,1999,081201,109,109,0,2
12,1999,081201,123,121,2,0
1,2000,081201,112,112,0,0
2,2000,081201,111,110,1,0
3,2000,081201,102,101,1,0
4,2000,081201,75,75,0,0
5,2000,081201,100,100,0,2
6,2000,081201,98,97,1,1
7,2000,081201,119,117,2,1
8,2000,081201,94,93,1,0
9,2000,081201,83,82,1,0
10,2000,081201,87,87,0,0
11,2000,081201,87,85,2,0
12,2000,081201,107,104,3,0
1,2001,081201,81,79,2,1
2,2001,081201,58,54,4,0
3,2001,081201,96,94,2,1
4,2001,081201,90,89,1,0
5,2001,081201,66,66,0,0
6,2001,081201,75,74,1,0
7,2001,081201,77,75,2,0
8,2001,081201,83,82,1,0
9,2001,081201,61,60,1,1
10,2001,081201,78,75,3,0
11,2001,081201,83,82,1,0
12,2001,081201,89,89,0,0
1,2002,081201,69,69,0,0
2,2002,081201,57,57,0,0
3,2002,081201,73,71,2,1
4,2002,081201,64,61,3,1
5,2002,081201,78,78,0,2
6,2002,081201,79,79,0,3
7,2002,081201,74,73,1,0
8,2002,081201,73,70,3,0
9,2002,081201,69,67,2,0
10,2002,081201,64,64,0,0
11,2002,081201,71,68,3,0
12,2002,081201,73,73,0,0
1,2003,081201,65,64,1,0
2,2003,081201,48,48,0,0
3,2003,081201,66,65,1,0
4,2003,081201,58,58,0,0
5,2003,081201,80,79,1,1
6,2003,081201,65,63,2,1
7,2003,081201,78,78,0,0
8,2003,081201,62,62,0,0
9,2003,081201,86,85,1,1
10,2003,081201,70,70,0,1
11,2003,081201,85,84,1,0
12,2003,081201,81,80,1,0
1,2004,081201,65,64,1,0
2,2004,081201,61,60,1,1
3,2004,081201,67,67,0,3
4,2004,081201,72,71,1,0
5,2004,081201,59,57,2,0
6,2004,081201,64,64,0,0
7,2004,081201,61,61,0,0
8,2004,081201,71,70,1,0
9,2004,081201,61,57,4,0
10,2004,081201,65,63,2,0
11,2004,081201,47,46,1,0
12,2004,081201,61,59,2,0
1,2005,081201,51,51,0,0
2,2005,081201,34,34,0,1
3,2005,081201,55,55,0,0
4,2005,081201,56,56,0,0
5,2005,081201,49,46,3,0
6,2005,081201,46,45,1,0
7,2005,081201,78,77,1,0
8,2005,081201,71,69,2,0
9,2005,081201,52,51,1,0
10,2005,081201,63,63,0,0
11,2005,081201,63,63,0,0
12,2005,081201,52,50,2,0
1,2006,081201,48,48,0,0
2,2006,081201,40,40,0,1
3,2006,081201,51,51,0,0
4,2006,081201,42,42,0,1
5,2006,081201,54,53,1,0
6,2006,081201,68,67,1,0
7,2006,081201,58,58,0,0
8,2006,081201,57,57,0,0
9,2006,081201,56,55,1,0
10,2006,081201,48,47,1,0
11,2006,081201,48,47,1,1
12,2006,081201,67,67,0,1
1,2007,081201,42,42,0,4
2,2007,081201,40,40,0,0
3,2007,081201,47,46,1,0
4,2007,081201,49,49,0,0
5,2007,081201,52,52,0,1
6,2007,081201,48,47,1,3
7,2007,081201,46,44,2,1
8,2007,081201,62,62,0,0
9,2007,081201,41,41,0,1
10,2007,081201,47,47,0,0
11,2007,081201,58,58,0,0
12,2007,081201,59,59,0,0
1,2008,081201,52,51,1,0
2,2008,081201,56,55,1,0
3,2008,081201,54,53,1,0
4,2008,081201,48,48,0,1
5,2008,081201,62,61,1,2
6,2008,081201,42,41,1,0
7,2008,081201,62,61,1,2
8,2008,081201,63,62,1,0
9,2008,081201,59,59,0,0
10,2008,081201,68,68,0,0
11,2008,081201,56,56,0,0
12,2008,081201,74,73,1,0
1,2009,081201,50,50,0,0
2,2009,081201,50,50,0,0
3,2009,081201,51,51,0,1
4,2009,081201,49,48,1,0
5,2009,081201,45,44,1,0
6,2009,081201,50,50,0,0
7,2009,081201,50,50,0,0
8,2009,081201,81,81,0,0
9,2009,081201,63,63,0,2
10,2009,081201,37,37,0,1
11,2009,081201,54,54,0,0
12,2009,081201,71,71,0,0
1,2010,081201,73,72,1,0
2,2010,081201,52,52,0,0
3,2010,081201,65,62,3,1
4,2010,081201,78,77,1,1
5,2010,081201,84,84,0,0
6,2010,081201,86,86,0,1
7,2010,081201,86,85,1,0
8,2010,081201,85,83,2,2
9,2010,081201,66,66,0,0
10,2010,081201,91,89,2,2
11,2010,081201,69,69,0,0
12,2010,081201,82,81,1,0
1,2011,081201,54,53,1,1
2,2011,081201,45,45,0,2
1,1999,081300,6,5,1,0
2,1999,081300,6,5,1,0
3,1999,081300,5,5,0,0
4,1999,081300,8,8,0,0
5,1999,081300,3,3,0,0
6,1999,081300,2,2,0,0
7,1999,081300,5,4,1,0
8,1999,081300,6,6,0,0
9,1999,081300,7,7,0,0
10,1999,081300,7,6,1,0
11,1999,081300,3,3,0,0
12,1999,081300,3,3,0,0
1,2000,081300,4,4,0,0
2,2000,081300,2,2,0,0
3,2000,081300,6,6,0,0
4,2000,081300,8,8,0,0
5,2000,081300,6,6,0,0
6,2000,081300,8,8,0,0
7,2000,081300,4,4,0,0
8,2000,081300,7,7,0,0
9,2000,081300,4,4,0,0
10,2000,081300,3,3,0,0
11,2000,081300,8,8,0,0
12,2000,081300,5,5,0,0
1,2001,081300,1,1,0,0
2,2001,081300,4,4,0,0
3,2001,081300,3,3,0,0
4,2001,081300,5,5,0,0
5,2001,081300,3,3,0,0
6,2001,081300,5,5,0,0
7,2001,081300,10,10,0,0
8,2001,081300,6,6,0,0
9,2001,081300,7,7,0,0
10,2001,081300,5,5,0,0
11,2001,081300,6,5,1,0
12,2001,081300,2,2,0,0
1,2002,081300,4,4,0,0
2,2002,081300,3,3,0,1
3,2002,081300,1,1,0,0
4,2002,081300,1,1,0,0
5,2002,081300,2,2,0,0
6,2002,081300,5,5,0,0
7,2002,081300,2,2,0,0
8,2002,081300,7,7,0,0
9,2002,081300,2,2,0,0
10,2002,081300,1,1,0,0
11,2002,081300,1,1,0,0
12,2002,081300,3,3,0,0
1,2003,081300,1,1,0,0
2,2003,081300,2,1,1,0
3,2003,081300,1,1,0,0
4,2003,081300,4,4,0,0
5,2003,081300,4,4,0,0
6,2003,081300,5,5,0,0
7,2003,081300,2,2,0,0
8,2003,081300,4,4,0,0
9,2003,081300,5,5,0,0
10,2003,081300,4,4,0,0
11,2003,081300,1,1,0,0
12,2003,081300,1,1,0,0
1,2004,081300,5,5,0,0
2,2004,081300,3,3,0,0
3,2004,081300,1,1,0,0
4,2004,081300,13,13,0,0
5,2004,081300,5,5,0,0
6,2004,081300,5,5,0,0
7,2004,081300,5,5,0,0
8,2004,081300,3,3,0,0
9,2004,081300,9,9,0,0
10,2004,081300,5,5,0,0
11,2004,081300,2,2,0,0
12,2004,081300,2,2,0,0
1,2005,081300,3,3,0,0
2,2005,081300,1,1,0,0
3,2005,081300,2,2,0,0
4,2005,081300,2,2,0,0
5,2005,081300,5,5,0,0
6,2005,081300,1,1,0,0
7,2005,081300,4,4,0,0
8,2005,081300,3,2,1,0
9,2005,081300,0,0,0,0
10,2005,081300,0,0,0,0
11,2005,081300,4,4,0,0
12,2005,081300,3,3,0,0
1,2006,081300,1,1,0,0
2,2006,081300,3,3,0,0
3,2006,081300,1,1,0,0
4,2006,081300,4,4,0,0
5,2006,081300,2,2,0,0
6,2006,081300,5,5,0,0
7,2006,081300,2,2,0,0
8,2006,081300,3,3,0,0
9,2006,081300,5,5,0,0
10,2006,081300,4,4,0,0
11,2006,081300,0,0,0,0
12,2006,081300,1,1,0,1
1,2007,081300,2,2,0,0
2,2007,081300,4,4,0,0
3,2007,081300,2,2,0,0
4,2007,081300,3,3,0,0
5,2007,081300,2,2,0,0
6,2007,081300,1,1,0,0
7,2007,081300,3,3,0,0
8,2007,081300,3,3,0,0
9,2007,081300,2,2,0,0
10,2007,081300,4,4,0,0
11,2007,081300,0,0,0,0
12,2007,081300,0,0,0,0
1,2008,081300,5,5,0,0
2,2008,081300,2,1,1,0
3,2008,081300,3,3,0,0
4,2008,081300,7,6,1,0
5,2008,081300,2,2,0,0
6,2008,081300,1,1,0,0
7,2008,081300,5,5,0,0
8,2008,081300,3,2,1,0
9,2008,081300,3,3,0,0
10,2008,081300,1,1,0,0
11,2008,081300,1,1,0,0
12,2008,081300,2,2,0,0
1,2009,081300,2,2,0,0
2,2009,081300,1,1,0,0
3,2009,081300,1,1,0,0
4,2009,081300,2,2,0,0
5,2009,081300,4,4,0,0
6,2009,081300,4,4,0,0
7,2009,081300,3,3,0,0
8,2009,081300,5,5,0,0
9,2009,081300,1,1,0,0
10,2009,081300,2,2,0,0
11,2009,081300,2,2,0,0
12,2009,081300,4,4,0,0
1,2010,081300,2,2,0,0
2,2010,081300,1,1,0,0
3,2010,081300,3,3,0,0
4,2010,081300,0,0,0,0
5,2010,081300,3,3,0,0
6,2010,081300,4,4,0,0
7,2010,081300,0,0,0,0
8,2010,081300,5,5,0,0
9,2010,081300,2,2,0,0
10,2010,081300,1,1,0,1
11,2010,081300,3,3,0,0
12,2010,081300,1,1,0,0
1,2011,081300,2,2,0,0
2,2011,081300,0,0,0,0
1,1999,231100,10,9,1,6
2,1999,231100,4,4,0,12
3,1999,231100,13,12,1,8
4,1999,231100,16,13,3,5
5,1999,231100,8,8,0,6
6,1999,231100,13,10,3,13
7,1999,231100,10,6,4,6
8,1999,231100,10,5,5,16
9,1999,231100,5,4,1,28
10,1999,231100,9,8,1,17
11,1999,231100,14,11,3,24
12,1999,231100,8,6,2,18
1,2000,231100,9,8,1,16
2,2000,231100,4,3,1,15
3,2000,231100,9,3,6,21
4,2000,231100,5,3,2,10
5,2000,231100,8,7,1,6
6,2000,231100,13,12,1,2
7,2000,231100,14,11,3,7
8,2000,231100,13,11,2,8
9,2000,231100,9,7,2,4
10,2000,231100,7,6,1,3
11,2000,231100,5,3,2,3
12,2000,231100,5,5,0,1
1,2001,231100,11,10,1,2
2,2001,231100,15,12,3,1
3,2001,231100,3,3,0,3
4,2001,231100,10,6,4,6
5,2001,231100,13,11,2,9
6,2001,231100,8,6,2,7
7,2001,231100,11,9,2,4
8,2001,231100,7,3,4,3
9,2001,231100,14,10,4,9
10,2001,231100,14,10,4,19
11,2001,231100,6,6,0,6
12,2001,231100,9,7,2,7
1,2002,231100,6,4,2,13
2,2002,231100,4,3,1,5
3,2002,231100,9,7,2,5
4,2002,231100,10,9,1,4
5,2002,231100,11,4,7,5
6,2002,231100,8,7,1,6
7,2002,231100,7,3,4,5
8,2002,231100,11,11,0,3
9,2002,231100,13,11,2,2
10,2002,231100,9,8,1,5
11,2002,231100,14,13,1,4
12,2002,231100,2,1,1,7
1,2003,231100,5,4,1,3
2,2003,231100,4,2,2,4
3,2003,231100,14,11,3,6
4,2003,231100,15,12,3,3
5,2003,231100,7,6,1,3
6,2003,231100,10,9,1,3
7,2003,231100,12,11,1,8
8,2003,231100,14,11,3,14
9,2003,231100,10,9,1,13
10,2003,231100,13,12,1,9
11,2003,231100,9,8,1,7
12,2003,231100,13,12,1,11
1,2004,231100,9,9,0,8
2,2004,231100,7,6,1,5
3,2004,231100,11,10,1,5
4,2004,231100,3,3,0,11
5,2004,231100,9,8,1,9
6,2004,231100,13,10,3,13
7,2004,231100,14,9,5,15
8,2004,231100,19,15,4,14
9,2004,231100,15,12,3,21
10,2004,231100,14,11,3,1
11,2004,231100,10,9,1,0
12,2004,231100,14,12,2,5
1,2005,231100,6,5,1,8
2,2005,231100,8,6,2,4
3,2005,231100,4,4,0,5
4,2005,231100,5,4,1,3
5,2005,231100,14,12,2,2
6,2005,231100,7,6,1,6
7,2005,231100,12,8,4,3
8,2005,231100,10,8,2,12
9,2005,231100,10,9,1,8
10,2005,231100,10,9,1,4
11,2005,231100,4,4,0,1
12,2005,231100,12,12,0,5
1,2006,231100,8,6,2,0
2,2006,231100,6,6,0,2
3,2006,231100,10,9,1,4
4,2006,231100,2,2,0,2
5,2006,231100,8,8,0,5
6,2006,231100,13,11,2,5
7,2006,231100,14,12,2,8
8,2006,231100,11,9,2,7
9,2006,231100,10,6,4,10
10,2006,231100,9,9,0,9
11,2006,231100,10,8,2,7
12,2006,231100,5,3,2,14
1,2007,231100,10,9,1,11
2,2007,231100,9,9,0,9
3,2007,231100,12,12,0,4
4,2007,231100,11,9,2,7
5,2007,231100,11,8,3,8
6,2007,231100,10,10,0,10
7,2007,231100,11,7,4,3
8,2007,231100,6,5,1,7
9,2007,231100,9,5,4,31
10,2007,231100,11,8,3,23
11,2007,231100,8,7,1,10
12,2007,231100,1,1,0,8
1,2008,231100,8,6,2,3
2,2008,231100,12,11,1,7
3,2008,231100,9,7,2,6
4,2008,231100,11,9,2,4
5,2008,231100,10,7,3,30
6,2008,231100,9,8,1,10
7,2008,231100,11,9,2,4
8,2008,231100,14,13,1,5
9,2008,231100,14,12,2,5
10,2008,231100,20,17,3,3
11,2008,231100,8,8,0,13
12,2008,231100,7,7,0,7
1,2009,231100,10,8,2,5
2,2009,231100,3,3,0,4
3,2009,231100,9,8,1,21
4,2009,231100,7,6,1,7
5,2009,231100,9,7,2,7
6,2009,231100,12,10,2,4
7,2009,231100,8,6,2,15
8,2009,231100,11,9,2,7
9,2009,231100,8,5,3,5
10,2009,231100,7,5,2,2
11,2009,231100,10,7,3,10
12,2009,231100,9,7,2,1
1,2010,231100,6,6,0,8
2,2010,231100,3,3,0,6
3,2010,231100,7,4,3,5
4,2010,231100,10,9,1,3
5,2010,231100,2,2,0,6
6,2010,231100,10,8,2,6
7,2010,231100,13,11,2,6
8,2010,231100,11,8,3,2
9,2010,231100,6,5,1,3
10,2010,231100,12,10,2,5
11,2010,231100,5,4,1,3
12,2010,231100,8,7,1,4
1,2011,231100,5,4,1,2
2,2011,231100,1,1,0,4
1,1999,081100,21,21,0,0
2,1999,081100,31,30,1,0
3,1999,081100,29,29,0,3
4,1999,081100,34,33,1,3
5,1999,081100,39,39,0,0
6,1999,081100,39,39,0,2
7,1999,081100,46,45,1,1
8,1999,081100,38,36,2,0
9,1999,081100,40,38,2,3
10,1999,081100,43,41,2,3
11,1999,081100,36,33,3,3
12,1999,081100,21,20,1,3
1,2000,081100,36,34,2,0
2,2000,081100,38,36,2,2
3,2000,081100,25,24,1,2
4,2000,081100,30,30,0,0
5,2000,081100,29,29,0,1
6,2000,081100,29,29,0,1
7,2000,081100,30,30,0,0
8,2000,081100,47,45,2,2
9,2000,081100,33,32,1,1
10,2000,081100,35,35,0,1
11,2000,081100,32,32,0,1
12,2000,081100,24,24,0,4
1,2001,081100,20,20,0,1
2,2001,081100,27,26,1,0
3,2001,081100,26,24,2,1
4,2001,081100,33,30,3,1
5,2001,081100,30,30,0,1
6,2001,081100,35,34,1,3
7,2001,081100,24,23,1,1
8,2001,081100,38,37,1,5
9,2001,081100,31,30,1,1
10,2001,081100,24,22,2,0
11,2001,081100,19,18,1,0
12,2001,081100,29,28,1,2
1,2002,081100,31,31,0,4
2,2002,081100,23,23,0,1
3,2002,081100,30,29,1,0
4,2002,081100,28,27,1,1
5,2002,081100,22,21,1,2
6,2002,081100,20,19,1,1
7,2002,081100,31,31,0,0
8,2002,081100,38,37,1,0
9,2002,081100,31,31,0,4
10,2002,081100,14,14,0,1
11,2002,081100,16,15,1,2
12,2002,081100,17,17,0,0
1,2003,081100,26,25,1,2
2,2003,081100,20,20,0,0
3,2003,081100,21,21,0,0
4,2003,081100,21,21,0,2
5,2003,081100,30,30,0,2
6,2003,081100,27,27,0,3
7,2003,081100,22,22,0,1
8,2003,081100,28,27,1,1
9,2003,081100,26,26,0,2
10,2003,081100,36,36,0,0
11,2003,081100,22,21,1,1
12,2003,081100,24,24,0,5
1,2004,081100,23,22,1,1
2,2004,081100,12,11,1,0
3,2004,081100,20,19,1,1
4,2004,081100,21,20,1,2
5,2004,081100,26,26,0,1
6,2004,081100,22,21,1,0
7,2004,081100,21,19,2,0
8,2004,081100,23,22,1,1
9,2004,081100,22,19,3,1
10,2004,081100,26,25,1,1
11,2004,081100,22,22,0,1
12,2004,081100,25,22,3,1
1,2005,081100,18,17,1,2
2,2005,081100,15,14,1,1
3,2005,081100,27,27,0,3
4,2005,081100,30,29,1,2
5,2005,081100,24,22,2,1
6,2005,081100,24,21,3,0
7,2005,081100,20,20,0,1
8,2005,081100,33,31,2,1
9,2005,081100,19,19,0,1
10,2005,081100,20,17,3,1
11,2005,081100,15,15,0,1
12,2005,081100,21,18,3,0
1,2006,081100,20,20,0,1
2,2006,081100,13,12,1,0
3,2006,081100,21,21,0,1
4,2006,081100,16,14,2,2
5,2006,081100,10,10,0,0
6,2006,081100,24,24,0,1
7,2006,081100,20,17,3,2
8,2006,081100,22,21,1,2
9,2006,081100,21,21,0,1
10,2006,081100,28,27,1,2
11,2006,081100,24,21,3,2
12,2006,081100,26,25,1,1
1,2007,081100,15,14,1,1
2,2007,081100,9,8,1,1
3,2007,081100,19,19,0,0
4,2007,081100,15,14,1,1
5,2007,081100,24,23,1,1
6,2007,081100,20,18,2,0
7,2007,081100,17,15,2,0
8,2007,081100,25,23,2,1
9,2007,081100,25,24,1,0
10,2007,081100,15,15,0,2
11,2007,081100,16,16,0,2
12,2007,081100,21,21,0,0
1,2008,081100,19,19,0,1
2,2008,081100,10,10,0,0
3,2008,081100,20,19,1,1
4,2008,081100,22,22,0,2
5,2008,081100,21,20,1,0
6,2008,081100,27,27,0,1
7,2008,081100,27,26,1,3
8,2008,081100,33,33,0,0
9,2008,081100,21,21,0,0
10,2008,081100,21,20,1,0
11,2008,081100,20,20,0,2
12,2008,081100,9,9,0,0
1,2009,081100,12,12,0,1
2,2009,081100,18,18,0,0
3,2009,081100,12,12,0,0
4,2009,081100,16,16,0,1
5,2009,081100,16,16,0,1
6,2009,081100,17,17,0,0
7,2009,081100,21,21,0,0
8,2009,081100,21,20,1,1
9,2009,081100,23,23,0,0
10,2009,081100,17,16,1,0
11,2009,081100,17,17,0,0
12,2009,081100,15,13,2,0
1,2010,081100,17,17,0,1
2,2010,081100,11,11,0,0
3,2010,081100,11,11,0,0
4,2010,081100,14,13,1,6
5,2010,081100,15,15,0,0
6,2010,081100,12,11,1,0
7,2010,081100,24,23,1,0
8,2010,081100,11,11,0,1
9,2010,081100,12,12,0,0
10,2010,081100,19,17,2,0
11,2010,081100,12,11,1,1
12,2010,081100,16,16,0,0
1,2011,081100,12,11,1,0
2,2011,081100,8,8,0,0
1,1999,842200,70,56,14,29
2,1999,842200,57,49,8,26
3,1999,842200,71,61,10,37
4,1999,842200,73,66,7,33
5,1999,842200,96,80,16,45
6,1999,842200,75,59,16,28
7,1999,842200,88,72,16,33
8,1999,842200,85,70,15,51
9,1999,842200,69,60,9,51
10,1999,842200,76,68,8,62
11,1999,842200,72,60,12,54
12,1999,842200,66,60,6,54
1,2000,842200,54,45,9,78
2,2000,842200,53,39,14,86
3,2000,842200,56,42,14,86
4,2000,842200,61,45,16,59
5,2000,842200,55,40,15,40
6,2000,842200,73,51,22,39
7,2000,842200,75,57,18,59
8,2000,842200,78,60,18,55
9,2000,842200,70,53,17,59
10,2000,842200,61,54,7,60
11,2000,842200,67,54,13,39
12,2000,842200,56,46,10,48
1,2001,842200,63,50,13,64
2,2001,842200,46,37,9,31
3,2001,842200,67,53,14,43
4,2001,842200,58,41,17,46
5,2001,842200,56,40,16,48
6,2001,842200,66,41,25,53
7,2001,842200,88,57,31,83
8,2001,842200,61,49,12,72
9,2001,842200,63,56,7,40
10,2001,842200,73,61,12,37
11,2001,842200,58,48,10,53
12,2001,842200,60,53,7,62
1,2002,842200,50,37,13,73
2,2002,842200,50,40,10,56
3,2002,842200,67,49,18,71
4,2002,842200,85,68,17,72
5,2002,842200,69,50,19,66
6,2002,842200,69,50,19,76
7,2002,842200,75,55,20,81
8,2002,842200,83,58,25,49
9,2002,842200,71,54,17,58
10,2002,842200,60,46,14,46
11,2002,842200,61,49,12,63
12,2002,842200,58,52,6,48
1,2003,842200,67,54,13,49
2,2003,842200,41,34,7,46
3,2003,842200,58,40,18,36
4,2003,842200,65,49,16,46
5,2003,842200,67,53,14,52
6,2003,842200,57,43,14,29
7,2003,842200,67,49,18,25
8,2003,842200,75,57,18,39
9,2003,842200,79,59,20,29
10,2003,842200,62,53,9,29
11,2003,842200,83,72,11,40
12,2003,842200,59,52,7,28
1,2004,842200,52,41,11,41
2,2004,842200,46,36,10,30
3,2004,842200,53,46,7,39
4,2004,842200,62,39,23,39
5,2004,842200,62,47,15,34
6,2004,842200,58,50,8,50
7,2004,842200,89,78,11,45
8,2004,842200,76,64,12,36
9,2004,842200,75,61,14,55
10,2004,842200,80,64,16,47
11,2004,842200,61,48,13,45
12,2004,842200,46,41,5,36
1,2005,842200,50,37,13,59
2,2005,842200,39,31,8,57
3,2005,842200,52,40,12,78
4,2005,842200,61,53,8,47
5,2005,842200,56,46,10,30
6,2005,842200,63,50,13,24
7,2005,842200,55,43,12,16
8,2005,842200,51,43,8,52
9,2005,842200,50,43,7,53
10,2005,842200,59,49,10,67
11,2005,842200,56,50,6,40
12,2005,842200,48,43,5,40
1,2006,842200,53,44,9,42
2,2006,842200,48,45,3,25
3,2006,842200,50,45,5,52
4,2006,842200,57,49,8,28
5,2006,842200,57,48,9,47
6,2006,842200,59,48,11,33
7,2006,842200,69,58,11,32
8,2006,842200,62,54,8,32
9,2006,842200,61,58,3,28
10,2006,842200,50,44,6,28
11,2006,842200,49,43,6,41
12,2006,842200,40,35,5,47
1,2007,842200,54,51,3,50
2,2007,842200,31,29,2,31
3,2007,842200,30,22,8,35
4,2007,842200,63,54,9,25
5,2007,842200,62,57,5,26
6,2007,842200,54,46,8,24
7,2007,842200,65,52,13,25
8,2007,842200,67,63,4,20
9,2007,842200,60,55,5,13
10,2007,842200,55,50,5,22
11,2007,842200,70,64,6,23
12,2007,842200,54,51,3,18
1,2008,842200,74,66,8,9
2,2008,842200,44,40,4,7
3,2008,842200,46,42,4,11
4,2008,842200,42,39,3,8
5,2008,842200,45,41,4,16
6,2008,842200,58,48,10,10
7,2008,842200,55,53,2,5
8,2008,842200,59,48,11,7
9,2008,842200,68,60,8,12
10,2008,842200,42,35,7,12
11,2008,842200,57,51,6,12
12,2008,842200,43,39,4,7
1,2009,842200,25,23,2,9
2,2009,842200,54,49,5,13
3,2009,842200,34,31,3,11
4,2009,842200,44,40,4,17
5,2009,842200,55,45,10,13
6,2009,842200,41,32,9,24
7,2009,842200,49,44,5,9
8,2009,842200,45,39,6,6
9,2009,842200,52,46,6,15
10,2009,842200,40,36,4,6
11,2009,842200,54,50,4,9
12,2009,842200,33,30,3,9
1,2010,842200,47,44,3,14
2,2010,842200,45,37,8,8
3,2010,842200,36,34,2,16
4,2010,842200,46,42,4,10
5,2010,842200,58,54,4,13
6,2010,842200,41,36,5,12
7,2010,842200,31,25,6,6
8,2010,842200,42,39,3,8
9,2010,842200,34,33,1,8
10,2010,842200,37,35,2,5
11,2010,842200,57,54,3,3
12,2010,842200,47,45,2,0
1,2011,842200,34,33,1,2
2,2011,842200,16,15,1,0
1,1999,838300,10,7,3,5
2,1999,838300,14,11,3,1
3,1999,838300,19,16,3,7
4,1999,838300,25,21,4,6
5,1999,838300,26,20,6,12
6,1999,838300,20,18,2,11
7,1999,838300,28,25,3,1
8,1999,838300,34,30,4,9
9,1999,838300,29,22,7,10
10,1999,838300,13,11,2,8
11,1999,838300,19,17,2,11
12,1999,838300,21,17,4,7
1,2000,838300,8,7,1,18
2,2000,838300,10,9,1,13
3,2000,838300,21,16,5,19
4,2000,838300,20,18,2,14
5,2000,838300,35,34,1,17
6,2000,838300,29,25,4,8
7,2000,838300,14,9,5,12
8,2000,838300,20,16,4,12
9,2000,838300,17,14,3,30
10,2000,838300,19,14,5,10
11,2000,838300,18,15,3,9
12,2000,838300,13,9,4,12
1,2001,838300,18,15,3,15
2,2001,838300,24,19,5,17
3,2001,838300,20,17,3,31
4,2001,838300,13,8,5,22
5,2001,838300,12,8,4,18
6,2001,838300,17,14,3,32
7,2001,838300,33,20,13,35
8,2001,838300,32,24,8,33
9,2001,838300,32,25,7,18
10,2001,838300,29,21,8,30
11,2001,838300,15,13,2,49
12,2001,838300,18,16,2,29
1,2002,838300,29,24,5,37
2,2002,838300,19,16,3,32
3,2002,838300,24,11,13,26
4,2002,838300,15,12,3,24
5,2002,838300,19,14,5,13
6,2002,838300,32,21,11,16
7,2002,838300,27,23,4,15
8,2002,838300,28,21,7,12
9,2002,838300,22,21,1,18
10,2002,838300,24,19,5,16
11,2002,838300,12,7,5,7
12,2002,838300,21,19,2,18
1,2003,838300,16,13,3,12
2,2003,838300,10,9,1,9
3,2003,838300,11,9,2,15
4,2003,838300,22,19,3,9
5,2003,838300,17,16,1,5
6,2003,838300,16,14,2,14
7,2003,838300,13,8,5,12
8,2003,838300,22,18,4,18
9,2003,838300,31,30,1,18
10,2003,838300,24,16,8,11
11,2003,838300,14,12,2,16
12,2003,838300,19,12,7,14
1,2004,838300,12,7,5,21
2,2004,838300,11,8,3,16
3,2004,838300,12,8,4,22
4,2004,838300,14,8,6,16
5,2004,838300,17,14,3,9
6,2004,838300,22,20,2,13
7,2004,838300,28,22,6,24
8,2004,838300,40,37,3,16
9,2004,838300,20,15,5,12
10,2004,838300,16,12,4,18
11,2004,838300,24,21,3,15
12,2004,838300,12,11,1,15
1,2005,838300,8,7,1,29
2,2005,838300,9,8,1,14
3,2005,838300,11,10,1,12
4,2005,838300,17,16,1,6
5,2005,838300,20,18,2,5
6,2005,838300,9,5,4,5
7,2005,838300,13,10,3,9
8,2005,838300,16,13,3,16
9,2005,838300,21,20,1,5
10,2005,838300,10,10,0,9
11,2005,838300,9,5,4,7
12,2005,838300,8,7,1,6
1,2006,838300,1,0,1,4
2,2006,838300,9,8,1,3
3,2006,838300,11,10,1,1
4,2006,838300,7,7,0,4
5,2006,838300,11,8,3,4
6,2006,838300,10,9,1,7
7,2006,838300,13,13,0,6
8,2006,838300,13,10,3,3
9,2006,838300,6,6,0,7
10,2006,838300,10,9,1,3
11,2006,838300,16,15,1,5
12,2006,838300,15,15,0,11
1,2007,838300,14,12,2,3
2,2007,838300,17,15,2,5
3,2007,838300,10,9,1,4
4,2007,838300,11,10,1,2
5,2007,838300,7,6,1,0
6,2007,838300,11,10,1,0
7,2007,838300,15,13,2,7
8,2007,838300,25,25,0,7
9,2007,838300,10,9,1,5
10,2007,838300,13,13,0,8
11,2007,838300,25,24,1,3
12,2007,838300,14,13,1,3
1,2008,838300,6,6,0,7
2,2008,838300,7,6,1,3
3,2008,838300,9,9,0,1
4,2008,838300,10,6,4,1
5,2008,838300,14,14,0,2
6,2008,838300,12,10,2,0
7,2008,838300,10,10,0,5
8,2008,838300,10,9,1,1
9,2008,838300,13,12,1,5
10,2008,838300,5,3,2,2
11,2008,838300,11,11,0,5
12,2008,838300,7,6,1,1
1,2009,838300,5,5,0,2
2,2009,838300,2,2,0,2
3,2009,838300,11,11,0,5
4,2009,838300,14,14,0,4
5,2009,838300,8,7,1,3
6,2009,838300,13,13,0,5
7,2009,838300,12,12,0,2
8,2009,838300,22,21,1,1
9,2009,838300,12,10,2,5
10,2009,838300,7,7,0,2
11,2009,838300,10,9,1,4
12,2009,838300,8,8,0,1
1,2010,838300,8,8,0,1
2,2010,838300,8,8,0,3
3,2010,838300,13,10,3,2
4,2010,838300,15,12,3,1
5,2010,838300,14,14,0,5
6,2010,838300,16,13,3,1
7,2010,838300,10,6,4,3
8,2010,838300,16,14,2,3
9,2010,838300,12,11,1,3
10,2010,838300,7,7,0,0
11,2010,838300,5,5,0,2
12,2010,838300,3,3,0,0
1,2011,838300,4,4,0,0
2,2011,838300,3,3,0,1
1,1999,240900,10,9,1,8
2,1999,240900,19,16,3,11
3,1999,240900,25,24,1,9
4,1999,240900,21,15,6,6
5,1999,240900,18,17,1,10
6,1999,240900,29,23,6,13
7,1999,240900,33,25,8,11
8,1999,240900,22,16,6,6
9,1999,240900,20,12,8,8
10,1999,240900,20,17,3,17
11,1999,240900,12,11,1,11
12,1999,240900,20,14,6,7
1,2000,240900,15,11,4,7
2,2000,240900,14,10,4,11
3,2000,240900,24,23,1,14
4,2000,240900,34,26,8,8
5,2000,240900,30,26,4,7
6,2000,240900,42,30,12,7
7,2000,240900,26,21,5,5
8,2000,240900,28,21,7,5
9,2000,240900,26,20,6,5
10,2000,240900,25,17,8,9
11,2000,240900,25,22,3,7
12,2000,240900,14,13,1,2
1,2001,240900,18,16,2,6
2,2001,240900,25,22,3,5
3,2001,240900,15,12,3,3
4,2001,240900,14,11,3,7
5,2001,240900,20,16,4,2
6,2001,240900,28,26,2,5
7,2001,240900,32,28,4,3
8,2001,240900,27,22,5,3
9,2001,240900,28,21,7,4
10,2001,240900,32,28,4,10
11,2001,240900,24,20,4,3
12,2001,240900,11,8,3,5
1,2002,240900,17,14,3,7
2,2002,240900,33,27,6,13
3,2002,240900,24,17,7,2
4,2002,240900,15,15,0,4
5,2002,240900,24,19,5,13
6,2002,240900,34,30,4,11
7,2002,240900,37,32,5,5
8,2002,240900,38,32,6,3
9,2002,240900,35,32,3,4
10,2002,240900,31,29,2,4
11,2002,240900,20,19,1,3
12,2002,240900,17,16,1,10
1,2003,240900,17,15,2,7
2,2003,240900,12,11,1,10
3,2003,240900,25,19,6,4
4,2003,240900,13,11,2,2
5,2003,240900,20,16,4,6
6,2003,240900,35,29,6,12
7,2003,240900,28,24,4,5
8,2003,240900,42,38,4,12
9,2003,240900,22,17,5,9
10,2003,240900,25,23,2,8
11,2003,240900,19,17,2,8
12,2003,240900,14,13,1,8
1,2004,240900,16,14,2,3
2,2004,240900,10,10,0,10
3,2004,240900,10,9,1,7
4,2004,240900,22,19,3,6
5,2004,240900,18,13,5,7
6,2004,240900,16,12,4,15
7,2004,240900,40,38,2,12
8,2004,240900,25,21,4,5
9,2004,240900,19,15,4,8
10,2004,240900,25,22,3,7
11,2004,240900,22,17,5,10
12,2004,240900,18,16,2,15
1,2005,240900,27,25,2,5
2,2005,240900,16,16,0,10
3,2005,240900,15,12,3,5
4,2005,240900,14,10,4,8
5,2005,240900,22,15,7,7
6,2005,240900,32,25,7,7
7,2005,240900,21,19,2,14
8,2005,240900,13,8,5,11
9,2005,240900,17,12,5,9
10,2005,240900,18,14,4,9
11,2005,240900,18,15,3,12
12,2005,240900,4,3,1,2
1,2006,240900,14,11,3,8
2,2006,240900,13,8,5,9
3,2006,240900,11,8,3,20
4,2006,240900,14,10,4,11
5,2006,240900,19,16,3,8
6,2006,240900,22,17,5,18
7,2006,240900,20,17,3,14
8,2006,240900,23,22,1,11
9,2006,240900,20,19,1,6
10,2006,240900,14,13,1,2
11,2006,240900,6,5,1,3
12,2006,240900,23,18,5,10
1,2007,240900,14,8,6,10
2,2007,240900,6,6,0,6
3,2007,240900,16,12,4,7
4,2007,240900,12,11,1,6
5,2007,240900,12,9,3,7
6,2007,240900,35,31,4,16
7,2007,240900,26,24,2,7
8,2007,240900,35,33,2,8
9,2007,240900,15,13,2,6
10,2007,240900,14,12,2,8
11,2007,240900,17,13,4,10
12,2007,240900,18,14,4,2
1,2008,240900,12,10,2,5
2,2008,240900,16,14,2,6
3,2008,240900,14,13,1,5
4,2008,240900,18,15,3,5
5,2008,240900,18,18,0,9
6,2008,240900,23,17,6,15
7,2008,240900,22,17,5,10
8,2008,240900,22,18,4,8
9,2008,240900,21,19,2,7
10,2008,240900,24,19,5,11
11,2008,240900,12,11,1,7
12,2008,240900,13,12,1,3
1,2009,240900,7,7,0,4
2,2009,240900,21,18,3,7
3,2009,240900,18,17,1,10
4,2009,240900,9,6,3,5
5,2009,240900,12,9,3,16
6,2009,240900,22,17,5,3
7,2009,240900,11,10,1,10
8,2009,240900,26,19,7,4
9,2009,240900,25,23,2,5
10,2009,240900,12,11,1,7
11,2009,240900,20,15,5,10
12,2009,240900,13,11,2,5
1,2010,240900,3,3,0,1
2,2010,240900,11,8,3,6
3,2010,240900,9,8,1,6
4,2010,240900,11,9,2,3
5,2010,240900,12,9,3,8
6,2010,240900,29,26,3,14
7,2010,240900,22,18,4,10
8,2010,240900,16,15,1,6
9,2010,240900,14,11,3,3
10,2010,240900,17,15,2,8
11,2010,240900,8,7,1,6
12,2010,240900,7,7,0,3
1,2011,240900,9,8,1,7
2,2011,240900,4,3,1,3
1,1999,081202,2,2,0,0
2,1999,081202,4,4,0,0
3,1999,081202,4,4,0,0
4,1999,081202,6,6,0,0
5,1999,081202,4,4,0,0
6,1999,081202,4,4,0,0
7,1999,081202,4,4,0,1
8,1999,081202,1,1,0,0
9,1999,081202,1,1,0,0
10,1999,081202,0,0,0,0
11,1999,081202,1,1,0,0
12,1999,081202,3,3,0,0
1,2000,081202,2,2,0,0
2,2000,081202,7,7,0,0
3,2000,081202,7,7,0,0
4,2000,081202,2,2,0,0
5,2000,081202,2,2,0,0
6,2000,081202,5,5,0,0
7,2000,081202,3,3,0,0
8,2000,081202,2,2,0,0
9,2000,081202,3,3,0,0
10,2000,081202,2,2,0,0
11,2000,081202,7,7,0,0
12,2000,081202,2,2,0,0
1,2001,081202,6,6,0,0
2,2001,081202,3,3,0,0
3,2001,081202,0,0,0,0
4,2001,081202,3,3,0,0
5,2001,081202,1,1,0,0
6,2001,081202,6,6,0,0
7,2001,081202,4,4,0,0
8,2001,081202,3,3,0,0
9,2001,081202,4,4,0,0
10,2001,081202,2,2,0,0
11,2001,081202,3,3,0,0
12,2001,081202,0,0,0,0
1,2002,081202,4,4,0,0
2,2002,081202,2,2,0,0
3,2002,081202,1,0,1,0
4,2002,081202,2,2,0,0
5,2002,081202,3,3,0,0
6,2002,081202,3,3,0,0
7,2002,081202,0,0,0,0
8,2002,081202,2,2,0,0
9,2002,081202,2,1,1,0
10,2002,081202,3,3,0,0
11,2002,081202,1,1,0,0
12,2002,081202,1,1,0,0
1,2003,081202,3,3,0,0
2,2003,081202,2,2,0,0
3,2003,081202,1,1,0,0
4,2003,081202,3,3,0,0
5,2003,081202,0,0,0,0
6,2003,081202,0,0,0,0
7,2003,081202,4,4,0,0
8,2003,081202,0,0,0,0
9,2003,081202,2,2,0,0
10,2003,081202,0,0,0,0
11,2003,081202,1,1,0,0
12,2003,081202,3,2,1,0
1,2004,081202,3,3,0,0
2,2004,081202,1,1,0,0
3,2004,081202,0,0,0,0
4,2004,081202,1,1,0,0
5,2004,081202,2,2,0,0
6,2004,081202,2,2,0,0
7,2004,081202,2,2,0,0
8,2004,081202,0,0,0,0
9,2004,081202,0,0,0,0
10,2004,081202,1,1,0,0
11,2004,081202,0,0,0,0
12,2004,081202,0,0,0,0
1,2005,081202,0,0,0,0
2,2005,081202,0,0,0,0
3,2005,081202,1,1,0,0
4,2005,081202,1,1,0,0
5,2005,081202,1,1,0,0
6,2005,081202,3,3,0,0
7,2005,081202,1,1,0,0
8,2005,081202,1,1,0,0
9,2005,081202,0,0,0,0
10,2005,081202,3,3,0,0
11,2005,081202,5,5,0,0
12,2005,081202,1,1,0,0
1,2006,081202,1,1,0,0
2,2006,081202,3,3,0,0
3,2006,081202,2,2,0,0
4,2006,081202,2,2,0,0
5,2006,081202,1,1,0,0
6,2006,081202,1,1,0,0
7,2006,081202,2,2,0,0
8,2006,081202,4,4,0,0
9,2006,081202,1,1,0,0
10,2006,081202,0,0,0,0
11,2006,081202,0,0,0,0
12,2006,081202,1,1,0,0
1,2007,081202,0,0,0,0
2,2007,081202,0,0,0,0
3,2007,081202,4,4,0,0
4,2007,081202,1,1,0,0
5,2007,081202,0,0,0,0
6,2007,081202,2,2,0,0
7,2007,081202,0,0,0,0
8,2007,081202,0,0,0,0
9,2007,081202,0,0,0,0
10,2007,081202,1,1,0,0
11,2007,081202,0,0,0,0
12,2007,081202,3,3,0,0
1,2008,081202,0,0,0,0
2,2008,081202,3,3,0,0
3,2008,081202,2,2,0,0
4,2008,081202,0,0,0,0
5,2008,081202,1,1,0,0
6,2008,081202,2,2,0,0
7,2008,081202,2,2,0,0
8,2008,081202,3,3,0,0
9,2008,081202,2,2,0,0
10,2008,081202,0,0,0,0
11,2008,081202,1,1,0,0
12,2008,081202,1,1,0,0
1,2009,081202,1,1,0,0
2,2009,081202,0,0,0,0
3,2009,081202,1,1,0,0
4,2009,081202,2,2,0,0
5,2009,081202,2,2,0,0
6,2009,081202,2,2,0,0
7,2009,081202,0,0,0,0
8,2009,081202,4,4,0,0
9,2009,081202,0,0,0,0
10,2009,081202,0,0,0,0
11,2009,081202,1,1,0,0
12,2009,081202,0,0,0,0
1,2010,081202,0,0,0,0
2,2010,081202,1,1,0,0
3,2010,081202,0,0,0,0
4,2010,081202,0,0,0,0
5,2010,081202,1,1,0,0
6,2010,081202,0,0,0,0
7,2010,081202,4,4,0,0
8,2010,081202,1,1,0,0
9,2010,081202,0,0,0,0
10,2010,081202,2,2,0,0
11,2010,081202,2,2,0,0
12,2010,081202,2,2,0,0
1,2011,081202,2,2,0,0
2,2011,081202,0,0,0,0
1,1999,250600,32,25,7,10
2,1999,250600,26,24,2,8
3,1999,250600,20,15,5,13
4,1999,250600,25,19,6,14
5,1999,250600,24,19,5,21
6,1999,250600,35,27,8,20
7,1999,250600,26,22,4,19
8,1999,250600,37,26,11,21
9,1999,250600,40,34,6,23
10,1999,250600,31,26,5,17
11,1999,250600,25,18,7,13
12,1999,250600,29,27,2,21
1,2000,250600,26,23,3,12
2,2000,250600,38,32,6,15
3,2000,250600,36,31,5,16
4,2000,250600,27,23,4,9
5,2000,250600,26,20,6,10
6,2000,250600,23,16,7,12
7,2000,250600,31,28,3,15
8,2000,250600,38,25,13,4
9,2000,250600,27,25,2,5
10,2000,250600,34,22,12,11
11,2000,250600,25,20,5,10
12,2000,250600,22,22,0,4
1,2001,250600,28,27,1,7
2,2001,250600,28,26,2,6
3,2001,250600,19,15,4,2
4,2001,250600,35,29,6,8
5,2001,250600,32,22,10,15
6,2001,250600,40,25,15,8
7,2001,250600,37,30,7,7
8,2001,250600,28,22,6,18
9,2001,250600,29,23,6,12
10,2001,250600,33,25,8,14
11,2001,250600,42,33,9,18
12,2001,250600,27,20,7,15
1,2002,250600,36,26,10,26
2,2002,250600,11,9,2,31
3,2002,250600,31,21,10,29
4,2002,250600,29,23,6,20
5,2002,250600,29,24,5,12
6,2002,250600,30,21,9,10
7,2002,250600,24,21,3,14
8,2002,250600,23,17,6,20
9,2002,250600,28,25,3,25
10,2002,250600,32,28,4,24
11,2002,250600,33,30,3,36
12,2002,250600,19,17,2,8
1,2003,250600,31,23,8,16
2,2003,250600,26,21,5,11
3,2003,250600,34,24,10,26
4,2003,250600,26,21,5,28
5,2003,250600,35,31,4,20
6,2003,250600,23,19,4,8
7,2003,250600,29,23,6,23
8,2003,250600,23,19,4,28
9,2003,250600,28,23,5,20
10,2003,250600,30,25,5,46
11,2003,250600,30,26,4,7
12,2003,250600,26,23,3,21
1,2004,250600,25,19,6,38
2,2004,250600,23,17,6,17
3,2004,250600,35,30,5,12
4,2004,250600,38,34,4,21
5,2004,250600,39,31,8,17
6,2004,250600,30,22,8,8
7,2004,250600,22,17,5,21
8,2004,250600,20,17,3,19
9,2004,250600,34,30,4,5
10,2004,250600,36,31,5,7
11,2004,250600,25,23,2,18
12,2004,250600,27,26,1,10
1,2005,250600,19,17,2,10
2,2005,250600,23,21,2,9
3,2005,250600,24,20,4,8
4,2005,250600,26,21,5,19
5,2005,250600,30,23,7,17
6,2005,250600,31,27,4,10
7,2005,250600,34,30,4,8
8,2005,250600,34,32,2,14
9,2005,250600,23,18,5,4
10,2005,250600,28,24,4,30
11,2005,250600,29,23,6,48
12,2005,250600,20,17,3,37
1,2006,250600,18,11,7,23
2,2006,250600,18,17,1,29
3,2006,250600,31,18,13,9
4,2006,250600,40,35,5,14
5,2006,250600,35,29,6,19
6,2006,250600,31,25,6,10
7,2006,250600,26,21,5,10
8,2006,250600,28,24,4,17
9,2006,250600,21,20,1,21
10,2006,250600,36,29,7,18
11,2006,250600,16,10,6,12
12,2006,250600,22,21,1,18
1,2007,250600,21,13,8,16
2,2007,250600,13,12,1,19
3,2007,250600,21,19,2,12
4,2007,250600,24,19,5,13
5,2007,250600,22,21,1,11
6,2007,250600,23,13,10,8
7,2007,250600,37,31,6,11
8,2007,250600,16,12,4,12
9,2007,250600,24,21,3,3
10,2007,250600,22,17,5,16
11,2007,250600,31,28,3,13
12,2007,250600,21,16,5,12
1,2008,250600,23,22,1,15
2,2008,250600,19,13,6,7
3,2008,250600,22,19,3,14
4,2008,250600,24,17,7,9
5,2008,250600,25,20,5,23
6,2008,250600,22,17,5,7
7,2008,250600,27,20,7,12
8,2008,250600,31,20,11,15
9,2008,250600,33,29,4,12
10,2008,250600,21,16,5,12
11,2008,250600,25,22,3,13
12,2008,250600,23,21,2,11
1,2009,250600,30,25,5,10
2,2009,250600,23,19,4,11
3,2009,250600,24,21,3,20
4,2009,250600,23,20,3,18
5,2009,250600,21,17,4,7
6,2009,250600,36,33,3,6
7,2009,250600,45,35,10,13
8,2009,250600,25,24,1,8
9,2009,250600,24,22,2,7
10,2009,250600,23,22,1,18
11,2009,250600,31,29,2,14
12,2009,250600,23,21,2,19
1,2010,250600,25,25,0,22
2,2010,250600,16,15,1,11
3,2010,250600,27,20,7,9
4,2010,250600,30,24,6,23
5,2010,250600,30,21,9,18
6,2010,250600,21,17,4,12
7,2010,250600,31,26,5,28
8,2010,250600,32,29,3,24
9,2010,250600,40,34,6,13
10,2010,250600,38,35,3,14
11,2010,250600,40,36,4,9
12,2010,250600,25,21,4,12
1,2011,250600,31,29,2,23
2,2011,250600,9,9,0,10
1,1999,250700,38,32,6,9
2,1999,250700,49,39,10,13
3,1999,250700,37,26,11,18
4,1999,250700,31,22,9,20
5,1999,250700,41,34,7,13
6,1999,250700,40,32,8,16
7,1999,250700,60,52,8,20
8,1999,250700,45,36,9,17
9,1999,250700,32,25,7,20
10,1999,250700,41,38,3,17
11,1999,250700,48,40,8,11
12,1999,250700,38,31,7,12
1,2000,250700,42,37,5,8
2,2000,250700,41,34,7,17
3,2000,250700,38,30,8,20
4,2000,250700,48,42,6,7
5,2000,250700,45,38,7,9
6,2000,250700,50,46,4,11
7,2000,250700,41,29,12,10
8,2000,250700,53,42,11,13
9,2000,250700,50,42,8,11
10,2000,250700,40,33,7,11
11,2000,250700,42,37,5,10
12,2000,250700,29,26,3,10
1,2001,250700,32,31,1,12
2,2001,250700,27,21,6,25
3,2001,250700,25,22,3,6
4,2001,250700,40,36,4,18
5,2001,250700,38,33,5,12
6,2001,250700,43,36,7,22
7,2001,250700,44,35,9,26
8,2001,250700,42,35,7,17
9,2001,250700,53,39,14,17
10,2001,250700,41,35,6,16
11,2001,250700,52,38,14,17
12,2001,250700,39,28,11,34
1,2002,250700,29,23,6,25
2,2002,250700,38,31,7,18
3,2002,250700,39,31,8,12
4,2002,250700,37,29,8,21
5,2002,250700,32,26,6,21
6,2002,250700,34,27,7,25
7,2002,250700,54,47,7,16
8,2002,250700,42,32,10,22
9,2002,250700,48,42,6,20
10,2002,250700,41,36,5,27
11,2002,250700,41,35,6,42
12,2002,250700,43,33,10,16
1,2003,250700,41,35,6,20
2,2003,250700,35,25,10,38
3,2003,250700,35,30,5,38
4,2003,250700,45,40,5,14
5,2003,250700,40,33,7,20
6,2003,250700,42,33,9,16
7,2003,250700,59,49,10,27
8,2003,250700,42,29,13,55
9,2003,250700,51,43,8,40
10,2003,250700,34,30,4,28
11,2003,250700,46,42,4,38
12,2003,250700,38,35,3,20
1,2004,250700,31,25,6,24
2,2004,250700,30,25,5,23
3,2004,250700,31,28,3,14
4,2004,250700,51,41,10,26
5,2004,250700,38,29,9,9
6,2004,250700,45,35,10,13
7,2004,250700,47,33,14,21
8,2004,250700,38,32,6,25
9,2004,250700,45,38,7,24
10,2004,250700,39,32,7,17
11,2004,250700,30,27,3,24
12,2004,250700,24,19,5,13
1,2005,250700,31,26,5,18
2,2005,250700,31,27,4,18
3,2005,250700,35,29,6,16
4,2005,250700,36,32,4,7
5,2005,250700,47,37,10,15
6,2005,250700,32,24,8,20
7,2005,250700,47,36,11,19
8,2005,250700,38,29,9,13
9,2005,250700,33,25,8,16
10,2005,250700,39,30,9,13
11,2005,250700,27,22,5,14
12,2005,250700,37,31,6,7
1,2006,250700,23,19,4,16
2,2006,250700,22,18,4,2
3,2006,250700,29,29,0,7
4,2006,250700,28,22,6,13
5,2006,250700,46,38,8,22
6,2006,250700,26,23,3,18
7,2006,250700,37,35,2,13
8,2006,250700,24,22,2,26
9,2006,250700,34,29,5,19
10,2006,250700,26,19,7,11
11,2006,250700,38,35,3,32
12,2006,250700,37,29,8,21
1,2007,250700,29,25,4,6
2,2007,250700,18,16,2,11
3,2007,250700,40,33,7,26
4,2007,250700,29,23,6,16
5,2007,250700,30,25,5,12
6,2007,250700,26,21,5,8
7,2007,250700,30,24,6,14
8,2007,250700,44,35,9,14
9,2007,250700,37,32,5,11
10,2007,250700,41,33,8,14
11,2007,250700,33,25,8,11
12,2007,250700,29,26,3,4
1,2008,250700,25,19,6,16
2,2008,250700,25,21,4,14
3,2008,250700,31,26,5,21
4,2008,250700,33,25,8,6
5,2008,250700,27,24,3,18
6,2008,250700,33,23,10,13
7,2008,250700,43,35,8,12
8,2008,250700,39,29,10,19
9,2008,250700,30,29,1,17
10,2008,250700,46,36,10,14
11,2008,250700,37,32,5,9
12,2008,250700,33,30,3,9
1,2009,250700,33,28,5,11
2,2009,250700,35,29,6,18
3,2009,250700,41,32,9,26
4,2009,250700,37,34,3,16
5,2009,250700,35,26,9,11
6,2009,250700,55,53,2,16
7,2009,250700,38,32,6,16
8,2009,250700,48,42,6,17
9,2009,250700,31,23,8,10
10,2009,250700,35,31,4,15
11,2009,250700,41,39,2,19
12,2009,250700,40,35,5,3
1,2010,250700,31,24,7,15
2,2010,250700,17,15,2,15
3,2010,250700,27,24,3,31
4,2010,250700,32,30,2,19
5,2010,250700,45,39,6,16
6,2010,250700,29,20,9,11
7,2010,250700,37,26,11,17
8,2010,250700,39,32,7,11
9,2010,250700,42,36,6,13
10,2010,250700,36,28,8,10
11,2010,250700,31,29,2,10
12,2010,250700,38,34,4,14
1,2011,250700,26,22,4,9
2,2011,250700,17,17,0,10
1,1999,831300,16,12,4,10
2,1999,831300,12,9,3,9
3,1999,831300,24,22,2,12
4,1999,831300,25,18,7,2
5,1999,831300,35,32,3,4
6,1999,831300,24,23,1,0
7,1999,831300,25,21,4,3
8,1999,831300,17,13,4,20
9,1999,831300,15,12,3,7
10,1999,831300,21,20,1,17
11,1999,831300,18,17,1,8
12,1999,831300,19,14,5,4
1,2000,831300,12,12,0,7
2,2000,831300,22,19,3,19
3,2000,831300,23,19,4,14
4,2000,831300,20,16,4,12
5,2000,831300,20,15,5,13
6,2000,831300,17,13,4,17
7,2000,831300,18,14,4,13
8,2000,831300,26,20,6,7
9,2000,831300,25,20,5,7
10,2000,831300,33,28,5,15
11,2000,831300,18,15,3,4
12,2000,831300,20,17,3,4
1,2001,831300,17,16,1,7
2,2001,831300,19,15,4,4
3,2001,831300,20,18,2,9
4,2001,831300,26,26,0,1
5,2001,831300,45,37,8,7
6,2001,831300,30,26,4,7
7,2001,831300,33,32,1,8
8,2001,831300,26,23,3,17
9,2001,831300,51,49,2,11
10,2001,831300,37,32,5,10
11,2001,831300,24,18,6,7
12,2001,831300,32,30,2,8
1,2002,831300,42,41,1,13
2,2002,831300,22,22,0,10
3,2002,831300,29,27,2,8
4,2002,831300,35,32,3,4
5,2002,831300,39,36,3,7
6,2002,831300,29,22,7,4
7,2002,831300,38,33,5,1
8,2002,831300,34,27,7,17
9,2002,831300,33,31,2,4
10,2002,831300,44,40,4,6
11,2002,831300,32,29,3,5
12,2002,831300,25,22,3,6
1,2003,831300,30,28,2,5
2,2003,831300,21,19,2,9
3,2003,831300,29,25,4,17
4,2003,831300,28,25,3,5
5,2003,831300,43,38,5,4
6,2003,831300,29,25,4,8
7,2003,831300,30,28,2,8
8,2003,831300,27,25,2,16
9,2003,831300,45,37,8,10
10,2003,831300,29,29,0,8
11,2003,831300,30,25,5,6
12,2003,831300,29,28,1,6
1,2004,831300,26,24,2,8
2,2004,831300,26,24,2,10
3,2004,831300,23,22,1,10
4,2004,831300,41,36,5,18
5,2004,831300,28,27,1,15
6,2004,831300,33,29,4,10
7,2004,831300,46,38,8,7
8,2004,831300,46,42,4,6
9,2004,831300,44,39,5,16
10,2004,831300,39,39,0,7
11,2004,831300,41,38,3,15
12,2004,831300,27,22,5,6
1,2005,831300,42,41,1,10
2,2005,831300,20,19,1,8
3,2005,831300,27,24,3,15
4,2005,831300,31,30,1,11
5,2005,831300,46,43,3,11
6,2005,831300,37,35,2,7
7,2005,831300,44,38,6,3
8,2005,831300,43,40,3,21
9,2005,831300,38,34,4,19
10,2005,831300,41,37,4,41
11,2005,831300,40,39,1,17
12,2005,831300,37,36,1,8
1,2006,831300,27,23,4,11
2,2006,831300,24,22,2,14
3,2006,831300,35,33,2,16
4,2006,831300,28,23,5,6
5,2006,831300,39,36,3,8
6,2006,831300,28,24,4,20
7,2006,831300,38,37,1,6
8,2006,831300,42,36,6,8
9,2006,831300,31,28,3,8
10,2006,831300,21,20,1,7
11,2006,831300,25,21,4,14
12,2006,831300,26,23,3,4
1,2007,831300,19,17,2,9
2,2007,831300,15,14,1,3
3,2007,831300,34,30,4,3
4,2007,831300,27,25,2,8
5,2007,831300,28,27,1,8
6,2007,831300,27,24,3,5
7,2007,831300,27,26,1,6
8,2007,831300,34,28,6,7
9,2007,831300,23,16,7,8
10,2007,831300,22,20,2,9
11,2007,831300,20,16,4,10
12,2007,831300,14,13,1,8
1,2008,831300,19,19,0,4
2,2008,831300,16,13,3,5
3,2008,831300,30,26,4,3
4,2008,831300,28,25,3,9
5,2008,831300,22,21,1,6
6,2008,831300,36,32,4,2
7,2008,831300,29,26,3,12
8,2008,831300,42,36,6,11
9,2008,831300,34,32,2,8
10,2008,831300,24,22,2,8
11,2008,831300,22,21,1,3
12,2008,831300,23,23,0,3
1,2009,831300,23,23,0,6
2,2009,831300,17,16,1,3
3,2009,831300,20,19,1,8
4,2009,831300,20,18,2,2
5,2009,831300,37,33,4,6
6,2009,831300,26,25,1,4
7,2009,831300,25,23,2,11
8,2009,831300,30,25,5,7
9,2009,831300,17,15,2,8
10,2009,831300,26,24,2,6
11,2009,831300,23,21,2,5
12,2009,831300,22,21,1,2
1,2010,831300,14,14,0,4
2,2010,831300,18,18,0,13
3,2010,831300,22,21,1,14
4,2010,831300,16,15,1,8
5,2010,831300,36,34,2,6
6,2010,831300,25,23,2,7
7,2010,831300,29,25,4,5
8,2010,831300,32,27,5,4
9,2010,831300,22,21,1,7
10,2010,831300,24,24,0,3
11,2010,831300,11,10,1,2
12,2010,831300,16,16,0,3
1,2011,831300,31,27,4,3
2,2011,831300,13,12,1,4
1,1999,230700,42,37,5,48
2,1999,230700,37,29,8,44
3,1999,230700,40,33,7,18
4,1999,230700,57,46,11,24
5,1999,230700,45,37,8,15
6,1999,230700,56,42,14,20
7,1999,230700,57,45,12,17
8,1999,230700,69,53,16,27
9,1999,230700,64,54,10,23
10,1999,230700,55,46,9,17
11,1999,230700,44,35,9,18
12,1999,230700,60,53,7,27
1,2000,230700,49,43,6,28
2,2000,230700,44,33,11,38
3,2000,230700,62,53,9,28
4,2000,230700,41,37,4,25
5,2000,230700,38,31,7,30
6,2000,230700,46,35,11,25
7,2000,230700,57,47,10,27
8,2000,230700,58,46,12,21
9,2000,230700,42,35,7,24
10,2000,230700,62,55,7,40
11,2000,230700,56,46,10,21
12,2000,230700,43,37,6,26
1,2001,230700,44,40,4,21
2,2001,230700,34,30,4,33
3,2001,230700,51,41,10,29
4,2001,230700,51,38,13,24
5,2001,230700,58,49,9,21
6,2001,230700,46,33,13,23
7,2001,230700,65,55,10,23
8,2001,230700,66,61,5,36
9,2001,230700,65,57,8,20
10,2001,230700,57,52,5,22
11,2001,230700,56,48,8,22
12,2001,230700,51,41,10,30
1,2002,230700,39,33,6,22
2,2002,230700,38,32,6,30
3,2002,230700,42,34,8,18
4,2002,230700,35,31,4,28
5,2002,230700,38,31,7,36
6,2002,230700,39,29,10,26
7,2002,230700,64,59,5,18
8,2002,230700,73,63,10,30
9,2002,230700,64,55,9,33
10,2002,230700,54,44,10,25
11,2002,230700,46,40,6,21
12,2002,230700,35,28,7,30
1,2003,230700,52,47,5,29
2,2003,230700,29,22,7,28
3,2003,230700,47,39,8,38
4,2003,230700,54,44,10,31
5,2003,230700,57,50,7,50
6,2003,230700,54,41,13,37
7,2003,230700,69,63,6,20
8,2003,230700,71,61,10,29
9,2003,230700,53,50,3,23
10,2003,230700,49,40,9,23
11,2003,230700,46,40,6,26
12,2003,230700,36,30,6,20
1,2004,230700,34,25,9,28
2,2004,230700,29,23,6,38
3,2004,230700,45,40,5,38
4,2004,230700,39,27,12,28
5,2004,230700,36,27,9,25
6,2004,230700,59,54,5,13
7,2004,230700,61,52,9,61
8,2004,230700,80,65,15,51
9,2004,230700,35,30,5,69
10,2004,230700,59,52,7,76
11,2004,230700,27,25,2,45
12,2004,230700,36,32,4,22
1,2005,230700,38,33,5,34
2,2005,230700,40,34,6,41
3,2005,230700,49,41,8,11
4,2005,230700,33,29,4,28
5,2005,230700,55,45,10,24
6,2005,230700,47,45,2,20
7,2005,230700,55,43,12,18
8,2005,230700,48,42,6,51
9,2005,230700,40,30,10,40
10,2005,230700,38,34,4,42
11,2005,230700,37,33,4,39
12,2005,230700,30,29,1,19
1,2006,230700,35,30,5,14
2,2006,230700,23,19,4,32
3,2006,230700,26,24,2,27
4,2006,230700,35,25,10,23
5,2006,230700,33,30,3,29
6,2006,230700,26,21,5,31
7,2006,230700,33,30,3,14
8,2006,230700,36,29,7,12
9,2006,230700,34,33,1,19
10,2006,230700,37,35,2,17
11,2006,230700,22,20,2,13
12,2006,230700,22,21,1,15
1,2007,230700,32,29,3,18
2,2007,230700,20,17,3,15
3,2007,230700,28,23,5,13
4,2007,230700,27,24,3,11
5,2007,230700,39,34,5,18
6,2007,230700,32,25,7,17
7,2007,230700,33,24,9,26
8,2007,230700,28,25,3,24
9,2007,230700,41,38,3,14
10,2007,230700,55,44,11,15
11,2007,230700,24,23,1,15
12,2007,230700,39,32,7,16
1,2008,230700,41,37,4,13
2,2008,230700,24,21,3,20
3,2008,230700,24,22,2,17
4,2008,230700,39,31,8,15
5,2008,230700,50,40,10,16
6,2008,230700,37,36,1,20
7,2008,230700,57,47,10,24
8,2008,230700,36,28,8,26
9,2008,230700,42,30,12,14
10,2008,230700,44,39,5,16
11,2008,230700,43,42,1,20
12,2008,230700,32,28,4,15
1,2009,230700,40,36,4,16
2,2009,230700,29,23,6,16
3,2009,230700,30,20,10,16
4,2009,230700,44,38,6,19
5,2009,230700,29,25,4,9
6,2009,230700,31,25,6,17
7,2009,230700,46,36,10,12
8,2009,230700,28,24,4,21
9,2009,230700,37,28,9,11
10,2009,230700,39,37,2,22
11,2009,230700,31,28,3,11
12,2009,230700,30,27,3,11
1,2010,230700,29,27,2,11
2,2010,230700,20,18,2,10
3,2010,230700,25,20,5,8
4,2010,230700,26,23,3,13
5,2010,230700,31,25,6,10
6,2010,230700,38,33,5,12
7,2010,230700,39,31,8,17
8,2010,230700,49,33,16,35
9,2010,230700,43,35,8,16
10,2010,230700,44,38,6,15
11,2010,230700,35,34,1,21
12,2010,230700,29,27,2,11
1,2011,230700,26,21,5,21
2,2011,230700,12,12,0,13
1,1999,230800,17,16,1,5
2,1999,230800,8,7,1,5
3,1999,230800,6,5,1,3
4,1999,230800,6,5,1,2
5,1999,230800,7,3,4,3
6,1999,230800,15,11,4,5
7,1999,230800,9,7,2,6
8,1999,230800,12,9,3,1
9,1999,230800,7,5,2,0
10,1999,230800,11,9,2,2
11,1999,230800,8,7,1,4
12,1999,230800,11,7,4,1
1,2000,230800,10,7,3,1
2,2000,230800,7,7,0,3
3,2000,230800,20,16,4,4
4,2000,230800,7,5,2,1
5,2000,230800,9,5,4,2
6,2000,230800,14,11,3,1
7,2000,230800,7,6,1,1
8,2000,230800,10,8,2,5
9,2000,230800,10,9,1,1
10,2000,230800,16,14,2,6
11,2000,230800,9,5,4,4
12,2000,230800,5,2,3,3
1,2001,230800,9,7,2,7
2,2001,230800,9,6,3,4
3,2001,230800,10,8,2,4
4,2001,230800,8,7,1,8
5,2001,230800,8,6,2,7
6,2001,230800,12,9,3,4
7,2001,230800,12,11,1,8
8,2001,230800,9,6,3,9
9,2001,230800,16,12,4,8
10,2001,230800,11,8,3,3
11,2001,230800,11,10,1,5
12,2001,230800,13,12,1,3
1,2002,230800,8,7,1,7
2,2002,230800,6,6,0,4
3,2002,230800,7,6,1,4
4,2002,230800,4,3,1,5
5,2002,230800,5,5,0,8
6,2002,230800,13,10,3,5
7,2002,230800,12,10,2,7
8,2002,230800,14,10,4,5
9,2002,230800,15,13,2,6
10,2002,230800,11,11,0,3
11,2002,230800,13,11,2,4
12,2002,230800,17,15,2,11
1,2003,230800,8,8,0,14
2,2003,230800,7,5,2,7
3,2003,230800,3,2,1,7
4,2003,230800,14,14,0,8
5,2003,230800,11,9,2,12
6,2003,230800,13,10,3,9
7,2003,230800,21,19,2,9
8,2003,230800,22,22,0,9
9,2003,230800,14,13,1,2
10,2003,230800,9,7,2,9
11,2003,230800,5,4,1,3
12,2003,230800,4,4,0,2
1,2004,230800,7,5,2,5
2,2004,230800,3,3,0,8
3,2004,230800,3,3,0,8
4,2004,230800,11,11,0,1
5,2004,230800,9,7,2,10
6,2004,230800,11,8,3,7
7,2004,230800,21,21,0,6
8,2004,230800,13,11,2,7
9,2004,230800,16,15,1,4
10,2004,230800,14,12,2,9
11,2004,230800,9,6,3,6
12,2004,230800,4,3,1,5
1,2005,230800,14,12,2,6
2,2005,230800,3,2,1,7
3,2005,230800,7,7,0,1
4,2005,230800,4,3,1,5
5,2005,230800,10,9,1,16
6,2005,230800,5,5,0,5
7,2005,230800,9,8,1,5
8,2005,230800,13,10,3,8
9,2005,230800,13,13,0,2
10,2005,230800,12,11,1,3
11,2005,230800,7,5,2,10
12,2005,230800,9,7,2,3
1,2006,230800,5,5,0,5
2,2006,230800,5,5,0,10
3,2006,230800,14,12,2,9
4,2006,230800,2,2,0,4
5,2006,230800,5,3,2,4
6,2006,230800,7,7,0,6
7,2006,230800,10,9,1,8
8,2006,230800,10,9,1,6
9,2006,230800,6,5,1,4
10,2006,230800,9,6,3,5
11,2006,230800,6,5,1,2
12,2006,230800,6,6,0,3
1,2007,230800,8,7,1,3
2,2007,230800,6,5,1,2
3,2007,230800,8,7,1,3
4,2007,230800,8,8,0,2
5,2007,230800,8,8,0,4
6,2007,230800,7,5,2,6
7,2007,230800,7,6,1,11
8,2007,230800,7,7,0,2
9,2007,230800,5,3,2,4
10,2007,230800,14,12,2,4
11,2007,230800,5,5,0,6
12,2007,230800,9,8,1,8
1,2008,230800,7,5,2,8
2,2008,230800,4,3,1,7
3,2008,230800,7,4,3,8
4,2008,230800,8,7,1,13
5,2008,230800,5,4,1,10
6,2008,230800,8,7,1,5
7,2008,230800,4,2,2,12
8,2008,230800,4,1,3,12
9,2008,230800,8,8,0,3
10,2008,230800,5,5,0,7
11,2008,230800,9,9,0,10
12,2008,230800,4,3,1,5
1,2009,230800,7,7,0,10
2,2009,230800,9,9,0,9
3,2009,230800,8,7,1,4
4,2009,230800,9,8,1,5
5,2009,230800,4,4,0,0
6,2009,230800,5,5,0,6
7,2009,230800,13,13,0,6
8,2009,230800,7,6,1,9
9,2009,230800,0,0,0,8
10,2009,230800,12,8,4,13
11,2009,230800,10,9,1,8
12,2009,230800,11,9,2,3
1,2010,230800,13,12,1,11
2,2010,230800,5,5,0,14
3,2010,230800,3,2,1,10
4,2010,230800,4,4,0,6
5,2010,230800,9,5,4,6
6,2010,230800,12,9,3,6
7,2010,230800,16,13,3,8
8,2010,230800,11,11,0,9
9,2010,230800,7,6,1,10
10,2010,230800,9,7,2,7
11,2010,230800,5,1,4,14
12,2010,230800,5,5,0,5
1,2011,230800,12,11,1,10
2,2011,230800,3,3,0,7
1,1999,230900,33,27,6,21
2,1999,230900,25,18,7,23
3,1999,230900,39,31,8,16
4,1999,230900,41,31,10,24
5,1999,230900,35,26,9,29
6,1999,230900,42,35,7,22
7,1999,230900,52,42,10,26
8,1999,230900,33,26,7,17
9,1999,230900,45,29,16,31
10,1999,230900,38,28,10,29
11,1999,230900,38,25,13,22
12,1999,230900,22,12,10,18
1,2000,230900,27,19,8,27
2,2000,230900,33,24,9,21
3,2000,230900,43,35,8,21
4,2000,230900,37,27,10,25
5,2000,230900,34,22,12,20
6,2000,230900,36,28,8,17
7,2000,230900,50,35,15,13
8,2000,230900,45,34,11,26
9,2000,230900,48,41,7,10
10,2000,230900,49,42,7,17
11,2000,230900,58,50,8,11
12,2000,230900,24,19,5,12
1,2001,230900,37,34,3,12
2,2001,230900,34,29,5,23
3,2001,230900,35,30,5,27
4,2001,230900,39,35,4,8
5,2001,230900,45,33,12,14
6,2001,230900,51,40,11,9
7,2001,230900,38,29,9,11
8,2001,230900,41,36,5,24
9,2001,230900,52,39,13,9
10,2001,230900,39,36,3,23
11,2001,230900,24,22,2,31
12,2001,230900,31,28,3,15
1,2002,230900,33,29,4,16
2,2002,230900,22,19,3,17
3,2002,230900,39,31,8,22
4,2002,230900,34,19,15,19
5,2002,230900,26,18,8,28
6,2002,230900,25,15,10,21
7,2002,230900,42,30,12,12
8,2002,230900,41,29,12,15
9,2002,230900,35,30,5,12
10,2002,230900,60,50,10,19
11,2002,230900,37,29,8,14
12,2002,230900,30,26,4,18
1,2003,230900,42,39,3,29
2,2003,230900,25,20,5,20
3,2003,230900,16,14,2,21
4,2003,230900,25,23,2,23
5,2003,230900,50,46,4,21
6,2003,230900,43,36,7,10
7,2003,230900,59,52,7,21
8,2003,230900,47,40,7,29
9,2003,230900,26,23,3,24
10,2003,230900,39,30,9,21
11,2003,230900,35,30,5,100
12,2003,230900,16,14,2,20
1,2004,230900,28,22,6,24
2,2004,230900,27,20,7,20
3,2004,230900,28,23,5,20
4,2004,230900,29,23,6,22
5,2004,230900,33,27,6,16
6,2004,230900,27,24,3,29
7,2004,230900,38,33,5,25
8,2004,230900,40,38,2,33
9,2004,230900,30,24,6,23
10,2004,230900,40,34,6,15
11,2004,230900,21,15,6,20
12,2004,230900,29,27,2,22
1,2005,230900,24,20,4,33
2,2005,230900,23,21,2,24
3,2005,230900,24,22,2,25
4,2005,230900,32,26,6,31
5,2005,230900,30,26,4,34
6,2005,230900,39,30,9,13
7,2005,230900,37,32,5,15
8,2005,230900,25,22,3,19
9,2005,230900,29,21,8,14
10,2005,230900,37,33,4,7
11,2005,230900,38,31,7,18
12,2005,230900,19,17,2,16
1,2006,230900,35,28,7,5
2,2006,230900,26,25,1,17
3,2006,230900,19,13,6,22
4,2006,230900,31,24,7,16
5,2006,230900,27,20,7,4
6,2006,230900,30,22,8,23
7,2006,230900,21,19,2,23
8,2006,230900,39,33,6,12
9,2006,230900,33,27,6,18
10,2006,230900,29,24,5,12
11,2006,230900,39,32,7,9
12,2006,230900,30,27,3,16
1,2007,230900,17,13,4,11
2,2007,230900,25,23,2,16
3,2007,230900,18,13,5,17
4,2007,230900,19,15,4,16
5,2007,230900,20,18,2,10
6,2007,230900,22,20,2,27
7,2007,230900,31,23,8,18
8,2007,230900,30,23,7,17
9,2007,230900,29,23,6,20
10,2007,230900,26,24,2,9
11,2007,230900,32,27,5,18
12,2007,230900,29,27,2,9
1,2008,230900,32,26,6,11
2,2008,230900,17,12,5,13
3,2008,230900,17,15,2,8
4,2008,230900,26,22,4,9
5,2008,230900,35,29,6,14
6,2008,230900,22,14,8,15
7,2008,230900,35,30,5,5
8,2008,230900,34,31,3,25
9,2008,230900,32,24,8,26
10,2008,230900,22,19,3,15
11,2008,230900,23,19,4,16
12,2008,230900,21,16,5,10
1,2009,230900,22,19,3,7
2,2009,230900,23,18,5,6
3,2009,230900,23,19,4,7
4,2009,230900,36,32,4,8
5,2009,230900,19,15,4,17
6,2009,230900,31,20,11,10
7,2009,230900,27,18,9,10
8,2009,230900,40,30,10,13
9,2009,230900,20,14,6,10
10,2009,230900,37,34,3,17
11,2009,230900,27,25,2,7
12,2009,230900,30,27,3,8
1,2010,230900,36,31,5,7
2,2010,230900,21,17,4,8
3,2010,230900,32,23,9,9
4,2010,230900,30,26,4,17
5,2010,230900,28,24,4,9
6,2010,230900,21,17,4,16
7,2010,230900,32,30,2,17
8,2010,230900,36,29,7,9
9,2010,230900,28,23,5,12
10,2010,230900,33,29,4,19
11,2010,230900,18,16,2,13
12,2010,230900,29,25,4,9
1,2011,230900,14,13,1,12
2,2011,230900,13,8,5,6
1,1999,241100,39,30,9,17
2,1999,241100,27,23,4,14
3,1999,241100,29,28,1,16
4,1999,241100,41,33,8,14
5,1999,241100,38,35,3,28
6,1999,241100,30,23,7,8
7,1999,241100,49,35,14,5
8,1999,241100,43,31,12,8
9,1999,241100,36,31,5,12
10,1999,241100,47,38,9,11
11,1999,241100,30,25,5,14
12,1999,241100,28,25,3,11
1,2000,241100,29,24,5,11
2,2000,241100,38,31,7,11
3,2000,241100,32,23,9,14
4,2000,241100,30,22,8,7
5,2000,241100,47,34,13,16
6,2000,241100,30,27,3,23
7,2000,241100,35,30,5,19
8,2000,241100,40,32,8,16
9,2000,241100,49,41,8,9
10,2000,241100,49,43,6,14
11,2000,241100,38,29,9,5
12,2000,241100,21,19,2,9
1,2001,241100,30,26,4,19
2,2001,241100,25,22,3,11
3,2001,241100,29,23,6,15
4,2001,241100,56,40,16,13
5,2001,241100,39,30,9,12
6,2001,241100,61,51,10,12
7,2001,241100,42,29,13,25
8,2001,241100,39,28,11,14
9,2001,241100,46,37,9,12
10,2001,241100,41,36,5,9
11,2001,241100,29,25,4,11
12,2001,241100,27,21,6,14
1,2002,241100,34,30,4,13
2,2002,241100,19,15,4,11
3,2002,241100,34,29,5,21
4,2002,241100,19,17,2,18
5,2002,241100,26,24,2,17
6,2002,241100,35,21,14,19
7,2002,241100,31,25,6,10
8,2002,241100,30,22,8,13
9,2002,241100,40,29,11,11
10,2002,241100,40,36,4,10
11,2002,241100,31,24,7,11
12,2002,241100,28,22,6,6
1,2003,241100,37,24,13,17
2,2003,241100,20,13,7,12
3,2003,241100,33,30,3,4
4,2003,241100,21,19,2,30
5,2003,241100,24,20,4,19
6,2003,241100,44,31,13,12
7,2003,241100,40,33,7,19
8,2003,241100,36,31,5,17
9,2003,241100,33,30,3,27
10,2003,241100,40,31,9,7
11,2003,241100,42,38,4,26
12,2003,241100,34,28,6,10
1,2004,241100,26,24,2,13
2,2004,241100,15,9,6,28
3,2004,241100,24,20,4,13
4,2004,241100,34,26,8,20
5,2004,241100,27,20,7,14
6,2004,241100,26,22,4,23
7,2004,241100,42,34,8,8
8,2004,241100,23,22,1,5
9,2004,241100,21,18,3,12
10,2004,241100,23,17,6,9
11,2004,241100,13,7,6,8
12,2004,241100,17,13,4,8
1,2005,241100,14,12,2,6
2,2005,241100,23,19,4,5
3,2005,241100,16,12,4,7
4,2005,241100,22,16,6,19
5,2005,241100,25,18,7,10
6,2005,241100,17,14,3,11
7,2005,241100,20,16,4,5
8,2005,241100,25,15,10,9
9,2005,241100,16,13,3,3
10,2005,241100,32,22,10,12
11,2005,241100,28,27,1,3
12,2005,241100,33,29,4,4
1,2006,241100,20,18,2,5
2,2006,241100,17,14,3,2
3,2006,241100,18,12,6,11
4,2006,241100,23,22,1,6
5,2006,241100,19,15,4,5
6,2006,241100,23,19,4,13
7,2006,241100,26,21,5,9
8,2006,241100,19,15,4,13
9,2006,241100,20,15,5,12
10,2006,241100,21,16,5,8
11,2006,241100,24,17,7,3
12,2006,241100,13,10,3,8
1,2007,241100,9,8,1,7
2,2007,241100,5,5,0,11
3,2007,241100,11,9,2,5
4,2007,241100,15,14,1,6
5,2007,241100,17,12,5,12
6,2007,241100,20,17,3,9
7,2007,241100,34,30,4,6
8,2007,241100,26,22,4,3
9,2007,241100,13,12,1,12
10,2007,241100,23,23,0,15
11,2007,241100,24,22,2,7
12,2007,241100,21,21,0,5
1,2008,241100,22,21,1,9
2,2008,241100,23,21,2,7
3,2008,241100,20,18,2,13
4,2008,241100,7,6,1,10
5,2008,241100,24,22,2,5
6,2008,241100,17,14,3,2
7,2008,241100,24,21,3,17
8,2008,241100,22,20,2,2
9,2008,241100,20,16,4,5
10,2008,241100,20,17,3,8
11,2008,241100,22,21,1,2
12,2008,241100,10,8,2,4
1,2009,241100,12,11,1,5
2,2009,241100,19,15,4,8
3,2009,241100,17,14,3,7
4,2009,241100,20,17,3,9
5,2009,241100,20,20,0,5
6,2009,241100,26,24,2,7
7,2009,241100,34,27,7,2
8,2009,241100,44,41,3,5
9,2009,241100,23,19,4,9
10,2009,241100,17,14,3,6
11,2009,241100,18,17,1,7
12,2009,241100,11,10,1,2
1,2010,241100,20,17,3,2
2,2010,241100,9,9,0,4
3,2010,241100,17,14,3,3
4,2010,241100,20,16,4,8
5,2010,241100,8,8,0,3
6,2010,241100,30,26,4,5
7,2010,241100,42,37,5,4
8,2010,241100,30,26,4,3
9,2010,241100,22,18,4,2
10,2010,241100,27,23,4,1
11,2010,241100,35,35,0,2
12,2010,241100,16,16,0,5
1,2011,241100,20,17,3,1
2,2011,241100,10,9,1,2
1,1999,250800,22,21,1,13
2,1999,250800,35,28,7,25
3,1999,250800,25,20,5,16
4,1999,250800,29,19,10,13
5,1999,250800,29,26,3,10
6,1999,250800,29,24,5,9
7,1999,250800,31,23,8,14
8,1999,250800,28,19,9,15
9,1999,250800,25,18,7,11
10,1999,250800,36,30,6,5
11,1999,250800,35,29,6,12
12,1999,250800,29,22,7,13
1,2000,250800,33,27,6,7
2,2000,250800,25,22,3,20
3,2000,250800,32,25,7,25
4,2000,250800,27,20,7,18
5,2000,250800,16,11,5,22
6,2000,250800,21,17,4,20
7,2000,250800,33,27,6,23
8,2000,250800,35,26,9,17
9,2000,250800,29,24,5,15
10,2000,250800,27,21,6,20
11,2000,250800,26,21,5,15
12,2000,250800,19,16,3,18
1,2001,250800,18,16,2,14
2,2001,250800,13,12,1,14
3,2001,250800,24,15,9,8
4,2001,250800,24,20,4,12
5,2001,250800,14,9,5,11
6,2001,250800,25,22,3,19
7,2001,250800,15,11,4,16
8,2001,250800,33,25,8,14
9,2001,250800,23,18,5,7
10,2001,250800,46,42,4,16
11,2001,250800,32,25,7,13
12,2001,250800,22,18,4,18
1,2002,250800,28,26,2,28
2,2002,250800,12,9,3,15
3,2002,250800,16,15,1,24
4,2002,250800,22,16,6,19
5,2002,250800,29,22,7,49
6,2002,250800,29,22,7,10
7,2002,250800,33,25,8,17
8,2002,250800,23,19,4,10
9,2002,250800,41,36,5,16
10,2002,250800,31,27,4,44
11,2002,250800,43,40,3,18
12,2002,250800,35,31,4,12
1,2003,250800,27,21,6,12
2,2003,250800,21,19,2,18
3,2003,250800,38,30,8,13
4,2003,250800,35,30,5,33
5,2003,250800,29,25,4,12
6,2003,250800,30,27,3,18
7,2003,250800,24,20,4,35
8,2003,250800,33,29,4,51
9,2003,250800,41,38,3,33
10,2003,250800,41,31,10,35
11,2003,250800,47,36,11,13
12,2003,250800,31,26,5,17
1,2004,250800,21,16,5,13
2,2004,250800,23,20,3,22
3,2004,250800,21,16,5,22
4,2004,250800,24,21,3,19
5,2004,250800,18,13,5,16
6,2004,250800,28,23,5,16
7,2004,250800,28,23,5,23
8,2004,250800,24,20,4,33
9,2004,250800,35,34,1,12
10,2004,250800,26,25,1,24
11,2004,250800,26,23,3,52
12,2004,250800,40,33,7,30
1,2005,250800,30,26,4,49
2,2005,250800,18,15,3,52
3,2005,250800,21,15,6,36
4,2005,250800,22,18,4,39
5,2005,250800,32,25,7,20
6,2005,250800,36,30,6,18
7,2005,250800,39,33,6,76
8,2005,250800,42,40,2,54
9,2005,250800,29,24,5,40
10,2005,250800,20,17,3,32
11,2005,250800,28,26,2,17
12,2005,250800,23,22,1,16
1,2006,250800,19,18,1,8
2,2006,250800,17,17,0,6
3,2006,250800,18,15,3,9
4,2006,250800,30,25,5,16
5,2006,250800,32,27,5,8
6,2006,250800,40,34,6,15
7,2006,250800,34,30,4,21
8,2006,250800,32,28,4,13
9,2006,250800,30,25,5,10
10,2006,250800,32,27,5,17
11,2006,250800,28,22,6,8
12,2006,250800,26,21,5,15
1,2007,250800,19,16,3,10
2,2007,250800,21,20,1,10
3,2007,250800,36,33,3,7
4,2007,250800,38,34,4,12
5,2007,250800,26,23,3,15
6,2007,250800,32,27,5,10
7,2007,250800,32,29,3,15
8,2007,250800,30,23,7,10
9,2007,250800,19,15,4,6
10,2007,250800,24,20,4,12
11,2007,250800,9,7,2,11
12,2007,250800,30,23,7,14
1,2008,250800,31,24,7,10
2,2008,250800,20,17,3,3
3,2008,250800,22,18,4,6
4,2008,250800,19,18,1,8
5,2008,250800,27,21,6,10
6,2008,250800,22,21,1,12
7,2008,250800,33,32,1,6
8,2008,250800,27,24,3,20
9,2008,250800,24,19,5,10
10,2008,250800,23,22,1,11
11,2008,250800,25,25,0,17
12,2008,250800,30,28,2,6
1,2009,250800,20,20,0,7
2,2009,250800,23,20,3,10
3,2009,250800,37,31,6,17
4,2009,250800,20,16,4,8
5,2009,250800,23,17,6,14
6,2009,250800,29,28,1,7
7,2009,250800,21,17,4,6
8,2009,250800,35,29,6,12
9,2009,250800,24,20,4,6
10,2009,250800,30,27,3,10
11,2009,250800,26,25,1,13
12,2009,250800,10,9,1,8
1,2010,250800,28,26,2,13
2,2010,250800,36,32,4,9
3,2010,250800,36,27,9,15
4,2010,250800,26,25,1,16
5,2010,250800,23,19,4,9
6,2010,250800,29,25,4,16
7,2010,250800,37,34,3,17
8,2010,250800,29,24,5,16
9,2010,250800,26,26,0,17
10,2010,250800,31,29,2,15
11,2010,250800,25,24,1,9
12,2010,250800,19,16,3,16
1,2011,250800,14,13,1,14
2,2011,250800,9,7,2,14
1,1999,241200,12,12,0,0
2,1999,241200,14,11,3,5
3,1999,241200,11,11,0,3
4,1999,241200,18,15,3,3
5,1999,241200,18,15,3,6
6,1999,241200,24,22,2,1
7,1999,241200,16,12,4,8
8,1999,241200,23,20,3,2
9,1999,241200,20,15,5,7
10,1999,241200,18,18,0,6
11,1999,241200,15,13,2,4
12,1999,241200,19,17,2,1
1,2000,241200,20,18,2,3
2,2000,241200,16,14,2,0
3,2000,241200,18,17,1,0
4,2000,241200,14,13,1,1
5,2000,241200,23,21,2,1
6,2000,241200,13,9,4,1
7,2000,241200,19,18,1,1
8,2000,241200,23,21,2,4
9,2000,241200,25,22,3,0
10,2000,241200,27,21,6,1
11,2000,241200,15,11,4,1
12,2000,241200,8,6,2,0
1,2001,241200,22,21,1,1
2,2001,241200,7,6,1,2
3,2001,241200,22,18,4,0
4,2001,241200,21,19,2,1
5,2001,241200,22,21,1,3
6,2001,241200,30,28,2,2
7,2001,241200,28,26,2,1
8,2001,241200,21,21,0,2
9,2001,241200,20,19,1,1
10,2001,241200,23,21,2,1
11,2001,241200,19,18,1,2
12,2001,241200,17,14,3,1
1,2002,241200,19,18,1,2
2,2002,241200,18,18,0,1
3,2002,241200,11,11,0,1
4,2002,241200,18,16,2,0
5,2002,241200,23,21,2,0
6,2002,241200,30,29,1,0
7,2002,241200,29,27,2,1
8,2002,241200,19,17,2,1
9,2002,241200,30,25,5,0
10,2002,241200,21,21,0,1
11,2002,241200,12,12,0,0
12,2002,241200,14,14,0,2
1,2003,241200,17,15,2,1
2,2003,241200,9,9,0,2
3,2003,241200,14,14,0,1
4,2003,241200,17,17,0,1
5,2003,241200,22,18,4,0
6,2003,241200,24,24,0,0
7,2003,241200,32,31,1,3
8,2003,241200,24,23,1,3
9,2003,241200,17,14,3,0
10,2003,241200,19,18,1,0
11,2003,241200,14,13,1,3
12,2003,241200,14,12,2,1
1,2004,241200,13,13,0,1
2,2004,241200,11,10,1,0
3,2004,241200,15,14,1,0
4,2004,241200,24,23,1,3
5,2004,241200,17,16,1,0
6,2004,241200,14,14,0,0
7,2004,241200,27,27,0,0
8,2004,241200,22,22,0,1
9,2004,241200,17,16,1,0
10,2004,241200,20,20,0,0
11,2004,241200,10,9,1,2
12,2004,241200,6,4,2,1
1,2005,241200,12,11,1,0
2,2005,241200,11,10,1,0
3,2005,241200,7,5,2,1
4,2005,241200,23,20,3,0
5,2005,241200,15,13,2,1
6,2005,241200,12,9,3,0
7,2005,241200,19,19,0,1
8,2005,241200,10,9,1,0
9,2005,241200,16,13,3,0
10,2005,241200,22,19,3,0
11,2005,241200,19,18,1,3
12,2005,241200,21,21,0,0
1,2006,241200,20,19,1,3
2,2006,241200,12,12,0,1
3,2006,241200,15,15,0,1
4,2006,241200,15,12,3,0
5,2006,241200,9,7,2,1
6,2006,241200,11,8,3,1
7,2006,241200,23,22,1,4
8,2006,241200,21,19,2,1
9,2006,241200,14,13,1,2
10,2006,241200,31,31,0,2
11,2006,241200,23,22,1,0
12,2006,241200,14,13,1,3
1,2007,241200,23,19,4,0
2,2007,241200,8,7,1,0
3,2007,241200,9,9,0,0
4,2007,241200,17,16,1,0
5,2007,241200,26,25,1,1
6,2007,241200,10,8,2,0
7,2007,241200,20,19,1,0
8,2007,241200,15,13,2,0
9,2007,241200,20,19,1,0
10,2007,241200,25,24,1,1
11,2007,241200,16,15,1,1
12,2007,241200,18,18,0,1
1,2008,241200,8,8,0,2
2,2008,241200,11,10,1,3
3,2008,241200,12,12,0,2
4,2008,241200,18,17,1,2
5,2008,241200,17,15,2,1
6,2008,241200,17,16,1,1
7,2008,241200,17,17,0,1
8,2008,241200,21,19,2,0
9,2008,241200,15,13,2,2
10,2008,241200,27,27,0,1
11,2008,241200,27,26,1,3
12,2008,241200,26,25,1,2
1,2009,241200,12,11,1,1
2,2009,241200,11,9,2,1
3,2009,241200,19,18,1,0
4,2009,241200,18,18,0,1
5,2009,241200,14,14,0,3
6,2009,241200,23,23,0,0
7,2009,241200,19,18,1,2
8,2009,241200,23,20,3,0
9,2009,241200,17,17,0,0
10,2009,241200,22,22,0,0
11,2009,241200,14,14,0,5
12,2009,241200,28,28,0,3
1,2010,241200,12,11,1,1
2,2010,241200,14,12,2,1
3,2010,241200,15,15,0,1
4,2010,241200,15,15,0,0
5,2010,241200,19,19,0,0
6,2010,241200,14,13,1,2
7,2010,241200,26,24,2,1
8,2010,241200,38,33,5,1
9,2010,241200,37,37,0,0
10,2010,241200,16,16,0,0
11,2010,241200,15,14,1,0
12,2010,241200,20,18,2,2
1,2011,241200,16,15,1,0
2,2011,241200,5,4,1,0
1,1999,241400,55,51,4,3
2,1999,241400,48,44,4,1
3,1999,241400,54,49,5,3
4,1999,241400,75,69,6,8
5,1999,241400,69,60,9,6
6,1999,241400,43,37,6,7
7,1999,241400,69,62,7,4
8,1999,241400,83,79,4,5
9,1999,241400,69,67,2,6
10,1999,241400,79,68,11,4
11,1999,241400,63,59,4,4
12,1999,241400,79,72,7,8
1,2000,241400,59,56,3,4
2,2000,241400,62,59,3,2
3,2000,241400,46,45,1,2
4,2000,241400,52,48,4,3
5,2000,241400,62,53,9,3
6,2000,241400,52,48,4,3
7,2000,241400,63,57,6,6
8,2000,241400,60,53,7,2
9,2000,241400,74,71,3,3
10,2000,241400,64,57,7,3
11,2000,241400,69,66,3,2
12,2000,241400,59,53,6,3
1,2001,241400,70,67,3,11
2,2001,241400,41,37,4,8
3,2001,241400,49,44,5,1
4,2001,241400,53,49,4,0
5,2001,241400,51,47,4,3
6,2001,241400,66,63,3,1
7,2001,241400,73,68,5,3
8,2001,241400,72,70,2,2
9,2001,241400,73,69,4,0
10,2001,241400,73,71,2,0
11,2001,241400,60,58,2,4
12,2001,241400,44,38,6,4
1,2002,241400,57,53,4,4
2,2002,241400,43,43,0,6
3,2002,241400,56,52,4,1
4,2002,241400,53,49,4,2
5,2002,241400,52,50,2,4
6,2002,241400,64,60,4,2
7,2002,241400,84,79,5,4
8,2002,241400,73,67,6,2
9,2002,241400,77,73,4,4
10,2002,241400,81,77,4,4
11,2002,241400,68,64,4,3
12,2002,241400,67,64,3,0
1,2003,241400,62,55,7,2
2,2003,241400,34,30,4,1
3,2003,241400,40,39,1,5
4,2003,241400,52,48,4,2
5,2003,241400,45,44,1,3
6,2003,241400,61,57,4,3
7,2003,241400,56,51,5,1
8,2003,241400,74,70,4,3
9,2003,241400,53,47,6,3
10,2003,241400,47,44,3,1
11,2003,241400,48,44,4,0
12,2003,241400,65,62,3,1
1,2004,241400,35,31,4,2
2,2004,241400,55,54,1,4
3,2004,241400,52,50,2,2
4,2004,241400,51,49,2,1
5,2004,241400,76,67,9,2
6,2004,241400,38,36,2,5
7,2004,241400,67,63,4,1
8,2004,241400,76,76,0,4
9,2004,241400,56,52,4,4
10,2004,241400,40,39,1,3
11,2004,241400,43,42,1,4
12,2004,241400,39,36,3,2
1,2005,241400,29,25,4,1
2,2005,241400,39,37,2,3
3,2005,241400,33,32,1,1
4,2005,241400,35,33,2,5
5,2005,241400,67,65,2,0
6,2005,241400,55,54,1,2
7,2005,241400,62,60,2,2
8,2005,241400,58,58,0,3
9,2005,241400,67,62,5,3
10,2005,241400,68,61,7,0
11,2005,241400,70,70,0,3
12,2005,241400,69,65,4,1
1,2006,241400,64,63,1,1
2,2006,241400,34,32,2,2
3,2006,241400,48,45,3,2
4,2006,241400,50,48,2,3
5,2006,241400,60,54,6,1
6,2006,241400,45,42,3,0
7,2006,241400,64,63,1,2
8,2006,241400,68,64,4,1
9,2006,241400,51,50,1,0
10,2006,241400,44,43,1,2
11,2006,241400,58,53,5,3
12,2006,241400,43,40,3,2
1,2007,241400,45,44,1,5
2,2007,241400,27,26,1,1
3,2007,241400,41,40,1,3
4,2007,241400,49,45,4,3
5,2007,241400,44,42,2,1
6,2007,241400,44,43,1,7
7,2007,241400,50,49,1,2
8,2007,241400,63,62,1,4
9,2007,241400,63,61,2,2
10,2007,241400,69,67,2,5
11,2007,241400,52,49,3,3
12,2007,241400,35,34,1,7
1,2008,241400,65,63,2,3
2,2008,241400,32,31,1,0
3,2008,241400,47,46,1,5
4,2008,241400,36,35,1,3
5,2008,241400,74,71,3,0
6,2008,241400,56,53,3,3
7,2008,241400,63,62,1,0
8,2008,241400,55,51,4,4
9,2008,241400,35,34,1,4
10,2008,241400,67,62,5,0
11,2008,241400,53,51,2,1
12,2008,241400,49,48,1,0
1,2009,241400,36,36,0,1
2,2009,241400,53,50,3,1
3,2009,241400,36,34,2,1
4,2009,241400,41,40,1,6
5,2009,241400,54,54,0,5
6,2009,241400,45,44,1,1
7,2009,241400,56,54,2,2
8,2009,241400,58,56,2,3
9,2009,241400,57,54,3,2
10,2009,241400,57,57,0,5
11,2009,241400,52,50,2,3
12,2009,241400,41,39,2,4
1,2010,241400,48,47,1,2
2,2010,241400,52,49,3,2
3,2010,241400,60,57,3,2
4,2010,241400,42,39,3,3
5,2010,241400,54,50,4,4
6,2010,241400,38,36,2,3
7,2010,241400,58,54,4,0
8,2010,241400,89,85,4,2
9,2010,241400,78,75,3,1
10,2010,241400,62,61,1,7
11,2010,241400,44,42,2,0
12,2010,241400,49,48,1,1
1,2011,241400,53,53,0,5
2,2011,241400,30,27,3,1
1,1999,241600,14,12,2,3
2,1999,241600,18,18,0,5
3,1999,241600,20,19,1,1
4,1999,241600,21,20,1,4
5,1999,241600,20,13,7,3
6,1999,241600,22,19,3,0
7,1999,241600,21,19,2,1
8,1999,241600,26,24,2,1
9,1999,241600,19,19,0,3
10,1999,241600,28,26,2,0
11,1999,241600,15,15,0,2
12,1999,241600,30,24,6,1
1,2000,241600,23,19,4,2
2,2000,241600,23,20,3,6
3,2000,241600,32,28,4,1
4,2000,241600,28,25,3,2
5,2000,241600,26,24,2,0
6,2000,241600,22,22,0,0
7,2000,241600,35,32,3,2
8,2000,241600,27,24,3,2
9,2000,241600,37,33,4,0
10,2000,241600,41,38,3,2
11,2000,241600,27,24,3,2
12,2000,241600,15,14,1,3
1,2001,241600,26,24,2,0
2,2001,241600,24,24,0,5
3,2001,241600,27,23,4,1
4,2001,241600,26,22,4,5
5,2001,241600,26,22,4,0
6,2001,241600,29,23,6,2
7,2001,241600,37,34,3,5
8,2001,241600,25,23,2,3
9,2001,241600,27,27,0,1
10,2001,241600,31,25,6,1
11,2001,241600,18,15,3,1
12,2001,241600,25,23,2,1
1,2002,241600,14,13,1,0
2,2002,241600,27,24,3,7
3,2002,241600,21,18,3,2
4,2002,241600,25,23,2,0
5,2002,241600,22,16,6,0
6,2002,241600,37,34,3,2
7,2002,241600,35,32,3,1
8,2002,241600,24,21,3,0
9,2002,241600,36,32,4,1
10,2002,241600,34,30,4,3
11,2002,241600,31,31,0,2
12,2002,241600,36,35,1,0
1,2003,241600,22,17,5,2
2,2003,241600,22,21,1,1
3,2003,241600,18,17,1,1
4,2003,241600,11,10,1,1
5,2003,241600,32,27,5,0
6,2003,241600,27,21,6,6
7,2003,241600,42,41,1,2
8,2003,241600,22,18,4,3
9,2003,241600,26,26,0,5
10,2003,241600,26,25,1,3
11,2003,241600,30,30,0,0
12,2003,241600,36,34,2,1
1,2004,241600,18,16,2,1
2,2004,241600,12,12,0,1
3,2004,241600,21,18,3,0
4,2004,241600,19,17,2,1
5,2004,241600,16,16,0,0
6,2004,241600,19,18,1,0
7,2004,241600,25,23,2,2
8,2004,241600,29,27,2,4
9,2004,241600,27,26,1,1
10,2004,241600,20,20,0,1
11,2004,241600,13,11,2,3
12,2004,241600,12,10,2,2
1,2005,241600,12,9,3,0
2,2005,241600,14,12,2,4
3,2005,241600,11,10,1,1
4,2005,241600,27,27,0,0
5,2005,241600,20,20,0,1
6,2005,241600,23,21,2,0
7,2005,241600,28,27,1,2
8,2005,241600,19,17,2,1
9,2005,241600,24,22,2,2
10,2005,241600,26,26,0,2
11,2005,241600,17,17,0,1
12,2005,241600,19,18,1,3
1,2006,241600,25,23,2,3
2,2006,241600,25,25,0,4
3,2006,241600,23,19,4,1
4,2006,241600,17,15,2,2
5,2006,241600,18,13,5,2
6,2006,241600,11,8,3,1
7,2006,241600,27,24,3,5
8,2006,241600,25,23,2,7
9,2006,241600,31,29,2,2
10,2006,241600,27,27,0,4
11,2006,241600,23,20,3,0
12,2006,241600,20,18,2,1
1,2007,241600,16,16,0,1
2,2007,241600,18,17,1,1
3,2007,241600,28,26,2,0
4,2007,241600,13,12,1,0
5,2007,241600,22,20,2,0
6,2007,241600,34,27,7,1
7,2007,241600,16,10,6,3
8,2007,241600,22,20,2,0
9,2007,241600,15,14,1,3
10,2007,241600,30,29,1,2
11,2007,241600,31,29,2,4
12,2007,241600,23,22,1,0
1,2008,241600,13,11,2,2
2,2008,241600,21,20,1,1
3,2008,241600,25,22,3,3
4,2008,241600,24,24,0,2
5,2008,241600,17,17,0,0
6,2008,241600,23,23,0,1
7,2008,241600,26,23,3,2
8,2008,241600,35,35,0,1
9,2008,241600,32,32,0,0
10,2008,241600,38,37,1,1
11,2008,241600,27,26,1,2
12,2008,241600,18,18,0,5
1,2009,241600,36,35,1,1
2,2009,241600,23,22,1,0
3,2009,241600,18,17,1,1
4,2009,241600,21,20,1,3
5,2009,241600,24,23,1,3
6,2009,241600,26,26,0,1
7,2009,241600,25,22,3,4
8,2009,241600,21,17,4,1
9,2009,241600,28,26,2,1
10,2009,241600,19,19,0,2
11,2009,241600,30,28,2,1
12,2009,241600,13,13,0,2
1,2010,241600,11,10,1,1
2,2010,241600,16,15,1,2
3,2010,241600,20,20,0,2
4,2010,241600,20,18,2,3
5,2010,241600,24,22,2,1
6,2010,241600,17,17,0,1
7,2010,241600,16,14,2,3
8,2010,241600,32,26,6,3
9,2010,241600,39,38,1,2
10,2010,241600,40,40,0,5
11,2010,241600,27,27,0,0
12,2010,241600,34,32,2,0
1,2011,241600,34,32,2,0
2,2011,241600,15,15,0,0
1,1999,230600,43,38,5,8
2,1999,230600,41,31,10,10
3,1999,230600,39,31,8,17
4,1999,230600,58,50,8,12
5,1999,230600,68,54,14,16
6,1999,230600,57,50,7,12
7,1999,230600,41,33,8,11
8,1999,230600,50,39,11,9
9,1999,230600,49,40,9,11
10,1999,230600,40,30,10,10
11,1999,230600,38,32,6,21
12,1999,230600,42,35,7,20
1,2000,230600,44,31,13,21
2,2000,230600,40,35,5,15
3,2000,230600,34,25,9,17
4,2000,230600,36,26,10,13
5,2000,230600,58,50,8,20
6,2000,230600,48,42,6,15
7,2000,230600,51,37,14,17
8,2000,230600,64,54,10,11
9,2000,230600,51,44,7,14
10,2000,230600,49,43,6,19
11,2000,230600,49,36,13,11
12,2000,230600,42,42,0,8
1,2001,230600,67,55,12,11
2,2001,230600,35,27,8,17
3,2001,230600,45,35,10,15
4,2001,230600,42,30,12,16
5,2001,230600,54,35,19,19
6,2001,230600,59,46,13,7
7,2001,230600,82,68,14,11
8,2001,230600,52,42,10,12
9,2001,230600,41,37,4,4
10,2001,230600,55,37,18,5
11,2001,230600,45,36,9,6
12,2001,230600,46,36,10,5
1,2002,230600,50,42,8,8
2,2002,230600,36,29,7,9
3,2002,230600,37,32,5,7
4,2002,230600,41,37,4,2
5,2002,230600,59,49,10,8
6,2002,230600,44,30,14,7
7,2002,230600,52,40,12,9
8,2002,230600,49,40,9,11
9,2002,230600,69,58,11,7
10,2002,230600,65,53,12,4
11,2002,230600,37,29,8,10
12,2002,230600,54,50,4,9
1,2003,230600,45,43,2,6
2,2003,230600,31,28,3,11
3,2003,230600,42,31,11,3
4,2003,230600,38,29,9,10
5,2003,230600,41,38,3,9
6,2003,230600,48,40,8,9
7,2003,230600,73,65,8,11
8,2003,230600,57,52,5,7
9,2003,230600,46,37,9,24
10,2003,230600,38,33,5,70
11,2003,230600,57,56,1,7
12,2003,230600,42,34,8,6
1,2004,230600,27,24,3,5
2,2004,230600,35,25,10,13
3,2004,230600,34,27,7,6
4,2004,230600,43,37,6,11
5,2004,230600,41,31,10,18
6,2004,230600,49,41,8,15
7,2004,230600,49,42,7,39
8,2004,230600,46,43,3,10
9,2004,230600,54,43,11,10
10,2004,230600,31,29,2,24
11,2004,230600,28,20,8,12
12,2004,230600,34,29,5,6
1,2005,230600,32,27,5,12
2,2005,230600,30,26,4,16
3,2005,230600,20,14,6,6
4,2005,230600,36,28,8,12
5,2005,230600,38,33,5,4
6,2005,230600,42,35,7,6
7,2005,230600,57,51,6,5
8,2005,230600,49,45,4,21
9,2005,230600,37,34,3,14
10,2005,230600,33,27,6,26
11,2005,230600,40,38,2,8
12,2005,230600,25,23,2,6
1,2006,230600,32,29,3,5
2,2006,230600,33,33,0,16
3,2006,230600,44,35,9,10
4,2006,230600,43,34,9,5
5,2006,230600,38,35,3,11
6,2006,230600,41,36,5,12
7,2006,230600,34,29,5,11
8,2006,230600,41,37,4,2
9,2006,230600,30,25,5,11
10,2006,230600,35,28,7,6
11,2006,230600,34,32,2,7
12,2006,230600,39,33,6,10
1,2007,230600,33,29,4,6
2,2007,230600,33,28,5,8
3,2007,230600,33,28,5,8
4,2007,230600,41,36,5,10
5,2007,230600,39,36,3,8
6,2007,230600,32,29,3,9
7,2007,230600,40,35,5,10
8,2007,230600,35,33,2,6
9,2007,230600,41,31,10,9
10,2007,230600,36,34,2,5
11,2007,230600,32,28,4,6
12,2007,230600,28,28,0,6
1,2008,230600,36,33,3,3
2,2008,230600,18,17,1,9
3,2008,230600,25,20,5,6
4,2008,230600,36,27,9,8
5,2008,230600,31,23,8,5
6,2008,230600,48,43,5,5
7,2008,230600,44,40,4,12
8,2008,230600,44,37,7,14
9,2008,230600,32,27,5,14
10,2008,230600,41,36,5,12
11,2008,230600,40,38,2,7
12,2008,230600,33,30,3,12
1,2009,230600,43,36,7,9
2,2009,230600,32,30,2,7
3,2009,230600,41,37,4,5
4,2009,230600,36,36,0,13
5,2009,230600,37,26,11,6
6,2009,230600,28,23,5,10
7,2009,230600,43,36,7,6
8,2009,230600,50,43,7,14
9,2009,230600,40,31,9,13
10,2009,230600,43,34,9,8
11,2009,230600,40,34,6,12
12,2009,230600,41,37,4,5
1,2010,230600,31,26,5,8
2,2010,230600,28,24,4,10
3,2010,230600,31,27,4,5
4,2010,230600,37,35,2,12
5,2010,230600,41,35,6,10
6,2010,230600,47,32,15,7
7,2010,230600,22,20,2,9
8,2010,230600,36,27,9,12
9,2010,230600,23,23,0,7
10,2010,230600,47,39,8,12
11,2010,230600,37,32,5,7
12,2010,230600,28,27,1,7
1,2011,230600,37,35,2,9
2,2011,230600,23,20,3,6
1,1999,080400,58,55,3,8
2,1999,080400,42,38,4,8
3,1999,080400,68,65,3,13
4,1999,080400,68,67,1,8
5,1999,080400,57,51,6,12
6,1999,080400,41,37,4,11
7,1999,080400,45,42,3,11
8,1999,080400,62,61,1,8
9,1999,080400,53,51,2,10
10,1999,080400,45,40,5,14
11,1999,080400,49,47,2,17
12,1999,080400,50,46,4,10
1,2000,080400,42,40,2,18
2,2000,080400,41,39,2,19
3,2000,080400,50,45,5,15
4,2000,080400,44,41,3,14
5,2000,080400,55,48,7,11
6,2000,080400,49,44,5,13
7,2000,080400,68,62,6,8
8,2000,080400,45,42,3,8
9,2000,080400,44,42,2,9
10,2000,080400,48,47,1,15
11,2000,080400,32,25,7,17
12,2000,080400,24,20,4,5
1,2001,080400,35,34,1,18
2,2001,080400,32,27,5,6
3,2001,080400,40,36,4,6
4,2001,080400,35,34,1,14
5,2001,080400,39,38,1,17
6,2001,080400,34,31,3,32
7,2001,080400,48,42,6,20
8,2001,080400,57,55,2,26
9,2001,080400,49,45,4,11
10,2001,080400,70,69,1,10
11,2001,080400,46,42,4,6
12,2001,080400,45,40,5,16
1,2002,080400,30,30,0,18
2,2002,080400,29,25,4,10
3,2002,080400,44,42,2,13
4,2002,080400,42,41,1,12
5,2002,080400,40,34,6,9
6,2002,080400,42,40,2,8
7,2002,080400,45,43,2,12
8,2002,080400,52,49,3,12
9,2002,080400,54,51,3,6
10,2002,080400,50,48,2,14
11,2002,080400,37,36,1,4
12,2002,080400,49,49,0,6
1,2003,080400,42,37,5,6
2,2003,080400,31,30,1,5
3,2003,080400,41,38,3,7
4,2003,080400,28,27,1,15
5,2003,080400,34,33,1,11
6,2003,080400,57,54,3,9
7,2003,080400,38,30,8,6
8,2003,080400,37,35,2,3
9,2003,080400,34,30,4,6
10,2003,080400,44,41,3,3
11,2003,080400,46,43,3,5
12,2003,080400,25,25,0,6
1,2004,080400,38,37,1,7
2,2004,080400,25,24,1,5
3,2004,080400,45,42,3,8
4,2004,080400,59,58,1,4
5,2004,080400,48,46,2,8
6,2004,080400,44,42,2,4
7,2004,080400,42,39,3,15
8,2004,080400,43,37,6,10
9,2004,080400,37,36,1,6
10,2004,080400,47,44,3,11
11,2004,080400,30,25,5,7
12,2004,080400,32,31,1,8
1,2005,080400,18,18,0,5
2,2005,080400,19,18,1,6
3,2005,080400,34,30,4,5
4,2005,080400,25,24,1,9
5,2005,080400,31,28,3,17
6,2005,080400,35,32,3,18
7,2005,080400,42,36,6,11
8,2005,080400,25,22,3,11
9,2005,080400,39,33,6,15
10,2005,080400,30,28,2,41
11,2005,080400,28,27,1,12
12,2005,080400,25,24,1,12
1,2006,080400,34,30,4,8
2,2006,080400,20,17,3,1
3,2006,080400,24,19,5,4
4,2006,080400,28,24,4,8
5,2006,080400,23,22,1,6
6,2006,080400,23,21,2,6
7,2006,080400,31,27,4,2
8,2006,080400,34,32,2,6
9,2006,080400,20,19,1,15
10,2006,080400,28,22,6,5
11,2006,080400,28,26,2,3
12,2006,080400,30,28,2,6
1,2007,080400,26,22,4,2
2,2007,080400,18,17,1,1
3,2007,080400,20,19,1,3
4,2007,080400,25,20,5,4
5,2007,080400,22,22,0,2
6,2007,080400,37,31,6,3
7,2007,080400,36,34,2,4
8,2007,080400,38,32,6,6
9,2007,080400,23,21,2,3
10,2007,080400,27,24,3,5
11,2007,080400,33,31,2,4
12,2007,080400,22,21,1,2
1,2008,080400,25,22,3,7
2,2008,080400,33,31,2,6
3,2008,080400,31,28,3,3
4,2008,080400,39,35,4,10
5,2008,080400,30,29,1,8
6,2008,080400,44,41,3,3
7,2008,080400,35,32,3,1
8,2008,080400,50,45,5,7
9,2008,080400,28,26,2,6
10,2008,080400,42,39,3,8
11,2008,080400,22,19,3,4
12,2008,080400,19,18,1,3
1,2009,080400,25,22,3,5
2,2009,080400,21,20,1,3
3,2009,080400,22,20,2,9
4,2009,080400,23,21,2,7
5,2009,080400,26,22,4,13
6,2009,080400,28,28,0,6
7,2009,080400,41,36,5,6
8,2009,080400,25,23,2,3
9,2009,080400,38,36,2,9
10,2009,080400,30,27,3,10
11,2009,080400,23,19,4,15
12,2009,080400,29,27,2,6
1,2010,080400,25,23,2,8
2,2010,080400,17,16,1,4
3,2010,080400,28,26,2,7
4,2010,080400,41,35,6,15
5,2010,080400,25,23,2,9
6,2010,080400,40,36,4,11
7,2010,080400,36,32,4,9
8,2010,080400,56,53,3,5
9,2010,080400,40,35,5,10
10,2010,080400,34,31,3,4
11,2010,080400,22,21,1,7
12,2010,080400,34,31,3,5
1,2011,080400,39,35,4,5
2,2011,080400,13,12,1,3
1,1999,080300,48,47,1,2
2,1999,080300,26,25,1,2
3,1999,080300,36,35,1,2
4,1999,080300,41,38,3,1
5,1999,080300,50,48,2,2
6,1999,080300,42,41,1,2
7,1999,080300,60,59,1,2
8,1999,080300,58,58,0,2
9,1999,080300,39,39,0,3
10,1999,080300,32,30,2,2
11,1999,080300,34,33,1,1
12,1999,080300,32,32,0,3
1,2000,080300,33,31,2,3
2,2000,080300,33,32,1,1
3,2000,080300,24,23,1,5
4,2000,080300,27,26,1,2
5,2000,080300,60,59,1,3
6,2000,080300,52,49,3,2
7,2000,080300,32,29,3,0
8,2000,080300,33,32,1,1
9,2000,080300,42,39,3,0
10,2000,080300,44,42,2,3
11,2000,080300,30,28,2,1
12,2000,080300,34,32,2,3
1,2001,080300,29,27,2,0
2,2001,080300,23,20,3,2
3,2001,080300,35,31,4,1
4,2001,080300,13,13,0,0
5,2001,080300,33,32,1,6
6,2001,080300,35,33,2,3
7,2001,080300,43,42,1,7
8,2001,080300,46,44,2,3
9,2001,080300,38,36,2,1
10,2001,080300,39,37,2,4
11,2001,080300,33,32,1,1
12,2001,080300,30,28,2,2
1,2002,080300,25,24,1,2
2,2002,080300,22,21,1,3
3,2002,080300,18,18,0,1
4,2002,080300,34,33,1,4
5,2002,080300,34,32,2,1
6,2002,080300,37,34,3,4
7,2002,080300,45,44,1,2
8,2002,080300,47,46,1,1
9,2002,080300,45,42,3,1
10,2002,080300,40,40,0,4
11,2002,080300,36,36,0,0
12,2002,080300,41,41,0,2
1,2003,080300,27,27,0,2
2,2003,080300,30,29,1,1
3,2003,080300,33,31,2,0
4,2003,080300,33,32,1,1
5,2003,080300,32,32,0,0
6,2003,080300,29,26,3,2
7,2003,080300,51,49,2,2
8,2003,080300,34,28,6,0
9,2003,080300,34,32,2,0
10,2003,080300,36,34,2,1
11,2003,080300,33,31,2,1
12,2003,080300,32,32,0,4
1,2004,080300,28,28,0,2
2,2004,080300,25,24,1,1
3,2004,080300,19,19,0,0
4,2004,080300,35,35,0,1
5,2004,080300,43,43,0,1
6,2004,080300,25,23,2,0
7,2004,080300,37,37,0,3
8,2004,080300,33,33,0,0
9,2004,080300,36,36,0,0
10,2004,080300,35,35,0,3
11,2004,080300,24,23,1,1
12,2004,080300,18,18,0,4
1,2005,080300,19,18,1,1
2,2005,080300,31,31,0,1
3,2005,080300,26,24,2,0
4,2005,080300,28,27,1,0
5,2005,080300,32,32,0,3
6,2005,080300,44,42,2,2
7,2005,080300,24,23,1,3
8,2005,080300,35,34,1,3
9,2005,080300,54,52,2,3
10,2005,080300,26,26,0,3
11,2005,080300,34,32,2,1
12,2005,080300,44,43,1,0
1,2006,080300,26,26,0,1
2,2006,080300,16,15,1,0
3,2006,080300,28,27,1,1
4,2006,080300,30,29,1,2
5,2006,080300,35,35,0,1
6,2006,080300,33,30,3,3
7,2006,080300,47,46,1,0
8,2006,080300,49,48,1,3
9,2006,080300,38,38,0,4
10,2006,080300,48,46,2,0
11,2006,080300,32,31,1,4
12,2006,080300,20,20,0,0
1,2007,080300,38,36,2,2
2,2007,080300,20,19,1,1
3,2007,080300,26,26,0,2
4,2007,080300,34,33,1,1
5,2007,080300,33,33,0,3
6,2007,080300,33,32,1,1
7,2007,080300,37,35,2,1
8,2007,080300,43,41,2,1
9,2007,080300,29,29,0,0
10,2007,080300,50,49,1,1
11,2007,080300,37,35,2,1
12,2007,080300,17,16,1,0
1,2008,080300,32,32,0,0
2,2008,080300,30,30,0,0
3,2008,080300,29,27,2,0
4,2008,080300,30,29,1,1
5,2008,080300,38,37,1,1
6,2008,080300,33,33,0,1
7,2008,080300,29,28,1,1
8,2008,080300,30,30,0,0
9,2008,080300,36,33,3,2
10,2008,080300,35,33,2,1
11,2008,080300,30,29,1,1
12,2008,080300,25,23,2,0
1,2009,080300,16,16,0,0
2,2009,080300,26,25,1,1
3,2009,080300,33,32,1,2
4,2009,080300,35,35,0,2
5,2009,080300,25,24,1,1
6,2009,080300,31,31,0,0
7,2009,080300,39,38,1,0
8,2009,080300,47,46,1,1
9,2009,080300,40,40,0,1
10,2009,080300,28,26,2,1
11,2009,080300,23,22,1,1
12,2009,080300,30,29,1,1
1,2010,080300,17,17,0,1
2,2010,080300,13,12,1,0
3,2010,080300,22,22,0,2
4,2010,080300,28,28,0,1
5,2010,080300,21,21,0,0
6,2010,080300,30,27,3,1
7,2010,080300,35,34,1,3
8,2010,080300,33,33,0,6
9,2010,080300,40,40,0,1
10,2010,080300,30,29,1,2
11,2010,080300,29,27,2,1
12,2010,080300,28,27,1,1
1,2011,080300,14,14,0,0
2,2011,080300,14,14,0,0
1,1999,080202,37,35,2,5
2,1999,080202,18,18,0,2
3,1999,080202,35,33,2,3
4,1999,080202,24,24,0,1
5,1999,080202,35,33,2,4
6,1999,080202,36,35,1,2
7,1999,080202,42,42,0,0
8,1999,080202,36,36,0,0
9,1999,080202,29,29,0,2
10,1999,080202,26,24,2,1
11,1999,080202,12,12,0,0
12,1999,080202,32,31,1,4
1,2000,080202,19,18,1,2
2,2000,080202,28,28,0,4
3,2000,080202,29,29,0,1
4,2000,080202,26,26,0,3
5,2000,080202,52,51,1,2
6,2000,080202,23,22,1,2
7,2000,080202,24,22,2,0
8,2000,080202,35,35,0,1
9,2000,080202,30,30,0,1
10,2000,080202,26,26,0,2
11,2000,080202,33,33,0,4
12,2000,080202,15,15,0,6
1,2001,080202,18,18,0,2
2,2001,080202,17,17,0,3
3,2001,080202,18,18,0,3
4,2001,080202,22,21,1,1
5,2001,080202,25,25,0,1
6,2001,080202,22,20,2,7
7,2001,080202,20,20,0,5
8,2001,080202,28,28,0,4
9,2001,080202,27,27,0,0
10,2001,080202,26,26,0,4
11,2001,080202,17,17,0,5
12,2001,080202,24,24,0,6
1,2002,080202,23,20,3,0
2,2002,080202,18,18,0,3
3,2002,080202,24,23,1,5
4,2002,080202,24,23,1,3
5,2002,080202,28,27,1,0
6,2002,080202,30,30,0,3
7,2002,080202,27,26,1,2
8,2002,080202,20,20,0,3
9,2002,080202,23,22,1,1
10,2002,080202,31,30,1,2
11,2002,080202,20,18,2,2
12,2002,080202,17,16,1,1
1,2003,080202,24,24,0,4
2,2003,080202,20,20,0,0
3,2003,080202,18,17,1,1
4,2003,080202,29,26,3,2
5,2003,080202,24,24,0,2
6,2003,080202,20,20,0,0
7,2003,080202,24,24,0,2
8,2003,080202,22,20,2,0
9,2003,080202,17,16,1,2
10,2003,080202,29,29,0,0
11,2003,080202,16,16,0,2
12,2003,080202,24,21,3,0
1,2004,080202,13,13,0,6
2,2004,080202,15,14,1,3
3,2004,080202,23,22,1,5
4,2004,080202,18,17,1,3
5,2004,080202,21,20,1,3
6,2004,080202,23,23,0,4
7,2004,080202,28,27,1,1
8,2004,080202,22,19,3,1
9,2004,080202,18,18,0,1
10,2004,080202,18,18,0,0
11,2004,080202,18,18,0,1
12,2004,080202,12,12,0,1
1,2005,080202,14,14,0,0
2,2005,080202,11,11,0,3
3,2005,080202,22,22,0,2
4,2005,080202,21,20,1,1
5,2005,080202,15,14,1,2
6,2005,080202,23,23,0,0
7,2005,080202,19,19,0,0
8,2005,080202,26,25,1,3
9,2005,080202,18,16,2,2
10,2005,080202,25,25,0,1
11,2005,080202,22,22,0,1
12,2005,080202,17,17,0,3
1,2006,080202,21,21,0,3
2,2006,080202,18,17,1,3
3,2006,080202,27,27,0,5
4,2006,080202,22,22,0,4
5,2006,080202,31,31,0,4
6,2006,080202,16,15,1,4
7,2006,080202,26,23,3,2
8,2006,080202,17,16,1,2
9,2006,080202,23,22,1,6
10,2006,080202,12,12,0,2
11,2006,080202,24,23,1,4
12,2006,080202,12,12,0,6
1,2007,080202,17,16,1,2
2,2007,080202,14,14,0,3
3,2007,080202,15,14,1,1
4,2007,080202,16,16,0,0
5,2007,080202,24,24,0,2
6,2007,080202,22,22,0,0
7,2007,080202,21,19,2,2
8,2007,080202,22,22,0,3
9,2007,080202,29,27,2,1
10,2007,080202,16,16,0,1
11,2007,080202,28,28,0,2
12,2007,080202,17,17,0,0
1,2008,080202,17,17,0,2
2,2008,080202,11,11,0,2
3,2008,080202,17,16,1,1
4,2008,080202,16,14,2,1
5,2008,080202,9,8,1,0
6,2008,080202,28,28,0,1
7,2008,080202,15,14,1,0
8,2008,080202,27,25,2,0
9,2008,080202,19,19,0,0
10,2008,080202,22,22,0,0
11,2008,080202,26,26,0,1
12,2008,080202,22,22,0,0
1,2009,080202,18,17,1,0
2,2009,080202,26,26,0,1
3,2009,080202,12,11,1,0
4,2009,080202,15,15,0,1
5,2009,080202,10,10,0,4
6,2009,080202,12,12,0,0
7,2009,080202,17,16,1,0
8,2009,080202,23,23,0,1
9,2009,080202,14,13,1,3
10,2009,080202,28,26,2,0
11,2009,080202,23,23,0,0
12,2009,080202,19,19,0,7
1,2010,080202,11,11,0,0
2,2010,080202,6,6,0,2
3,2010,080202,14,14,0,0
4,2010,080202,10,10,0,2
5,2010,080202,19,19,0,1
6,2010,080202,12,11,1,3
7,2010,080202,16,16,0,3
8,2010,080202,22,22,0,1
9,2010,080202,16,16,0,2
10,2010,080202,17,16,1,0
11,2010,080202,14,14,0,0
12,2010,080202,13,13,0,0
1,2011,080202,17,17,0,2
2,2011,080202,6,6,0,0
1,1999,080100,21,20,1,0
2,1999,080100,8,7,1,0
3,1999,080100,10,9,1,0
4,1999,080100,15,15,0,2
5,1999,080100,16,15,1,0
6,1999,080100,15,15,0,0
7,1999,080100,13,12,1,0
8,1999,080100,13,12,1,1
9,1999,080100,11,9,2,0
10,1999,080100,8,8,0,0
11,1999,080100,16,14,2,1
12,1999,080100,9,8,1,1
1,2000,080100,4,3,1,0
2,2000,080100,8,8,0,2
3,2000,080100,13,13,0,0
4,2000,080100,12,12,0,0
5,2000,080100,12,11,1,0
6,2000,080100,16,15,1,1
7,2000,080100,15,12,3,0
8,2000,080100,20,20,0,0
9,2000,080100,12,11,1,0
10,2000,080100,14,13,1,0
11,2000,080100,18,16,2,0
12,2000,080100,14,13,1,0
1,2001,080100,18,17,1,1
2,2001,080100,8,7,1,0
3,2001,080100,13,13,0,2
4,2001,080100,12,11,1,0
5,2001,080100,7,5,2,1
6,2001,080100,7,6,1,1
7,2001,080100,10,10,0,3
8,2001,080100,7,7,0,0
9,2001,080100,14,13,1,0
10,2001,080100,13,11,2,1
11,2001,080100,10,9,1,1
12,2001,080100,13,11,2,0
1,2002,080100,14,13,1,0
2,2002,080100,8,8,0,1
3,2002,080100,15,15,0,1
4,2002,080100,7,7,0,1
5,2002,080100,10,10,0,0
6,2002,080100,18,16,2,1
7,2002,080100,10,10,0,0
8,2002,080100,13,13,0,0
9,2002,080100,18,16,2,0
10,2002,080100,13,12,1,0
11,2002,080100,19,19,0,2
12,2002,080100,6,6,0,0
1,2003,080100,4,4,0,0
2,2003,080100,10,10,0,0
3,2003,080100,12,11,1,0
4,2003,080100,11,8,3,0
5,2003,080100,9,9,0,0
6,2003,080100,14,12,2,1
7,2003,080100,11,10,1,1
8,2003,080100,8,8,0,2
9,2003,080100,9,8,1,0
10,2003,080100,7,6,1,0
11,2003,080100,16,16,0,1
12,2003,080100,11,10,1,2
1,2004,080100,9,8,1,0
2,2004,080100,11,11,0,1
3,2004,080100,20,20,0,0
4,2004,080100,11,9,2,1
5,2004,080100,7,7,0,2
6,2004,080100,13,11,2,0
7,2004,080100,9,7,2,0
8,2004,080100,11,10,1,0
9,2004,080100,11,11,0,1
10,2004,080100,17,15,2,1
11,2004,080100,8,7,1,0
12,2004,080100,9,9,0,0
1,2005,080100,11,10,1,0
2,2005,080100,9,8,1,0
3,2005,080100,9,9,0,0
4,2005,080100,12,10,2,0
5,2005,080100,10,9,1,0
6,2005,080100,12,12,0,1
7,2005,080100,11,8,3,2
8,2005,080100,9,8,1,0
9,2005,080100,8,7,1,0
10,2005,080100,15,15,0,1
11,2005,080100,18,17,1,0
12,2005,080100,8,7,1,0
1,2006,080100,13,10,3,0
2,2006,080100,4,4,0,0
3,2006,080100,11,11,0,0
4,2006,080100,15,12,3,0
5,2006,080100,11,10,1,0
6,2006,080100,15,14,1,0
7,2006,080100,20,18,2,0
8,2006,080100,11,11,0,0
9,2006,080100,5,4,1,0
10,2006,080100,13,13,0,0
11,2006,080100,11,11,0,1
12,2006,080100,10,10,0,0
1,2007,080100,12,11,1,1
2,2007,080100,14,14,0,0
3,2007,080100,8,6,2,0
4,2007,080100,7,7,0,0
5,2007,080100,11,10,1,1
6,2007,080100,18,18,0,0
7,2007,080100,7,7,0,0
8,2007,080100,12,11,1,0
9,2007,080100,8,8,0,0
10,2007,080100,9,8,1,0
11,2007,080100,12,11,1,0
12,2007,080100,10,8,2,0
1,2008,080100,9,8,1,1
2,2008,080100,6,6,0,0
3,2008,080100,18,17,1,1
4,2008,080100,13,13,0,1
5,2008,080100,18,16,2,0
6,2008,080100,6,5,1,0
7,2008,080100,25,23,2,0
8,2008,080100,20,18,2,0
9,2008,080100,11,10,1,0
10,2008,080100,10,9,1,2
11,2008,080100,15,15,0,0
12,2008,080100,8,8,0,2
1,2009,080100,9,8,1,0
2,2009,080100,12,11,1,1
3,2009,080100,8,8,0,0
4,2009,080100,8,7,1,1
5,2009,080100,8,8,0,0
6,2009,080100,6,5,1,0
7,2009,080100,13,13,0,0
8,2009,080100,14,12,2,0
9,2009,080100,6,5,1,2
10,2009,080100,13,11,2,0
11,2009,080100,9,9,0,1
12,2009,080100,12,12,0,2
1,2010,080100,9,7,2,0
2,2010,080100,6,6,0,1
3,2010,080100,15,15,0,0
4,2010,080100,9,8,1,0
5,2010,080100,11,9,2,0
6,2010,080100,14,11,3,0
7,2010,080100,12,11,1,0
8,2010,080100,9,8,1,0
9,2010,080100,16,16,0,0
10,2010,080100,13,13,0,1
11,2010,080100,7,7,0,1
12,2010,080100,12,12,0,1
1,2011,080100,11,9,2,0
2,2011,080100,6,4,2,0
1,1999,241300,6,6,0,0
2,1999,241300,8,8,0,0
3,1999,241300,9,7,2,0
4,1999,241300,2,2,0,0
5,1999,241300,16,15,1,3
6,1999,241300,9,9,0,0
7,1999,241300,14,13,1,1
8,1999,241300,11,10,1,4
9,1999,241300,10,10,0,3
10,1999,241300,12,10,2,0
11,1999,241300,11,10,1,2
12,1999,241300,9,7,2,0
1,2000,241300,10,9,1,0
2,2000,241300,6,6,0,1
3,2000,241300,8,8,0,0
4,2000,241300,13,12,1,0
5,2000,241300,12,10,2,1
6,2000,241300,8,8,0,1
7,2000,241300,13,13,0,1
8,2000,241300,4,3,1,0
9,2000,241300,14,11,3,1
10,2000,241300,10,9,1,0
11,2000,241300,9,9,0,0
12,2000,241300,7,6,1,0
1,2001,241300,4,4,0,1
2,2001,241300,6,6,0,0
3,2001,241300,6,5,1,1
4,2001,241300,11,11,0,0
5,2001,241300,6,6,0,1
6,2001,241300,11,10,1,1
7,2001,241300,10,10,0,0
8,2001,241300,11,10,1,0
9,2001,241300,9,8,1,0
10,2001,241300,13,13,0,1
11,2001,241300,8,8,0,0
12,2001,241300,9,9,0,0
1,2002,241300,8,8,0,0
2,2002,241300,7,6,1,0
3,2002,241300,9,9,0,0
4,2002,241300,4,4,0,0
5,2002,241300,7,7,0,0
6,2002,241300,8,6,2,0
7,2002,241300,11,11,0,0
8,2002,241300,18,18,0,2
9,2002,241300,11,11,0,1
10,2002,241300,16,16,0,1
11,2002,241300,14,14,0,1
12,2002,241300,11,11,0,0
1,2003,241300,8,8,0,1
2,2003,241300,11,11,0,0
3,2003,241300,9,7,2,0
4,2003,241300,7,6,1,0
5,2003,241300,8,8,0,0
6,2003,241300,9,9,0,0
7,2003,241300,10,10,0,0
8,2003,241300,12,10,2,0
9,2003,241300,12,12,0,0
10,2003,241300,9,8,1,0
11,2003,241300,5,5,0,0
12,2003,241300,8,8,0,0
1,2004,241300,7,7,0,0
2,2004,241300,4,4,0,0
3,2004,241300,13,12,1,0
4,2004,241300,10,10,0,0
5,2004,241300,11,11,0,0
6,2004,241300,9,9,0,0
7,2004,241300,10,10,0,0
8,2004,241300,16,15,1,0
9,2004,241300,13,12,1,0
10,2004,241300,2,2,0,0
11,2004,241300,2,1,1,0
12,2004,241300,4,4,0,0
1,2005,241300,6,6,0,0
2,2005,241300,3,3,0,1
3,2005,241300,10,10,0,0
4,2005,241300,6,6,0,0
5,2005,241300,12,11,1,1
6,2005,241300,7,7,0,0
7,2005,241300,5,4,1,0
8,2005,241300,4,4,0,4
9,2005,241300,11,9,2,0
10,2005,241300,14,14,0,0
11,2005,241300,13,13,0,0
12,2005,241300,5,4,1,0
1,2006,241300,16,16,0,0
2,2006,241300,11,9,2,1
3,2006,241300,6,5,1,0
4,2006,241300,6,6,0,0
5,2006,241300,7,7,0,1
6,2006,241300,8,8,0,0
7,2006,241300,9,9,0,0
8,2006,241300,18,18,0,0
9,2006,241300,8,8,0,2
10,2006,241300,9,9,0,0
11,2006,241300,5,5,0,0
12,2006,241300,12,12,0,1
1,2007,241300,6,6,0,0
2,2007,241300,3,3,0,0
3,2007,241300,7,7,0,2
4,2007,241300,1,1,0,0
5,2007,241300,7,7,0,0
6,2007,241300,5,5,0,0
7,2007,241300,12,11,1,1
8,2007,241300,13,11,2,0
9,2007,241300,9,9,0,0
10,2007,241300,13,13,0,0
11,2007,241300,7,7,0,0
12,2007,241300,13,13,0,0
1,2008,241300,5,5,0,1
2,2008,241300,6,6,0,0
3,2008,241300,9,9,0,0
4,2008,241300,9,9,0,1
5,2008,241300,9,9,0,0
6,2008,241300,12,12,0,0
7,2008,241300,8,8,0,0
8,2008,241300,12,12,0,1
9,2008,241300,9,9,0,0
10,2008,241300,16,16,0,1
11,2008,241300,8,8,0,0
12,2008,241300,7,7,0,0
1,2009,241300,6,6,0,0
2,2009,241300,2,2,0,0
3,2009,241300,6,6,0,0
4,2009,241300,5,5,0,0
5,2009,241300,8,8,0,0
6,2009,241300,5,5,0,0
7,2009,241300,5,5,0,1
8,2009,241300,6,6,0,1
9,2009,241300,11,10,1,1
10,2009,241300,9,9,0,0
11,2009,241300,8,7,1,0
12,2009,241300,8,8,0,0
1,2010,241300,6,6,0,0
2,2010,241300,2,1,1,0
3,2010,241300,4,2,2,0
4,2010,241300,5,5,0,0
5,2010,241300,8,8,0,0
6,2010,241300,11,11,0,0
7,2010,241300,22,22,0,0
8,2010,241300,20,20,0,0
9,2010,241300,14,14,0,0
10,2010,241300,10,10,0,0
11,2010,241300,6,6,0,0
12,2010,241300,10,10,0,0
1,2011,241300,3,3,0,0
2,2011,241300,4,4,0,1
1,1999,241500,36,33,3,2
2,1999,241500,24,24,0,5
3,1999,241500,34,34,0,3
4,1999,241500,28,26,2,6
5,1999,241500,37,31,6,5
6,1999,241500,43,36,7,1
7,1999,241500,51,46,5,2
8,1999,241500,40,36,4,3
9,1999,241500,33,32,1,2
10,1999,241500,45,43,2,2
11,1999,241500,38,36,2,1
12,1999,241500,38,38,0,0
1,2000,241500,20,19,1,0
2,2000,241500,26,24,2,2
3,2000,241500,22,19,3,1
4,2000,241500,32,31,1,0
5,2000,241500,26,26,0,1
6,2000,241500,32,31,1,0
7,2000,241500,29,28,1,0
8,2000,241500,46,40,6,1
9,2000,241500,32,30,2,0
10,2000,241500,33,30,3,4
11,2000,241500,32,31,1,0
12,2000,241500,24,23,1,0
1,2001,241500,23,22,1,2
2,2001,241500,21,21,0,2
3,2001,241500,22,21,1,0
4,2001,241500,34,28,6,1
5,2001,241500,31,27,4,0
6,2001,241500,27,25,2,2
7,2001,241500,44,38,6,1
8,2001,241500,36,28,8,0
9,2001,241500,30,26,4,1
10,2001,241500,22,20,2,3
11,2001,241500,23,23,0,1
12,2001,241500,28,26,2,2
1,2002,241500,17,15,2,1
2,2002,241500,18,17,1,1
3,2002,241500,23,22,1,4
4,2002,241500,22,22,0,0
5,2002,241500,22,22,0,1
6,2002,241500,37,34,3,0
7,2002,241500,34,33,1,0
8,2002,241500,56,54,2,3
9,2002,241500,40,35,5,1
10,2002,241500,50,45,5,2
11,2002,241500,47,47,0,1
12,2002,241500,64,63,1,0
1,2003,241500,40,35,5,2
2,2003,241500,24,24,0,0
3,2003,241500,22,21,1,0
4,2003,241500,19,18,1,1
5,2003,241500,29,26,3,1
6,2003,241500,28,26,2,0
7,2003,241500,32,31,1,3
8,2003,241500,26,25,1,0
9,2003,241500,26,26,0,0
10,2003,241500,36,35,1,0
11,2003,241500,29,29,0,1
12,2003,241500,39,38,1,0
1,2004,241500,15,14,1,0
2,2004,241500,17,16,1,2
3,2004,241500,31,29,2,0
4,2004,241500,32,29,3,0
5,2004,241500,13,12,1,1
6,2004,241500,32,31,1,1
7,2004,241500,32,32,0,0
8,2004,241500,41,36,5,2
9,2004,241500,31,30,1,1
10,2004,241500,27,26,1,1
11,2004,241500,23,23,0,0
12,2004,241500,20,20,0,0
1,2005,241500,14,14,0,0
2,2005,241500,21,19,2,2
3,2005,241500,29,28,1,0
4,2005,241500,30,28,2,1
5,2005,241500,26,22,4,0
6,2005,241500,20,19,1,1
7,2005,241500,20,20,0,2
8,2005,241500,22,21,1,0
9,2005,241500,31,31,0,0
10,2005,241500,24,24,0,0
11,2005,241500,16,16,0,1
12,2005,241500,29,28,1,1
1,2006,241500,26,25,1,0
2,2006,241500,18,17,1,1
3,2006,241500,25,25,0,0
4,2006,241500,19,18,1,0
5,2006,241500,23,23,0,1
6,2006,241500,27,27,0,1
7,2006,241500,29,28,1,0
8,2006,241500,38,37,1,0
9,2006,241500,27,25,2,0
10,2006,241500,21,21,0,0
11,2006,241500,24,24,0,2
12,2006,241500,22,21,1,1
1,2007,241500,26,24,2,0
2,2007,241500,12,12,0,1
3,2007,241500,24,24,0,0
4,2007,241500,13,11,2,0
5,2007,241500,27,26,1,0
6,2007,241500,19,18,1,1
7,2007,241500,26,25,1,2
8,2007,241500,25,21,4,2
9,2007,241500,26,26,0,0
10,2007,241500,29,29,0,1
11,2007,241500,21,20,1,0
12,2007,241500,30,29,1,0
1,2008,241500,29,29,0,0
2,2008,241500,21,20,1,1
3,2008,241500,18,16,2,2
4,2008,241500,19,19,0,2
5,2008,241500,27,26,1,4
6,2008,241500,39,38,1,0
7,2008,241500,19,18,1,0
8,2008,241500,31,31,0,2
9,2008,241500,22,21,1,0
10,2008,241500,27,27,0,0
11,2008,241500,35,35,0,1
12,2008,241500,23,21,2,1
1,2009,241500,24,22,2,2
2,2009,241500,18,18,0,1
3,2009,241500,16,14,2,1
4,2009,241500,26,25,1,0
5,2009,241500,21,21,0,0
6,2009,241500,18,18,0,1
7,2009,241500,25,25,0,1
8,2009,241500,27,26,1,1
9,2009,241500,31,30,1,0
10,2009,241500,23,22,1,0
11,2009,241500,22,21,1,1
12,2009,241500,18,18,0,1
1,2010,241500,16,15,1,1
2,2010,241500,21,20,1,2
3,2010,241500,21,21,0,1
4,2010,241500,15,15,0,1
5,2010,241500,23,23,0,2
6,2010,241500,24,21,3,1
7,2010,241500,23,22,1,0
8,2010,241500,25,24,1,0
9,2010,241500,23,23,0,0
10,2010,241500,31,30,1,1
11,2010,241500,30,30,0,0
12,2010,241500,26,25,1,0
1,2011,241500,28,28,0,2
2,2011,241500,8,8,0,0
1,1999,241000,24,19,5,20
2,1999,241000,31,26,5,16
3,1999,241000,24,19,5,40
4,1999,241000,27,21,6,29
5,1999,241000,35,24,11,30
6,1999,241000,34,20,14,16
7,1999,241000,15,14,1,5
8,1999,241000,31,25,6,9
9,1999,241000,21,16,5,15
10,1999,241000,30,24,6,6
11,1999,241000,23,17,6,22
12,1999,241000,13,11,2,22
1,2000,241000,25,16,9,14
2,2000,241000,24,18,6,15
3,2000,241000,33,28,5,12
4,2000,241000,22,17,5,4
5,2000,241000,36,29,7,9
6,2000,241000,23,16,7,20
7,2000,241000,24,16,8,12
8,2000,241000,38,32,6,18
9,2000,241000,42,34,8,14
10,2000,241000,27,17,10,14
11,2000,241000,15,10,5,11
12,2000,241000,12,10,2,8
1,2001,241000,22,18,4,10
2,2001,241000,22,17,5,18
3,2001,241000,23,18,5,8
4,2001,241000,27,24,3,4
5,2001,241000,21,14,7,4
6,2001,241000,30,18,12,9
7,2001,241000,28,21,7,9
8,2001,241000,24,19,5,9
9,2001,241000,25,21,4,6
10,2001,241000,24,18,6,7
11,2001,241000,21,19,2,6
12,2001,241000,23,17,6,4
1,2002,241000,22,15,7,10
2,2002,241000,19,15,4,7
3,2002,241000,12,12,0,7
4,2002,241000,22,20,2,8
5,2002,241000,22,15,7,13
6,2002,241000,20,16,4,9
7,2002,241000,48,42,6,3
8,2002,241000,37,30,7,1
9,2002,241000,39,34,5,8
10,2002,241000,26,21,5,3
11,2002,241000,24,20,4,1
12,2002,241000,20,16,4,6
1,2003,241000,26,23,3,4
2,2003,241000,12,9,3,19
3,2003,241000,22,19,3,15
4,2003,241000,26,21,5,23
5,2003,241000,23,20,3,8
6,2003,241000,27,20,7,28
7,2003,241000,43,38,5,9
8,2003,241000,37,28,9,14
9,2003,241000,28,25,3,15
10,2003,241000,24,20,4,8
11,2003,241000,26,22,4,9
12,2003,241000,13,10,3,17
1,2004,241000,25,23,2,12
2,2004,241000,14,11,3,26
3,2004,241000,16,16,0,6
4,2004,241000,21,17,4,27
5,2004,241000,28,25,3,4
6,2004,241000,26,19,7,18
7,2004,241000,29,26,3,6
8,2004,241000,26,21,5,10
9,2004,241000,18,17,1,9
10,2004,241000,17,14,3,16
11,2004,241000,22,18,4,16
12,2004,241000,21,20,1,19
1,2005,241000,17,13,4,7
2,2005,241000,17,14,3,5
3,2005,241000,12,9,3,10
4,2005,241000,23,19,4,11
5,2005,241000,19,17,2,8
6,2005,241000,31,26,5,7
7,2005,241000,28,24,4,16
8,2005,241000,22,18,4,8
9,2005,241000,18,17,1,8
10,2005,241000,22,20,2,16
11,2005,241000,29,25,4,14
12,2005,241000,17,16,1,4
1,2006,241000,22,14,8,16
2,2006,241000,16,13,3,6
3,2006,241000,27,22,5,12
4,2006,241000,16,12,4,16
5,2006,241000,18,13,5,7
6,2006,241000,17,13,4,21
7,2006,241000,24,20,4,18
8,2006,241000,27,25,2,8
9,2006,241000,21,16,5,12
10,2006,241000,15,14,1,5
11,2006,241000,28,24,4,19
12,2006,241000,23,19,4,14
1,2007,241000,21,17,4,9
2,2007,241000,12,12,0,5
3,2007,241000,20,17,3,12
4,2007,241000,14,12,2,7
5,2007,241000,21,17,4,12
6,2007,241000,19,16,3,13
7,2007,241000,25,22,3,7
8,2007,241000,40,34,6,9
9,2007,241000,26,25,1,7
10,2007,241000,17,13,4,9
11,2007,241000,20,18,2,3
12,2007,241000,19,19,0,6
1,2008,241000,19,16,3,12
2,2008,241000,14,13,1,7
3,2008,241000,21,17,4,11
4,2008,241000,8,6,2,14
5,2008,241000,28,27,1,11
6,2008,241000,19,17,2,18
7,2008,241000,34,30,4,11
8,2008,241000,32,29,3,21
9,2008,241000,25,18,7,9
10,2008,241000,26,25,1,9
11,2008,241000,27,26,1,4
12,2008,241000,20,18,2,3
1,2009,241000,23,18,5,2
2,2009,241000,12,11,1,8
3,2009,241000,30,29,1,6
4,2009,241000,26,20,6,15
5,2009,241000,15,14,1,4
6,2009,241000,20,13,7,8
7,2009,241000,25,22,3,7
8,2009,241000,21,20,1,13
9,2009,241000,20,18,2,12
10,2009,241000,19,16,3,10
11,2009,241000,12,10,2,11
12,2009,241000,14,14,0,4
1,2010,241000,14,12,2,7
2,2010,241000,18,17,1,6
3,2010,241000,17,16,1,9
4,2010,241000,22,21,1,8
5,2010,241000,16,15,1,14
6,2010,241000,25,23,2,15
7,2010,241000,21,20,1,10
8,2010,241000,23,19,4,13
9,2010,241000,28,22,6,6
10,2010,241000,20,19,1,12
11,2010,241000,27,23,4,6
12,2010,241000,19,19,0,4
1,2011,241000,18,17,1,7
2,2011,241000,10,10,0,3
1,1999,080201,10,10,0,0
2,1999,080201,6,6,0,0
3,1999,080201,11,11,0,0
4,1999,080201,5,5,0,0
5,1999,080201,5,5,0,0
6,1999,080201,10,10,0,0
7,1999,080201,14,13,1,0
8,1999,080201,5,5,0,0
9,1999,080201,7,7,0,0
10,1999,080201,5,5,0,0
11,1999,080201,7,6,1,0
12,1999,080201,8,8,0,0
1,2000,080201,9,9,0,0
2,2000,080201,5,5,0,0
3,2000,080201,10,9,1,1
4,2000,080201,8,8,0,0
5,2000,080201,11,11,0,0
6,2000,080201,4,4,0,0
7,2000,080201,6,6,0,2
8,2000,080201,20,20,0,0
9,2000,080201,9,8,1,0
10,2000,080201,12,12,0,0
11,2000,080201,11,11,0,0
12,2000,080201,10,9,1,1
1,2001,080201,5,5,0,0
2,2001,080201,2,2,0,0
3,2001,080201,6,6,0,1
4,2001,080201,7,6,1,0
5,2001,080201,10,10,0,1
6,2001,080201,5,5,0,0
7,2001,080201,5,5,0,0
8,2001,080201,3,3,0,0
9,2001,080201,10,9,1,0
10,2001,080201,8,8,0,1
11,2001,080201,8,8,0,0
12,2001,080201,6,6,0,0
1,2002,080201,3,3,0,0
2,2002,080201,9,9,0,1
3,2002,080201,2,2,0,0
4,2002,080201,4,4,0,0
5,2002,080201,5,4,1,0
6,2002,080201,15,14,1,0
7,2002,080201,6,6,0,0
8,2002,080201,9,9,0,0
9,2002,080201,4,4,0,0
10,2002,080201,6,6,0,0
11,2002,080201,7,7,0,0
12,2002,080201,6,6,0,0
1,2003,080201,9,9,0,0
2,2003,080201,3,3,0,0
3,2003,080201,4,4,0,0
4,2003,080201,9,9,0,0
5,2003,080201,4,4,0,0
6,2003,080201,10,10,0,0
7,2003,080201,12,12,0,0
8,2003,080201,5,5,0,0
9,2003,080201,7,7,0,0
10,2003,080201,6,6,0,0
11,2003,080201,6,6,0,0
12,2003,080201,7,7,0,0
1,2004,080201,10,10,0,0
2,2004,080201,2,2,0,0
3,2004,080201,6,6,0,0
4,2004,080201,3,3,0,0
5,2004,080201,5,5,0,0
6,2004,080201,7,7,0,0
7,2004,080201,8,8,0,0
8,2004,080201,10,10,0,0
9,2004,080201,4,4,0,1
10,2004,080201,7,7,0,0
11,2004,080201,7,7,0,0
12,2004,080201,6,6,0,0
1,2005,080201,6,6,0,0
2,2005,080201,4,3,1,0
3,2005,080201,1,1,0,0
4,2005,080201,3,3,0,0
5,2005,080201,5,5,0,1
6,2005,080201,8,8,0,0
7,2005,080201,6,6,0,0
8,2005,080201,8,8,0,0
9,2005,080201,6,6,0,1
10,2005,080201,7,7,0,0
11,2005,080201,8,7,1,0
12,2005,080201,7,6,1,0
1,2006,080201,5,5,0,0
2,2006,080201,7,6,1,0
3,2006,080201,7,7,0,0
4,2006,080201,5,5,0,2
5,2006,080201,15,13,2,0
6,2006,080201,4,2,2,0
7,2006,080201,9,9,0,0
8,2006,080201,6,6,0,0
9,2006,080201,3,3,0,1
10,2006,080201,2,2,0,0
11,2006,080201,3,3,0,0
12,2006,080201,7,7,0,0
1,2007,080201,5,5,0,0
2,2007,080201,1,1,0,0
3,2007,080201,7,7,0,0
4,2007,080201,4,4,0,1
5,2007,080201,5,5,0,0
6,2007,080201,5,5,0,0
7,2007,080201,13,12,1,0
8,2007,080201,8,8,0,0
9,2007,080201,8,8,0,0
10,2007,080201,6,5,1,1
11,2007,080201,3,3,0,0
12,2007,080201,5,5,0,0
1,2008,080201,3,3,0,0
2,2008,080201,8,8,0,0
3,2008,080201,7,7,0,0
4,2008,080201,7,7,0,0
5,2008,080201,6,6,0,0
6,2008,080201,2,2,0,0
7,2008,080201,8,8,0,1
8,2008,080201,9,9,0,0
9,2008,080201,9,9,0,1
10,2008,080201,7,7,0,0
11,2008,080201,6,6,0,0
12,2008,080201,4,4,0,0
1,2009,080201,4,4,0,1
2,2009,080201,6,6,0,0
3,2009,080201,3,3,0,0
4,2009,080201,7,7,0,0
5,2009,080201,3,3,0,0
6,2009,080201,4,3,1,0
7,2009,080201,6,6,0,0
8,2009,080201,6,6,0,0
9,2009,080201,7,7,0,0
10,2009,080201,7,7,0,0
11,2009,080201,8,8,0,0
12,2009,080201,7,6,1,0
1,2010,080201,2,2,0,0
2,2010,080201,1,1,0,2
3,2010,080201,8,8,0,0
4,2010,080201,4,4,0,0
5,2010,080201,9,9,0,0
6,2010,080201,6,6,0,0
7,2010,080201,3,3,0,0
8,2010,080201,4,4,0,0
9,2010,080201,7,7,0,0
10,2010,080201,7,7,0,0
11,2010,080201,9,9,0,0
12,2010,080201,3,3,0,0
1,2011,080201,4,4,0,0
2,2011,080201,2,2,0,0
1,1999,250500,17,15,2,0
2,1999,250500,12,12,0,0
3,1999,250500,18,17,1,1
4,1999,250500,21,20,1,0
5,1999,250500,18,16,2,0
6,1999,250500,24,23,1,0
7,1999,250500,18,13,5,1
8,1999,250500,34,30,4,0
9,1999,250500,18,16,2,1
10,1999,250500,17,15,2,0
11,1999,250500,12,11,1,1
12,1999,250500,14,14,0,0
1,2000,250500,8,8,0,1
2,2000,250500,7,7,0,0
3,2000,250500,9,8,1,1
4,2000,250500,21,20,1,1
5,2000,250500,16,16,0,0
6,2000,250500,23,21,2,0
7,2000,250500,14,13,1,0
8,2000,250500,10,10,0,0
9,2000,250500,8,6,2,0
10,2000,250500,9,9,0,2
11,2000,250500,17,14,3,1
12,2000,250500,10,9,1,0
1,2001,250500,5,5,0,1
2,2001,250500,12,12,0,1
3,2001,250500,11,10,1,0
4,2001,250500,8,7,1,0
5,2001,250500,17,17,0,0
6,2001,250500,12,12,0,0
7,2001,250500,12,11,1,1
8,2001,250500,19,17,2,3
9,2001,250500,18,17,1,1
10,2001,250500,29,29,0,0
11,2001,250500,18,18,0,0
12,2001,250500,10,10,0,2
1,2002,250500,11,9,2,1
2,2002,250500,16,16,0,1
3,2002,250500,11,11,0,0
4,2002,250500,6,6,0,0
5,2002,250500,12,9,3,0
6,2002,250500,15,14,1,1
7,2002,250500,14,11,3,0
8,2002,250500,19,19,0,0
9,2002,250500,13,13,0,2
10,2002,250500,14,13,1,0
11,2002,250500,14,14,0,0
12,2002,250500,9,9,0,0
1,2003,250500,21,21,0,0
2,2003,250500,9,9,0,0
3,2003,250500,17,15,2,0
4,2003,250500,19,18,1,0
5,2003,250500,11,10,1,0
6,2003,250500,15,15,0,0
7,2003,250500,20,20,0,0
8,2003,250500,23,20,3,1
9,2003,250500,20,19,1,2
10,2003,250500,32,32,0,0
11,2003,250500,10,10,0,0
12,2003,250500,15,13,2,0
1,2004,250500,11,9,2,1
2,2004,250500,7,6,1,1
3,2004,250500,13,13,0,0
4,2004,250500,9,8,1,0
5,2004,250500,10,8,2,1
6,2004,250500,12,11,1,0
7,2004,250500,18,18,0,0
8,2004,250500,22,22,0,0
9,2004,250500,15,15,0,3
10,2004,250500,12,12,0,1
11,2004,250500,20,20,0,1
12,2004,250500,12,11,1,0
1,2005,250500,17,16,1,0
2,2005,250500,8,7,1,1
3,2005,250500,9,8,1,1
4,2005,250500,5,5,0,0
5,2005,250500,11,11,0,1
6,2005,250500,9,9,0,0
7,2005,250500,16,16,0,1
8,2005,250500,12,12,0,0
9,2005,250500,8,8,0,0
10,2005,250500,14,14,0,0
11,2005,250500,9,9,0,0
12,2005,250500,7,7,0,0
1,2006,250500,11,11,0,0
2,2006,250500,32,31,1,0
3,2006,250500,16,16,0,0
4,2006,250500,8,8,0,0
5,2006,250500,9,9,0,0
6,2006,250500,9,9,0,0
7,2006,250500,16,13,3,0
8,2006,250500,11,10,1,0
9,2006,250500,19,18,1,1
10,2006,250500,15,14,1,0
11,2006,250500,7,7,0,2
12,2006,250500,8,8,0,1
1,2007,250500,6,6,0,0
2,2007,250500,6,6,0,1
3,2007,250500,6,5,1,0
4,2007,250500,8,8,0,2
5,2007,250500,12,12,0,0
6,2007,250500,17,17,0,0
7,2007,250500,13,11,2,0
8,2007,250500,11,11,0,0
9,2007,250500,16,15,1,0
10,2007,250500,11,10,1,0
11,2007,250500,10,10,0,0
12,2007,250500,9,7,2,1
1,2008,250500,6,6,0,1
2,2008,250500,9,9,0,0
3,2008,250500,15,12,3,3
4,2008,250500,11,11,0,0
5,2008,250500,17,17,0,0
6,2008,250500,11,11,0,3
7,2008,250500,27,27,0,0
8,2008,250500,12,11,1,1
9,2008,250500,8,6,2,1
10,2008,250500,8,8,0,0
11,2008,250500,11,11,0,0
12,2008,250500,8,7,1,1
1,2009,250500,7,7,0,0
2,2009,250500,4,3,1,0
3,2009,250500,9,9,0,2
4,2009,250500,11,11,0,0
5,2009,250500,9,8,1,0
6,2009,250500,10,10,0,2
7,2009,250500,11,11,0,0
8,2009,250500,8,8,0,0
9,2009,250500,11,11,0,0
10,2009,250500,15,15,0,2
11,2009,250500,8,8,0,1
12,2009,250500,11,9,2,0
1,2010,250500,14,14,0,2
2,2010,250500,5,5,0,0
3,2010,250500,12,12,0,0
4,2010,250500,19,16,3,3
5,2010,250500,10,9,1,2
6,2010,250500,9,9,0,0
7,2010,250500,7,7,0,3
8,2010,250500,14,14,0,2
9,2010,250500,12,12,0,2
10,2010,250500,15,11,4,0
11,2010,250500,8,8,0,0
12,2010,250500,7,7,0,0
1,2011,250500,8,8,0,2
2,2011,250500,1,1,0,0
1,1999,250400,17,15,2,6
2,1999,250400,28,26,2,8
3,1999,250400,15,13,2,12
4,1999,250400,17,12,5,12
5,1999,250400,23,16,7,7
6,1999,250400,24,20,4,5
7,1999,250400,16,15,1,3
8,1999,250400,28,26,2,8
9,1999,250400,33,29,4,7
10,1999,250400,29,24,5,4
11,1999,250400,19,17,2,12
12,1999,250400,21,20,1,5
1,2000,250400,22,22,0,6
2,2000,250400,19,16,3,3
3,2000,250400,21,17,4,4
4,2000,250400,16,16,0,8
5,2000,250400,21,19,2,7
6,2000,250400,25,22,3,7
7,2000,250400,12,11,1,7
8,2000,250400,20,17,3,11
9,2000,250400,25,23,2,18
10,2000,250400,23,18,5,8
11,2000,250400,16,13,3,12
12,2000,250400,17,13,4,6
1,2001,250400,12,11,1,11
2,2001,250400,18,18,0,2
3,2001,250400,16,11,5,5
4,2001,250400,20,15,5,6
5,2001,250400,21,18,3,7
6,2001,250400,23,17,6,10
7,2001,250400,35,25,10,19
8,2001,250400,27,17,10,14
9,2001,250400,44,43,1,12
10,2001,250400,45,43,2,12
11,2001,250400,31,27,4,21
12,2001,250400,26,24,2,17
1,2002,250400,24,18,6,25
2,2002,250400,16,16,0,8
3,2002,250400,15,13,2,9
4,2002,250400,15,12,3,9
5,2002,250400,21,18,3,15
6,2002,250400,21,17,4,46
7,2002,250400,13,12,1,7
8,2002,250400,18,13,5,4
9,2002,250400,16,15,1,9
10,2002,250400,19,18,1,9
11,2002,250400,18,17,1,14
12,2002,250400,20,18,2,8
1,2003,250400,22,20,2,9
2,2003,250400,16,14,2,11
3,2003,250400,22,19,3,8
4,2003,250400,19,13,6,9
5,2003,250400,23,21,2,4
6,2003,250400,22,17,5,5
7,2003,250400,23,22,1,12
8,2003,250400,17,14,3,2
9,2003,250400,17,15,2,10
10,2003,250400,21,21,0,11
11,2003,250400,20,16,4,14
12,2003,250400,25,22,3,13
1,2004,250400,17,17,0,2
2,2004,250400,21,20,1,14
3,2004,250400,18,15,3,22
4,2004,250400,22,21,1,8
5,2004,250400,16,15,1,3
6,2004,250400,15,15,0,2
7,2004,250400,25,19,6,12
8,2004,250400,18,15,3,4
9,2004,250400,25,18,7,2
10,2004,250400,27,23,4,7
11,2004,250400,17,16,1,12
12,2004,250400,25,23,2,0
1,2005,250400,18,16,2,4
2,2005,250400,15,14,1,9
3,2005,250400,20,16,4,9
4,2005,250400,29,26,3,9
5,2005,250400,24,22,2,9
6,2005,250400,23,20,3,14
7,2005,250400,23,21,2,8
8,2005,250400,24,23,1,13
9,2005,250400,26,24,2,9
10,2005,250400,16,13,3,7
11,2005,250400,20,20,0,5
12,2005,250400,21,20,1,8
1,2006,250400,16,13,3,6
2,2006,250400,14,12,2,9
3,2006,250400,18,16,2,5
4,2006,250400,20,15,5,3
5,2006,250400,17,14,3,14
6,2006,250400,17,17,0,9
7,2006,250400,20,16,4,1
8,2006,250400,15,14,1,6
9,2006,250400,20,19,1,4
10,2006,250400,17,17,0,2
11,2006,250400,14,13,1,0
12,2006,250400,13,9,4,4
1,2007,250400,16,12,4,3
2,2007,250400,12,11,1,3
3,2007,250400,14,14,0,6
4,2007,250400,20,15,5,5
5,2007,250400,18,14,4,1
6,2007,250400,19,18,1,4
7,2007,250400,17,15,2,3
8,2007,250400,17,17,0,3
9,2007,250400,19,15,4,1
10,2007,250400,13,9,4,3
11,2007,250400,14,13,1,6
12,2007,250400,15,13,2,3
1,2008,250400,16,14,2,0
2,2008,250400,13,9,4,2
3,2008,250400,17,14,3,6
4,2008,250400,24,24,0,2
5,2008,250400,18,14,4,12
6,2008,250400,20,16,4,3
7,2008,250400,26,21,5,6
8,2008,250400,19,14,5,9
9,2008,250400,17,14,3,3
10,2008,250400,14,12,2,5
11,2008,250400,16,13,3,4
12,2008,250400,16,15,1,0
1,2009,250400,15,12,3,1
2,2009,250400,13,13,0,3
3,2009,250400,17,12,5,2
4,2009,250400,16,13,3,2
5,2009,250400,18,16,2,2
6,2009,250400,18,15,3,5
7,2009,250400,16,15,1,3
8,2009,250400,14,14,0,6
9,2009,250400,17,14,3,4
10,2009,250400,15,13,2,10
11,2009,250400,14,12,2,6
12,2009,250400,15,12,3,10
1,2010,250400,9,9,0,4
2,2010,250400,17,16,1,3
3,2010,250400,21,21,0,9
4,2010,250400,14,13,1,9
5,2010,250400,18,18,0,6
6,2010,250400,20,15,5,4
7,2010,250400,21,21,0,7
8,2010,250400,21,20,1,6
9,2010,250400,12,11,1,8
10,2010,250400,13,13,0,10
11,2010,250400,20,19,1,4
12,2010,250400,21,20,1,4
1,2011,250400,13,12,1,5
2,2011,250400,4,4,0,1
1,1999,250300,18,14,4,2
2,1999,250300,14,10,4,2
3,1999,250300,15,13,2,1
4,1999,250300,12,10,2,1
5,1999,250300,11,8,3,3
6,1999,250300,16,14,2,1
7,1999,250300,25,21,4,4
8,1999,250300,20,13,7,2
9,1999,250300,16,13,3,6
10,1999,250300,19,14,5,1
11,1999,250300,9,8,1,3
12,1999,250300,14,14,0,2
1,2000,250300,9,7,2,4
2,2000,250300,8,5,3,6
3,2000,250300,21,12,9,3
4,2000,250300,18,11,7,2
5,2000,250300,21,16,5,2
6,2000,250300,20,16,4,4
7,2000,250300,22,15,7,4
8,2000,250300,16,14,2,4
9,2000,250300,21,18,3,2
10,2000,250300,23,20,3,0
11,2000,250300,22,17,5,5
12,2000,250300,18,12,6,1
1,2001,250300,17,15,2,12
2,2001,250300,15,11,4,1
3,2001,250300,9,9,0,12
4,2001,250300,15,13,2,2
5,2001,250300,13,12,1,2
6,2001,250300,18,16,2,5
7,2001,250300,16,15,1,4
8,2001,250300,23,18,5,10
9,2001,250300,11,9,2,7
10,2001,250300,16,14,2,5
11,2001,250300,16,13,3,9
12,2001,250300,15,13,2,10
1,2002,250300,15,14,1,2
2,2002,250300,16,13,3,6
3,2002,250300,18,9,9,11
4,2002,250300,15,11,4,7
5,2002,250300,12,9,3,9
6,2002,250300,11,8,3,5
7,2002,250300,21,17,4,3
8,2002,250300,9,7,2,6
9,2002,250300,16,14,2,5
10,2002,250300,12,7,5,7
11,2002,250300,8,8,0,7
12,2002,250300,12,9,3,6
1,2003,250300,18,10,8,3
2,2003,250300,13,12,1,12
3,2003,250300,11,7,4,7
4,2003,250300,14,13,1,2
5,2003,250300,10,8,2,6
6,2003,250300,16,14,2,7
7,2003,250300,19,14,5,5
8,2003,250300,17,14,3,5
9,2003,250300,16,11,5,12
10,2003,250300,9,9,0,4
11,2003,250300,12,12,0,5
12,2003,250300,12,12,0,7
1,2004,250300,16,13,3,7
2,2004,250300,16,12,4,5
3,2004,250300,16,9,7,6
4,2004,250300,12,12,0,6
5,2004,250300,13,13,0,4
6,2004,250300,13,11,2,2
7,2004,250300,14,13,1,8
8,2004,250300,14,13,1,6
9,2004,250300,11,9,2,2
10,2004,250300,22,15,7,4
11,2004,250300,18,16,2,15
12,2004,250300,7,6,1,2
1,2005,250300,16,16,0,4
2,2005,250300,4,3,1,1
3,2005,250300,13,12,1,1
4,2005,250300,15,14,1,10
5,2005,250300,13,10,3,2
6,2005,250300,12,10,2,2
7,2005,250300,17,13,4,2
8,2005,250300,16,14,2,4
9,2005,250300,11,6,5,7
10,2005,250300,15,10,5,3
11,2005,250300,7,5,2,2
12,2005,250300,13,10,3,5
1,2006,250300,8,7,1,2
2,2006,250300,8,5,3,1
3,2006,250300,15,13,2,1
4,2006,250300,11,9,2,1
5,2006,250300,12,10,2,4
6,2006,250300,12,8,4,9
7,2006,250300,17,13,4,5
8,2006,250300,11,9,2,7
9,2006,250300,9,8,1,6
10,2006,250300,10,8,2,1
11,2006,250300,21,16,5,3
12,2006,250300,12,10,2,5
1,2007,250300,15,13,2,5
2,2007,250300,6,5,1,4
3,2007,250300,16,10,6,7
4,2007,250300,7,7,0,7
5,2007,250300,15,14,1,5
6,2007,250300,19,16,3,4
7,2007,250300,15,9,6,3
8,2007,250300,19,16,3,4
9,2007,250300,10,10,0,1
10,2007,250300,13,12,1,3
11,2007,250300,12,10,2,3
12,2007,250300,16,13,3,0
1,2008,250300,18,18,0,5
2,2008,250300,11,8,3,1
3,2008,250300,11,8,3,9
4,2008,250300,16,12,4,5
5,2008,250300,17,12,5,6
6,2008,250300,10,7,3,1
7,2008,250300,18,16,2,4
8,2008,250300,15,15,0,6
9,2008,250300,19,19,0,5
10,2008,250300,8,5,3,4
11,2008,250300,8,8,0,2
12,2008,250300,10,6,4,3
1,2009,250300,4,3,1,0
2,2009,250300,11,11,0,1
3,2009,250300,11,10,1,4
4,2009,250300,10,8,2,0
5,2009,250300,14,12,2,4
6,2009,250300,11,11,0,5
7,2009,250300,19,17,2,9
8,2009,250300,19,16,3,7
9,2009,250300,19,16,3,4
10,2009,250300,16,13,3,2
11,2009,250300,30,27,3,7
12,2009,250300,15,13,2,3
1,2010,250300,17,16,1,5
2,2010,250300,9,9,0,4
3,2010,250300,10,10,0,8
4,2010,250300,28,26,2,3
5,2010,250300,11,10,1,1
6,2010,250300,19,17,2,6
7,2010,250300,33,28,5,5
8,2010,250300,24,22,2,3
9,2010,250300,19,17,2,8
10,2010,250300,22,21,1,2
11,2010,250300,26,23,3,3
12,2010,250300,18,16,2,6
1,2011,250300,12,11,1,2
2,2011,250300,8,8,0,0
1,1999,230500,38,36,2,7
2,1999,230500,44,39,5,8
3,1999,230500,40,39,1,9
4,1999,230500,35,31,4,2
5,1999,230500,39,37,2,2
6,1999,230500,41,41,0,3
7,1999,230500,36,32,4,7
8,1999,230500,44,38,6,6
9,1999,230500,45,38,7,4
10,1999,230500,52,48,4,4
11,1999,230500,36,31,5,4
12,1999,230500,41,41,0,3
1,2000,230500,40,40,0,5
2,2000,230500,35,32,3,3
3,2000,230500,38,36,2,5
4,2000,230500,29,28,1,3
5,2000,230500,34,28,6,3
6,2000,230500,42,39,3,5
7,2000,230500,48,46,2,5
8,2000,230500,37,33,4,12
9,2000,230500,44,39,5,7
10,2000,230500,45,39,6,6
11,2000,230500,40,37,3,2
12,2000,230500,35,33,2,5
1,2001,230500,31,30,1,10
2,2001,230500,28,25,3,5
3,2001,230500,33,32,1,2
4,2001,230500,23,23,0,3
5,2001,230500,27,25,2,0
6,2001,230500,35,29,6,4
7,2001,230500,31,30,1,3
8,2001,230500,43,41,2,5
9,2001,230500,37,34,3,3
10,2001,230500,52,48,4,4
11,2001,230500,43,38,5,2
12,2001,230500,23,22,1,0
1,2002,230500,29,29,0,2
2,2002,230500,29,28,1,3
3,2002,230500,34,33,1,0
4,2002,230500,28,27,1,2
5,2002,230500,45,43,2,4
6,2002,230500,26,25,1,1
7,2002,230500,38,34,4,1
8,2002,230500,28,25,3,2
9,2002,230500,32,30,2,1
10,2002,230500,32,29,3,2
11,2002,230500,31,29,2,4
12,2002,230500,20,18,2,2
1,2003,230500,23,20,3,3
2,2003,230500,25,23,2,3
3,2003,230500,15,10,5,1
4,2003,230500,10,9,1,3
5,2003,230500,26,23,3,0
6,2003,230500,19,15,4,5
7,2003,230500,34,32,2,1
8,2003,230500,24,22,2,1
9,2003,230500,28,26,2,7
10,2003,230500,26,24,2,4
11,2003,230500,31,31,0,4
12,2003,230500,19,16,3,1
1,2004,230500,21,20,1,0
2,2004,230500,16,15,1,3
3,2004,230500,20,18,2,2
4,2004,230500,18,16,2,3
5,2004,230500,18,11,7,6
6,2004,230500,16,14,2,4
7,2004,230500,46,42,4,10
8,2004,230500,17,14,3,2
9,2004,230500,16,14,2,6
10,2004,230500,21,17,4,7
11,2004,230500,21,18,3,3
12,2004,230500,20,18,2,1
1,2005,230500,8,8,0,1
2,2005,230500,16,14,2,2
3,2005,230500,17,13,4,1
4,2005,230500,20,13,7,3
5,2005,230500,18,16,2,3
6,2005,230500,27,22,5,6
7,2005,230500,14,11,3,2
8,2005,230500,19,17,2,6
9,2005,230500,12,9,3,10
10,2005,230500,17,15,2,6
11,2005,230500,14,11,3,7
12,2005,230500,13,12,1,2
1,2006,230500,19,16,3,0
2,2006,230500,10,9,1,2
3,2006,230500,10,9,1,8
4,2006,230500,14,12,2,0
5,2006,230500,13,10,3,5
6,2006,230500,11,8,3,4
7,2006,230500,18,16,2,6
8,2006,230500,12,10,2,1
9,2006,230500,26,22,4,2
10,2006,230500,29,28,1,1
11,2006,230500,28,23,5,1
12,2006,230500,30,28,2,1
1,2007,230500,20,18,2,1
2,2007,230500,13,13,0,7
3,2007,230500,16,12,4,2
4,2007,230500,23,23,0,2
5,2007,230500,32,29,3,2
6,2007,230500,33,31,2,1
7,2007,230500,33,31,2,5
8,2007,230500,40,40,0,1
9,2007,230500,26,22,4,2
10,2007,230500,28,28,0,2
11,2007,230500,34,33,1,2
12,2007,230500,43,40,3,6
1,2008,230500,35,33,2,4
2,2008,230500,32,32,0,2
3,2008,230500,43,40,3,4
4,2008,230500,36,34,2,2
5,2008,230500,38,36,2,2
6,2008,230500,43,39,4,7
7,2008,230500,34,30,4,6
8,2008,230500,45,43,2,6
9,2008,230500,38,36,2,7
10,2008,230500,39,38,1,3
11,2008,230500,54,52,2,3
12,2008,230500,57,55,2,5
1,2009,230500,39,36,3,3
2,2009,230500,41,40,1,3
3,2009,230500,54,49,5,4
4,2009,230500,62,61,1,1
5,2009,230500,45,41,4,5
6,2009,230500,64,62,2,4
7,2009,230500,59,56,3,3
8,2009,230500,45,41,4,1
9,2009,230500,60,55,5,5
10,2009,230500,67,67,0,2
11,2009,230500,55,53,2,3
12,2009,230500,72,68,4,1
1,2010,230500,49,47,2,4
2,2010,230500,27,26,1,3
3,2010,230500,50,50,0,1
4,2010,230500,43,43,0,6
5,2010,230500,36,32,4,7
6,2010,230500,29,25,4,2
7,2010,230500,30,27,3,5
8,2010,230500,41,37,4,3
9,2010,230500,34,30,4,5
10,2010,230500,36,32,4,4
11,2010,230500,35,35,0,2
12,2010,230500,37,36,1,5
1,2011,230500,34,33,1,1
2,2011,230500,30,27,3,6
1,1999,230400,11,9,2,0
2,1999,230400,10,10,0,3
3,1999,230400,11,10,1,2
4,1999,230400,8,7,1,3
5,1999,230400,13,11,2,5
6,1999,230400,18,16,2,2
7,1999,230400,12,11,1,3
8,1999,230400,11,10,1,4
9,1999,230400,17,16,1,1
10,1999,230400,15,13,2,2
11,1999,230400,17,14,3,4
12,1999,230400,15,14,1,2
1,2000,230400,14,14,0,5
2,2000,230400,11,7,4,4
3,2000,230400,15,11,4,2
4,2000,230400,14,11,3,0
5,2000,230400,8,7,1,1
6,2000,230400,20,16,4,3
7,2000,230400,18,14,4,3
8,2000,230400,20,18,2,4
9,2000,230400,13,11,2,2
10,2000,230400,18,11,7,2
11,2000,230400,11,11,0,1
12,2000,230400,10,7,3,1
1,2001,230400,8,7,1,2
2,2001,230400,12,10,2,0
3,2001,230400,5,5,0,1
4,2001,230400,11,11,0,0
5,2001,230400,11,9,2,1
6,2001,230400,16,14,2,2
7,2001,230400,16,14,2,4
8,2001,230400,16,15,1,3
9,2001,230400,19,17,2,2
10,2001,230400,9,8,1,3
11,2001,230400,16,15,1,2
12,2001,230400,17,16,1,1
1,2002,230400,14,12,2,1
2,2002,230400,6,6,0,5
3,2002,230400,12,8,4,2
4,2002,230400,16,11,5,2
5,2002,230400,7,6,1,3
6,2002,230400,13,11,2,4
7,2002,230400,19,15,4,3
8,2002,230400,22,17,5,4
9,2002,230400,11,10,1,0
10,2002,230400,14,14,0,0
11,2002,230400,19,18,1,4
12,2002,230400,5,3,2,2
1,2003,230400,5,5,0,2
2,2003,230400,10,8,2,2
3,2003,230400,9,5,4,5
4,2003,230400,7,5,2,2
5,2003,230400,10,9,1,0
6,2003,230400,19,16,3,1
7,2003,230400,23,21,2,2
8,2003,230400,24,23,1,3
9,2003,230400,18,16,2,2
10,2003,230400,9,9,0,2
11,2003,230400,15,13,2,0
12,2003,230400,7,7,0,3
1,2004,230400,6,5,1,1
2,2004,230400,9,8,1,5
3,2004,230400,9,8,1,12
4,2004,230400,10,10,0,4
5,2004,230400,6,6,0,1
6,2004,230400,7,6,1,4
7,2004,230400,21,19,2,7
8,2004,230400,24,22,2,9
9,2004,230400,13,11,2,2
10,2004,230400,10,8,2,5
11,2004,230400,10,9,1,3
12,2004,230400,11,9,2,6
1,2005,230400,12,11,1,5
2,2005,230400,7,7,0,6
3,2005,230400,11,9,2,3
4,2005,230400,7,7,0,5
5,2005,230400,7,6,1,3
6,2005,230400,9,8,1,6
7,2005,230400,9,9,0,2
8,2005,230400,12,11,1,7
9,2005,230400,11,11,0,3
10,2005,230400,13,10,3,2
11,2005,230400,10,8,2,2
12,2005,230400,6,5,1,3
1,2006,230400,15,15,0,0
2,2006,230400,4,4,0,1
3,2006,230400,5,4,1,0
4,2006,230400,5,5,0,3
5,2006,230400,19,15,4,3
6,2006,230400,5,5,0,1
7,2006,230400,12,12,0,2
8,2006,230400,11,8,3,2
9,2006,230400,10,8,2,1
10,2006,230400,8,8,0,5
11,2006,230400,11,10,1,0
12,2006,230400,8,6,2,3
1,2007,230400,6,4,2,2
2,2007,230400,5,5,0,0
3,2007,230400,8,6,2,1
4,2007,230400,10,8,2,2
5,2007,230400,10,9,1,3
6,2007,230400,12,10,2,4
7,2007,230400,6,5,1,1
8,2007,230400,12,9,3,2
9,2007,230400,10,9,1,2
10,2007,230400,17,13,4,7
11,2007,230400,13,12,1,2
12,2007,230400,9,8,1,4
1,2008,230400,16,16,0,0
2,2008,230400,11,8,3,5
3,2008,230400,10,7,3,5
4,2008,230400,11,10,1,5
5,2008,230400,9,9,0,3
6,2008,230400,17,14,3,0
7,2008,230400,14,14,0,3
8,2008,230400,17,17,0,4
9,2008,230400,10,10,0,0
10,2008,230400,8,7,1,1
11,2008,230400,6,6,0,1
12,2008,230400,8,7,1,0
1,2009,230400,12,12,0,1
2,2009,230400,9,9,0,2
3,2009,230400,10,10,0,2
4,2009,230400,13,11,2,4
5,2009,230400,6,6,0,2
6,2009,230400,15,11,4,5
7,2009,230400,11,10,1,1
8,2009,230400,8,7,1,4
9,2009,230400,9,8,1,0
10,2009,230400,11,10,1,1
11,2009,230400,4,4,0,2
12,2009,230400,16,14,2,3
1,2010,230400,6,5,1,2
2,2010,230400,3,2,1,1
3,2010,230400,7,7,0,1
4,2010,230400,10,7,3,0
5,2010,230400,4,3,1,3
6,2010,230400,8,7,1,0
7,2010,230400,10,8,2,6
8,2010,230400,10,9,1,1
9,2010,230400,5,4,1,0
10,2010,230400,14,12,2,2
11,2010,230400,4,4,0,0
12,2010,230400,18,17,1,1
1,2011,230400,6,5,1,7
2,2011,230400,5,4,1,2
1,1999,230100,18,12,6,3
2,1999,230100,17,15,2,8
3,1999,230100,14,9,5,4
4,1999,230100,17,14,3,2
5,1999,230100,21,12,9,4
6,1999,230100,30,23,7,4
7,1999,230100,33,29,4,3
8,1999,230100,27,22,5,2
9,1999,230100,33,31,2,3
10,1999,230100,14,11,3,5
11,1999,230100,15,13,2,12
12,1999,230100,10,9,1,6
1,2000,230100,17,16,1,5
2,2000,230100,6,4,2,2
3,2000,230100,19,12,7,6
4,2000,230100,8,8,0,1
5,2000,230100,19,14,5,1
6,2000,230100,13,8,5,1
7,2000,230100,14,9,5,1
8,2000,230100,23,17,6,9
9,2000,230100,26,21,5,1
10,2000,230100,21,17,4,2
11,2000,230100,14,13,1,3
12,2000,230100,11,8,3,6
1,2001,230100,18,18,0,0
2,2001,230100,22,17,5,3
3,2001,230100,14,12,2,4
4,2001,230100,13,11,2,6
5,2001,230100,14,11,3,5
6,2001,230100,24,21,3,3
7,2001,230100,27,22,5,1
8,2001,230100,17,12,5,3
9,2001,230100,16,15,1,3
10,2001,230100,23,19,4,6
11,2001,230100,22,20,2,1
12,2001,230100,12,11,1,3
1,2002,230100,5,3,2,0
2,2002,230100,12,11,1,2
3,2002,230100,9,7,2,4
4,2002,230100,16,11,5,1
5,2002,230100,9,6,3,3
6,2002,230100,13,11,2,1
7,2002,230100,26,23,3,1
8,2002,230100,30,27,3,1
9,2002,230100,20,19,1,1
10,2002,230100,29,28,1,0
11,2002,230100,19,19,0,0
12,2002,230100,10,10,0,3
1,2003,230100,11,6,5,1
2,2003,230100,7,5,2,10
3,2003,230100,11,9,2,3
4,2003,230100,13,10,3,6
5,2003,230100,11,10,1,3
6,2003,230100,20,18,2,5
7,2003,230100,24,21,3,9
8,2003,230100,33,30,3,1
9,2003,230100,12,12,0,3
10,2003,230100,17,13,4,1
11,2003,230100,14,13,1,4
12,2003,230100,6,6,0,4
1,2004,230100,9,8,1,5
2,2004,230100,11,10,1,2
3,2004,230100,9,7,2,2
4,2004,230100,14,13,1,4
5,2004,230100,19,14,5,2
6,2004,230100,22,17,5,11
7,2004,230100,22,20,2,2
8,2004,230100,24,21,3,2
9,2004,230100,15,14,1,2
10,2004,230100,11,8,3,1
11,2004,230100,9,7,2,5
12,2004,230100,5,3,2,3
1,2005,230100,7,5,2,3
2,2005,230100,8,6,2,1
3,2005,230100,13,12,1,0
4,2005,230100,13,11,2,2
5,2005,230100,10,7,3,1
6,2005,230100,9,5,4,11
7,2005,230100,9,7,2,4
8,2005,230100,21,14,7,4
9,2005,230100,19,13,6,7
10,2005,230100,12,11,1,3
11,2005,230100,4,4,0,0
12,2005,230100,4,3,1,7
1,2006,230100,9,7,2,1
2,2006,230100,3,3,0,1
3,2006,230100,15,14,1,2
4,2006,230100,15,11,4,3
5,2006,230100,18,14,4,1
6,2006,230100,15,13,2,4
7,2006,230100,11,8,3,6
8,2006,230100,19,16,3,7
9,2006,230100,18,15,3,2
10,2006,230100,15,15,0,7
11,2006,230100,10,7,3,3
12,2006,230100,8,5,3,1
1,2007,230100,5,5,0,2
2,2007,230100,5,5,0,1
3,2007,230100,9,7,2,3
4,2007,230100,9,6,3,2
5,2007,230100,11,7,4,4
6,2007,230100,11,10,1,1
7,2007,230100,13,12,1,1
8,2007,230100,11,9,2,9
9,2007,230100,11,10,1,6
10,2007,230100,8,6,2,1
11,2007,230100,9,9,0,6
12,2007,230100,14,14,0,1
1,2008,230100,14,12,2,4
2,2008,230100,11,10,1,4
3,2008,230100,3,3,0,10
4,2008,230100,6,6,0,14
5,2008,230100,7,7,0,2
6,2008,230100,12,11,1,3
7,2008,230100,12,7,5,2
8,2008,230100,7,7,0,4
9,2008,230100,12,11,1,2
10,2008,230100,13,10,3,6
11,2008,230100,10,10,0,3
12,2008,230100,5,3,2,2
1,2009,230100,13,12,1,4
2,2009,230100,13,11,2,1
3,2009,230100,5,4,1,1
4,2009,230100,8,5,3,1
5,2009,230100,11,9,2,7
6,2009,230100,11,8,3,10
7,2009,230100,16,14,2,5
8,2009,230100,7,4,3,5
9,2009,230100,7,7,0,2
10,2009,230100,3,3,0,3
11,2009,230100,12,11,1,0
12,2009,230100,13,11,2,0
1,2010,230100,4,4,0,4
2,2010,230100,3,3,0,5
3,2010,230100,8,7,1,4
4,2010,230100,10,10,0,1
5,2010,230100,8,8,0,3
6,2010,230100,11,10,1,2
7,2010,230100,16,16,0,3
8,2010,230100,9,7,2,5
9,2010,230100,6,6,0,4
10,2010,230100,9,9,0,4
11,2010,230100,10,10,0,2
12,2010,230100,8,7,1,0
1,2011,230100,6,6,0,2
2,2011,230100,6,6,0,0
1,1999,230200,14,11,3,5
2,1999,230200,13,9,4,2
3,1999,230200,9,9,0,1
4,1999,230200,9,7,2,1
5,1999,230200,12,9,3,4
6,1999,230200,19,16,3,4
7,1999,230200,25,16,9,3
8,1999,230200,12,9,3,8
9,1999,230200,15,11,4,2
10,1999,230200,12,10,2,1
11,1999,230200,12,5,7,3
12,1999,230200,9,6,3,2
1,2000,230200,13,9,4,8
2,2000,230200,12,10,2,5
3,2000,230200,7,6,1,5
4,2000,230200,21,17,4,13
5,2000,230200,19,13,6,4
6,2000,230200,16,10,6,8
7,2000,230200,23,13,10,0
8,2000,230200,24,21,3,4
9,2000,230200,19,13,6,1
10,2000,230200,13,8,5,0
11,2000,230200,11,11,0,2
12,2000,230200,13,11,2,3
1,2001,230200,13,12,1,4
2,2001,230200,13,12,1,2
3,2001,230200,19,15,4,1
4,2001,230200,13,11,2,3
5,2001,230200,20,14,6,4
6,2001,230200,20,19,1,4
7,2001,230200,16,10,6,1
8,2001,230200,12,12,0,1
9,2001,230200,16,12,4,8
10,2001,230200,13,11,2,5
11,2001,230200,9,8,1,7
12,2001,230200,11,9,2,10
1,2002,230200,9,5,4,10
2,2002,230200,8,7,1,15
3,2002,230200,9,7,2,9
4,2002,230200,11,8,3,1
5,2002,230200,11,7,4,4
6,2002,230200,14,14,0,3
7,2002,230200,13,7,6,0
8,2002,230200,20,17,3,2
9,2002,230200,20,17,3,0
10,2002,230200,14,13,1,2
11,2002,230200,12,10,2,1
12,2002,230200,4,3,1,1
1,2003,230200,12,9,3,2
2,2003,230200,6,6,0,6
3,2003,230200,12,9,3,2
4,2003,230200,9,6,3,11
5,2003,230200,7,7,0,4
6,2003,230200,24,16,8,0
7,2003,230200,18,17,1,4
8,2003,230200,16,11,5,0
9,2003,230200,14,11,3,2
10,2003,230200,20,17,3,5
11,2003,230200,11,9,2,3
12,2003,230200,9,8,1,3
1,2004,230200,8,7,1,9
2,2004,230200,8,7,1,8
3,2004,230200,14,10,4,10
4,2004,230200,13,9,4,2
5,2004,230200,15,11,4,3
6,2004,230200,15,13,2,3
7,2004,230200,18,17,1,5
8,2004,230200,15,13,2,0
9,2004,230200,5,4,1,1
10,2004,230200,20,18,2,2
11,2004,230200,6,5,1,1
12,2004,230200,9,9,0,10
1,2005,230200,8,8,0,1
2,2005,230200,8,7,1,2
3,2005,230200,5,5,0,1
4,2005,230200,10,8,2,3
5,2005,230200,5,3,2,3
6,2005,230200,4,3,1,2
7,2005,230200,10,8,2,7
8,2005,230200,14,13,1,2
9,2005,230200,6,6,0,0
10,2005,230200,23,20,3,4
11,2005,230200,11,11,0,5
12,2005,230200,10,7,3,1
1,2006,230200,7,7,0,2
2,2006,230200,5,3,2,8
3,2006,230200,11,7,4,2
4,2006,230200,9,9,0,3
5,2006,230200,15,13,2,4
6,2006,230200,14,12,2,8
7,2006,230200,15,12,3,8
8,2006,230200,12,10,2,2
9,2006,230200,10,10,0,3
10,2006,230200,13,13,0,2
11,2006,230200,12,10,2,4
12,2006,230200,6,6,0,3
1,2007,230200,2,2,0,5
2,2007,230200,2,2,0,5
3,2007,230200,8,8,0,6
4,2007,230200,4,4,0,2
5,2007,230200,10,8,2,4
6,2007,230200,11,8,3,4
7,2007,230200,11,11,0,4
8,2007,230200,16,16,0,7
9,2007,230200,15,15,0,1
10,2007,230200,11,9,2,2
11,2007,230200,9,9,0,4
12,2007,230200,11,7,4,4
1,2008,230200,11,10,1,3
2,2008,230200,9,8,1,1
3,2008,230200,8,8,0,6
4,2008,230200,6,4,2,3
5,2008,230200,7,5,2,6
6,2008,230200,7,5,2,4
7,2008,230200,9,7,2,3
8,2008,230200,9,7,2,3
9,2008,230200,7,5,2,0
10,2008,230200,11,9,2,5
11,2008,230200,10,9,1,1
12,2008,230200,11,11,0,3
1,2009,230200,5,4,1,1
2,2009,230200,9,7,2,1
3,2009,230200,7,6,1,0
4,2009,230200,9,4,5,6
5,2009,230200,6,6,0,2
6,2009,230200,9,7,2,6
7,2009,230200,7,6,1,1
8,2009,230200,6,5,1,5
9,2009,230200,9,9,0,2
10,2009,230200,11,10,1,2
11,2009,230200,11,10,1,3
12,2009,230200,8,7,1,2
1,2010,230200,4,2,2,3
2,2010,230200,5,5,0,3
3,2010,230200,11,10,1,2
4,2010,230200,12,11,1,3
5,2010,230200,9,8,1,4
6,2010,230200,7,7,0,10
7,2010,230200,4,3,1,4
8,2010,230200,17,14,3,3
9,2010,230200,14,9,5,2
10,2010,230200,6,6,0,3
11,2010,230200,15,13,2,2
12,2010,230200,9,9,0,0
1,2011,230200,11,9,2,0
2,2011,230200,5,4,1,3
1,1999,240600,9,8,1,0
2,1999,240600,16,16,0,0
3,1999,240600,9,9,0,2
4,1999,240600,15,13,2,1
5,1999,240600,19,16,3,1
6,1999,240600,15,14,1,3
7,1999,240600,5,5,0,1
8,1999,240600,16,16,0,1
9,1999,240600,13,12,1,2
10,1999,240600,16,15,1,3
11,1999,240600,14,12,2,0
12,1999,240600,14,14,0,0
1,2000,240600,9,8,1,0
2,2000,240600,9,9,0,1
3,2000,240600,21,18,3,1
4,2000,240600,16,14,2,2
5,2000,240600,11,10,1,3
6,2000,240600,8,8,0,0
7,2000,240600,15,13,2,2
8,2000,240600,17,14,3,0
9,2000,240600,16,15,1,1
10,2000,240600,20,18,2,3
11,2000,240600,15,14,1,2
12,2000,240600,7,6,1,0
1,2001,240600,17,15,2,1
2,2001,240600,12,12,0,1
3,2001,240600,12,11,1,0
4,2001,240600,11,10,1,3
5,2001,240600,19,18,1,1
6,2001,240600,28,27,1,0
7,2001,240600,10,9,1,3
8,2001,240600,19,17,2,3
9,2001,240600,11,11,0,1
10,2001,240600,14,11,3,1
11,2001,240600,14,12,2,2
12,2001,240600,9,8,1,0
1,2002,240600,10,9,1,1
2,2002,240600,8,7,1,0
3,2002,240600,10,8,2,1
4,2002,240600,10,9,1,2
5,2002,240600,19,18,1,0
6,2002,240600,25,22,3,2
7,2002,240600,14,14,0,1
8,2002,240600,12,11,1,1
9,2002,240600,7,6,1,2
10,2002,240600,11,9,2,0
11,2002,240600,12,12,0,0
12,2002,240600,6,6,0,2
1,2003,240600,4,4,0,1
2,2003,240600,6,5,1,2
3,2003,240600,7,7,0,0
4,2003,240600,14,14,0,2
5,2003,240600,8,8,0,0
6,2003,240600,13,11,2,3
7,2003,240600,16,14,2,6
8,2003,240600,13,11,2,1
9,2003,240600,10,8,2,8
10,2003,240600,16,11,5,0
11,2003,240600,15,14,1,0
12,2003,240600,14,12,2,0
1,2004,240600,4,4,0,0
2,2004,240600,7,6,1,3
3,2004,240600,8,5,3,2
4,2004,240600,8,8,0,5
5,2004,240600,8,7,1,1
6,2004,240600,19,15,4,6
7,2004,240600,22,20,2,1
8,2004,240600,8,7,1,1
9,2004,240600,19,18,1,1
10,2004,240600,15,13,2,4
11,2004,240600,13,12,1,0
12,2004,240600,11,11,0,2
1,2005,240600,10,10,0,0
2,2005,240600,9,9,0,3
3,2005,240600,12,11,1,0
4,2005,240600,11,10,1,1
5,2005,240600,10,8,2,5
6,2005,240600,9,8,1,0
7,2005,240600,6,6,0,0
8,2005,240600,18,17,1,2
9,2005,240600,6,5,1,0
10,2005,240600,12,11,1,0
11,2005,240600,7,7,0,3
12,2005,240600,13,12,1,0
1,2006,240600,11,10,1,0
2,2006,240600,3,3,0,0
3,2006,240600,8,8,0,1
4,2006,240600,6,6,0,0
5,2006,240600,12,11,1,3
6,2006,240600,6,6,0,1
7,2006,240600,8,7,1,0
8,2006,240600,5,4,1,2
9,2006,240600,9,8,1,2
10,2006,240600,8,7,1,1
11,2006,240600,3,3,0,1
12,2006,240600,1,1,0,1
1,2007,240600,5,5,0,3
2,2007,240600,6,6,0,0
3,2007,240600,6,5,1,1
4,2007,240600,12,11,1,0
5,2007,240600,15,12,3,1
6,2007,240600,14,14,0,2
7,2007,240600,10,9,1,2
8,2007,240600,12,12,0,1
9,2007,240600,6,6,0,0
10,2007,240600,15,13,2,3
11,2007,240600,10,9,1,4
12,2007,240600,9,9,0,0
1,2008,240600,9,9,0,5
2,2008,240600,8,7,1,3
3,2008,240600,9,8,1,3
4,2008,240600,8,7,1,1
5,2008,240600,8,7,1,0
6,2008,240600,10,10,0,0
7,2008,240600,9,7,2,0
8,2008,240600,12,12,0,1
9,2008,240600,9,9,0,2
10,2008,240600,14,13,1,0
11,2008,240600,9,9,0,2
12,2008,240600,7,7,0,2
1,2009,240600,12,12,0,3
2,2009,240600,3,3,0,1
3,2009,240600,12,12,0,0
4,2009,240600,12,11,1,1
5,2009,240600,8,7,1,1
6,2009,240600,9,5,4,1
7,2009,240600,12,11,1,1
8,2009,240600,7,7,0,1
9,2009,240600,6,6,0,1
10,2009,240600,8,8,0,1
11,2009,240600,11,11,0,2
12,2009,240600,6,6,0,0
1,2010,240600,3,3,0,3
2,2010,240600,3,3,0,1
3,2010,240600,12,11,1,0
4,2010,240600,6,6,0,2
5,2010,240600,4,4,0,2
6,2010,240600,10,9,1,1
7,2010,240600,3,2,1,0
8,2010,240600,4,4,0,0
9,2010,240600,9,9,0,1
10,2010,240600,3,3,0,1
11,2010,240600,10,10,0,1
12,2010,240600,6,6,0,0
1,2011,240600,7,7,0,0
2,2011,240600,2,2,0,0
1,1999,240500,16,14,2,1
2,1999,240500,13,12,1,0
3,1999,240500,14,13,1,0
4,1999,240500,15,14,1,0
5,1999,240500,11,9,2,1
6,1999,240500,22,21,1,0
7,1999,240500,19,18,1,0
8,1999,240500,17,16,1,1
9,1999,240500,19,19,0,0
10,1999,240500,23,22,1,0
11,1999,240500,11,11,0,1
12,1999,240500,17,17,0,0
1,2000,240500,19,19,0,0
2,2000,240500,9,9,0,0
3,2000,240500,22,21,1,0
4,2000,240500,21,19,2,0
5,2000,240500,16,15,1,0
6,2000,240500,15,14,1,1
7,2000,240500,30,29,1,0
8,2000,240500,23,21,2,0
9,2000,240500,27,26,1,0
10,2000,240500,19,19,0,0
11,2000,240500,18,18,0,0
12,2000,240500,12,12,0,0
1,2001,240500,13,12,1,0
2,2001,240500,14,14,0,0
3,2001,240500,19,17,2,0
4,2001,240500,17,17,0,0
5,2001,240500,16,15,1,1
6,2001,240500,20,19,1,0
7,2001,240500,18,18,0,0
8,2001,240500,27,26,1,1
9,2001,240500,24,24,0,0
10,2001,240500,18,18,0,1
11,2001,240500,17,16,1,0
12,2001,240500,7,7,0,0
1,2002,240500,11,11,0,0
2,2002,240500,7,7,0,0
3,2002,240500,11,9,2,0
4,2002,240500,11,10,1,0
5,2002,240500,18,18,0,0
6,2002,240500,17,17,0,1
7,2002,240500,29,28,1,1
8,2002,240500,38,37,1,0
9,2002,240500,34,34,0,0
10,2002,240500,22,20,2,0
11,2002,240500,24,24,0,0
12,2002,240500,18,18,0,0
1,2003,240500,18,18,0,0
2,2003,240500,15,15,0,0
3,2003,240500,24,24,0,0
4,2003,240500,23,22,1,0
5,2003,240500,23,22,1,0
6,2003,240500,29,28,1,0
7,2003,240500,17,16,1,0
8,2003,240500,22,22,0,0
9,2003,240500,12,12,0,0
10,2003,240500,10,9,1,0
11,2003,240500,14,14,0,0
12,2003,240500,23,23,0,0
1,2004,240500,12,11,1,0
2,2004,240500,10,10,0,0
3,2004,240500,7,7,0,2
4,2004,240500,12,12,0,1
5,2004,240500,19,19,0,0
6,2004,240500,9,9,0,0
7,2004,240500,23,22,1,0
8,2004,240500,18,17,1,0
9,2004,240500,22,22,0,0
10,2004,240500,16,15,1,0
11,2004,240500,6,6,0,1
12,2004,240500,13,13,0,2
1,2005,240500,5,5,0,0
2,2005,240500,10,9,1,0
3,2005,240500,13,13,0,0
4,2005,240500,11,10,1,1
5,2005,240500,5,5,0,0
6,2005,240500,12,11,1,0
7,2005,240500,11,9,2,1
8,2005,240500,24,24,0,0
9,2005,240500,17,16,1,0
10,2005,240500,10,10,0,0
11,2005,240500,8,8,0,0
12,2005,240500,8,8,0,0
1,2006,240500,17,17,0,0
2,2006,240500,6,5,1,0
3,2006,240500,12,11,1,1
4,2006,240500,12,12,0,0
5,2006,240500,8,7,1,0
6,2006,240500,22,19,3,2
7,2006,240500,9,9,0,1
8,2006,240500,15,15,0,0
9,2006,240500,12,12,0,0
10,2006,240500,16,16,0,0
11,2006,240500,11,10,1,0
12,2006,240500,6,6,0,0
1,2007,240500,3,3,0,0
2,2007,240500,7,7,0,0
3,2007,240500,6,6,0,0
4,2007,240500,22,22,0,1
5,2007,240500,12,12,0,0
6,2007,240500,18,18,0,0
7,2007,240500,23,23,0,0
8,2007,240500,16,16,0,2
9,2007,240500,13,12,1,0
10,2007,240500,24,23,1,1
11,2007,240500,12,12,0,0
12,2007,240500,10,10,0,0
1,2008,240500,18,17,1,0
2,2008,240500,11,10,1,0
3,2008,240500,10,10,0,0
4,2008,240500,19,19,0,0
5,2008,240500,8,8,0,0
6,2008,240500,17,16,1,1
7,2008,240500,17,17,0,1
8,2008,240500,18,17,1,3
9,2008,240500,23,23,0,2
10,2008,240500,31,31,0,0
11,2008,240500,27,27,0,0
12,2008,240500,7,7,0,0
1,2009,240500,2,2,0,0
2,2009,240500,8,7,1,0
3,2009,240500,9,9,0,0
4,2009,240500,14,13,1,0
5,2009,240500,9,9,0,0
6,2009,240500,12,12,0,0
7,2009,240500,18,17,1,0
8,2009,240500,20,20,0,0
9,2009,240500,16,16,0,0
10,2009,240500,23,22,1,0
11,2009,240500,11,11,0,1
12,2009,240500,8,8,0,0
1,2010,240500,11,11,0,0
2,2010,240500,4,4,0,1
3,2010,240500,7,7,0,1
4,2010,240500,10,10,0,1
5,2010,240500,7,7,0,0
6,2010,240500,15,15,0,0
7,2010,240500,15,15,0,0
8,2010,240500,16,15,1,0
9,2010,240500,13,12,1,0
10,2010,240500,10,9,1,1
11,2010,240500,11,11,0,0
12,2010,240500,9,9,0,0
1,2011,240500,8,8,0,2
2,2011,240500,5,5,0,0
1,1999,250200,6,5,1,1
2,1999,250200,3,2,1,2
3,1999,250200,14,14,0,0
4,1999,250200,11,11,0,2
5,1999,250200,11,9,2,1
6,1999,250200,8,6,2,1
7,1999,250200,12,11,1,2
8,1999,250200,9,9,0,5
9,1999,250200,11,9,2,2
10,1999,250200,16,13,3,1
11,1999,250200,6,5,1,4
12,1999,250200,5,5,0,2
1,2000,250200,7,6,1,1
2,2000,250200,5,5,0,3
3,2000,250200,9,8,1,7
4,2000,250200,7,7,0,3
5,2000,250200,5,3,2,8
6,2000,250200,12,10,2,6
7,2000,250200,12,11,1,4
8,2000,250200,5,4,1,7
9,2000,250200,8,5,3,5
10,2000,250200,3,2,1,4
11,2000,250200,11,9,2,1
12,2000,250200,9,7,2,2
1,2001,250200,8,7,1,4
2,2001,250200,8,8,0,0
3,2001,250200,6,3,3,3
4,2001,250200,8,7,1,1
5,2001,250200,5,4,1,4
6,2001,250200,3,2,1,3
7,2001,250200,13,9,4,3
8,2001,250200,9,7,2,5
9,2001,250200,15,11,4,1
10,2001,250200,10,7,3,2
11,2001,250200,17,14,3,5
12,2001,250200,7,6,1,6
1,2002,250200,6,6,0,12
2,2002,250200,4,4,0,9
3,2002,250200,3,2,1,13
4,2002,250200,1,1,0,9
5,2002,250200,8,7,1,10
6,2002,250200,13,10,3,9
7,2002,250200,16,14,2,3
8,2002,250200,6,6,0,7
9,2002,250200,7,5,2,5
10,2002,250200,9,8,1,3
11,2002,250200,6,5,1,19
12,2002,250200,10,10,0,20
1,2003,250200,7,7,0,12
2,2003,250200,6,6,0,3
3,2003,250200,2,2,0,6
4,2003,250200,5,4,1,8
5,2003,250200,12,11,1,5
6,2003,250200,2,1,1,6
7,2003,250200,11,9,2,9
8,2003,250200,10,8,2,14
9,2003,250200,13,13,0,11
10,2003,250200,15,12,3,5
11,2003,250200,14,13,1,2
12,2003,250200,6,6,0,3
1,2004,250200,9,8,1,2
2,2004,250200,4,2,2,6
3,2004,250200,8,8,0,5
4,2004,250200,3,2,1,1
5,2004,250200,4,4,0,6
6,2004,250200,3,3,0,3
7,2004,250200,7,7,0,0
8,2004,250200,8,6,2,5
9,2004,250200,7,5,2,3
10,2004,250200,4,2,2,4
11,2004,250200,6,6,0,6
12,2004,250200,3,1,2,2
1,2005,250200,5,5,0,3
2,2005,250200,3,3,0,4
3,2005,250200,5,5,0,17
4,2005,250200,5,4,1,12
5,2005,250200,4,4,0,6
6,2005,250200,9,9,0,4
7,2005,250200,10,10,0,0
8,2005,250200,7,6,1,6
9,2005,250200,7,6,1,10
10,2005,250200,4,3,1,8
11,2005,250200,5,4,1,7
12,2005,250200,4,3,1,7
1,2006,250200,5,4,1,6
2,2006,250200,3,3,0,6
3,2006,250200,3,2,1,8
4,2006,250200,4,4,0,5
5,2006,250200,12,11,1,7
6,2006,250200,12,10,2,2
7,2006,250200,7,7,0,3
8,2006,250200,11,10,1,1
9,2006,250200,11,10,1,1
10,2006,250200,2,2,0,7
11,2006,250200,5,5,0,3
12,2006,250200,8,7,1,2
1,2007,250200,7,6,1,0
2,2007,250200,2,2,0,4
3,2007,250200,7,6,1,5
4,2007,250200,8,7,1,1
5,2007,250200,3,3,0,1
6,2007,250200,6,6,0,4
7,2007,250200,16,15,1,1
8,2007,250200,7,7,0,1
9,2007,250200,2,2,0,0
10,2007,250200,8,6,2,2
11,2007,250200,4,3,1,6
12,2007,250200,8,8,0,1
1,2008,250200,4,2,2,1
2,2008,250200,3,3,0,0
3,2008,250200,1,1,0,1
4,2008,250200,4,3,1,0
5,2008,250200,10,8,2,3
6,2008,250200,5,3,2,1
7,2008,250200,8,7,1,0
8,2008,250200,4,4,0,4
9,2008,250200,6,6,0,0
10,2008,250200,10,10,0,6
11,2008,250200,8,8,0,3
12,2008,250200,8,8,0,1
1,2009,250200,5,4,1,0
2,2009,250200,8,6,2,0
3,2009,250200,6,4,2,3
4,2009,250200,6,5,1,1
5,2009,250200,8,8,0,4
6,2009,250200,9,9,0,4
7,2009,250200,13,11,2,2
8,2009,250200,9,9,0,0
9,2009,250200,7,7,0,2
10,2009,250200,12,11,1,4
11,2009,250200,2,2,0,2
12,2009,250200,2,1,1,1
1,2010,250200,6,6,0,5
2,2010,250200,4,2,2,3
3,2010,250200,7,5,2,4
4,2010,250200,8,5,3,1
5,2010,250200,10,10,0,1
6,2010,250200,14,9,5,2
7,2010,250200,8,7,1,6
8,2010,250200,8,8,0,2
9,2010,250200,6,5,1,3
10,2010,250200,10,9,1,2
11,2010,250200,4,4,0,2
12,2010,250200,14,13,1,2
1,2011,250200,7,6,1,0
2,2011,250200,7,6,1,1
1,1999,831000,26,25,1,0
2,1999,831000,26,26,0,2
3,1999,831000,21,21,0,0
4,1999,831000,36,36,0,0
5,1999,831000,29,28,1,0
6,1999,831000,39,39,0,1
7,1999,831000,38,34,4,0
8,1999,831000,37,37,0,0
9,1999,831000,31,31,0,1
10,1999,831000,39,37,2,0
11,1999,831000,34,34,0,0
12,1999,831000,31,30,1,1
1,2000,831000,27,27,0,0
2,2000,831000,18,18,0,0
3,2000,831000,23,22,1,2
4,2000,831000,35,35,0,0
5,2000,831000,41,39,2,2
6,2000,831000,28,28,0,0
7,2000,831000,28,26,2,2
8,2000,831000,34,33,1,3
9,2000,831000,45,42,3,2
10,2000,831000,46,44,2,1
11,2000,831000,35,34,1,1
12,2000,831000,22,21,1,0
1,2001,831000,25,25,0,0
2,2001,831000,18,15,3,0
3,2001,831000,25,23,2,0
4,2001,831000,21,20,1,0
5,2001,831000,39,37,2,1
6,2001,831000,21,20,1,0
7,2001,831000,47,43,4,1
8,2001,831000,44,43,1,2
9,2001,831000,32,32,0,0
10,2001,831000,33,31,2,0
11,2001,831000,38,38,0,1
12,2001,831000,21,19,2,0
1,2002,831000,28,27,1,0
2,2002,831000,17,15,2,0
3,2002,831000,22,21,1,0
4,2002,831000,30,29,1,0
5,2002,831000,36,33,3,1
6,2002,831000,32,31,1,0
7,2002,831000,34,33,1,1
8,2002,831000,33,33,0,0
9,2002,831000,34,34,0,1
10,2002,831000,39,37,2,3
11,2002,831000,18,17,1,0
12,2002,831000,40,40,0,0
1,2003,831000,30,30,0,0
2,2003,831000,35,35,0,1
3,2003,831000,35,35,0,0
4,2003,831000,34,33,1,0
5,2003,831000,27,26,1,0
6,2003,831000,28,25,3,0
7,2003,831000,22,22,0,0
8,2003,831000,32,31,1,0
9,2003,831000,27,27,0,1
10,2003,831000,18,18,0,0
11,2003,831000,21,20,1,2
12,2003,831000,36,36,0,0
1,2004,831000,15,15,0,0
2,2004,831000,21,20,1,2
3,2004,831000,17,16,1,0
4,2004,831000,27,27,0,1
5,2004,831000,19,17,2,1
6,2004,831000,24,23,1,2
7,2004,831000,21,21,0,2
8,2004,831000,32,32,0,1
9,2004,831000,28,27,1,1
10,2004,831000,22,21,1,0
11,2004,831000,20,19,1,1
12,2004,831000,20,19,1,0
1,2005,831000,18,18,0,0
2,2005,831000,9,9,0,0
3,2005,831000,12,12,0,0
4,2005,831000,26,26,0,1
5,2005,831000,21,20,1,0
6,2005,831000,25,23,2,1
7,2005,831000,17,17,0,0
8,2005,831000,18,18,0,0
9,2005,831000,23,22,1,0
10,2005,831000,19,19,0,0
11,2005,831000,23,23,0,0
12,2005,831000,35,35,0,0
1,2006,831000,27,26,1,0
2,2006,831000,22,20,2,0
3,2006,831000,25,25,0,0
4,2006,831000,25,23,2,1
5,2006,831000,24,22,2,0
6,2006,831000,23,23,0,0
7,2006,831000,35,35,0,0
8,2006,831000,33,33,0,2
9,2006,831000,25,25,0,0
10,2006,831000,21,21,0,0
11,2006,831000,30,29,1,0
12,2006,831000,21,20,1,1
1,2007,831000,22,22,0,0
2,2007,831000,10,10,0,0
3,2007,831000,15,15,0,0
4,2007,831000,19,19,0,1
5,2007,831000,20,20,0,0
6,2007,831000,25,25,0,1
7,2007,831000,28,27,1,0
8,2007,831000,26,25,1,0
9,2007,831000,17,17,0,2
10,2007,831000,37,37,0,1
11,2007,831000,26,26,0,0
12,2007,831000,26,26,0,0
1,2008,831000,26,26,0,1
2,2008,831000,18,18,0,0
3,2008,831000,23,20,3,1
4,2008,831000,23,21,2,1
5,2008,831000,26,24,2,0
6,2008,831000,28,28,0,1
7,2008,831000,24,23,1,1
8,2008,831000,19,19,0,1
9,2008,831000,24,23,1,0
10,2008,831000,30,30,0,1
11,2008,831000,38,36,2,1
12,2008,831000,25,25,0,1
1,2009,831000,20,18,2,0
2,2009,831000,22,21,1,1
3,2009,831000,20,20,0,0
4,2009,831000,18,18,0,0
5,2009,831000,28,28,0,0
6,2009,831000,12,12,0,0
7,2009,831000,27,27,0,3
8,2009,831000,21,19,2,1
9,2009,831000,20,20,0,1
10,2009,831000,23,23,0,2
11,2009,831000,20,19,1,0
12,2009,831000,21,21,0,0
1,2010,831000,19,18,1,0
2,2010,831000,15,14,1,0
3,2010,831000,23,23,0,1
4,2010,831000,22,22,0,0
5,2010,831000,34,34,0,0
6,2010,831000,18,18,0,0
7,2010,831000,23,23,0,0
8,2010,831000,34,33,1,1
9,2010,831000,29,29,0,0
10,2010,831000,25,25,0,1
11,2010,831000,15,15,0,2
12,2010,831000,22,21,1,0
1,2011,831000,25,25,0,2
2,2011,831000,11,10,1,0
1,1999,240300,10,8,2,0
2,1999,240300,17,16,1,1
3,1999,240300,13,11,2,0
4,1999,240300,16,16,0,2
5,1999,240300,12,11,1,0
6,1999,240300,11,11,0,0
7,1999,240300,11,11,0,0
8,1999,240300,18,18,0,0
9,1999,240300,10,9,1,0
10,1999,240300,15,14,1,0
11,1999,240300,11,11,0,0
12,1999,240300,21,19,2,1
1,2000,240300,9,9,0,0
2,2000,240300,7,6,1,1
3,2000,240300,6,6,0,1
4,2000,240300,21,20,1,1
5,2000,240300,15,15,0,0
6,2000,240300,18,16,2,0
7,2000,240300,10,10,0,0
8,2000,240300,14,14,0,0
9,2000,240300,8,7,1,1
10,2000,240300,16,15,1,1
11,2000,240300,9,8,1,0
12,2000,240300,14,12,2,0
1,2001,240300,14,14,0,1
2,2001,240300,13,12,1,0
3,2001,240300,13,12,1,3
4,2001,240300,13,13,0,0
5,2001,240300,10,9,1,0
6,2001,240300,16,15,1,3
7,2001,240300,22,19,3,1
8,2001,240300,15,14,1,4
9,2001,240300,16,14,2,0
10,2001,240300,15,14,1,0
11,2001,240300,20,19,1,0
12,2001,240300,14,14,0,0
1,2002,240300,15,14,1,0
2,2002,240300,16,16,0,0
3,2002,240300,11,11,0,0
4,2002,240300,7,7,0,0
5,2002,240300,10,10,0,0
6,2002,240300,13,12,1,0
7,2002,240300,16,15,1,0
8,2002,240300,17,16,1,0
9,2002,240300,22,21,1,0
10,2002,240300,21,19,2,0
11,2002,240300,18,18,0,1
12,2002,240300,17,17,0,0
1,2003,240300,14,14,0,0
2,2003,240300,11,11,0,0
3,2003,240300,4,4,0,0
4,2003,240300,9,9,0,0
5,2003,240300,10,10,0,0
6,2003,240300,12,11,1,0
7,2003,240300,11,11,0,1
8,2003,240300,19,18,1,0
9,2003,240300,9,8,1,0
10,2003,240300,12,11,1,0
11,2003,240300,12,10,2,1
12,2003,240300,17,16,1,1
1,2004,240300,10,10,0,0
2,2004,240300,4,4,0,0
3,2004,240300,4,4,0,0
4,2004,240300,11,11,0,2
5,2004,240300,8,8,0,0
6,2004,240300,7,7,0,0
7,2004,240300,10,10,0,0
8,2004,240300,19,18,1,0
9,2004,240300,13,13,0,1
10,2004,240300,20,19,1,2
11,2004,240300,11,11,0,1
12,2004,240300,9,9,0,2
1,2005,240300,4,4,0,1
2,2005,240300,9,8,1,0
3,2005,240300,3,3,0,0
4,2005,240300,7,7,0,0
5,2005,240300,10,10,0,0
6,2005,240300,11,10,1,0
7,2005,240300,4,4,0,0
8,2005,240300,6,6,0,0
9,2005,240300,13,13,0,0
10,2005,240300,7,7,0,0
11,2005,240300,11,11,0,0
12,2005,240300,9,8,1,0
1,2006,240300,10,10,0,0
2,2006,240300,5,5,0,1
3,2006,240300,7,6,1,1
4,2006,240300,13,13,0,0
5,2006,240300,13,13,0,1
6,2006,240300,7,7,0,0
7,2006,240300,18,16,2,0
8,2006,240300,13,12,1,0
9,2006,240300,7,7,0,0
10,2006,240300,8,8,0,0
11,2006,240300,11,11,0,1
12,2006,240300,13,13,0,0
1,2007,240300,12,11,1,0
2,2007,240300,12,12,0,2
3,2007,240300,12,11,1,0
4,2007,240300,10,9,1,0
5,2007,240300,8,8,0,0
6,2007,240300,7,7,0,0
7,2007,240300,8,8,0,2
8,2007,240300,17,17,0,0
9,2007,240300,15,14,1,0
10,2007,240300,18,16,2,0
11,2007,240300,12,12,0,0
12,2007,240300,13,13,0,0
1,2008,240300,13,12,1,0
2,2008,240300,10,9,1,1
3,2008,240300,9,8,1,2
4,2008,240300,15,15,0,0
5,2008,240300,9,8,1,0
6,2008,240300,8,6,2,0
7,2008,240300,13,13,0,0
8,2008,240300,9,9,0,1
9,2008,240300,7,7,0,1
10,2008,240300,15,15,0,0
11,2008,240300,6,5,1,2
12,2008,240300,10,10,0,0
1,2009,240300,5,4,1,0
2,2009,240300,10,10,0,0
3,2009,240300,16,14,2,0
4,2009,240300,13,10,3,1
5,2009,240300,10,10,0,0
6,2009,240300,7,7,0,0
7,2009,240300,9,9,0,0
8,2009,240300,12,11,1,0
9,2009,240300,7,7,0,0
10,2009,240300,12,12,0,2
11,2009,240300,10,10,0,0
12,2009,240300,8,8,0,0
1,2010,240300,5,5,0,1
2,2010,240300,4,4,0,0
3,2010,240300,12,11,1,0
4,2010,240300,12,12,0,0
5,2010,240300,14,14,0,1
6,2010,240300,13,13,0,0
7,2010,240300,14,14,0,0
8,2010,240300,13,13,0,0
9,2010,240300,6,6,0,0
10,2010,240300,8,8,0,0
11,2010,240300,8,7,1,1
12,2010,240300,8,8,0,0
1,2011,240300,10,10,0,0
2,2011,240300,3,3,0,0
1,1999,240200,13,12,1,1
2,1999,240200,18,17,1,0
3,1999,240200,13,13,0,1
4,1999,240200,19,19,0,0
5,1999,240200,24,23,1,1
6,1999,240200,17,15,2,4
7,1999,240200,15,13,2,1
8,1999,240200,12,12,0,0
9,1999,240200,24,22,2,0
10,1999,240200,21,20,1,1
11,1999,240200,14,14,0,0
12,1999,240200,16,14,2,0
1,2000,240200,21,18,3,0
2,2000,240200,5,5,0,0
3,2000,240200,11,10,1,1
4,2000,240200,12,10,2,0
5,2000,240200,23,21,2,1
6,2000,240200,21,19,2,1
7,2000,240200,24,21,3,4
8,2000,240200,25,23,2,2
9,2000,240200,21,20,1,1
10,2000,240200,14,14,0,1
11,2000,240200,17,17,0,0
12,2000,240200,10,10,0,0
1,2001,240200,10,10,0,0
2,2001,240200,5,5,0,0
3,2001,240200,13,12,1,1
4,2001,240200,18,16,2,2
5,2001,240200,15,14,1,0
6,2001,240200,18,15,3,1
7,2001,240200,19,19,0,3
8,2001,240200,18,17,1,1
9,2001,240200,22,16,6,2
10,2001,240200,25,23,2,0
11,2001,240200,18,17,1,1
12,2001,240200,13,12,1,0
1,2002,240200,16,15,1,3
2,2002,240200,15,14,1,0
3,2002,240200,12,12,0,0
4,2002,240200,9,9,0,2
5,2002,240200,12,11,1,0
6,2002,240200,19,18,1,1
7,2002,240200,21,19,2,0
8,2002,240200,19,18,1,0
9,2002,240200,17,15,2,0
10,2002,240200,19,18,1,3
11,2002,240200,29,28,1,2
12,2002,240200,32,32,0,0
1,2003,240200,12,11,1,2
2,2003,240200,15,12,3,1
3,2003,240200,16,16,0,0
4,2003,240200,11,10,1,1
5,2003,240200,12,12,0,1
6,2003,240200,23,20,3,1
7,2003,240200,18,16,2,0
8,2003,240200,17,17,0,0
9,2003,240200,8,8,0,0
10,2003,240200,9,9,0,0
11,2003,240200,14,14,0,0
12,2003,240200,18,16,2,1
1,2004,240200,13,13,0,1
2,2004,240200,7,7,0,1
3,2004,240200,10,10,0,1
4,2004,240200,9,8,1,1
5,2004,240200,9,8,1,0
6,2004,240200,16,14,2,0
7,2004,240200,17,17,0,0
8,2004,240200,22,22,0,2
9,2004,240200,14,12,2,0
10,2004,240200,12,12,0,0
11,2004,240200,8,7,1,1
12,2004,240200,11,10,1,0
1,2005,240200,6,6,0,0
2,2005,240200,2,2,0,1
3,2005,240200,11,10,1,0
4,2005,240200,10,10,0,0
5,2005,240200,12,11,1,0
6,2005,240200,11,9,2,1
7,2005,240200,8,8,0,0
8,2005,240200,13,13,0,0
9,2005,240200,15,15,0,1
10,2005,240200,18,15,3,0
11,2005,240200,12,11,1,0
12,2005,240200,9,9,0,1
1,2006,240200,13,13,0,0
2,2006,240200,10,9,1,1
3,2006,240200,9,9,0,0
4,2006,240200,11,10,1,1
5,2006,240200,13,12,1,0
6,2006,240200,11,11,0,1
7,2006,240200,15,14,1,1
8,2006,240200,13,13,0,1
9,2006,240200,7,6,1,0
10,2006,240200,17,17,0,0
11,2006,240200,12,12,0,0
12,2006,240200,13,13,0,0
1,2007,240200,11,10,1,0
2,2007,240200,4,4,0,0
3,2007,240200,8,8,0,1
4,2007,240200,9,9,0,0
5,2007,240200,9,9,0,1
6,2007,240200,10,10,0,0
7,2007,240200,20,20,0,0
8,2007,240200,19,19,0,0
9,2007,240200,8,7,1,0
10,2007,240200,22,21,1,1
11,2007,240200,18,18,0,0
12,2007,240200,15,15,0,0
1,2008,240200,14,13,1,2
2,2008,240200,7,7,0,0
3,2008,240200,14,14,0,1
4,2008,240200,11,11,0,0
5,2008,240200,11,10,1,0
6,2008,240200,13,13,0,3
7,2008,240200,14,12,2,2
8,2008,240200,18,18,0,1
9,2008,240200,22,21,1,1
10,2008,240200,12,11,1,0
11,2008,240200,22,21,1,0
12,2008,240200,16,15,1,1
1,2009,240200,4,3,1,1
2,2009,240200,10,9,1,1
3,2009,240200,11,11,0,1
4,2009,240200,15,15,0,0
5,2009,240200,16,14,2,1
6,2009,240200,9,8,1,0
7,2009,240200,11,10,1,0
8,2009,240200,7,7,0,0
9,2009,240200,12,11,1,1
10,2009,240200,8,8,0,1
11,2009,240200,10,9,1,0
12,2009,240200,8,8,0,0
1,2010,240200,10,10,0,0
2,2010,240200,4,4,0,1
3,2010,240200,12,12,0,0
4,2010,240200,16,16,0,0
5,2010,240200,12,12,0,0
6,2010,240200,16,16,0,0
7,2010,240200,12,11,1,1
8,2010,240200,20,20,0,2
9,2010,240200,14,14,0,1
10,2010,240200,18,17,1,0
11,2010,240200,11,10,1,0
12,2010,240200,11,11,0,0
1,2011,240200,13,12,1,0
2,2011,240200,13,13,0,0
1,1999,832600,47,47,0,1
2,1999,832600,54,54,0,3
3,1999,832600,83,82,1,2
4,1999,832600,55,55,0,0
5,1999,832600,60,58,2,4
6,1999,832600,85,84,1,0
7,1999,832600,88,87,1,0
8,1999,832600,70,70,0,0
9,1999,832600,62,61,1,1
10,1999,832600,56,55,1,3
11,1999,832600,66,64,2,0
12,1999,832600,58,54,4,3
1,2000,832600,56,56,0,2
2,2000,832600,39,38,1,4
3,2000,832600,60,59,1,4
4,2000,832600,50,48,2,2
5,2000,832600,45,42,3,0
6,2000,832600,55,55,0,2
7,2000,832600,44,43,1,0
8,2000,832600,61,61,0,1
9,2000,832600,84,83,1,5
10,2000,832600,80,80,0,4
11,2000,832600,53,52,1,4
12,2000,832600,35,33,2,2
1,2001,832600,36,36,0,5
2,2001,832600,24,23,1,3
3,2001,832600,45,45,0,3
4,2001,832600,29,25,4,0
5,2001,832600,48,48,0,4
6,2001,832600,27,26,1,2
7,2001,832600,43,42,1,5
8,2001,832600,45,44,1,0
9,2001,832600,45,45,0,1
10,2001,832600,55,52,3,3
11,2001,832600,41,41,0,5
12,2001,832600,42,40,2,0
1,2002,832600,52,50,2,2
2,2002,832600,36,33,3,1
3,2002,832600,26,25,1,2
4,2002,832600,30,30,0,2
5,2002,832600,45,42,3,3
6,2002,832600,38,36,2,5
7,2002,832600,65,64,1,2
8,2002,832600,49,48,1,4
9,2002,832600,48,45,3,2
10,2002,832600,49,48,1,0
11,2002,832600,33,33,0,1
12,2002,832600,56,55,1,3
1,2003,832600,43,41,2,4
2,2003,832600,31,29,2,1
3,2003,832600,50,44,6,3
4,2003,832600,44,41,3,3
5,2003,832600,41,40,1,3
6,2003,832600,44,42,2,1
7,2003,832600,53,51,2,0
8,2003,832600,56,54,2,3
9,2003,832600,52,50,2,1
10,2003,832600,74,72,2,0
11,2003,832600,56,55,1,2
12,2003,832600,51,50,1,0
1,2004,832600,32,31,1,4
2,2004,832600,19,18,1,3
3,2004,832600,30,27,3,6
4,2004,832600,51,50,1,1
5,2004,832600,40,40,0,0
6,2004,832600,39,38,1,2
7,2004,832600,68,67,1,2
8,2004,832600,38,38,0,1
9,2004,832600,67,66,1,1
10,2004,832600,48,44,4,1
11,2004,832600,45,43,2,1
12,2004,832600,37,35,2,1
1,2005,832600,35,34,1,0
2,2005,832600,26,25,1,0
3,2005,832600,33,33,0,0
4,2005,832600,41,40,1,0
5,2005,832600,41,40,1,3
6,2005,832600,53,52,1,1
7,2005,832600,45,42,3,0
8,2005,832600,65,64,1,3
9,2005,832600,45,44,1,0
10,2005,832600,33,32,1,1
11,2005,832600,23,22,1,4
12,2005,832600,43,43,0,0
1,2006,832600,29,28,1,0
2,2006,832600,32,31,1,2
3,2006,832600,37,36,1,0
4,2006,832600,36,35,1,1
5,2006,832600,32,32,0,0
6,2006,832600,51,51,0,2
7,2006,832600,37,36,1,2
8,2006,832600,39,39,0,0
9,2006,832600,27,26,1,5
10,2006,832600,33,33,0,1
11,2006,832600,28,28,0,0
12,2006,832600,27,26,1,0
1,2007,832600,46,46,0,0
2,2007,832600,29,27,2,0
3,2007,832600,35,34,1,3
4,2007,832600,33,32,1,0
5,2007,832600,38,36,2,0
6,2007,832600,43,42,1,1
7,2007,832600,56,55,1,2
8,2007,832600,52,52,0,0
9,2007,832600,54,52,2,0
10,2007,832600,39,39,0,0
11,2007,832600,37,36,1,0
12,2007,832600,37,37,0,3
1,2008,832600,43,42,1,0
2,2008,832600,31,30,1,1
3,2008,832600,37,36,1,1
4,2008,832600,32,31,1,1
5,2008,832600,34,33,1,0
6,2008,832600,46,45,1,1
7,2008,832600,46,43,3,0
8,2008,832600,47,45,2,0
9,2008,832600,54,53,1,1
10,2008,832600,38,37,1,0
11,2008,832600,32,31,1,0
12,2008,832600,42,41,1,1
1,2009,832600,34,34,0,0
2,2009,832600,37,37,0,0
3,2009,832600,31,31,0,0
4,2009,832600,32,31,1,0
5,2009,832600,40,39,1,0
6,2009,832600,20,18,2,1
7,2009,832600,45,45,0,0
8,2009,832600,31,28,3,1
9,2009,832600,34,33,1,0
10,2009,832600,37,37,0,0
11,2009,832600,27,27,0,0
12,2009,832600,33,32,1,0
1,2010,832600,30,30,0,2
2,2010,832600,28,28,0,0
3,2010,832600,40,39,1,0
4,2010,832600,29,27,2,0
5,2010,832600,46,44,2,1
6,2010,832600,40,40,0,0
7,2010,832600,49,48,1,1
8,2010,832600,30,30,0,0
9,2010,832600,35,34,1,0
10,2010,832600,47,46,1,1
11,2010,832600,26,25,1,0
12,2010,832600,33,33,0,0
1,2011,832600,31,31,0,2
2,2011,832600,15,15,0,1
1,1999,071800,11,10,1,0
2,1999,071800,5,5,0,0
3,1999,071800,16,16,0,0
4,1999,071800,18,18,0,0
5,1999,071800,18,18,0,0
6,1999,071800,11,10,1,0
7,1999,071800,16,16,0,5
8,1999,071800,10,10,0,0
9,1999,071800,13,13,0,0
10,1999,071800,12,12,0,0
11,1999,071800,15,15,0,0
12,1999,071800,6,6,0,3
1,2000,071800,7,6,1,0
2,2000,071800,10,10,0,0
3,2000,071800,13,13,0,0
4,2000,071800,4,4,0,0
5,2000,071800,7,6,1,1
6,2000,071800,4,4,0,0
7,2000,071800,13,13,0,0
8,2000,071800,12,12,0,0
9,2000,071800,7,7,0,0
10,2000,071800,10,10,0,0
11,2000,071800,11,10,1,1
12,2000,071800,5,5,0,0
1,2001,071800,4,4,0,0
2,2001,071800,3,3,0,1
3,2001,071800,5,4,1,0
4,2001,071800,4,4,0,0
5,2001,071800,10,9,1,0
6,2001,071800,6,5,1,1
7,2001,071800,10,10,0,1
8,2001,071800,5,5,0,0
9,2001,071800,6,6,0,0
10,2001,071800,6,6,0,1
11,2001,071800,8,8,0,0
12,2001,071800,4,4,0,0
1,2002,071800,5,5,0,1
2,2002,071800,4,4,0,0
3,2002,071800,6,6,0,0
4,2002,071800,3,3,0,0
5,2002,071800,10,9,1,0
6,2002,071800,6,6,0,0
7,2002,071800,12,12,0,0
8,2002,071800,24,24,0,0
9,2002,071800,10,9,1,0
10,2002,071800,8,8,0,0
11,2002,071800,5,5,0,0
12,2002,071800,5,5,0,0
1,2003,071800,5,4,1,0
2,2003,071800,4,4,0,0
3,2003,071800,3,3,0,0
4,2003,071800,5,5,0,0
5,2003,071800,4,4,0,2
6,2003,071800,8,8,0,0
7,2003,071800,4,4,0,0
8,2003,071800,10,8,2,1
9,2003,071800,10,10,0,0
10,2003,071800,7,7,0,0
11,2003,071800,7,7,0,0
12,2003,071800,5,5,0,0
1,2004,071800,9,9,0,0
2,2004,071800,4,3,1,0
3,2004,071800,11,11,0,0
4,2004,071800,8,8,0,0
5,2004,071800,6,5,1,0
6,2004,071800,8,8,0,0
7,2004,071800,7,7,0,0
8,2004,071800,12,11,1,0
9,2004,071800,6,6,0,0
10,2004,071800,4,4,0,0
11,2004,071800,9,8,1,0
12,2004,071800,5,5,0,0
1,2005,071800,2,2,0,0
2,2005,071800,2,2,0,0
3,2005,071800,3,3,0,0
4,2005,071800,11,11,0,1
5,2005,071800,2,2,0,0
6,2005,071800,12,12,0,1
7,2005,071800,7,7,0,0
8,2005,071800,8,8,0,2
9,2005,071800,2,2,0,1
10,2005,071800,6,4,2,0
11,2005,071800,8,8,0,0
12,2005,071800,5,5,0,0
1,2006,071800,9,9,0,0
2,2006,071800,6,5,1,0
3,2006,071800,5,5,0,0
4,2006,071800,6,6,0,0
5,2006,071800,6,5,1,0
6,2006,071800,5,5,0,0
7,2006,071800,6,5,1,0
8,2006,071800,5,5,0,0
9,2006,071800,6,6,0,0
10,2006,071800,10,9,1,1
11,2006,071800,3,3,0,0
12,2006,071800,5,5,0,0
1,2007,071800,7,7,0,0
2,2007,071800,2,2,0,0
3,2007,071800,3,3,0,0
4,2007,071800,8,6,2,0
5,2007,071800,8,7,1,0
6,2007,071800,7,6,1,0
7,2007,071800,10,10,0,0
8,2007,071800,5,5,0,2
9,2007,071800,9,9,0,0
10,2007,071800,11,11,0,0
11,2007,071800,4,4,0,0
12,2007,071800,5,4,1,0
1,2008,071800,4,4,0,0
2,2008,071800,5,5,0,0
3,2008,071800,12,12,0,1
4,2008,071800,4,4,0,0
5,2008,071800,9,9,0,0
6,2008,071800,5,4,1,0
7,2008,071800,5,5,0,0
8,2008,071800,6,6,0,0
9,2008,071800,6,6,0,0
10,2008,071800,12,12,0,0
11,2008,071800,4,4,0,0
12,2008,071800,7,7,0,0
1,2009,071800,3,3,0,0
2,2009,071800,1,1,0,0
3,2009,071800,3,3,0,1
4,2009,071800,9,9,0,1
5,2009,071800,9,8,1,1
6,2009,071800,7,7,0,0
7,2009,071800,5,5,0,0
8,2009,071800,7,7,0,0
9,2009,071800,7,7,0,0
10,2009,071800,2,2,0,0
11,2009,071800,8,8,0,0
12,2009,071800,2,1,1,0
1,2010,071800,3,3,0,0
2,2010,071800,5,5,0,0
3,2010,071800,6,5,1,0
4,2010,071800,1,1,0,0
5,2010,071800,2,2,0,0
6,2010,071800,11,11,0,0
7,2010,071800,9,9,0,0
8,2010,071800,9,9,0,0
9,2010,071800,13,13,0,0
10,2010,071800,3,3,0,0
11,2010,071800,4,4,0,0
12,2010,071800,4,4,0,0
1,2011,071800,3,3,0,0
2,2011,071800,1,1,0,1
1,1999,071500,21,20,1,0
2,1999,071500,18,18,0,1
3,1999,071500,27,26,1,0
4,1999,071500,25,21,4,0
5,1999,071500,38,35,3,2
6,1999,071500,36,35,1,4
7,1999,071500,20,20,0,1
8,1999,071500,36,35,1,0
9,1999,071500,27,27,0,0
10,1999,071500,28,25,3,0
11,1999,071500,20,18,2,0
12,1999,071500,26,26,0,0
1,2000,071500,20,20,0,0
2,2000,071500,16,16,0,1
3,2000,071500,25,23,2,0
4,2000,071500,17,16,1,0
5,2000,071500,19,19,0,2
6,2000,071500,32,32,0,1
7,2000,071500,29,29,0,1
8,2000,071500,34,34,0,0
9,2000,071500,31,31,0,0
10,2000,071500,31,31,0,3
11,2000,071500,23,23,0,0
12,2000,071500,11,10,1,4
1,2001,071500,15,15,0,2
2,2001,071500,17,17,0,0
3,2001,071500,19,17,2,2
4,2001,071500,12,12,0,0
5,2001,071500,30,28,2,2
6,2001,071500,20,19,1,3
7,2001,071500,20,18,2,0
8,2001,071500,28,28,0,0
9,2001,071500,18,18,0,0
10,2001,071500,21,19,2,2
11,2001,071500,18,18,0,0
12,2001,071500,14,13,1,0
1,2002,071500,15,15,0,1
2,2002,071500,24,24,0,0
3,2002,071500,25,25,0,1
4,2002,071500,20,19,1,1
5,2002,071500,16,16,0,0
6,2002,071500,39,38,1,1
7,2002,071500,26,25,1,3
8,2002,071500,35,35,0,0
9,2002,071500,24,24,0,0
10,2002,071500,22,22,0,2
11,2002,071500,22,22,0,0
12,2002,071500,15,15,0,0
1,2003,071500,13,12,1,0
2,2003,071500,11,11,0,0
3,2003,071500,18,18,0,0
4,2003,071500,17,16,1,3
5,2003,071500,17,16,1,1
6,2003,071500,20,20,0,0
7,2003,071500,25,23,2,0
8,2003,071500,23,23,0,0
9,2003,071500,22,21,1,0
10,2003,071500,20,20,0,0
11,2003,071500,16,15,1,0
12,2003,071500,12,12,0,1
1,2004,071500,15,15,0,0
2,2004,071500,12,12,0,0
3,2004,071500,15,13,2,0
4,2004,071500,20,20,0,0
5,2004,071500,16,13,3,0
6,2004,071500,19,19,0,0
7,2004,071500,29,27,2,0
8,2004,071500,30,28,2,1
9,2004,071500,16,16,0,1
10,2004,071500,14,14,0,0
11,2004,071500,10,10,0,0
12,2004,071500,13,12,1,1
1,2005,071500,11,11,0,0
2,2005,071500,8,7,1,0
3,2005,071500,6,5,1,0
4,2005,071500,7,7,0,1
5,2005,071500,13,13,0,0
6,2005,071500,19,19,0,2
7,2005,071500,16,15,1,1
8,2005,071500,22,21,1,1
9,2005,071500,16,16,0,0
10,2005,071500,17,16,1,2
11,2005,071500,19,19,0,5
12,2005,071500,9,9,0,0
1,2006,071500,18,17,1,0
2,2006,071500,5,5,0,1
3,2006,071500,20,20,0,0
4,2006,071500,14,13,1,0
5,2006,071500,20,19,1,0
6,2006,071500,28,27,1,0
7,2006,071500,22,21,1,0
8,2006,071500,22,22,0,0
9,2006,071500,18,18,0,0
10,2006,071500,16,15,1,1
11,2006,071500,26,24,2,0
12,2006,071500,16,16,0,2
1,2007,071500,15,15,0,0
2,2007,071500,4,4,0,0
3,2007,071500,12,12,0,1
4,2007,071500,16,16,0,0
5,2007,071500,14,14,0,0
6,2007,071500,24,21,3,1
7,2007,071500,29,28,1,0
8,2007,071500,19,18,1,0
9,2007,071500,22,21,1,1
10,2007,071500,19,19,0,0
11,2007,071500,14,14,0,1
12,2007,071500,14,14,0,0
1,2008,071500,10,10,0,0
2,2008,071500,15,14,1,0
3,2008,071500,15,15,0,2
4,2008,071500,20,19,1,0
5,2008,071500,31,30,1,1
6,2008,071500,39,38,1,3
7,2008,071500,27,26,1,1
8,2008,071500,22,21,1,0
9,2008,071500,23,23,0,0
10,2008,071500,15,15,0,1
11,2008,071500,23,23,0,0
12,2008,071500,5,5,0,1
1,2009,071500,13,13,0,0
2,2009,071500,13,13,0,0
3,2009,071500,8,8,0,0
4,2009,071500,15,15,0,0
5,2009,071500,16,16,0,0
6,2009,071500,19,18,1,1
7,2009,071500,26,25,1,1
8,2009,071500,20,18,2,0
9,2009,071500,17,17,0,1
10,2009,071500,18,17,1,0
11,2009,071500,11,9,2,0
12,2009,071500,11,10,1,0
1,2010,071500,8,8,0,0
2,2010,071500,9,9,0,0
3,2010,071500,10,10,0,0
4,2010,071500,17,17,0,0
5,2010,071500,14,14,0,1
6,2010,071500,18,18,0,0
7,2010,071500,11,11,0,1
8,2010,071500,26,26,0,0
9,2010,071500,18,18,0,0
10,2010,071500,24,23,1,0
11,2010,071500,12,12,0,0
12,2010,071500,7,7,0,0
1,2011,071500,11,11,0,0
2,2011,071500,4,3,1,0
1,1999,230300,3,3,0,1
2,1999,230300,2,1,1,0
3,1999,230300,0,0,0,0
4,1999,230300,3,3,0,1
5,1999,230300,4,4,0,0
6,1999,230300,3,3,0,1
7,1999,230300,3,3,0,1
8,1999,230300,7,4,3,0
9,1999,230300,6,6,0,0
10,1999,230300,3,2,1,0
11,1999,230300,4,2,2,0
12,1999,230300,4,4,0,0
1,2000,230300,1,1,0,0
2,2000,230300,1,1,0,0
3,2000,230300,5,3,2,0
4,2000,230300,4,4,0,0
5,2000,230300,7,5,2,1
6,2000,230300,4,4,0,1
7,2000,230300,4,4,0,0
8,2000,230300,5,3,2,0
9,2000,230300,3,2,1,1
10,2000,230300,6,4,2,1
11,2000,230300,3,3,0,0
12,2000,230300,0,0,0,0
1,2001,230300,1,1,0,0
2,2001,230300,3,3,0,0
3,2001,230300,5,4,1,0
4,2001,230300,1,1,0,0
5,2001,230300,4,2,2,0
6,2001,230300,1,1,0,0
7,2001,230300,6,5,1,0
8,2001,230300,2,2,0,3
9,2001,230300,6,5,1,0
10,2001,230300,2,2,0,0
11,2001,230300,4,3,1,0
12,2001,230300,4,3,1,0
1,2002,230300,2,1,1,0
2,2002,230300,1,1,0,0
3,2002,230300,1,1,0,0
4,2002,230300,5,5,0,1
5,2002,230300,3,2,1,0
6,2002,230300,0,0,0,0
7,2002,230300,2,2,0,0
8,2002,230300,4,2,2,1
9,2002,230300,4,3,1,0
10,2002,230300,6,4,2,0
11,2002,230300,8,7,1,0
12,2002,230300,2,2,0,0
1,2003,230300,4,4,0,0
2,2003,230300,3,2,1,0
3,2003,230300,0,0,0,1
4,2003,230300,1,0,1,0
5,2003,230300,1,1,0,1
6,2003,230300,1,1,0,0
7,2003,230300,7,6,1,2
8,2003,230300,4,4,0,0
9,2003,230300,1,1,0,0
10,2003,230300,3,3,0,0
11,2003,230300,4,4,0,4
12,2003,230300,0,0,0,1
1,2004,230300,2,2,0,2
2,2004,230300,1,0,1,0
3,2004,230300,5,3,2,0
4,2004,230300,3,2,1,0
5,2004,230300,1,1,0,3
6,2004,230300,3,2,1,1
7,2004,230300,12,11,1,0
8,2004,230300,2,1,1,5
9,2004,230300,3,2,1,3
10,2004,230300,1,1,0,0
11,2004,230300,1,0,1,5
12,2004,230300,10,8,2,1
1,2005,230300,3,3,0,1
2,2005,230300,0,0,0,0
3,2005,230300,1,1,0,2
4,2005,230300,1,1,0,1
5,2005,230300,5,4,1,0
6,2005,230300,4,2,2,0
7,2005,230300,4,3,1,0
8,2005,230300,8,5,3,1
9,2005,230300,1,0,1,1
10,2005,230300,1,0,1,0
11,2005,230300,0,0,0,6
12,2005,230300,1,0,1,0
1,2006,230300,2,1,1,0
2,2006,230300,1,0,1,1
3,2006,230300,5,5,0,0
4,2006,230300,0,0,0,0
5,2006,230300,1,0,1,2
6,2006,230300,2,2,0,0
7,2006,230300,3,2,1,2
8,2006,230300,6,4,2,0
9,2006,230300,4,2,2,1
10,2006,230300,1,0,1,1
11,2006,230300,0,0,0,1
12,2006,230300,2,2,0,0
1,2007,230300,2,2,0,1
2,2007,230300,2,2,0,0
3,2007,230300,1,0,1,0
4,2007,230300,2,1,1,0
5,2007,230300,5,3,2,0
6,2007,230300,1,1,0,2
7,2007,230300,1,1,0,1
8,2007,230300,2,2,0,1
9,2007,230300,2,2,0,1
10,2007,230300,3,2,1,1
11,2007,230300,2,2,0,1
12,2007,230300,2,2,0,1
1,2008,230300,1,0,1,0
2,2008,230300,0,0,0,1
3,2008,230300,1,1,0,3
4,2008,230300,1,1,0,0
5,2008,230300,1,1,0,2
6,2008,230300,2,1,1,0
7,2008,230300,3,3,0,2
8,2008,230300,2,1,1,0
9,2008,230300,4,4,0,0
10,2008,230300,2,2,0,0
11,2008,230300,1,0,1,1
12,2008,230300,2,2,0,0
1,2009,230300,6,4,2,0
2,2009,230300,3,0,3,0
3,2009,230300,0,0,0,1
4,2009,230300,1,1,0,1
5,2009,230300,4,4,0,2
6,2009,230300,1,1,0,0
7,2009,230300,3,3,0,1
8,2009,230300,0,0,0,0
9,2009,230300,3,2,1,2
10,2009,230300,6,6,0,0
11,2009,230300,5,5,0,0
12,2009,230300,1,1,0,0
1,2010,230300,1,1,0,4
2,2010,230300,2,2,0,1
3,2010,230300,2,2,0,0
4,2010,230300,1,1,0,3
5,2010,230300,4,4,0,1
6,2010,230300,3,3,0,2
7,2010,230300,3,3,0,0
8,2010,230300,1,1,0,0
9,2010,230300,0,0,0,1
10,2010,230300,0,0,0,0
11,2010,230300,1,0,1,0
12,2010,230300,1,1,0,0
1,2011,230300,3,2,1,0
2,2011,230300,0,0,0,1
1,1999,240700,7,2,5,2
2,1999,240700,2,1,1,3
3,1999,240700,4,4,0,3
4,1999,240700,9,8,1,2
5,1999,240700,2,2,0,0
6,1999,240700,11,9,2,3
7,1999,240700,15,14,1,0
8,1999,240700,5,5,0,1
9,1999,240700,6,6,0,0
10,1999,240700,3,1,2,2
11,1999,240700,2,2,0,2
12,1999,240700,5,4,1,1
1,2000,240700,3,3,0,2
2,2000,240700,4,3,1,1
3,2000,240700,6,5,1,3
4,2000,240700,8,7,1,0
5,2000,240700,7,7,0,0
6,2000,240700,12,12,0,2
7,2000,240700,4,4,0,0
8,2000,240700,10,9,1,2
9,2000,240700,10,9,1,2
10,2000,240700,6,5,1,1
11,2000,240700,3,3,0,3
12,2000,240700,7,7,0,0
1,2001,240700,9,9,0,2
2,2001,240700,9,9,0,0
3,2001,240700,6,5,1,1
4,2001,240700,7,6,1,0
5,2001,240700,9,8,1,1
6,2001,240700,12,11,1,1
7,2001,240700,10,7,3,0
8,2001,240700,7,6,1,0
9,2001,240700,8,6,2,2
10,2001,240700,5,5,0,0
11,2001,240700,9,8,1,1
12,2001,240700,5,5,0,1
1,2002,240700,4,4,0,2
2,2002,240700,2,2,0,4
3,2002,240700,6,4,2,1
4,2002,240700,10,10,0,1
5,2002,240700,17,17,0,0
6,2002,240700,8,5,3,1
7,2002,240700,6,6,0,0
8,2002,240700,12,11,1,0
9,2002,240700,5,5,0,1
10,2002,240700,9,7,2,2
11,2002,240700,9,8,1,1
12,2002,240700,6,5,1,0
1,2003,240700,6,6,0,1
2,2003,240700,5,5,0,2
3,2003,240700,2,1,1,0
4,2003,240700,2,2,0,1
5,2003,240700,6,6,0,0
6,2003,240700,10,6,4,2
7,2003,240700,7,6,1,1
8,2003,240700,8,7,1,1
9,2003,240700,4,4,0,0
10,2003,240700,9,9,0,1
11,2003,240700,4,3,1,2
12,2003,240700,3,3,0,2
1,2004,240700,2,1,1,2
2,2004,240700,1,1,0,2
3,2004,240700,6,6,0,1
4,2004,240700,4,4,0,0
5,2004,240700,1,0,1,1
6,2004,240700,2,1,1,4
7,2004,240700,2,1,1,0
8,2004,240700,6,6,0,4
9,2004,240700,4,3,1,1
10,2004,240700,3,2,1,2
11,2004,240700,1,1,0,0
12,2004,240700,4,3,1,2
1,2005,240700,3,3,0,0
2,2005,240700,5,3,2,1
3,2005,240700,7,6,1,0
4,2005,240700,3,3,0,0
5,2005,240700,3,3,0,0
6,2005,240700,2,2,0,1
7,2005,240700,0,0,0,0
8,2005,240700,0,0,0,0
9,2005,240700,4,3,1,0
10,2005,240700,8,6,2,0
11,2005,240700,3,3,0,0
12,2005,240700,3,3,0,0
1,2006,240700,5,5,0,0
2,2006,240700,1,1,0,0
3,2006,240700,3,2,1,1
4,2006,240700,2,2,0,0
5,2006,240700,1,1,0,0
6,2006,240700,1,1,0,0
7,2006,240700,5,5,0,3
8,2006,240700,5,3,2,0
9,2006,240700,4,2,2,1
10,2006,240700,1,1,0,2
11,2006,240700,0,0,0,0
12,2006,240700,5,4,1,3
1,2007,240700,3,3,0,0
2,2007,240700,2,2,0,2
3,2007,240700,3,3,0,1
4,2007,240700,2,2,0,0
5,2007,240700,7,6,1,0
6,2007,240700,4,4,0,0
7,2007,240700,5,5,0,4
8,2007,240700,11,9,2,0
9,2007,240700,3,3,0,0
10,2007,240700,8,6,2,0
11,2007,240700,3,3,0,0
12,2007,240700,10,9,1,0
1,2008,240700,8,8,0,1
2,2008,240700,3,3,0,0
3,2008,240700,4,4,0,2
4,2008,240700,3,3,0,1
5,2008,240700,3,3,0,2
6,2008,240700,4,3,1,0
7,2008,240700,9,9,0,0
8,2008,240700,7,7,0,3
9,2008,240700,3,3,0,0
10,2008,240700,5,5,0,1
11,2008,240700,5,5,0,2
12,2008,240700,4,4,0,1
1,2009,240700,3,3,0,0
2,2009,240700,1,1,0,1
3,2009,240700,8,8,0,0
4,2009,240700,7,6,1,0
5,2009,240700,9,8,1,1
6,2009,240700,5,4,1,0
7,2009,240700,10,9,1,1
8,2009,240700,5,5,0,0
9,2009,240700,9,9,0,0
10,2009,240700,2,2,0,1
11,2009,240700,6,4,2,0
12,2009,240700,4,4,0,1
1,2010,240700,6,6,0,0
2,2010,240700,4,3,1,2
3,2010,240700,6,5,1,1
4,2010,240700,3,3,0,2
5,2010,240700,6,6,0,1
6,2010,240700,3,2,1,1
7,2010,240700,7,7,0,0
8,2010,240700,6,4,2,0
9,2010,240700,6,6,0,0
10,2010,240700,5,5,0,0
11,2010,240700,6,6,0,0
12,2010,240700,2,2,0,0
1,2011,240700,4,4,0,0
2,2011,240700,1,1,0,0
1,1999,071700,3,3,0,0
2,1999,071700,9,9,0,0
3,1999,071700,11,11,0,0
4,1999,071700,6,6,0,0
5,1999,071700,9,9,0,0
6,1999,071700,6,6,0,0
7,1999,071700,13,13,0,0
8,1999,071700,3,3,0,0
9,1999,071700,7,7,0,0
10,1999,071700,5,5,0,0
11,1999,071700,2,2,0,1
12,1999,071700,2,2,0,0
1,2000,071700,4,4,0,0
2,2000,071700,2,2,0,0
3,2000,071700,5,5,0,0
4,2000,071700,5,5,0,0
5,2000,071700,5,5,0,0
6,2000,071700,11,11,0,1
7,2000,071700,10,9,1,0
8,2000,071700,6,6,0,0
9,2000,071700,5,5,0,0
10,2000,071700,4,4,0,0
11,2000,071700,4,4,0,1
12,2000,071700,0,0,0,0
1,2001,071700,3,3,0,0
2,2001,071700,2,2,0,0
3,2001,071700,3,3,0,0
4,2001,071700,3,3,0,0
5,2001,071700,4,4,0,0
6,2001,071700,10,10,0,0
7,2001,071700,6,6,0,0
8,2001,071700,5,5,0,0
9,2001,071700,2,2,0,0
10,2001,071700,5,5,0,0
11,2001,071700,3,3,0,0
12,2001,071700,2,2,0,0
1,2002,071700,3,3,0,0
2,2002,071700,7,7,0,0
3,2002,071700,7,7,0,0
4,2002,071700,6,6,0,0
5,2002,071700,2,2,0,0
6,2002,071700,6,6,0,0
7,2002,071700,4,4,0,0
8,2002,071700,5,5,0,0
9,2002,071700,3,3,0,0
10,2002,071700,3,3,0,1
11,2002,071700,3,3,0,0
12,2002,071700,7,6,1,0
1,2003,071700,5,5,0,0
2,2003,071700,3,3,0,0
3,2003,071700,6,6,0,0
4,2003,071700,7,7,0,0
5,2003,071700,9,9,0,0
6,2003,071700,6,6,0,0
7,2003,071700,5,5,0,0
8,2003,071700,3,3,0,0
9,2003,071700,6,6,0,0
10,2003,071700,6,6,0,0
11,2003,071700,4,4,0,0
12,2003,071700,2,2,0,0
1,2004,071700,6,6,0,0
2,2004,071700,1,0,1,0
3,2004,071700,3,3,0,0
4,2004,071700,2,2,0,0
5,2004,071700,3,3,0,0
6,2004,071700,6,6,0,0
7,2004,071700,8,8,0,0
8,2004,071700,2,2,0,0
9,2004,071700,6,6,0,0
10,2004,071700,2,2,0,1
11,2004,071700,5,5,0,0
12,2004,071700,2,2,0,0
1,2005,071700,4,4,0,1
2,2005,071700,1,1,0,0
3,2005,071700,1,1,0,0
4,2005,071700,4,4,0,0
5,2005,071700,3,3,0,0
6,2005,071700,5,5,0,0
7,2005,071700,2,2,0,0
8,2005,071700,3,2,1,0
9,2005,071700,6,5,1,0
10,2005,071700,6,6,0,0
11,2005,071700,4,4,0,0
12,2005,071700,3,3,0,0
1,2006,071700,1,1,0,0
2,2006,071700,0,0,0,0
3,2006,071700,5,5,0,0
4,2006,071700,2,2,0,0
5,2006,071700,9,8,1,0
6,2006,071700,6,6,0,0
7,2006,071700,3,3,0,0
8,2006,071700,4,4,0,0
9,2006,071700,3,3,0,0
10,2006,071700,2,2,0,0
11,2006,071700,3,3,0,0
12,2006,071700,7,7,0,0
1,2007,071700,2,2,0,0
2,2007,071700,5,5,0,2
3,2007,071700,4,4,0,0
4,2007,071700,4,4,0,0
5,2007,071700,7,7,0,0
6,2007,071700,3,3,0,0
7,2007,071700,5,5,0,0
8,2007,071700,4,4,0,0
9,2007,071700,7,7,0,0
10,2007,071700,7,7,0,0
11,2007,071700,2,2,0,0
12,2007,071700,6,6,0,0
1,2008,071700,4,4,0,0
2,2008,071700,1,1,0,0
3,2008,071700,5,5,0,0
4,2008,071700,3,3,0,0
5,2008,071700,3,3,0,0
6,2008,071700,10,10,0,0
7,2008,071700,4,4,0,0
8,2008,071700,6,6,0,0
9,2008,071700,4,4,0,0
10,2008,071700,10,10,0,2
11,2008,071700,7,7,0,0
12,2008,071700,5,4,1,0
1,2009,071700,4,4,0,0
2,2009,071700,1,1,0,0
3,2009,071700,2,2,0,0
4,2009,071700,7,7,0,0
5,2009,071700,3,2,1,0
6,2009,071700,2,2,0,0
7,2009,071700,5,5,0,0
8,2009,071700,4,4,0,0
9,2009,071700,6,6,0,0
10,2009,071700,5,5,0,0
11,2009,071700,3,2,1,0
12,2009,071700,5,4,1,0
1,2010,071700,3,3,0,0
2,2010,071700,3,3,0,0
3,2010,071700,3,3,0,0
4,2010,071700,1,1,0,0
5,2010,071700,3,3,0,0
6,2010,071700,4,4,0,0
7,2010,071700,2,2,0,0
8,2010,071700,7,7,0,0
9,2010,071700,6,6,0,0
10,2010,071700,10,10,0,0
11,2010,071700,2,2,0,0
12,2010,071700,2,2,0,0
1,2011,071700,2,2,0,0
2,2011,071700,5,5,0,0
1,1999,240800,3,2,1,4
2,1999,240800,5,4,1,5
3,1999,240800,8,5,3,5
4,1999,240800,6,2,4,5
5,1999,240800,4,1,3,1
6,1999,240800,2,2,0,0
7,1999,240800,7,6,1,6
8,1999,240800,5,5,0,2
9,1999,240800,5,5,0,1
10,1999,240800,7,4,3,3
11,1999,240800,6,6,0,2
12,1999,240800,8,7,1,2
1,2000,240800,2,2,0,4
2,2000,240800,4,1,3,0
3,2000,240800,10,9,1,0
4,2000,240800,5,5,0,1
5,2000,240800,4,4,0,5
6,2000,240800,10,9,1,0
7,2000,240800,3,3,0,0
8,2000,240800,3,3,0,3
9,2000,240800,7,6,1,0
10,2000,240800,10,8,2,1
11,2000,240800,10,10,0,1
12,2000,240800,4,4,0,0
1,2001,240800,2,2,0,1
2,2001,240800,7,4,3,1
3,2001,240800,4,4,0,1
4,2001,240800,7,5,2,0
5,2001,240800,8,7,1,1
6,2001,240800,11,10,1,2
7,2001,240800,5,5,0,0
8,2001,240800,5,2,3,5
9,2001,240800,4,2,2,3
10,2001,240800,8,7,1,1
11,2001,240800,3,2,1,1
12,2001,240800,3,3,0,2
1,2002,240800,6,5,1,15
2,2002,240800,7,6,1,7
3,2002,240800,5,5,0,4
4,2002,240800,12,8,4,0
5,2002,240800,7,5,2,2
6,2002,240800,8,7,1,0
7,2002,240800,5,4,1,3
8,2002,240800,10,10,0,4
9,2002,240800,4,4,0,1
10,2002,240800,8,7,1,11
11,2002,240800,9,7,2,6
12,2002,240800,6,5,1,3
1,2003,240800,2,1,1,1
2,2003,240800,5,4,1,5
3,2003,240800,6,6,0,2
4,2003,240800,5,5,0,0
5,2003,240800,2,1,1,1
6,2003,240800,6,5,1,2
7,2003,240800,7,5,2,3
8,2003,240800,10,10,0,6
9,2003,240800,8,5,3,3
10,2003,240800,6,5,1,0
11,2003,240800,5,4,1,1
12,2003,240800,4,2,2,1
1,2004,240800,5,5,0,0
2,2004,240800,5,5,0,3
3,2004,240800,3,1,2,4
4,2004,240800,5,5,0,2
5,2004,240800,4,2,2,2
6,2004,240800,1,0,1,7
7,2004,240800,6,5,1,0
8,2004,240800,13,13,0,1
9,2004,240800,4,4,0,14
10,2004,240800,7,5,2,3
11,2004,240800,3,2,1,2
12,2004,240800,4,2,2,1
1,2005,240800,2,2,0,2
2,2005,240800,3,1,2,3
3,2005,240800,5,3,2,4
4,2005,240800,2,1,1,2
5,2005,240800,5,4,1,3
6,2005,240800,2,1,1,0
7,2005,240800,0,0,0,0
8,2005,240800,4,4,0,2
9,2005,240800,3,3,0,2
10,2005,240800,5,3,2,1
11,2005,240800,2,1,1,4
12,2005,240800,4,2,2,1
1,2006,240800,3,2,1,3
2,2006,240800,2,2,0,2
3,2006,240800,3,2,1,3
4,2006,240800,7,7,0,1
5,2006,240800,6,5,1,4
6,2006,240800,7,7,0,0
7,2006,240800,2,0,2,3
8,2006,240800,3,3,0,12
9,2006,240800,5,3,2,3
10,2006,240800,3,3,0,7
11,2006,240800,2,2,0,1
12,2006,240800,2,2,0,2
1,2007,240800,1,1,0,8
2,2007,240800,1,1,0,2
3,2007,240800,3,3,0,2
4,2007,240800,5,4,1,3
5,2007,240800,4,3,1,3
6,2007,240800,4,2,2,0
7,2007,240800,3,2,1,2
8,2007,240800,2,2,0,0
9,2007,240800,2,1,1,1
10,2007,240800,4,2,2,2
11,2007,240800,6,6,0,3
12,2007,240800,3,3,0,1
1,2008,240800,6,6,0,0
2,2008,240800,3,2,1,2
3,2008,240800,3,2,1,0
4,2008,240800,1,1,0,0
5,2008,240800,3,3,0,1
6,2008,240800,6,5,1,3
7,2008,240800,10,6,4,1
8,2008,240800,5,4,1,3
9,2008,240800,5,4,1,2
10,2008,240800,7,5,2,3
11,2008,240800,5,3,2,2
12,2008,240800,6,6,0,2
1,2009,240800,7,5,2,0
2,2009,240800,12,10,2,1
3,2009,240800,3,2,1,4
4,2009,240800,3,3,0,0
5,2009,240800,4,3,1,1
6,2009,240800,5,3,2,1
7,2009,240800,5,3,2,1
8,2009,240800,5,3,2,1
9,2009,240800,4,4,0,1
10,2009,240800,2,2,0,1
11,2009,240800,4,4,0,0
12,2009,240800,5,5,0,1
1,2010,240800,5,5,0,1
2,2010,240800,3,3,0,0
3,2010,240800,1,1,0,1
4,2010,240800,4,4,0,5
5,2010,240800,4,4,0,2
6,2010,240800,1,1,0,0
7,2010,240800,1,1,0,2
8,2010,240800,2,2,0,0
9,2010,240800,6,5,1,1
10,2010,240800,6,5,1,1
11,2010,240800,3,2,1,1
12,2010,240800,10,7,3,1
1,2011,240800,1,0,1,1
2,2011,240800,3,3,0,1
1,1999,222700,13,11,2,2
2,1999,222700,11,8,3,7
3,1999,222700,23,15,8,0
4,1999,222700,21,17,4,10
5,1999,222700,24,18,6,1
6,1999,222700,21,14,7,9
7,1999,222700,19,14,5,2
8,1999,222700,17,11,6,7
9,1999,222700,19,15,4,7
10,1999,222700,16,12,4,5
11,1999,222700,18,12,6,5
12,1999,222700,16,10,6,3
1,2000,222700,15,11,4,2
2,2000,222700,11,10,1,1
3,2000,222700,19,15,4,3
4,2000,222700,16,14,2,2
5,2000,222700,24,17,7,2
6,2000,222700,17,14,3,6
7,2000,222700,18,10,8,2
8,2000,222700,14,11,3,7
9,2000,222700,30,18,12,4
10,2000,222700,19,14,5,8
11,2000,222700,19,15,4,8
12,2000,222700,15,13,2,5
1,2001,222700,11,8,3,12
2,2001,222700,19,15,4,4
3,2001,222700,17,16,1,7
4,2001,222700,17,15,2,0
5,2001,222700,17,14,3,4
6,2001,222700,17,12,5,2
7,2001,222700,15,11,4,2
8,2001,222700,23,18,5,4
9,2001,222700,23,20,3,3
10,2001,222700,27,22,5,1
11,2001,222700,15,14,1,3
12,2001,222700,5,5,0,3
1,2002,222700,16,11,5,6
2,2002,222700,10,7,3,5
3,2002,222700,9,6,3,3
4,2002,222700,19,15,4,5
5,2002,222700,20,16,4,7
6,2002,222700,15,13,2,6
7,2002,222700,23,17,6,6
8,2002,222700,26,19,7,3
9,2002,222700,25,21,4,6
10,2002,222700,21,15,6,3
11,2002,222700,14,14,0,1
12,2002,222700,18,17,1,1
1,2003,222700,11,10,1,2
2,2003,222700,7,5,2,4
3,2003,222700,10,8,2,2
4,2003,222700,15,11,4,10
5,2003,222700,12,9,3,6
6,2003,222700,16,13,3,2
7,2003,222700,23,19,4,5
8,2003,222700,20,19,1,1
9,2003,222700,25,18,7,1
10,2003,222700,8,6,2,5
11,2003,222700,14,14,0,7
12,2003,222700,9,9,0,4
1,2004,222700,11,9,2,6
2,2004,222700,8,7,1,5
3,2004,222700,14,13,1,7
4,2004,222700,13,12,1,11
5,2004,222700,16,12,4,2
6,2004,222700,20,16,4,5
7,2004,222700,23,20,3,9
8,2004,222700,24,22,2,11
9,2004,222700,12,10,2,1
10,2004,222700,14,12,2,4
11,2004,222700,11,8,3,2
12,2004,222700,12,11,1,2
1,2005,222700,10,8,2,3
2,2005,222700,7,7,0,5
3,2005,222700,14,9,5,4
4,2005,222700,14,14,0,1
5,2005,222700,9,6,3,2
6,2005,222700,15,11,4,2
7,2005,222700,16,13,3,0
8,2005,222700,19,17,2,2
9,2005,222700,10,7,3,1
10,2005,222700,14,12,2,3
11,2005,222700,5,3,2,5
12,2005,222700,6,5,1,0
1,2006,222700,8,8,0,0
2,2006,222700,17,14,3,1
3,2006,222700,8,8,0,1
4,2006,222700,10,8,2,4
5,2006,222700,7,6,1,3
6,2006,222700,13,11,2,4
7,2006,222700,8,5,3,5
8,2006,222700,13,11,2,5
9,2006,222700,8,8,0,3
10,2006,222700,13,13,0,0
11,2006,222700,9,7,2,2
12,2006,222700,16,14,2,1
1,2007,222700,14,11,3,3
2,2007,222700,11,9,2,6
3,2007,222700,10,8,2,0
4,2007,222700,8,6,2,3
5,2007,222700,8,6,2,8
6,2007,222700,9,8,1,0
7,2007,222700,7,6,1,2
8,2007,222700,19,18,1,1
9,2007,222700,14,10,4,0
10,2007,222700,14,13,1,3
11,2007,222700,6,6,0,7
12,2007,222700,7,6,1,3
1,2008,222700,6,6,0,1
2,2008,222700,2,2,0,3
3,2008,222700,6,5,1,1
4,2008,222700,8,7,1,3
5,2008,222700,9,6,3,1
6,2008,222700,9,6,3,3
7,2008,222700,10,9,1,5
8,2008,222700,11,11,0,8
9,2008,222700,9,8,1,1
10,2008,222700,11,10,1,4
11,2008,222700,7,6,1,2
12,2008,222700,5,5,0,6
1,2009,222700,5,4,1,3
2,2009,222700,6,6,0,2
3,2009,222700,11,10,1,2
4,2009,222700,6,5,1,3
5,2009,222700,6,5,1,6
6,2009,222700,17,16,1,4
7,2009,222700,8,7,1,5
8,2009,222700,10,7,3,5
9,2009,222700,10,8,2,2
10,2009,222700,13,12,1,0
11,2009,222700,9,8,1,2
12,2009,222700,12,11,1,1
1,2010,222700,13,12,1,5
2,2010,222700,5,5,0,1
3,2010,222700,10,10,0,2
4,2010,222700,9,7,2,1
5,2010,222700,12,8,4,5
6,2010,222700,9,9,0,0
7,2010,222700,9,8,1,3
8,2010,222700,8,8,0,1
9,2010,222700,12,11,1,1
10,2010,222700,6,5,1,1
11,2010,222700,12,10,2,3
12,2010,222700,16,16,0,0
1,2011,222700,10,8,2,1
2,2011,222700,6,5,1,0
1,1999,222900,6,3,3,3
2,1999,222900,8,6,2,1
3,1999,222900,9,7,2,7
4,1999,222900,12,6,6,10
5,1999,222900,22,19,3,7
6,1999,222900,9,7,2,5
7,1999,222900,19,17,2,4
8,1999,222900,14,13,1,5
9,1999,222900,17,16,1,7
10,1999,222900,13,8,5,13
11,1999,222900,8,8,0,8
12,1999,222900,6,4,2,5
1,2000,222900,5,4,1,5
2,2000,222900,6,6,0,4
3,2000,222900,12,9,3,4
4,2000,222900,10,9,1,5
5,2000,222900,14,12,2,6
6,2000,222900,12,9,3,0
7,2000,222900,11,11,0,6
8,2000,222900,16,15,1,2
9,2000,222900,15,11,4,6
10,2000,222900,13,7,6,12
11,2000,222900,10,6,4,7
12,2000,222900,9,8,1,2
1,2001,222900,10,9,1,15
2,2001,222900,17,15,2,8
3,2001,222900,9,8,1,2
4,2001,222900,6,6,0,2
5,2001,222900,13,9,4,7
6,2001,222900,12,6,6,5
7,2001,222900,8,7,1,4
8,2001,222900,14,10,4,1
9,2001,222900,12,11,1,4
10,2001,222900,6,4,2,4
11,2001,222900,8,7,1,8
12,2001,222900,10,5,5,3
1,2002,222900,8,8,0,4
2,2002,222900,4,3,1,9
3,2002,222900,11,9,2,5
4,2002,222900,2,1,1,5
5,2002,222900,10,8,2,5
6,2002,222900,14,10,4,3
7,2002,222900,14,11,3,4
8,2002,222900,9,6,3,5
9,2002,222900,12,8,4,3
10,2002,222900,15,14,1,3
11,2002,222900,9,8,1,3
12,2002,222900,9,6,3,3
1,2003,222900,10,9,1,1
2,2003,222900,4,3,1,5
3,2003,222900,7,7,0,9
4,2003,222900,13,11,2,3
5,2003,222900,13,11,2,2
6,2003,222900,5,4,1,3
7,2003,222900,19,17,2,6
8,2003,222900,19,18,1,2
9,2003,222900,14,11,3,3
10,2003,222900,18,15,3,3
11,2003,222900,15,15,0,7
12,2003,222900,7,6,1,4
1,2004,222900,7,4,3,6
2,2004,222900,9,7,2,7
3,2004,222900,10,7,3,7
4,2004,222900,5,3,2,4
5,2004,222900,10,8,2,11
6,2004,222900,13,10,3,11
7,2004,222900,31,30,1,9
8,2004,222900,16,14,2,2
9,2004,222900,16,11,5,4
10,2004,222900,16,15,1,11
11,2004,222900,10,9,1,7
12,2004,222900,6,6,0,2
1,2005,222900,12,11,1,9
2,2005,222900,6,6,0,7
3,2005,222900,8,7,1,2
4,2005,222900,11,9,2,8
5,2005,222900,7,6,1,3
6,2005,222900,11,9,2,2
7,2005,222900,7,7,0,5
8,2005,222900,8,8,0,2
9,2005,222900,6,5,1,8
10,2005,222900,9,8,1,4
11,2005,222900,8,8,0,6
12,2005,222900,10,8,2,3
1,2006,222900,5,5,0,1
2,2006,222900,7,6,1,6
3,2006,222900,7,5,2,3
4,2006,222900,8,7,1,5
5,2006,222900,9,8,1,4
6,2006,222900,8,8,0,10
7,2006,222900,10,8,2,3
8,2006,222900,5,3,2,3
9,2006,222900,2,2,0,0
10,2006,222900,9,6,3,8
11,2006,222900,11,10,1,3
12,2006,222900,7,7,0,6
1,2007,222900,5,5,0,6
2,2007,222900,8,7,1,3
3,2007,222900,6,5,1,9
4,2007,222900,6,4,2,5
5,2007,222900,11,10,1,16
6,2007,222900,11,9,2,4
7,2007,222900,3,3,0,4
8,2007,222900,6,4,2,0
9,2007,222900,8,8,0,7
10,2007,222900,9,8,1,4
11,2007,222900,4,2,2,10
12,2007,222900,5,2,3,4
1,2008,222900,4,4,0,8
2,2008,222900,6,6,0,5
3,2008,222900,7,4,3,5
4,2008,222900,6,5,1,2
5,2008,222900,2,2,0,3
6,2008,222900,3,3,0,5
7,2008,222900,4,4,0,2
8,2008,222900,5,5,0,1
9,2008,222900,5,3,2,1
10,2008,222900,8,7,1,3
11,2008,222900,10,9,1,1
12,2008,222900,8,8,0,1
1,2009,222900,10,10,0,1
2,2009,222900,8,7,1,4
3,2009,222900,11,8,3,3
4,2009,222900,10,9,1,3
5,2009,222900,7,7,0,2
6,2009,222900,5,4,1,2
7,2009,222900,3,2,1,4
8,2009,222900,8,6,2,3
9,2009,222900,14,12,2,2
10,2009,222900,9,9,0,2
11,2009,222900,6,5,1,4
12,2009,222900,10,10,0,4
1,2010,222900,8,6,2,1
2,2010,222900,6,4,2,2
3,2010,222900,12,10,2,4
4,2010,222900,8,7,1,4
5,2010,222900,13,10,3,0
6,2010,222900,7,4,3,0
7,2010,222900,4,4,0,2
8,2010,222900,14,13,1,3
9,2010,222900,13,11,2,2
10,2010,222900,7,6,1,6
11,2010,222900,9,9,0,5
12,2010,222900,10,10,0,0
1,2011,222900,17,17,0,2
2,2011,222900,7,6,1,2
1,1999,831200,22,21,1,3
2,1999,831200,22,19,3,16
3,1999,831200,29,24,5,6
4,1999,831200,25,24,1,12
5,1999,831200,44,39,5,10
6,1999,831200,26,23,3,4
7,1999,831200,23,18,5,3
8,1999,831200,41,35,6,6
9,1999,831200,39,32,7,5
10,1999,831200,32,24,8,9
11,1999,831200,30,29,1,5
12,1999,831200,20,20,0,9
1,2000,831200,27,23,4,4
2,2000,831200,19,17,2,5
3,2000,831200,34,29,5,6
4,2000,831200,21,13,8,10
5,2000,831200,24,20,4,11
6,2000,831200,12,10,2,7
7,2000,831200,30,20,10,3
8,2000,831200,27,23,4,6
9,2000,831200,12,10,2,6
10,2000,831200,17,14,3,5
11,2000,831200,25,20,5,11
12,2000,831200,23,21,2,6
1,2001,831200,35,30,5,9
2,2001,831200,26,23,3,3
3,2001,831200,29,22,7,5
4,2001,831200,18,17,1,5
5,2001,831200,20,18,2,4
6,2001,831200,17,14,3,12
7,2001,831200,27,21,6,7
8,2001,831200,26,23,3,4
9,2001,831200,27,22,5,9
10,2001,831200,20,15,5,8
11,2001,831200,24,16,8,5
12,2001,831200,27,26,1,11
1,2002,831200,25,22,3,4
2,2002,831200,9,6,3,7
3,2002,831200,26,22,4,6
4,2002,831200,18,14,4,5
5,2002,831200,18,16,2,5
6,2002,831200,26,21,5,3
7,2002,831200,22,18,4,4
8,2002,831200,28,24,4,2
9,2002,831200,31,26,5,2
10,2002,831200,35,31,4,3
11,2002,831200,21,19,2,2
12,2002,831200,18,15,3,3
1,2003,831200,20,17,3,3
2,2003,831200,18,15,3,7
3,2003,831200,18,13,5,5
4,2003,831200,22,17,5,8
5,2003,831200,34,30,4,4
6,2003,831200,21,15,6,9
7,2003,831200,33,27,6,3
8,2003,831200,27,21,6,9
9,2003,831200,25,24,1,7
10,2003,831200,32,28,4,12
11,2003,831200,24,19,5,11
12,2003,831200,33,30,3,12
1,2004,831200,17,17,0,5
2,2004,831200,18,17,1,0
3,2004,831200,17,16,1,13
4,2004,831200,20,17,3,27
5,2004,831200,27,20,7,10
6,2004,831200,13,13,0,11
7,2004,831200,26,23,3,15
8,2004,831200,24,21,3,4
9,2004,831200,21,16,5,10
10,2004,831200,23,19,4,9
11,2004,831200,22,21,1,2
12,2004,831200,25,24,1,8
1,2005,831200,22,22,0,3
2,2005,831200,14,14,0,9
3,2005,831200,23,21,2,5
4,2005,831200,14,11,3,4
5,2005,831200,24,19,5,5
6,2005,831200,21,21,0,6
7,2005,831200,15,12,3,17
8,2005,831200,25,20,5,16
9,2005,831200,13,11,2,7
10,2005,831200,16,14,2,9
11,2005,831200,15,12,3,8
12,2005,831200,11,9,2,10
1,2006,831200,21,19,2,4
2,2006,831200,18,17,1,9
3,2006,831200,22,19,3,6
4,2006,831200,8,6,2,2
5,2006,831200,22,19,3,3
6,2006,831200,15,13,2,13
7,2006,831200,29,24,5,5
8,2006,831200,30,27,3,7
9,2006,831200,24,20,4,7
10,2006,831200,20,19,1,7
11,2006,831200,14,13,1,1
12,2006,831200,15,12,3,3
1,2007,831200,14,13,1,13
2,2007,831200,10,9,1,4
3,2007,831200,22,20,2,5
4,2007,831200,23,20,3,5
5,2007,831200,24,19,5,6
6,2007,831200,17,16,1,3
7,2007,831200,19,16,3,4
8,2007,831200,25,17,8,5
9,2007,831200,28,24,4,4
10,2007,831200,14,13,1,6
11,2007,831200,22,19,3,8
12,2007,831200,24,18,6,8
1,2008,831200,10,9,1,3
2,2008,831200,12,10,2,7
3,2008,831200,14,12,2,6
4,2008,831200,12,11,1,6
5,2008,831200,18,17,1,7
6,2008,831200,16,15,1,5
7,2008,831200,18,13,5,9
8,2008,831200,21,18,3,7
9,2008,831200,22,19,3,1
10,2008,831200,25,22,3,8
11,2008,831200,9,9,0,3
12,2008,831200,18,15,3,2
1,2009,831200,18,14,4,5
2,2009,831200,16,13,3,5
3,2009,831200,25,19,6,7
4,2009,831200,23,21,2,5
5,2009,831200,15,14,1,3
6,2009,831200,16,12,4,4
7,2009,831200,26,20,6,4
8,2009,831200,20,16,4,1
9,2009,831200,15,10,5,4
10,2009,831200,12,10,2,4
11,2009,831200,19,17,2,5
12,2009,831200,20,17,3,7
1,2010,831200,19,16,3,5
2,2010,831200,18,15,3,1
3,2010,831200,18,16,2,10
4,2010,831200,19,18,1,4
5,2010,831200,21,17,4,7
6,2010,831200,15,12,3,1
7,2010,831200,14,9,5,7
8,2010,831200,27,24,3,5
9,2010,831200,25,18,7,7
10,2010,831200,30,26,4,4
11,2010,831200,23,19,4,5
12,2010,831200,27,25,2,2
1,2011,831200,15,14,1,4
2,2011,831200,7,7,0,4
1,1999,832300,16,15,1,0
2,1999,832300,23,22,1,0
3,1999,832300,18,18,0,2
4,1999,832300,17,15,2,3
5,1999,832300,22,21,1,1
6,1999,832300,26,25,1,0
7,1999,832300,27,22,5,0
8,1999,832300,27,26,1,1
9,1999,832300,18,17,1,1
10,1999,832300,19,19,0,0
11,1999,832300,22,19,3,0
12,1999,832300,23,22,1,0
1,2000,832300,14,12,2,0
2,2000,832300,21,20,1,0
3,2000,832300,19,17,2,0
4,2000,832300,25,25,0,0
5,2000,832300,25,23,2,2
6,2000,832300,28,27,1,0
7,2000,832300,21,21,0,3
8,2000,832300,22,21,1,2
9,2000,832300,22,21,1,0
10,2000,832300,20,19,1,2
11,2000,832300,32,32,0,0
12,2000,832300,12,11,1,0
1,2001,832300,13,13,0,0
2,2001,832300,21,20,1,0
3,2001,832300,19,19,0,0
4,2001,832300,16,14,2,0
5,2001,832300,19,18,1,0
6,2001,832300,18,16,2,0
7,2001,832300,26,25,1,1
8,2001,832300,19,16,3,1
9,2001,832300,22,20,2,1
10,2001,832300,25,24,1,0
11,2001,832300,14,13,1,0
12,2001,832300,15,15,0,0
1,2002,832300,17,17,0,0
2,2002,832300,14,12,2,2
3,2002,832300,26,22,4,1
4,2002,832300,18,17,1,0
5,2002,832300,15,14,1,0
6,2002,832300,25,24,1,0
7,2002,832300,37,35,2,1
8,2002,832300,29,29,0,0
9,2002,832300,33,31,2,0
10,2002,832300,31,30,1,0
11,2002,832300,20,19,1,0
12,2002,832300,35,35,0,0
1,2003,832300,14,14,0,2
2,2003,832300,12,11,1,0
3,2003,832300,19,19,0,2
4,2003,832300,22,21,1,4
5,2003,832300,17,16,1,0
6,2003,832300,18,18,0,0
7,2003,832300,28,28,0,1
8,2003,832300,22,22,0,0
9,2003,832300,9,9,0,0
10,2003,832300,23,22,1,0
11,2003,832300,22,21,1,3
12,2003,832300,16,15,1,1
1,2004,832300,10,10,0,0
2,2004,832300,10,10,0,1
3,2004,832300,21,20,1,0
4,2004,832300,12,11,1,0
5,2004,832300,13,13,0,0
6,2004,832300,12,11,1,0
7,2004,832300,16,16,0,0
8,2004,832300,24,24,0,0
9,2004,832300,25,24,1,0
10,2004,832300,16,16,0,0
11,2004,832300,13,12,1,0
12,2004,832300,16,16,0,0
1,2005,832300,19,18,1,0
2,2005,832300,8,8,0,0
3,2005,832300,17,16,1,0
4,2005,832300,17,17,0,0
5,2005,832300,19,19,0,0
6,2005,832300,17,15,2,0
7,2005,832300,30,30,0,0
8,2005,832300,22,22,0,0
9,2005,832300,18,14,4,1
10,2005,832300,25,24,1,0
11,2005,832300,20,19,1,1
12,2005,832300,14,14,0,1
1,2006,832300,28,28,0,0
2,2006,832300,11,11,0,0
3,2006,832300,19,18,1,1
4,2006,832300,20,19,1,0
5,2006,832300,28,27,1,1
6,2006,832300,28,27,1,2
7,2006,832300,37,35,2,0
8,2006,832300,19,18,1,0
9,2006,832300,17,16,1,0
10,2006,832300,15,14,1,0
11,2006,832300,9,9,0,0
12,2006,832300,23,22,1,0
1,2007,832300,21,20,1,1
2,2007,832300,15,15,0,0
3,2007,832300,27,26,1,1
4,2007,832300,26,25,1,2
5,2007,832300,16,16,0,0
6,2007,832300,21,20,1,0
7,2007,832300,18,18,0,0
8,2007,832300,20,20,0,0
9,2007,832300,34,34,0,1
10,2007,832300,39,38,1,0
11,2007,832300,28,27,1,0
12,2007,832300,29,29,0,2
1,2008,832300,28,27,1,0
2,2008,832300,21,21,0,1
3,2008,832300,24,24,0,1
4,2008,832300,18,17,1,0
5,2008,832300,21,21,0,0
6,2008,832300,34,33,1,0
7,2008,832300,34,34,0,0
8,2008,832300,40,39,1,1
9,2008,832300,28,27,1,2
10,2008,832300,38,38,0,0
11,2008,832300,40,40,0,0
12,2008,832300,30,29,1,0
1,2009,832300,45,45,0,0
2,2009,832300,18,18,0,0
3,2009,832300,34,32,2,0
4,2009,832300,34,33,1,0
5,2009,832300,23,23,0,1
6,2009,832300,26,26,0,0
7,2009,832300,26,25,1,0
8,2009,832300,31,31,0,0
9,2009,832300,34,34,0,0
10,2009,832300,30,29,1,0
11,2009,832300,25,23,2,0
12,2009,832300,23,23,0,1
1,2010,832300,28,26,2,2
2,2010,832300,19,18,1,0
3,2010,832300,21,21,0,0
4,2010,832300,26,25,1,0
5,2010,832300,18,17,1,0
6,2010,832300,20,20,0,0
7,2010,832300,19,18,1,0
8,2010,832300,26,23,3,1
9,2010,832300,26,24,2,1
10,2010,832300,31,29,2,1
11,2010,832300,20,18,2,0
12,2010,832300,24,23,1,0
1,2011,832300,18,17,1,0
2,2011,832300,7,7,0,0
1,1999,222200,8,8,0,0
2,1999,222200,8,7,1,0
3,1999,222200,10,10,0,0
4,1999,222200,7,7,0,1
5,1999,222200,18,18,0,0
6,1999,222200,8,8,0,1
7,1999,222200,11,9,2,0
8,1999,222200,28,26,2,1
9,1999,222200,13,13,0,0
10,1999,222200,13,13,0,1
11,1999,222200,14,14,0,3
12,1999,222200,10,10,0,0
1,2000,222200,8,7,1,0
2,2000,222200,9,9,0,0
3,2000,222200,9,9,0,1
4,2000,222200,11,10,1,0
5,2000,222200,14,13,1,0
6,2000,222200,25,20,5,0
7,2000,222200,12,11,1,0
8,2000,222200,12,12,0,0
9,2000,222200,29,29,0,1
10,2000,222200,17,17,0,0
11,2000,222200,17,15,2,2
12,2000,222200,12,11,1,1
1,2001,222200,16,15,1,0
2,2001,222200,8,7,1,0
3,2001,222200,8,8,0,0
4,2001,222200,17,16,1,0
5,2001,222200,13,12,1,1
6,2001,222200,15,14,1,5
7,2001,222200,16,14,2,1
8,2001,222200,21,20,1,0
9,2001,222200,10,8,2,3
10,2001,222200,11,10,1,0
11,2001,222200,12,10,2,0
12,2001,222200,14,13,1,0
1,2002,222200,10,10,0,1
2,2002,222200,14,13,1,0
3,2002,222200,11,10,1,0
4,2002,222200,16,13,3,1
5,2002,222200,10,10,0,1
6,2002,222200,7,7,0,2
7,2002,222200,7,7,0,0
8,2002,222200,18,18,0,0
9,2002,222200,17,15,2,0
10,2002,222200,16,14,2,0
11,2002,222200,10,10,0,0
12,2002,222200,11,10,1,0
1,2003,222200,16,16,0,0
2,2003,222200,13,12,1,0
3,2003,222200,18,18,0,0
4,2003,222200,14,13,1,1
5,2003,222200,12,12,0,0
6,2003,222200,14,13,1,0
7,2003,222200,9,9,0,0
8,2003,222200,5,5,0,2
9,2003,222200,10,10,0,0
10,2003,222200,11,10,1,0
11,2003,222200,10,9,1,0
12,2003,222200,14,14,0,1
1,2004,222200,10,9,1,0
2,2004,222200,11,11,0,2
3,2004,222200,6,6,0,0
4,2004,222200,11,10,1,1
5,2004,222200,11,11,0,2
6,2004,222200,12,12,0,0
7,2004,222200,10,10,0,1
8,2004,222200,18,18,0,0
9,2004,222200,13,13,0,0
10,2004,222200,9,9,0,0
11,2004,222200,9,7,2,1
12,2004,222200,11,11,0,0
1,2005,222200,2,2,0,0
2,2005,222200,3,3,0,0
3,2005,222200,10,10,0,0
4,2005,222200,6,6,0,1
5,2005,222200,19,18,1,1
6,2005,222200,6,6,0,0
7,2005,222200,12,11,1,0
8,2005,222200,14,13,1,0
9,2005,222200,10,9,1,0
10,2005,222200,6,6,0,0
11,2005,222200,6,6,0,0
12,2005,222200,6,6,0,0
1,2006,222200,10,9,1,0
2,2006,222200,7,7,0,0
3,2006,222200,5,5,0,0
4,2006,222200,9,5,4,0
5,2006,222200,11,11,0,2
6,2006,222200,11,11,0,1
7,2006,222200,8,7,1,1
8,2006,222200,14,14,0,0
9,2006,222200,8,7,1,0
10,2006,222200,5,5,0,0
11,2006,222200,6,5,1,0
12,2006,222200,10,9,1,0
1,2007,222200,5,5,0,0
2,2007,222200,5,5,0,0
3,2007,222200,6,6,0,1
4,2007,222200,9,9,0,1
5,2007,222200,10,9,1,0
6,2007,222200,11,11,0,0
7,2007,222200,22,21,1,3
8,2007,222200,13,13,0,0
9,2007,222200,10,10,0,2
10,2007,222200,11,11,0,0
11,2007,222200,10,10,0,0
12,2007,222200,10,10,0,1
1,2008,222200,9,8,1,2
2,2008,222200,11,11,0,0
3,2008,222200,4,4,0,0
4,2008,222200,14,13,1,1
5,2008,222200,14,12,2,0
6,2008,222200,5,5,0,2
7,2008,222200,12,11,1,0
8,2008,222200,10,10,0,0
9,2008,222200,11,11,0,0
10,2008,222200,12,11,1,1
11,2008,222200,6,6,0,0
12,2008,222200,6,6,0,0
1,2009,222200,14,13,1,0
2,2009,222200,10,9,1,0
3,2009,222200,11,11,0,0
4,2009,222200,8,8,0,1
5,2009,222200,3,3,0,2
6,2009,222200,5,5,0,0
7,2009,222200,10,10,0,0
8,2009,222200,6,6,0,0
9,2009,222200,11,10,1,1
10,2009,222200,9,9,0,0
11,2009,222200,9,9,0,0
12,2009,222200,2,2,0,0
1,2010,222200,5,5,0,0
2,2010,222200,5,5,0,0
3,2010,222200,7,7,0,0
4,2010,222200,3,3,0,1
5,2010,222200,3,3,0,1
6,2010,222200,5,5,0,0
7,2010,222200,13,13,0,0
8,2010,222200,8,8,0,0
9,2010,222200,8,7,1,0
10,2010,222200,11,11,0,0
11,2010,222200,11,11,0,0
12,2010,222200,5,5,0,0
1,2011,222200,3,3,0,0
2,2011,222200,4,4,0,0
1,1999,832400,9,7,2,0
2,1999,832400,7,7,0,2
3,1999,832400,12,11,1,1
4,1999,832400,13,13,0,5
5,1999,832400,10,7,3,0
6,1999,832400,12,11,1,0
7,1999,832400,10,10,0,0
8,1999,832400,17,17,0,4
9,1999,832400,16,14,2,2
10,1999,832400,6,4,2,1
11,1999,832400,12,10,2,1
12,1999,832400,6,6,0,5
1,2000,832400,7,7,0,1
2,2000,832400,14,13,1,4
3,2000,832400,19,19,0,2
4,2000,832400,11,9,2,2
5,2000,832400,8,6,2,2
6,2000,832400,8,6,2,5
7,2000,832400,17,13,4,4
8,2000,832400,23,21,2,2
9,2000,832400,24,20,4,1
10,2000,832400,27,21,6,5
11,2000,832400,12,10,2,0
12,2000,832400,10,10,0,3
1,2001,832400,15,15,0,0
2,2001,832400,15,13,2,0
3,2001,832400,9,8,1,4
4,2001,832400,18,14,4,1
5,2001,832400,16,14,2,5
6,2001,832400,21,20,1,4
7,2001,832400,17,14,3,1
8,2001,832400,8,6,2,1
9,2001,832400,16,14,2,2
10,2001,832400,20,17,3,4
11,2001,832400,11,8,3,3
12,2001,832400,13,11,2,3
1,2002,832400,6,6,0,4
2,2002,832400,7,6,1,5
3,2002,832400,8,6,2,4
4,2002,832400,8,8,0,3
5,2002,832400,12,11,1,2
6,2002,832400,11,7,4,1
7,2002,832400,20,16,4,0
8,2002,832400,17,15,2,6
9,2002,832400,19,18,1,2
10,2002,832400,25,25,0,4
11,2002,832400,9,9,0,1
12,2002,832400,13,12,1,2
1,2003,832400,4,2,2,5
2,2003,832400,11,9,2,9
3,2003,832400,9,8,1,1
4,2003,832400,10,10,0,6
5,2003,832400,15,13,2,3
6,2003,832400,14,11,3,1
7,2003,832400,16,13,3,8
8,2003,832400,13,10,3,2
9,2003,832400,19,16,3,3
10,2003,832400,11,10,1,5
11,2003,832400,8,7,1,4
12,2003,832400,4,4,0,2
1,2004,832400,5,5,0,1
2,2004,832400,7,7,0,2
3,2004,832400,6,6,0,0
4,2004,832400,8,7,1,0
5,2004,832400,7,6,1,3
6,2004,832400,6,6,0,1
7,2004,832400,11,10,1,2
8,2004,832400,5,5,0,0
9,2004,832400,6,3,3,0
10,2004,832400,14,13,1,2
11,2004,832400,4,4,0,2
12,2004,832400,4,4,0,0
1,2005,832400,10,10,0,0
2,2005,832400,5,5,0,1
3,2005,832400,15,13,2,1
4,2005,832400,3,2,1,3
5,2005,832400,11,10,1,3
6,2005,832400,9,9,0,0
7,2005,832400,8,7,1,0
8,2005,832400,13,11,2,0
9,2005,832400,9,8,1,1
10,2005,832400,10,10,0,2
11,2005,832400,3,3,0,3
12,2005,832400,8,7,1,1
1,2006,832400,6,5,1,1
2,2006,832400,4,2,2,1
3,2006,832400,5,3,2,1
4,2006,832400,4,4,0,2
5,2006,832400,6,4,2,2
6,2006,832400,12,10,2,1
7,2006,832400,10,9,1,1
8,2006,832400,6,6,0,0
9,2006,832400,9,9,0,4
10,2006,832400,7,6,1,2
11,2006,832400,2,1,1,2
12,2006,832400,3,3,0,2
1,2007,832400,10,7,3,1
2,2007,832400,2,2,0,0
3,2007,832400,7,7,0,0
4,2007,832400,8,8,0,2
5,2007,832400,14,13,1,1
6,2007,832400,6,4,2,0
7,2007,832400,8,8,0,0
8,2007,832400,12,9,3,2
9,2007,832400,7,6,1,1
10,2007,832400,14,12,2,0
11,2007,832400,8,7,1,0
12,2007,832400,8,8,0,0
1,2008,832400,5,5,0,2
2,2008,832400,10,10,0,1
3,2008,832400,6,6,0,0
4,2008,832400,7,7,0,3
5,2008,832400,6,6,0,0
6,2008,832400,5,5,0,0
7,2008,832400,12,11,1,1
8,2008,832400,5,3,2,1
9,2008,832400,10,9,1,1
10,2008,832400,8,8,0,2
11,2008,832400,11,9,2,0
12,2008,832400,11,9,2,0
1,2009,832400,14,12,2,0
2,2009,832400,5,5,0,0
3,2009,832400,2,2,0,3
4,2009,832400,7,6,1,0
5,2009,832400,5,3,2,0
6,2009,832400,11,9,2,3
7,2009,832400,13,13,0,0
8,2009,832400,18,17,1,2
9,2009,832400,8,5,3,1
10,2009,832400,13,12,1,1
11,2009,832400,6,6,0,0
12,2009,832400,4,3,1,4
1,2010,832400,5,5,0,1
2,2010,832400,7,7,0,1
3,2010,832400,4,4,0,3
4,2010,832400,4,4,0,2
5,2010,832400,11,9,2,4
6,2010,832400,6,6,0,0
7,2010,832400,9,7,2,1
8,2010,832400,13,13,0,1
9,2010,832400,15,13,2,1
10,2010,832400,6,6,0,1
11,2010,832400,8,8,0,0
12,2010,832400,7,7,0,0
1,2011,832400,8,8,0,5
2,2011,832400,4,4,0,0
1,1999,222600,17,15,2,3
2,1999,222600,12,12,0,17
3,1999,222600,13,11,2,7
4,1999,222600,4,3,1,11
5,1999,222600,13,11,2,12
6,1999,222600,7,6,1,7
7,1999,222600,14,11,3,7
8,1999,222600,17,13,4,10
9,1999,222600,12,10,2,4
10,1999,222600,12,10,2,8
11,1999,222600,10,5,5,17
12,1999,222600,9,8,1,2
1,2000,222600,16,13,3,15
2,2000,222600,9,6,3,5
3,2000,222600,12,10,2,8
4,2000,222600,13,9,4,2
5,2000,222600,13,12,1,4
6,2000,222600,13,9,4,4
7,2000,222600,15,14,1,10
8,2000,222600,16,12,4,12
9,2000,222600,7,7,0,0
10,2000,222600,14,12,2,0
11,2000,222600,11,10,1,1
12,2000,222600,10,10,0,0
1,2001,222600,6,4,2,0
2,2001,222600,6,6,0,1
3,2001,222600,10,7,3,2
4,2001,222600,7,5,2,5
5,2001,222600,9,9,0,0
6,2001,222600,6,4,2,0
7,2001,222600,15,13,2,4
8,2001,222600,8,8,0,1
9,2001,222600,9,8,1,1
10,2001,222600,12,10,2,1
11,2001,222600,9,8,1,0
12,2001,222600,10,8,2,0
1,2002,222600,9,9,0,0
2,2002,222600,6,6,0,0
3,2002,222600,7,7,0,0
4,2002,222600,8,7,1,3
5,2002,222600,5,5,0,1
6,2002,222600,3,1,2,3
7,2002,222600,11,8,3,2
8,2002,222600,8,6,2,7
9,2002,222600,11,9,2,0
10,2002,222600,10,9,1,2
11,2002,222600,8,7,1,1
12,2002,222600,5,3,2,5
1,2003,222600,9,9,0,0
2,2003,222600,10,9,1,7
3,2003,222600,7,7,0,1
4,2003,222600,10,10,0,2
5,2003,222600,5,5,0,0
6,2003,222600,13,13,0,0
7,2003,222600,19,18,1,1
8,2003,222600,10,10,0,0
9,2003,222600,7,7,0,0
10,2003,222600,9,9,0,3
11,2003,222600,8,7,1,0
12,2003,222600,6,5,1,0
1,2004,222600,12,11,1,0
2,2004,222600,7,7,0,1
3,2004,222600,3,2,1,0
4,2004,222600,4,4,0,1
5,2004,222600,11,10,1,0
6,2004,222600,10,10,0,1
7,2004,222600,13,12,1,1
8,2004,222600,10,10,0,1
9,2004,222600,9,9,0,0
10,2004,222600,1,1,0,2
11,2004,222600,8,7,1,1
12,2004,222600,9,9,0,2
1,2005,222600,9,9,0,0
2,2005,222600,3,3,0,1
3,2005,222600,7,6,1,1
4,2005,222600,6,5,1,1
5,2005,222600,2,2,0,2
6,2005,222600,10,9,1,0
7,2005,222600,13,11,2,2
8,2005,222600,10,10,0,0
9,2005,222600,9,9,0,3
10,2005,222600,5,5,0,3
11,2005,222600,12,11,1,1
12,2005,222600,8,8,0,0
1,2006,222600,4,4,0,5
2,2006,222600,2,2,0,0
3,2006,222600,16,14,2,3
4,2006,222600,10,10,0,2
5,2006,222600,13,13,0,4
6,2006,222600,7,6,1,1
7,2006,222600,3,3,0,2
8,2006,222600,10,9,1,3
9,2006,222600,10,10,0,3
10,2006,222600,13,12,1,2
11,2006,222600,9,9,0,0
12,2006,222600,7,7,0,0
1,2007,222600,5,4,1,1
2,2007,222600,3,3,0,2
3,2007,222600,10,9,1,0
4,2007,222600,9,9,0,1
5,2007,222600,10,10,0,1
6,2007,222600,15,14,1,1
7,2007,222600,8,8,0,4
8,2007,222600,7,6,1,1
9,2007,222600,9,9,0,0
10,2007,222600,3,2,1,0
11,2007,222600,7,7,0,2
12,2007,222600,6,6,0,0
1,2008,222600,3,3,0,4
2,2008,222600,3,3,0,2
3,2008,222600,9,7,2,1
4,2008,222600,5,5,0,1
5,2008,222600,7,7,0,1
6,2008,222600,5,5,0,1
7,2008,222600,8,6,2,0
8,2008,222600,4,4,0,1
9,2008,222600,6,6,0,2
10,2008,222600,10,8,2,0
11,2008,222600,8,8,0,0
12,2008,222600,4,3,1,1
1,2009,222600,7,6,1,0
2,2009,222600,12,12,0,1
3,2009,222600,6,5,1,1
4,2009,222600,11,9,2,0
5,2009,222600,3,3,0,1
6,2009,222600,14,14,0,1
7,2009,222600,4,4,0,1
8,2009,222600,8,8,0,3
9,2009,222600,8,8,0,4
10,2009,222600,11,11,0,1
11,2009,222600,1,1,0,2
12,2009,222600,12,10,2,1
1,2010,222600,0,0,0,0
2,2010,222600,4,4,0,1
3,2010,222600,13,13,0,1
4,2010,222600,2,2,0,1
5,2010,222600,15,14,1,0
6,2010,222600,7,6,1,2
7,2010,222600,7,6,1,0
8,2010,222600,10,8,2,0
9,2010,222600,9,8,1,1
10,2010,222600,1,1,0,1
11,2010,222600,6,5,1,2
12,2010,222600,6,6,0,0
1,2011,222600,5,5,0,0
2,2011,222600,7,6,1,1
1,1999,071600,9,9,0,0
2,1999,071600,6,6,0,1
3,1999,071600,18,18,0,0
4,1999,071600,12,11,1,0
5,1999,071600,13,13,0,0
6,1999,071600,14,13,1,0
7,1999,071600,9,9,0,0
8,1999,071600,10,10,0,0
9,1999,071600,7,7,0,0
10,1999,071600,7,7,0,0
11,1999,071600,5,5,0,2
12,1999,071600,6,6,0,1
1,2000,071600,3,3,0,0
2,2000,071600,8,8,0,0
3,2000,071600,8,8,0,0
4,2000,071600,4,4,0,0
5,2000,071600,7,7,0,0
6,2000,071600,5,5,0,0
7,2000,071600,14,14,0,0
8,2000,071600,12,12,0,0
9,2000,071600,15,15,0,0
10,2000,071600,5,5,0,0
11,2000,071600,3,3,0,0
12,2000,071600,7,7,0,0
1,2001,071600,6,6,0,0
2,2001,071600,4,4,0,0
3,2001,071600,7,7,0,0
4,2001,071600,10,10,0,0
5,2001,071600,8,8,0,0
6,2001,071600,7,7,0,0
7,2001,071600,5,5,0,1
8,2001,071600,10,9,1,0
9,2001,071600,4,4,0,0
10,2001,071600,12,12,0,0
11,2001,071600,6,6,0,0
12,2001,071600,11,11,0,1
1,2002,071600,9,9,0,0
2,2002,071600,7,7,0,0
3,2002,071600,3,3,0,0
4,2002,071600,5,5,0,0
5,2002,071600,5,5,0,0
6,2002,071600,8,8,0,0
7,2002,071600,8,8,0,0
8,2002,071600,16,16,0,0
9,2002,071600,2,2,0,0
10,2002,071600,7,7,0,0
11,2002,071600,8,8,0,0
12,2002,071600,8,8,0,0
1,2003,071600,4,4,0,0
2,2003,071600,3,3,0,0
3,2003,071600,7,7,0,0
4,2003,071600,8,8,0,0
5,2003,071600,8,8,0,0
6,2003,071600,6,6,0,0
7,2003,071600,4,4,0,1
8,2003,071600,6,6,0,0
9,2003,071600,5,5,0,0
10,2003,071600,4,4,0,0
11,2003,071600,5,5,0,0
12,2003,071600,7,7,0,0
1,2004,071600,3,3,0,1
2,2004,071600,2,2,0,0
3,2004,071600,4,4,0,0
4,2004,071600,7,7,0,0
5,2004,071600,3,3,0,0
6,2004,071600,2,2,0,0
7,2004,071600,8,8,0,0
8,2004,071600,9,9,0,0
9,2004,071600,15,15,0,0
10,2004,071600,12,12,0,0
11,2004,071600,4,4,0,0
12,2004,071600,3,3,0,0
1,2005,071600,4,4,0,0
2,2005,071600,2,2,0,0
3,2005,071600,3,3,0,0
4,2005,071600,6,5,1,0
5,2005,071600,9,9,0,0
6,2005,071600,5,5,0,0
7,2005,071600,5,5,0,0
8,2005,071600,10,10,0,0
9,2005,071600,6,6,0,0
10,2005,071600,10,10,0,0
11,2005,071600,5,5,0,0
12,2005,071600,1,1,0,0
1,2006,071600,1,1,0,0
2,2006,071600,1,1,0,0
3,2006,071600,4,4,0,0
4,2006,071600,4,4,0,0
5,2006,071600,10,10,0,0
6,2006,071600,5,5,0,0
7,2006,071600,3,3,0,0
8,2006,071600,5,5,0,0
9,2006,071600,14,14,0,0
10,2006,071600,8,8,0,1
11,2006,071600,14,14,0,0
12,2006,071600,10,10,0,2
1,2007,071600,1,1,0,0
2,2007,071600,5,5,0,0
3,2007,071600,5,5,0,0
4,2007,071600,8,7,1,0
5,2007,071600,8,8,0,0
6,2007,071600,10,10,0,0
7,2007,071600,8,8,0,0
8,2007,071600,9,9,0,0
9,2007,071600,3,3,0,0
10,2007,071600,10,10,0,0
11,2007,071600,9,9,0,0
12,2007,071600,8,8,0,1
1,2008,071600,6,6,0,0
2,2008,071600,5,5,0,0
3,2008,071600,10,10,0,0
4,2008,071600,5,5,0,0
5,2008,071600,5,5,0,0
6,2008,071600,8,8,0,0
7,2008,071600,12,11,1,0
8,2008,071600,8,8,0,0
9,2008,071600,5,5,0,0
10,2008,071600,5,5,0,0
11,2008,071600,8,8,0,0
12,2008,071600,2,2,0,0
1,2009,071600,6,6,0,0
2,2009,071600,3,3,0,0
3,2009,071600,4,4,0,0
4,2009,071600,4,4,0,0
5,2009,071600,6,6,0,0
6,2009,071600,6,6,0,0
7,2009,071600,3,3,0,0
8,2009,071600,6,6,0,0
9,2009,071600,5,5,0,0
10,2009,071600,5,5,0,0
11,2009,071600,3,2,1,0
12,2009,071600,7,7,0,0
1,2010,071600,2,2,0,0
2,2010,071600,1,1,0,0
3,2010,071600,6,6,0,0
4,2010,071600,2,2,0,0
5,2010,071600,5,5,0,0
6,2010,071600,4,4,0,0
7,2010,071600,11,9,2,0
8,2010,071600,16,16,0,0
9,2010,071600,9,9,0,0
10,2010,071600,8,8,0,0
11,2010,071600,3,3,0,0
12,2010,071600,5,5,0,0
1,2011,071600,3,3,0,0
2,2011,071600,3,3,0,0
1,1999,191000,18,13,5,2
2,1999,191000,8,8,0,2
3,1999,191000,15,11,4,2
4,1999,191000,19,19,0,0
5,1999,191000,16,12,4,1
6,1999,191000,20,15,5,6
7,1999,191000,22,21,1,7
8,1999,191000,23,21,2,1
9,1999,191000,22,20,2,1
10,1999,191000,25,22,3,4
11,1999,191000,14,12,2,4
12,1999,191000,16,16,0,3
1,2000,191000,15,10,5,0
2,2000,191000,16,14,2,1
3,2000,191000,23,22,1,2
4,2000,191000,18,16,2,3
5,2000,191000,17,14,3,2
6,2000,191000,15,13,2,0
7,2000,191000,24,20,4,2
8,2000,191000,20,19,1,3
9,2000,191000,16,15,1,6
10,2000,191000,24,18,6,6
11,2000,191000,13,13,0,3
12,2000,191000,11,11,0,4
1,2001,191000,15,13,2,5
2,2001,191000,12,11,1,4
3,2001,191000,11,10,1,7
4,2001,191000,17,13,4,4
5,2001,191000,16,13,3,3
6,2001,191000,17,15,2,2
7,2001,191000,22,19,3,0
8,2001,191000,15,13,2,3
9,2001,191000,15,15,0,3
10,2001,191000,21,18,3,6
11,2001,191000,16,11,5,3
12,2001,191000,22,18,4,3
1,2002,191000,15,15,0,3
2,2002,191000,14,12,2,5
3,2002,191000,14,13,1,3
4,2002,191000,23,22,1,2
5,2002,191000,14,12,2,4
6,2002,191000,11,10,1,3
7,2002,191000,16,14,2,1
8,2002,191000,15,14,1,3
9,2002,191000,16,13,3,1
10,2002,191000,21,18,3,2
11,2002,191000,15,14,1,1
12,2002,191000,15,13,2,3
1,2003,191000,13,12,1,2
2,2003,191000,13,12,1,5
3,2003,191000,10,9,1,0
4,2003,191000,18,15,3,1
5,2003,191000,17,16,1,1
6,2003,191000,14,12,2,2
7,2003,191000,20,20,0,0
8,2003,191000,15,11,4,1
9,2003,191000,13,10,3,2
10,2003,191000,24,22,2,4
11,2003,191000,24,23,1,2
12,2003,191000,24,23,1,3
1,2004,191000,8,6,2,0
2,2004,191000,10,9,1,0
3,2004,191000,17,16,1,6
4,2004,191000,18,17,1,6
5,2004,191000,19,17,2,3
6,2004,191000,19,16,3,2
7,2004,191000,31,25,6,3
8,2004,191000,13,11,2,6
9,2004,191000,9,8,1,7
10,2004,191000,17,15,2,3
11,2004,191000,18,18,0,5
12,2004,191000,12,10,2,3
1,2005,191000,19,18,1,1
2,2005,191000,10,9,1,3
3,2005,191000,8,7,1,2
4,2005,191000,9,9,0,1
5,2005,191000,4,4,0,1
6,2005,191000,16,14,2,4
7,2005,191000,11,9,2,2
8,2005,191000,14,13,1,2
9,2005,191000,19,16,3,2
10,2005,191000,23,22,1,2
11,2005,191000,16,14,2,1
12,2005,191000,16,16,0,1
1,2006,191000,10,8,2,1
2,2006,191000,21,20,1,1
3,2006,191000,16,16,0,4
4,2006,191000,13,12,1,10
5,2006,191000,9,8,1,0
6,2006,191000,16,16,0,0
7,2006,191000,13,9,4,3
8,2006,191000,20,18,2,3
9,2006,191000,18,16,2,0
10,2006,191000,6,5,1,2
11,2006,191000,11,11,0,2
12,2006,191000,8,8,0,1
1,2007,191000,13,12,1,1
2,2007,191000,7,6,1,6
3,2007,191000,10,10,0,1
4,2007,191000,14,14,0,3
5,2007,191000,12,10,2,3
6,2007,191000,8,7,1,3
7,2007,191000,15,13,2,4
8,2007,191000,15,14,1,0
9,2007,191000,16,14,2,6
10,2007,191000,13,12,1,3
11,2007,191000,12,11,1,1
12,2007,191000,14,12,2,2
1,2008,191000,15,15,0,4
2,2008,191000,14,13,1,0
3,2008,191000,7,6,1,0
4,2008,191000,7,7,0,2
5,2008,191000,10,8,2,3
6,2008,191000,13,13,0,2
7,2008,191000,11,10,1,1
8,2008,191000,14,13,1,3
9,2008,191000,15,13,2,2
10,2008,191000,19,16,3,5
11,2008,191000,13,11,2,3
12,2008,191000,8,6,2,1
1,2009,191000,11,8,3,1
2,2009,191000,12,11,1,4
3,2009,191000,8,8,0,1
4,2009,191000,12,12,0,4
5,2009,191000,13,12,1,2
6,2009,191000,11,9,2,4
7,2009,191000,8,7,1,3
8,2009,191000,8,8,0,5
9,2009,191000,12,10,2,2
10,2009,191000,13,12,1,3
11,2009,191000,5,4,1,3
12,2009,191000,12,9,3,6
1,2010,191000,10,9,1,3
2,2010,191000,7,7,0,2
3,2010,191000,7,6,1,2
4,2010,191000,6,5,1,1
5,2010,191000,8,7,1,4
6,2010,191000,3,2,1,9
7,2010,191000,4,3,1,4
8,2010,191000,7,5,2,3
9,2010,191000,11,8,3,3
10,2010,191000,14,14,0,4
11,2010,191000,15,14,1,3
12,2010,191000,11,10,1,2
1,2011,191000,8,7,1,1
2,2011,191000,2,2,0,1
1,1999,191100,35,33,2,3
2,1999,191100,34,28,6,4
3,1999,191100,27,25,2,5
4,1999,191100,33,28,5,4
5,1999,191100,27,25,2,10
6,1999,191100,21,18,3,1
7,1999,191100,29,26,3,2
8,1999,191100,41,36,5,1
9,1999,191100,23,21,2,1
10,1999,191100,35,31,4,3
11,1999,191100,28,25,3,7
12,1999,191100,28,25,3,4
1,2000,191100,25,23,2,9
2,2000,191100,15,12,3,5
3,2000,191100,36,28,8,6
4,2000,191100,27,24,3,4
5,2000,191100,35,30,5,3
6,2000,191100,32,27,5,3
7,2000,191100,39,34,5,6
8,2000,191100,27,25,2,4
9,2000,191100,23,16,7,4
10,2000,191100,32,26,6,6
11,2000,191100,36,30,6,5
12,2000,191100,16,14,2,4
1,2001,191100,24,20,4,3
2,2001,191100,18,17,1,3
3,2001,191100,25,19,6,3
4,2001,191100,27,25,2,2
5,2001,191100,20,17,3,6
6,2001,191100,23,21,2,2
7,2001,191100,38,31,7,7
8,2001,191100,28,22,6,6
9,2001,191100,26,22,4,5
10,2001,191100,24,23,1,4
11,2001,191100,18,14,4,6
12,2001,191100,32,28,4,8
1,2002,191100,25,20,5,4
2,2002,191100,19,16,3,7
3,2002,191100,22,21,1,6
4,2002,191100,26,23,3,3
5,2002,191100,31,26,5,8
6,2002,191100,22,22,0,5
7,2002,191100,38,34,4,3
8,2002,191100,32,27,5,3
9,2002,191100,35,28,7,1
10,2002,191100,36,31,5,5
11,2002,191100,34,31,3,6
12,2002,191100,24,21,3,2
1,2003,191100,23,21,2,5
2,2003,191100,18,17,1,5
3,2003,191100,26,17,9,5
4,2003,191100,19,17,2,3
5,2003,191100,24,20,4,2
6,2003,191100,25,24,1,5
7,2003,191100,37,32,5,4
8,2003,191100,32,30,2,3
9,2003,191100,25,20,5,2
10,2003,191100,35,33,2,1
11,2003,191100,37,32,5,2
12,2003,191100,24,20,4,7
1,2004,191100,22,17,5,4
2,2004,191100,15,13,2,5
3,2004,191100,17,15,2,6
4,2004,191100,26,21,5,2
5,2004,191100,25,20,5,8
6,2004,191100,19,15,4,4
7,2004,191100,34,29,5,9
8,2004,191100,28,22,6,8
9,2004,191100,21,18,3,3
10,2004,191100,18,15,3,6
11,2004,191100,20,17,3,6
12,2004,191100,22,19,3,4
1,2005,191100,16,12,4,4
2,2005,191100,13,8,5,4
3,2005,191100,19,17,2,8
4,2005,191100,21,13,8,4
5,2005,191100,20,13,7,9
6,2005,191100,14,13,1,5
7,2005,191100,22,20,2,3
8,2005,191100,18,16,2,4
9,2005,191100,20,15,5,4
10,2005,191100,40,38,2,8
11,2005,191100,28,25,3,9
12,2005,191100,23,21,2,3
1,2006,191100,23,19,4,4
2,2006,191100,16,13,3,0
3,2006,191100,23,19,4,2
4,2006,191100,14,10,4,4
5,2006,191100,27,23,4,7
6,2006,191100,23,17,6,5
7,2006,191100,23,18,5,0
8,2006,191100,27,26,1,1
9,2006,191100,16,14,2,6
10,2006,191100,25,22,3,2
11,2006,191100,18,15,3,5
12,2006,191100,14,13,1,2
1,2007,191100,8,8,0,7
2,2007,191100,20,19,1,4
3,2007,191100,20,16,4,2
4,2007,191100,38,35,3,3
5,2007,191100,19,15,4,7
6,2007,191100,24,21,3,10
7,2007,191100,22,16,6,6
8,2007,191100,34,24,10,4
9,2007,191100,22,20,2,7
10,2007,191100,26,22,4,12
11,2007,191100,27,26,1,4
12,2007,191100,18,15,3,3
1,2008,191100,20,18,2,9
2,2008,191100,10,8,2,1
3,2008,191100,21,18,3,6
4,2008,191100,18,17,1,1
5,2008,191100,19,16,3,5
6,2008,191100,28,26,2,2
7,2008,191100,16,15,1,3
8,2008,191100,33,25,8,2
9,2008,191100,17,16,1,6
10,2008,191100,27,23,4,12
11,2008,191100,24,21,3,8
12,2008,191100,18,18,0,11
1,2009,191100,24,22,2,9
2,2009,191100,18,17,1,4
3,2009,191100,23,22,1,4
4,2009,191100,24,23,1,7
5,2009,191100,30,28,2,7
6,2009,191100,17,14,3,2
7,2009,191100,22,18,4,1
8,2009,191100,24,18,6,5
9,2009,191100,31,28,3,5
10,2009,191100,24,21,3,4
11,2009,191100,22,18,4,10
12,2009,191100,24,23,1,3
1,2010,191100,24,20,4,11
2,2010,191100,19,16,3,6
3,2010,191100,27,22,5,7
4,2010,191100,26,24,2,4
5,2010,191100,21,17,4,3
6,2010,191100,18,16,2,1
7,2010,191100,18,15,3,5
8,2010,191100,9,8,1,2
9,2010,191100,19,17,2,0
10,2010,191100,16,12,4,6
11,2010,191100,18,16,2,0
12,2010,191100,24,23,1,3
1,2011,191100,32,29,3,4
2,2011,191100,16,16,0,4
1,1999,222500,1,1,0,3
2,1999,222500,2,2,0,2
3,1999,222500,3,2,1,2
4,1999,222500,4,3,1,1
5,1999,222500,2,2,0,4
6,1999,222500,1,1,0,4
7,1999,222500,7,5,2,0
8,1999,222500,8,7,1,0
9,1999,222500,3,2,1,1
10,1999,222500,0,0,0,0
11,1999,222500,1,1,0,0
12,1999,222500,6,5,1,2
1,2000,222500,5,4,1,4
2,2000,222500,1,1,0,2
3,2000,222500,3,2,1,0
4,2000,222500,3,3,0,1
5,2000,222500,5,5,0,2
6,2000,222500,5,3,2,1
7,2000,222500,2,1,1,1
8,2000,222500,4,4,0,3
9,2000,222500,5,5,0,0
10,2000,222500,8,7,1,0
11,2000,222500,1,1,0,1
12,2000,222500,4,4,0,0
1,2001,222500,1,1,0,0
2,2001,222500,1,1,0,0
3,2001,222500,7,6,1,0
4,2001,222500,1,1,0,2
5,2001,222500,1,1,0,0
6,2001,222500,6,5,1,3
7,2001,222500,6,5,1,2
8,2001,222500,2,2,0,0
9,2001,222500,4,4,0,1
10,2001,222500,8,6,2,1
11,2001,222500,2,2,0,1
12,2001,222500,3,3,0,0
1,2002,222500,2,2,0,1
2,2002,222500,1,1,0,1
3,2002,222500,5,5,0,0
4,2002,222500,0,0,0,0
5,2002,222500,2,2,0,0
6,2002,222500,5,5,0,0
7,2002,222500,4,3,1,1
8,2002,222500,5,4,1,0
9,2002,222500,9,9,0,1
10,2002,222500,4,4,0,1
11,2002,222500,2,1,1,5
12,2002,222500,2,2,0,2
1,2003,222500,2,1,1,1
2,2003,222500,3,3,0,2
3,2003,222500,3,2,1,1
4,2003,222500,3,2,1,1
5,2003,222500,3,1,2,0
6,2003,222500,4,2,2,1
7,2003,222500,3,3,0,1
8,2003,222500,7,3,4,1
9,2003,222500,5,5,0,3
10,2003,222500,4,2,2,3
11,2003,222500,3,3,0,4
12,2003,222500,2,1,1,2
1,2004,222500,4,3,1,0
2,2004,222500,2,2,0,3
3,2004,222500,3,3,0,4
4,2004,222500,3,3,0,2
5,2004,222500,6,3,3,2
6,2004,222500,3,3,0,5
7,2004,222500,3,3,0,2
8,2004,222500,4,4,0,4
9,2004,222500,2,1,1,3
10,2004,222500,4,4,0,1
11,2004,222500,4,2,2,2
12,2004,222500,4,3,1,2
1,2005,222500,1,0,1,1
2,2005,222500,2,2,0,1
3,2005,222500,4,3,1,1
4,2005,222500,4,4,0,1
5,2005,222500,3,3,0,1
6,2005,222500,2,2,0,0
7,2005,222500,1,1,0,3
8,2005,222500,3,3,0,1
9,2005,222500,6,6,0,2
10,2005,222500,2,2,0,5
11,2005,222500,1,1,0,0
12,2005,222500,0,0,0,0
1,2006,222500,5,4,1,6
2,2006,222500,7,6,1,1
3,2006,222500,2,1,1,0
4,2006,222500,0,0,0,0
5,2006,222500,1,1,0,6
6,2006,222500,3,3,0,3
7,2006,222500,5,5,0,13
8,2006,222500,3,2,1,7
9,2006,222500,2,2,0,10
10,2006,222500,3,2,1,0
11,2006,222500,3,3,0,9
12,2006,222500,3,2,1,0
1,2007,222500,0,0,0,9
2,2007,222500,0,0,0,2
3,2007,222500,3,3,0,0
4,2007,222500,4,4,0,1
5,2007,222500,2,2,0,3
6,2007,222500,1,1,0,0
7,2007,222500,2,1,1,1
8,2007,222500,4,3,1,0
9,2007,222500,3,3,0,5
10,2007,222500,6,5,1,2
11,2007,222500,3,2,1,0
12,2007,222500,4,3,1,1
1,2008,222500,7,7,0,1
2,2008,222500,1,1,0,0
3,2008,222500,3,3,0,0
4,2008,222500,2,2,0,1
5,2008,222500,2,2,0,1
6,2008,222500,4,2,2,1
7,2008,222500,4,3,1,0
8,2008,222500,1,1,0,1
9,2008,222500,3,2,1,1
10,2008,222500,5,5,0,0
11,2008,222500,3,3,0,3
12,2008,222500,3,2,1,0
1,2009,222500,3,3,0,0
2,2009,222500,2,2,0,0
3,2009,222500,3,3,0,0
4,2009,222500,2,2,0,1
5,2009,222500,1,1,0,2
6,2009,222500,2,1,1,1
7,2009,222500,2,2,0,4
8,2009,222500,4,3,1,1
9,2009,222500,2,1,1,0
10,2009,222500,2,1,1,0
11,2009,222500,2,2,0,0
12,2009,222500,2,2,0,0
1,2010,222500,3,3,0,1
2,2010,222500,4,4,0,1
3,2010,222500,3,3,0,0
4,2010,222500,1,1,0,0
5,2010,222500,3,3,0,0
6,2010,222500,3,3,0,0
7,2010,222500,2,1,1,0
8,2010,222500,1,1,0,0
9,2010,222500,2,2,0,0
10,2010,222500,2,2,0,0
11,2010,222500,1,1,0,0
12,2010,222500,1,1,0,1
1,2011,222500,1,1,0,2
2,2011,222500,1,1,0,0
1,1999,222800,3,1,2,0
2,1999,222800,1,1,0,0
3,1999,222800,3,3,0,0
4,1999,222800,0,0,0,0
5,1999,222800,1,0,1,1
6,1999,222800,4,2,2,1
7,1999,222800,2,2,0,1
8,1999,222800,0,0,0,0
9,1999,222800,0,0,0,0
10,1999,222800,0,0,0,2
11,1999,222800,2,1,1,0
12,1999,222800,1,1,0,0
1,2000,222800,1,1,0,2
2,2000,222800,1,1,0,1
3,2000,222800,1,1,0,0
4,2000,222800,2,2,0,0
5,2000,222800,1,1,0,0
6,2000,222800,1,1,0,0
7,2000,222800,3,1,2,1
8,2000,222800,0,0,0,1
9,2000,222800,1,1,0,0
10,2000,222800,2,2,0,0
11,2000,222800,0,0,0,1
12,2000,222800,2,1,1,0
1,2001,222800,4,3,1,1
2,2001,222800,1,0,1,0
3,2001,222800,0,0,0,3
4,2001,222800,0,0,0,3
5,2001,222800,4,3,1,0
6,2001,222800,3,3,0,2
7,2001,222800,2,1,1,0
8,2001,222800,4,2,2,0
9,2001,222800,0,0,0,0
10,2001,222800,1,1,0,0
11,2001,222800,0,0,0,0
12,2001,222800,0,0,0,0
1,2002,222800,2,1,1,0
2,2002,222800,1,1,0,0
3,2002,222800,0,0,0,0
4,2002,222800,1,1,0,0
5,2002,222800,0,0,0,0
6,2002,222800,1,1,0,0
7,2002,222800,2,1,1,1
8,2002,222800,2,2,0,0
9,2002,222800,3,2,1,0
10,2002,222800,1,1,0,1
11,2002,222800,2,2,0,1
12,2002,222800,2,1,1,0
1,2003,222800,2,1,1,0
2,2003,222800,1,1,0,0
3,2003,222800,1,1,0,0
4,2003,222800,1,1,0,3
5,2003,222800,0,0,0,0
6,2003,222800,2,2,0,0
7,2003,222800,3,3,0,0
8,2003,222800,0,0,0,0
9,2003,222800,3,3,0,0
10,2003,222800,1,1,0,0
11,2003,222800,5,5,0,2
12,2003,222800,1,1,0,2
1,2004,222800,1,1,0,0
2,2004,222800,0,0,0,0
3,2004,222800,1,1,0,0
4,2004,222800,3,2,1,1
5,2004,222800,3,3,0,0
6,2004,222800,2,2,0,1
7,2004,222800,5,4,1,0
8,2004,222800,2,2,0,0
9,2004,222800,1,0,1,0
10,2004,222800,0,0,0,0
11,2004,222800,1,1,0,0
12,2004,222800,0,0,0,1
1,2005,222800,0,0,0,0
2,2005,222800,1,1,0,0
3,2005,222800,1,0,1,3
4,2005,222800,0,0,0,0
5,2005,222800,0,0,0,0
6,2005,222800,1,1,0,0
7,2005,222800,0,0,0,0
8,2005,222800,3,3,0,0
9,2005,222800,0,0,0,0
10,2005,222800,0,0,0,0
11,2005,222800,0,0,0,0
12,2005,222800,1,1,0,0
1,2006,222800,1,1,0,0
2,2006,222800,0,0,0,2
3,2006,222800,0,0,0,1
4,2006,222800,1,1,0,0
5,2006,222800,2,2,0,0
6,2006,222800,1,1,0,1
7,2006,222800,1,1,0,0
8,2006,222800,1,1,0,0
9,2006,222800,2,2,0,0
10,2006,222800,3,3,0,0
11,2006,222800,2,2,0,1
12,2006,222800,0,0,0,0
1,2007,222800,2,2,0,0
2,2007,222800,1,1,0,0
3,2007,222800,2,2,0,0
4,2007,222800,2,2,0,0
5,2007,222800,1,1,0,0
6,2007,222800,2,2,0,0
7,2007,222800,1,0,1,1
8,2007,222800,1,1,0,0
9,2007,222800,2,2,0,0
10,2007,222800,3,2,1,0
11,2007,222800,1,1,0,0
12,2007,222800,0,0,0,0
1,2008,222800,1,1,0,0
2,2008,222800,0,0,0,1
3,2008,222800,1,1,0,1
4,2008,222800,2,2,0,0
5,2008,222800,1,1,0,2
6,2008,222800,2,2,0,0
7,2008,222800,1,1,0,0
8,2008,222800,1,1,0,0
9,2008,222800,0,0,0,1
10,2008,222800,3,3,0,0
11,2008,222800,1,1,0,0
12,2008,222800,3,3,0,0
1,2009,222800,2,2,0,1
2,2009,222800,0,0,0,0
3,2009,222800,1,1,0,0
4,2009,222800,0,0,0,0
5,2009,222800,1,1,0,0
6,2009,222800,1,1,0,1
7,2009,222800,1,1,0,0
8,2009,222800,0,0,0,4
9,2009,222800,1,1,0,0
10,2009,222800,0,0,0,2
11,2009,222800,0,0,0,0
12,2009,222800,1,1,0,0
1,2010,222800,1,1,0,0
2,2010,222800,1,0,1,0
3,2010,222800,0,0,0,0
4,2010,222800,2,1,1,0
5,2010,222800,0,0,0,0
6,2010,222800,0,0,0,0
7,2010,222800,0,0,0,0
8,2010,222800,1,1,0,0
9,2010,222800,2,2,0,0
10,2010,222800,4,4,0,0
11,2010,222800,1,1,0,0
12,2010,222800,2,1,1,0
1,2011,222800,1,1,0,0
2,2011,222800,1,1,0,0
1,1999,832200,16,16,0,0
2,1999,832200,17,16,1,0
3,1999,832200,18,17,1,0
4,1999,832200,11,10,1,0
5,1999,832200,14,14,0,0
6,1999,832200,16,16,0,0
7,1999,832200,26,25,1,0
8,1999,832200,18,17,1,0
9,1999,832200,21,20,1,0
10,1999,832200,13,13,0,0
11,1999,832200,14,14,0,1
12,1999,832200,6,6,0,1
1,2000,832200,18,16,2,0
2,2000,832200,8,8,0,0
3,2000,832200,8,8,0,0
4,2000,832200,14,14,0,1
5,2000,832200,20,19,1,1
6,2000,832200,22,20,2,0
7,2000,832200,23,22,1,1
8,2000,832200,25,25,0,0
9,2000,832200,22,21,1,3
10,2000,832200,17,16,1,0
11,2000,832200,19,18,1,0
12,2000,832200,14,13,1,1
1,2001,832200,12,12,0,0
2,2001,832200,19,19,0,1
3,2001,832200,23,23,0,0
4,2001,832200,16,15,1,4
5,2001,832200,17,17,0,0
6,2001,832200,18,17,1,0
7,2001,832200,27,26,1,0
8,2001,832200,21,21,0,0
9,2001,832200,22,22,0,1
10,2001,832200,21,21,0,0
11,2001,832200,19,19,0,0
12,2001,832200,8,8,0,0
1,2002,832200,19,19,0,0
2,2002,832200,20,20,0,1
3,2002,832200,15,14,1,0
4,2002,832200,20,20,0,0
5,2002,832200,17,17,0,0
6,2002,832200,15,15,0,0
7,2002,832200,18,17,1,0
8,2002,832200,15,14,1,0
9,2002,832200,17,13,4,1
10,2002,832200,22,22,0,0
11,2002,832200,16,16,0,0
12,2002,832200,15,15,0,1
1,2003,832200,18,17,1,0
2,2003,832200,17,17,0,0
3,2003,832200,16,16,0,1
4,2003,832200,21,21,0,2
5,2003,832200,13,13,0,1
6,2003,832200,9,8,1,0
7,2003,832200,16,16,0,0
8,2003,832200,16,16,0,0
9,2003,832200,16,14,2,0
10,2003,832200,11,10,1,1
11,2003,832200,12,10,2,0
12,2003,832200,11,11,0,0
1,2004,832200,19,19,0,0
2,2004,832200,9,9,0,0
3,2004,832200,13,12,1,0
4,2004,832200,12,12,0,0
5,2004,832200,8,8,0,0
6,2004,832200,17,17,0,0
7,2004,832200,24,23,1,0
8,2004,832200,37,35,2,0
9,2004,832200,10,10,0,0
10,2004,832200,14,13,1,0
11,2004,832200,30,30,0,0
12,2004,832200,15,15,0,0
1,2005,832200,14,14,0,1
2,2005,832200,9,8,1,0
3,2005,832200,6,6,0,0
4,2005,832200,17,16,1,0
5,2005,832200,9,8,1,0
6,2005,832200,16,16,0,0
7,2005,832200,10,10,0,0
8,2005,832200,13,13,0,0
9,2005,832200,12,12,0,0
10,2005,832200,16,16,0,0
11,2005,832200,14,14,0,0
12,2005,832200,7,6,1,0
1,2006,832200,9,8,1,0
2,2006,832200,8,7,1,0
3,2006,832200,11,11,0,1
4,2006,832200,13,12,1,1
5,2006,832200,12,12,0,0
6,2006,832200,15,15,0,0
7,2006,832200,14,14,0,0
8,2006,832200,13,12,1,0
9,2006,832200,11,11,0,0
10,2006,832200,13,13,0,0
11,2006,832200,11,11,0,0
12,2006,832200,15,14,1,0
1,2007,832200,10,10,0,1
2,2007,832200,12,12,0,0
3,2007,832200,12,12,0,0
4,2007,832200,13,12,1,0
5,2007,832200,13,11,2,0
6,2007,832200,7,7,0,0
7,2007,832200,24,23,1,1
8,2007,832200,21,21,0,1
9,2007,832200,18,18,0,0
10,2007,832200,30,28,2,0
11,2007,832200,17,17,0,2
12,2007,832200,18,18,0,0
1,2008,832200,20,19,1,0
2,2008,832200,20,20,0,0
3,2008,832200,13,13,0,0
4,2008,832200,13,13,0,1
5,2008,832200,12,12,0,0
6,2008,832200,10,10,0,0
7,2008,832200,21,21,0,0
8,2008,832200,22,22,0,0
9,2008,832200,12,10,2,1
10,2008,832200,17,17,0,0
11,2008,832200,16,15,1,0
12,2008,832200,21,21,0,0
1,2009,832200,14,14,0,0
2,2009,832200,12,12,0,1
3,2009,832200,21,21,0,0
4,2009,832200,13,13,0,0
5,2009,832200,7,7,0,0
6,2009,832200,7,6,1,1
7,2009,832200,17,17,0,0
8,2009,832200,14,13,1,0
9,2009,832200,9,9,0,0
10,2009,832200,12,12,0,0
11,2009,832200,19,18,1,0
12,2009,832200,11,11,0,0
1,2010,832200,14,14,0,0
2,2010,832200,8,7,1,0
3,2010,832200,13,13,0,0
4,2010,832200,16,15,1,0
5,2010,832200,12,12,0,0
6,2010,832200,15,15,0,2
7,2010,832200,10,10,0,0
8,2010,832200,14,14,0,0
9,2010,832200,11,11,0,0
10,2010,832200,19,19,0,0
11,2010,832200,9,9,0,0
12,2010,832200,11,10,1,0
1,2011,832200,12,12,0,0
2,2011,832200,6,6,0,0
1,1999,191200,28,27,1,2
2,1999,191200,16,12,4,12
3,1999,191200,21,12,9,8
4,1999,191200,13,11,2,7
5,1999,191200,24,22,2,4
6,1999,191200,22,20,2,7
7,1999,191200,20,13,7,8
8,1999,191200,24,22,2,10
9,1999,191200,18,17,1,9
10,1999,191200,22,20,2,9
11,1999,191200,15,14,1,6
12,1999,191200,12,9,3,8
1,2000,191200,23,18,5,3
2,2000,191200,18,14,4,12
3,2000,191200,17,13,4,6
4,2000,191200,17,11,6,4
5,2000,191200,26,24,2,12
6,2000,191200,25,21,4,7
7,2000,191200,21,17,4,10
8,2000,191200,19,14,5,9
9,2000,191200,25,22,3,9
10,2000,191200,19,17,2,11
11,2000,191200,19,16,3,8
12,2000,191200,22,19,3,8
1,2001,191200,19,16,3,9
2,2001,191200,18,14,4,6
3,2001,191200,13,11,2,6
4,2001,191200,20,18,2,6
5,2001,191200,16,14,2,9
6,2001,191200,23,18,5,10
7,2001,191200,30,25,5,6
8,2001,191200,24,20,4,6
9,2001,191200,21,14,7,10
10,2001,191200,25,16,9,15
11,2001,191200,19,13,6,6
12,2001,191200,16,12,4,2
1,2002,191200,22,18,4,2
2,2002,191200,30,27,3,2
3,2002,191200,27,21,6,1
4,2002,191200,20,15,5,7
5,2002,191200,24,15,9,3
6,2002,191200,22,21,1,4
7,2002,191200,31,27,4,3
8,2002,191200,25,20,5,8
9,2002,191200,19,16,3,5
10,2002,191200,30,27,3,7
11,2002,191200,21,18,3,3
12,2002,191200,15,14,1,2
1,2003,191200,21,17,4,6
2,2003,191200,18,16,2,0
3,2003,191200,11,7,4,5
4,2003,191200,17,12,5,3
5,2003,191200,25,17,8,1
6,2003,191200,21,18,3,2
7,2003,191200,14,10,4,4
8,2003,191200,18,17,1,7
9,2003,191200,19,14,5,3
10,2003,191200,15,15,0,1
11,2003,191200,13,13,0,1
12,2003,191200,15,12,3,3
1,2004,191200,17,15,2,3
2,2004,191200,14,12,2,7
3,2004,191200,18,18,0,11
4,2004,191200,21,18,3,5
5,2004,191200,26,23,3,6
6,2004,191200,28,21,7,2
7,2004,191200,29,21,8,5
8,2004,191200,23,20,3,4
9,2004,191200,22,18,4,6
10,2004,191200,8,8,0,2
11,2004,191200,16,14,2,8
12,2004,191200,13,11,2,2
1,2005,191200,7,6,1,4
2,2005,191200,16,16,0,2
3,2005,191200,23,21,2,6
4,2005,191200,15,11,4,3
5,2005,191200,25,23,2,14
6,2005,191200,23,19,4,10
7,2005,191200,31,27,4,7
8,2005,191200,17,16,1,7
9,2005,191200,35,33,2,5
10,2005,191200,25,23,2,4
11,2005,191200,17,15,2,2
12,2005,191200,18,18,0,3
1,2006,191200,13,11,2,2
2,2006,191200,12,11,1,6
3,2006,191200,14,12,2,8
4,2006,191200,12,9,3,6
5,2006,191200,16,14,2,10
6,2006,191200,19,15,4,0
7,2006,191200,12,10,2,4
8,2006,191200,13,10,3,4
9,2006,191200,15,13,2,0
10,2006,191200,11,7,4,4
11,2006,191200,20,19,1,3
12,2006,191200,7,4,3,7
1,2007,191200,13,9,4,4
2,2007,191200,18,17,1,6
3,2007,191200,14,13,1,8
4,2007,191200,17,13,4,7
5,2007,191200,13,12,1,8
6,2007,191200,18,12,6,10
7,2007,191200,20,13,7,10
8,2007,191200,15,13,2,9
9,2007,191200,24,23,1,10
10,2007,191200,20,15,5,6
11,2007,191200,12,11,1,2
12,2007,191200,24,23,1,3
1,2008,191200,20,19,1,4
2,2008,191200,17,17,0,4
3,2008,191200,18,14,4,9
4,2008,191200,13,12,1,8
5,2008,191200,25,20,5,13
6,2008,191200,19,13,6,6
7,2008,191200,17,13,4,12
8,2008,191200,20,16,4,7
9,2008,191200,23,18,5,5
10,2008,191200,15,13,2,4
11,2008,191200,21,16,5,9
12,2008,191200,19,17,2,3
1,2009,191200,23,18,5,10
2,2009,191200,22,20,2,6
3,2009,191200,23,21,2,5
4,2009,191200,19,16,3,4
5,2009,191200,21,19,2,5
6,2009,191200,24,19,5,6
7,2009,191200,21,18,3,7
8,2009,191200,17,13,4,3
9,2009,191200,25,21,4,12
10,2009,191200,16,11,5,12
11,2009,191200,13,12,1,8
12,2009,191200,11,9,2,4
1,2010,191200,18,15,3,8
2,2010,191200,11,9,2,13
3,2010,191200,21,15,6,12
4,2010,191200,12,10,2,6
5,2010,191200,26,21,5,8
6,2010,191200,19,16,3,5
7,2010,191200,15,12,3,5
8,2010,191200,9,9,0,6
9,2010,191200,17,14,3,13
10,2010,191200,11,9,2,13
11,2010,191200,14,11,3,5
12,2010,191200,14,13,1,4
1,2011,191200,16,14,2,6
2,2011,191200,11,10,1,2
1,1999,191301,19,18,1,2
2,1999,191301,18,16,2,1
3,1999,191301,21,18,3,1
4,1999,191301,13,13,0,4
5,1999,191301,21,19,2,0
6,1999,191301,15,15,0,3
7,1999,191301,28,24,4,3
8,1999,191301,16,13,3,1
9,1999,191301,15,15,0,2
10,1999,191301,16,11,5,0
11,1999,191301,21,21,0,3
12,1999,191301,13,12,1,2
1,2000,191301,9,9,0,2
2,2000,191301,13,8,5,0
3,2000,191301,14,10,4,5
4,2000,191301,16,15,1,6
5,2000,191301,17,14,3,8
6,2000,191301,26,22,4,5
7,2000,191301,16,14,2,3
8,2000,191301,20,16,4,1
9,2000,191301,23,20,3,2
10,2000,191301,18,14,4,4
11,2000,191301,18,18,0,5
12,2000,191301,14,11,3,0
1,2001,191301,15,12,3,2
2,2001,191301,7,6,1,1
3,2001,191301,16,15,1,4
4,2001,191301,17,16,1,0
5,2001,191301,22,21,1,0
6,2001,191301,15,15,0,4
7,2001,191301,18,16,2,1
8,2001,191301,26,20,6,3
9,2001,191301,16,16,0,2
10,2001,191301,27,20,7,1
11,2001,191301,19,16,3,2
12,2001,191301,15,14,1,4
1,2002,191301,21,17,4,2
2,2002,191301,29,24,5,5
3,2002,191301,24,24,0,3
4,2002,191301,17,16,1,4
5,2002,191301,18,16,2,6
6,2002,191301,18,18,0,4
7,2002,191301,26,20,6,4
8,2002,191301,13,13,0,4
9,2002,191301,18,18,0,1
10,2002,191301,17,12,5,0
11,2002,191301,13,13,0,2
12,2002,191301,13,13,0,2
1,2003,191301,17,17,0,0
2,2003,191301,19,16,3,3
3,2003,191301,16,12,4,1
4,2003,191301,16,13,3,4
5,2003,191301,14,14,0,0
6,2003,191301,18,14,4,3
7,2003,191301,19,16,3,1
8,2003,191301,25,20,5,2
9,2003,191301,23,18,5,3
10,2003,191301,19,18,1,2
11,2003,191301,25,18,7,4
12,2003,191301,12,10,2,1
1,2004,191301,10,9,1,0
2,2004,191301,12,10,2,9
3,2004,191301,13,12,1,2
4,2004,191301,8,7,1,4
5,2004,191301,18,15,3,7
6,2004,191301,20,15,5,2
7,2004,191301,30,26,4,5
8,2004,191301,19,15,4,2
9,2004,191301,18,17,1,3
10,2004,191301,16,14,2,5
11,2004,191301,17,15,2,2
12,2004,191301,15,13,2,6
1,2005,191301,13,11,2,2
2,2005,191301,13,12,1,4
3,2005,191301,14,12,2,2
4,2005,191301,10,9,1,4
5,2005,191301,16,15,1,7
6,2005,191301,20,17,3,4
7,2005,191301,20,16,4,8
8,2005,191301,20,19,1,3
9,2005,191301,7,7,0,4
10,2005,191301,13,9,4,2
11,2005,191301,23,21,2,10
12,2005,191301,13,12,1,2
1,2006,191301,15,15,0,2
2,2006,191301,17,14,3,6
3,2006,191301,7,6,1,5
4,2006,191301,15,13,2,3
5,2006,191301,14,12,2,4
6,2006,191301,15,13,2,5
7,2006,191301,18,12,6,4
8,2006,191301,19,15,4,7
9,2006,191301,23,19,4,2
10,2006,191301,10,7,3,4
11,2006,191301,9,6,3,5
12,2006,191301,10,10,0,0
1,2007,191301,17,15,2,1
2,2007,191301,12,10,2,0
3,2007,191301,12,11,1,7
4,2007,191301,14,11,3,3
5,2007,191301,15,14,1,4
6,2007,191301,8,6,2,6
7,2007,191301,21,17,4,4
8,2007,191301,26,23,3,3
9,2007,191301,13,13,0,4
10,2007,191301,8,8,0,1
11,2007,191301,18,17,1,2
12,2007,191301,17,15,2,1
1,2008,191301,16,14,2,2
2,2008,191301,6,5,1,2
3,2008,191301,19,19,0,2
4,2008,191301,8,7,1,2
5,2008,191301,27,22,5,2
6,2008,191301,16,13,3,5
7,2008,191301,24,21,3,6
8,2008,191301,21,16,5,6
9,2008,191301,11,10,1,5
10,2008,191301,20,16,4,3
11,2008,191301,21,19,2,2
12,2008,191301,17,17,0,2
1,2009,191301,17,15,2,5
2,2009,191301,17,16,1,3
3,2009,191301,16,12,4,1
4,2009,191301,12,9,3,12
5,2009,191301,20,12,8,4
6,2009,191301,9,7,2,5
7,2009,191301,21,20,1,4
8,2009,191301,18,17,1,3
9,2009,191301,20,17,3,2
10,2009,191301,14,14,0,6
11,2009,191301,13,10,3,3
12,2009,191301,17,15,2,3
1,2010,191301,20,20,0,1
2,2010,191301,11,9,2,1
3,2010,191301,21,18,3,8
4,2010,191301,13,7,6,4
5,2010,191301,16,13,3,3
6,2010,191301,11,9,2,6
7,2010,191301,16,15,1,4
8,2010,191301,19,15,4,10
9,2010,191301,19,18,1,5
10,2010,191301,14,12,2,3
11,2010,191301,13,12,1,1
12,2010,191301,14,13,1,1
1,2011,191301,16,13,3,11
2,2011,191301,3,2,1,1
1,1999,191302,17,15,2,1
2,1999,191302,16,16,0,0
3,1999,191302,22,22,0,1
4,1999,191302,18,13,5,1
5,1999,191302,24,19,5,2
6,1999,191302,30,28,2,1
7,1999,191302,21,15,6,6
8,1999,191302,17,15,2,3
9,1999,191302,15,14,1,6
10,1999,191302,18,16,2,5
11,1999,191302,20,18,2,1
12,1999,191302,15,13,2,1
1,2000,191302,11,11,0,7
2,2000,191302,16,14,2,0
3,2000,191302,11,11,0,2
4,2000,191302,10,10,0,0
5,2000,191302,22,17,5,13
6,2000,191302,19,18,1,0
7,2000,191302,27,24,3,3
8,2000,191302,16,14,2,0
9,2000,191302,25,25,0,3
10,2000,191302,26,24,2,2
11,2000,191302,23,17,6,0
12,2000,191302,9,8,1,0
1,2001,191302,20,19,1,2
2,2001,191302,12,12,0,2
3,2001,191302,18,13,5,6
4,2001,191302,14,11,3,5
5,2001,191302,11,11,0,0
6,2001,191302,24,19,5,1
7,2001,191302,21,15,6,2
8,2001,191302,27,23,4,6
9,2001,191302,21,19,2,2
10,2001,191302,20,16,4,2
11,2001,191302,14,12,2,2
12,2001,191302,26,25,1,2
1,2002,191302,27,22,5,0
2,2002,191302,20,19,1,7
3,2002,191302,26,22,4,5
4,2002,191302,21,17,4,4
5,2002,191302,13,11,2,3
6,2002,191302,27,22,5,9
7,2002,191302,22,16,6,4
8,2002,191302,26,23,3,4
9,2002,191302,23,20,3,3
10,2002,191302,18,15,3,2
11,2002,191302,11,10,1,1
12,2002,191302,14,12,2,0
1,2003,191302,13,9,4,0
2,2003,191302,15,12,3,1
3,2003,191302,17,16,1,3
4,2003,191302,18,15,3,3
5,2003,191302,19,14,5,4
6,2003,191302,21,16,5,0
7,2003,191302,15,13,2,5
8,2003,191302,20,18,2,3
9,2003,191302,12,9,3,7
10,2003,191302,13,13,0,5
11,2003,191302,11,9,2,4
12,2003,191302,16,13,3,2
1,2004,191302,16,16,0,1
2,2004,191302,15,14,1,2
3,2004,191302,21,19,2,1
4,2004,191302,14,10,4,8
5,2004,191302,19,14,5,4
6,2004,191302,14,10,4,2
7,2004,191302,8,5,3,3
8,2004,191302,17,14,3,2
9,2004,191302,19,18,1,2
10,2004,191302,21,17,4,2
11,2004,191302,18,17,1,13
12,2004,191302,12,10,2,1
1,2005,191302,14,13,1,2
2,2005,191302,11,11,0,5
3,2005,191302,13,11,2,5
4,2005,191302,10,10,0,2
5,2005,191302,14,10,4,3
6,2005,191302,13,13,0,3
7,2005,191302,15,13,2,11
8,2005,191302,33,29,4,5
9,2005,191302,12,12,0,4
10,2005,191302,16,15,1,2
11,2005,191302,18,16,2,1
12,2005,191302,14,13,1,1
1,2006,191302,12,12,0,1
2,2006,191302,12,11,1,1
3,2006,191302,13,13,0,4
4,2006,191302,11,11,0,2
5,2006,191302,16,15,1,3
6,2006,191302,19,17,2,5
7,2006,191302,20,16,4,4
8,2006,191302,13,10,3,2
9,2006,191302,5,5,0,3
10,2006,191302,19,16,3,1
11,2006,191302,19,18,1,4
12,2006,191302,15,13,2,3
1,2007,191302,19,17,2,3
2,2007,191302,12,12,0,1
3,2007,191302,21,17,4,6
4,2007,191302,12,9,3,3
5,2007,191302,12,9,3,4
6,2007,191302,19,15,4,6
7,2007,191302,20,19,1,6
8,2007,191302,17,13,4,2
9,2007,191302,18,14,4,4
10,2007,191302,13,12,1,10
11,2007,191302,14,13,1,2
12,2007,191302,15,13,2,5
1,2008,191302,15,13,2,2
2,2008,191302,19,18,1,6
3,2008,191302,21,19,2,10
4,2008,191302,18,16,2,3
5,2008,191302,11,7,4,8
6,2008,191302,15,14,1,6
7,2008,191302,14,13,1,3
8,2008,191302,14,12,2,11
9,2008,191302,18,17,1,5
10,2008,191302,22,20,2,7
11,2008,191302,10,10,0,5
12,2008,191302,18,18,0,1
1,2009,191302,12,9,3,6
2,2009,191302,14,13,1,2
3,2009,191302,16,14,2,5
4,2009,191302,23,21,2,6
5,2009,191302,19,17,2,2
6,2009,191302,8,8,0,5
7,2009,191302,16,14,2,6
8,2009,191302,19,15,4,6
9,2009,191302,16,14,2,7
10,2009,191302,10,9,1,5
11,2009,191302,14,12,2,6
12,2009,191302,18,15,3,8
1,2010,191302,13,12,1,3
2,2010,191302,16,15,1,2
3,2010,191302,17,16,1,6
4,2010,191302,21,19,2,5
5,2010,191302,17,14,3,5
6,2010,191302,18,15,3,4
7,2010,191302,17,16,1,3
8,2010,191302,23,21,2,2
9,2010,191302,13,9,4,7
10,2010,191302,21,19,2,5
11,2010,191302,14,11,3,1
12,2010,191302,13,11,2,3
1,2011,191302,13,12,1,2
2,2011,191302,14,13,1,3
1,1999,831500,15,15,0,0
2,1999,831500,18,16,2,1
3,1999,831500,17,14,3,0
4,1999,831500,16,16,0,0
5,1999,831500,17,16,1,2
6,1999,831500,13,13,0,0
7,1999,831500,13,12,1,0
8,1999,831500,22,18,4,0
9,1999,831500,17,16,1,1
10,1999,831500,25,25,0,0
11,1999,831500,17,16,1,0
12,1999,831500,15,14,1,0
1,2000,831500,15,14,1,0
2,2000,831500,15,14,1,0
3,2000,831500,18,17,1,0
4,2000,831500,23,23,0,1
5,2000,831500,16,15,1,2
6,2000,831500,21,19,2,0
7,2000,831500,19,18,1,0
8,2000,831500,6,5,1,3
9,2000,831500,13,13,0,3
10,2000,831500,20,20,0,0
11,2000,831500,21,21,0,1
12,2000,831500,19,19,0,0
1,2001,831500,13,13,0,0
2,2001,831500,11,11,0,1
3,2001,831500,14,14,0,1
4,2001,831500,12,11,1,2
5,2001,831500,17,16,1,0
6,2001,831500,20,19,1,1
7,2001,831500,22,20,2,1
8,2001,831500,18,18,0,0
9,2001,831500,14,13,1,0
10,2001,831500,8,8,0,1
11,2001,831500,20,20,0,1
12,2001,831500,10,9,1,0
1,2002,831500,17,16,1,3
2,2002,831500,10,8,2,1
3,2002,831500,9,9,0,1
4,2002,831500,4,4,0,0
5,2002,831500,20,19,1,0
6,2002,831500,9,9,0,2
7,2002,831500,14,13,1,1
8,2002,831500,19,18,1,0
9,2002,831500,16,16,0,0
10,2002,831500,14,13,1,1
11,2002,831500,11,9,2,0
12,2002,831500,14,12,2,0
1,2003,831500,9,8,1,0
2,2003,831500,18,17,1,4
3,2003,831500,14,13,1,1
4,2003,831500,14,14,0,1
5,2003,831500,13,13,0,0
6,2003,831500,11,11,0,1
7,2003,831500,20,20,0,0
8,2003,831500,13,13,0,0
9,2003,831500,14,14,0,0
10,2003,831500,15,15,0,0
11,2003,831500,12,10,2,2
12,2003,831500,10,10,0,0
1,2004,831500,10,10,0,0
2,2004,831500,7,7,0,0
3,2004,831500,17,16,1,1
4,2004,831500,7,7,0,0
5,2004,831500,7,7,0,0
6,2004,831500,27,26,1,0
7,2004,831500,9,9,0,0
8,2004,831500,7,6,1,0
9,2004,831500,12,10,2,0
10,2004,831500,14,13,1,4
11,2004,831500,10,10,0,1
12,2004,831500,9,8,1,0
1,2005,831500,13,13,0,1
2,2005,831500,8,8,0,0
3,2005,831500,10,7,3,0
4,2005,831500,10,9,1,0
5,2005,831500,22,22,0,1
6,2005,831500,8,7,1,1
7,2005,831500,11,11,0,1
8,2005,831500,14,14,0,3
9,2005,831500,13,12,1,0
10,2005,831500,22,19,3,0
11,2005,831500,9,7,2,0
12,2005,831500,10,10,0,1
1,2006,831500,17,16,1,3
2,2006,831500,20,20,0,1
3,2006,831500,14,14,0,0
4,2006,831500,6,6,0,0
5,2006,831500,17,17,0,0
6,2006,831500,18,18,0,0
7,2006,831500,6,6,0,1
8,2006,831500,10,9,1,0
9,2006,831500,10,9,1,0
10,2006,831500,11,10,1,1
11,2006,831500,11,9,2,2
12,2006,831500,12,12,0,0
1,2007,831500,10,9,1,2
2,2007,831500,7,7,0,0
3,2007,831500,13,13,0,1
4,2007,831500,12,12,0,0
5,2007,831500,23,22,1,0
6,2007,831500,11,10,1,0
7,2007,831500,11,10,1,0
8,2007,831500,16,15,1,0
9,2007,831500,13,12,1,0
10,2007,831500,15,14,1,0
11,2007,831500,6,6,0,1
12,2007,831500,11,11,0,1
1,2008,831500,12,12,0,1
2,2008,831500,8,8,0,0
3,2008,831500,8,8,0,0
4,2008,831500,13,12,1,0
5,2008,831500,14,12,2,2
6,2008,831500,12,12,0,0
7,2008,831500,16,15,1,1
8,2008,831500,14,14,0,0
9,2008,831500,24,23,1,0
10,2008,831500,28,28,0,2
11,2008,831500,25,24,1,1
12,2008,831500,19,19,0,0
1,2009,831500,20,20,0,0
2,2009,831500,15,13,2,0
3,2009,831500,17,15,2,0
4,2009,831500,14,14,0,0
5,2009,831500,18,17,1,0
6,2009,831500,17,17,0,0
7,2009,831500,13,11,2,1
8,2009,831500,23,22,1,0
9,2009,831500,15,14,1,0
10,2009,831500,24,23,1,0
11,2009,831500,25,25,0,0
12,2009,831500,16,15,1,0
1,2010,831500,19,18,1,0
2,2010,831500,12,11,1,0
3,2010,831500,10,10,0,0
4,2010,831500,18,18,0,0
5,2010,831500,13,13,0,1
6,2010,831500,13,13,0,1
7,2010,831500,8,8,0,2
8,2010,831500,7,7,0,0
9,2010,831500,17,17,0,0
10,2010,831500,11,11,0,0
11,2010,831500,8,8,0,0
12,2010,831500,8,8,0,0
1,2011,831500,9,8,1,1
2,2011,831500,10,9,1,3
1,1999,200402,25,20,5,6
2,1999,200402,16,14,2,2
3,1999,200402,12,10,2,3
4,1999,200402,23,20,3,3
5,1999,200402,22,19,3,3
6,1999,200402,25,22,3,6
7,1999,200402,30,21,9,6
8,1999,200402,27,21,6,6
9,1999,200402,19,15,4,1
10,1999,200402,17,15,2,3
11,1999,200402,22,17,5,5
12,1999,200402,25,23,2,4
1,2000,200402,24,22,2,2
2,2000,200402,16,15,1,2
3,2000,200402,18,16,2,1
4,2000,200402,13,10,3,3
5,2000,200402,10,10,0,3
6,2000,200402,16,14,2,3
7,2000,200402,14,13,1,3
8,2000,200402,6,5,1,4
9,2000,200402,19,17,2,5
10,2000,200402,19,16,3,1
11,2000,200402,13,10,3,1
12,2000,200402,20,17,3,2
1,2001,200402,21,17,4,2
2,2001,200402,16,12,4,2
3,2001,200402,23,21,2,0
4,2001,200402,19,17,2,1
5,2001,200402,8,7,1,3
6,2001,200402,18,15,3,2
7,2001,200402,19,11,8,3
8,2001,200402,19,16,3,3
9,2001,200402,17,15,2,1
10,2001,200402,15,12,3,3
11,2001,200402,25,22,3,2
12,2001,200402,18,15,3,4
1,2002,200402,12,10,2,6
2,2002,200402,11,9,2,3
3,2002,200402,8,8,0,2
4,2002,200402,15,13,2,1
5,2002,200402,13,11,2,4
6,2002,200402,10,10,0,2
7,2002,200402,18,16,2,1
8,2002,200402,21,16,5,4
9,2002,200402,17,16,1,2
10,2002,200402,20,18,2,3
11,2002,200402,8,7,1,1
12,2002,200402,11,9,2,2
1,2003,200402,22,20,2,3
2,2003,200402,10,8,2,1
3,2003,200402,9,9,0,0
4,2003,200402,15,14,1,7
5,2003,200402,12,10,2,4
6,2003,200402,22,21,1,2
7,2003,200402,30,24,6,2
8,2003,200402,17,15,2,3
9,2003,200402,7,6,1,1
10,2003,200402,11,10,1,1
11,2003,200402,18,14,4,3
12,2003,200402,9,8,1,2
1,2004,200402,6,6,0,3
2,2004,200402,9,8,1,3
3,2004,200402,15,14,1,2
4,2004,200402,6,4,2,2
5,2004,200402,5,4,1,6
6,2004,200402,13,10,3,1
7,2004,200402,18,17,1,3
8,2004,200402,21,18,3,2
9,2004,200402,11,9,2,1
10,2004,200402,14,13,1,1
11,2004,200402,17,17,0,3
12,2004,200402,17,15,2,1
1,2005,200402,9,8,1,1
2,2005,200402,13,12,1,3
3,2005,200402,10,7,3,0
4,2005,200402,12,9,3,2
5,2005,200402,11,10,1,2
6,2005,200402,18,16,2,2
7,2005,200402,16,13,3,1
8,2005,200402,12,10,2,2
9,2005,200402,16,12,4,0
10,2005,200402,9,9,0,5
11,2005,200402,16,11,5,5
12,2005,200402,4,3,1,2
1,2006,200402,13,12,1,2
2,2006,200402,13,13,0,3
3,2006,200402,17,17,0,5
4,2006,200402,13,9,4,1
5,2006,200402,13,13,0,3
6,2006,200402,12,9,3,2
7,2006,200402,10,8,2,7
8,2006,200402,9,8,1,5
9,2006,200402,6,4,2,4
10,2006,200402,12,11,1,7
11,2006,200402,8,7,1,3
12,2006,200402,11,11,0,2
1,2007,200402,12,10,2,3
2,2007,200402,10,10,0,4
3,2007,200402,12,11,1,4
4,2007,200402,10,9,1,3
5,2007,200402,8,7,1,4
6,2007,200402,14,8,6,2
7,2007,200402,13,11,2,4
8,2007,200402,13,10,3,1
9,2007,200402,15,13,2,6
10,2007,200402,18,17,1,5
11,2007,200402,17,15,2,1
12,2007,200402,9,9,0,4
1,2008,200402,8,6,2,6
2,2008,200402,8,4,4,3
3,2008,200402,6,6,0,4
4,2008,200402,9,8,1,2
5,2008,200402,22,15,7,3
6,2008,200402,20,16,4,4
7,2008,200402,15,12,3,2
8,2008,200402,12,10,2,1
9,2008,200402,10,6,4,2
10,2008,200402,14,11,3,8
11,2008,200402,8,8,0,4
12,2008,200402,6,3,3,0
1,2009,200402,6,5,1,2
2,2009,200402,6,6,0,3
3,2009,200402,14,10,4,3
4,2009,200402,11,10,1,2
5,2009,200402,10,5,5,1
6,2009,200402,12,10,2,4
7,2009,200402,12,8,4,1
8,2009,200402,12,12,0,14
9,2009,200402,22,20,2,5
10,2009,200402,13,10,3,4
11,2009,200402,12,10,2,2
12,2009,200402,19,18,1,2
1,2010,200402,14,11,3,2
2,2010,200402,7,5,2,0
3,2010,200402,16,13,3,0
4,2010,200402,7,7,0,5
5,2010,200402,10,8,2,5
6,2010,200402,10,9,1,0
7,2010,200402,8,6,2,3
8,2010,200402,17,14,3,1
9,2010,200402,10,9,1,2
10,2010,200402,7,6,1,5
11,2010,200402,9,8,1,5
12,2010,200402,13,10,3,0
1,2011,200402,9,8,1,2
2,2011,200402,7,5,2,3
1,1999,832500,20,20,0,0
2,1999,832500,27,26,1,1
3,1999,832500,30,29,1,2
4,1999,832500,33,32,1,0
5,1999,832500,37,34,3,1
6,1999,832500,37,36,1,0
7,1999,832500,51,51,0,2
8,1999,832500,52,47,5,0
9,1999,832500,46,46,0,1
10,1999,832500,47,45,2,0
11,1999,832500,29,28,1,0
12,1999,832500,24,21,3,0
1,2000,832500,32,32,0,0
2,2000,832500,38,37,1,1
3,2000,832500,42,42,0,2
4,2000,832500,40,37,3,2
5,2000,832500,44,42,2,0
6,2000,832500,36,36,0,1
7,2000,832500,56,53,3,1
8,2000,832500,33,32,1,1
9,2000,832500,42,42,0,0
10,2000,832500,42,42,0,0
11,2000,832500,44,42,2,1
12,2000,832500,28,27,1,0
1,2001,832500,44,42,2,0
2,2001,832500,30,29,1,1
3,2001,832500,31,30,1,0
4,2001,832500,29,27,2,1
5,2001,832500,25,25,0,0
6,2001,832500,28,28,0,0
7,2001,832500,48,47,1,0
8,2001,832500,33,31,2,0
9,2001,832500,36,36,0,0
10,2001,832500,28,25,3,1
11,2001,832500,27,27,0,0
12,2001,832500,28,27,1,0
1,2002,832500,23,21,2,1
2,2002,832500,19,18,1,1
3,2002,832500,27,25,2,2
4,2002,832500,26,24,2,0
5,2002,832500,29,29,0,1
6,2002,832500,38,37,1,0
7,2002,832500,27,27,0,2
8,2002,832500,35,34,1,1
9,2002,832500,32,31,1,0
10,2002,832500,27,27,0,0
11,2002,832500,34,34,0,0
12,2002,832500,31,31,0,0
1,2003,832500,38,38,0,1
2,2003,832500,35,34,1,0
3,2003,832500,37,36,1,0
4,2003,832500,44,44,0,1
5,2003,832500,37,36,1,0
6,2003,832500,32,32,0,1
7,2003,832500,39,37,2,0
8,2003,832500,50,48,2,1
9,2003,832500,42,42,0,0
10,2003,832500,64,63,1,2
11,2003,832500,36,36,0,1
12,2003,832500,51,49,2,0
1,2004,832500,48,46,2,0
2,2004,832500,32,32,0,2
3,2004,832500,26,25,1,0
4,2004,832500,25,25,0,1
5,2004,832500,27,25,2,0
6,2004,832500,30,29,1,1
7,2004,832500,40,36,4,0
8,2004,832500,27,26,1,0
9,2004,832500,28,27,1,1
10,2004,832500,25,25,0,0
11,2004,832500,14,14,0,1
12,2004,832500,29,28,1,0
1,2005,832500,19,19,0,2
2,2005,832500,22,21,1,0
3,2005,832500,29,28,1,1
4,2005,832500,34,33,1,0
5,2005,832500,36,34,2,1
6,2005,832500,31,30,1,0
7,2005,832500,32,32,0,0
8,2005,832500,28,27,1,1
9,2005,832500,20,20,0,0
10,2005,832500,25,25,0,0
11,2005,832500,30,29,1,2
12,2005,832500,21,21,0,0
1,2006,832500,35,35,0,1
2,2006,832500,26,25,1,0
3,2006,832500,18,18,0,3
4,2006,832500,31,30,1,0
5,2006,832500,27,26,1,1
6,2006,832500,17,17,0,1
7,2006,832500,34,33,1,0
8,2006,832500,30,28,2,0
9,2006,832500,18,17,1,0
10,2006,832500,34,32,2,0
11,2006,832500,25,24,1,1
12,2006,832500,32,31,1,0
1,2007,832500,34,32,2,1
2,2007,832500,18,17,1,1
3,2007,832500,20,20,0,2
4,2007,832500,22,21,1,0
5,2007,832500,28,28,0,0
6,2007,832500,23,22,1,1
7,2007,832500,31,30,1,0
8,2007,832500,40,38,2,1
9,2007,832500,28,27,1,1
10,2007,832500,40,37,3,1
11,2007,832500,24,21,3,1
12,2007,832500,28,28,0,0
1,2008,832500,26,26,0,0
2,2008,832500,13,13,0,0
3,2008,832500,36,36,0,0
4,2008,832500,30,30,0,1
5,2008,832500,22,22,0,1
6,2008,832500,27,25,2,2
7,2008,832500,41,39,2,0
8,2008,832500,28,28,0,0
9,2008,832500,33,32,1,1
10,2008,832500,23,22,1,1
11,2008,832500,56,55,1,0
12,2008,832500,30,30,0,0
1,2009,832500,41,41,0,0
2,2009,832500,28,27,1,0
3,2009,832500,21,21,0,0
4,2009,832500,22,21,1,0
5,2009,832500,31,31,0,1
6,2009,832500,22,21,1,0
7,2009,832500,40,40,0,0
8,2009,832500,27,26,1,1
9,2009,832500,38,38,0,1
10,2009,832500,34,34,0,1
11,2009,832500,34,33,1,2
12,2009,832500,33,32,1,0
1,2010,832500,25,24,1,3
2,2010,832500,14,13,1,1
3,2010,832500,21,21,0,1
4,2010,832500,29,28,1,0
5,2010,832500,29,29,0,2
6,2010,832500,23,23,0,1
7,2010,832500,28,27,1,0
8,2010,832500,34,33,1,1
9,2010,832500,24,22,2,0
10,2010,832500,39,38,1,0
11,2010,832500,27,27,0,0
12,2010,832500,21,21,0,0
1,2011,832500,18,18,0,1
2,2011,832500,10,10,0,0
1,1999,220901,9,8,1,2
2,1999,220901,11,6,5,9
3,1999,220901,13,13,0,5
4,1999,220901,15,10,5,5
5,1999,220901,24,14,10,7
6,1999,220901,18,17,1,5
7,1999,220901,14,12,2,5
8,1999,220901,20,17,3,2
9,1999,220901,15,7,8,4
10,1999,220901,13,11,2,6
11,1999,220901,5,4,1,7
12,1999,220901,13,8,5,2
1,2000,220901,15,12,3,11
2,2000,220901,8,7,1,6
3,2000,220901,13,10,3,4
4,2000,220901,7,7,0,5
5,2000,220901,14,10,4,3
6,2000,220901,10,7,3,5
7,2000,220901,10,8,2,5
8,2000,220901,13,10,3,9
9,2000,220901,10,8,2,4
10,2000,220901,12,7,5,2
11,2000,220901,8,4,4,3
12,2000,220901,7,6,1,0
1,2001,220901,12,9,3,8
2,2001,220901,10,7,3,1
3,2001,220901,6,3,3,2
4,2001,220901,9,8,1,4
5,2001,220901,8,7,1,2
6,2001,220901,14,9,5,3
7,2001,220901,14,12,2,2
8,2001,220901,12,9,3,7
9,2001,220901,11,7,4,3
10,2001,220901,12,10,2,4
11,2001,220901,19,14,5,8
12,2001,220901,11,11,0,4
1,2002,220901,5,4,1,2
2,2002,220901,12,5,7,1
3,2002,220901,6,3,3,4
4,2002,220901,8,2,6,4
5,2002,220901,13,7,6,3
6,2002,220901,11,9,2,3
7,2002,220901,15,15,0,0
8,2002,220901,9,5,4,1
9,2002,220901,13,10,3,0
10,2002,220901,7,5,2,0
11,2002,220901,19,16,3,3
12,2002,220901,10,10,0,1
1,2003,220901,8,8,0,2
2,2003,220901,6,6,0,3
3,2003,220901,9,6,3,3
4,2003,220901,7,3,4,5
5,2003,220901,16,13,3,4
6,2003,220901,20,14,6,7
7,2003,220901,19,15,4,0
8,2003,220901,8,7,1,4
9,2003,220901,15,14,1,1
10,2003,220901,9,8,1,7
11,2003,220901,10,8,2,2
12,2003,220901,14,12,2,4
1,2004,220901,9,8,1,8
2,2004,220901,5,3,2,6
3,2004,220901,10,6,4,5
4,2004,220901,6,5,1,3
5,2004,220901,3,2,1,6
6,2004,220901,12,9,3,5
7,2004,220901,12,7,5,9
8,2004,220901,15,15,0,0
9,2004,220901,14,12,2,5
10,2004,220901,8,8,0,14
11,2004,220901,18,17,1,7
12,2004,220901,8,6,2,6
1,2005,220901,10,10,0,6
2,2005,220901,6,5,1,13
3,2005,220901,8,6,2,6
4,2005,220901,5,5,0,13
5,2005,220901,14,12,2,3
6,2005,220901,6,3,3,7
7,2005,220901,8,4,4,5
8,2005,220901,16,14,2,7
9,2005,220901,12,12,0,8
10,2005,220901,6,5,1,8
11,2005,220901,8,7,1,6
12,2005,220901,10,7,3,3
1,2006,220901,11,11,0,0
2,2006,220901,11,10,1,3
3,2006,220901,6,5,1,2
4,2006,220901,3,3,0,1
5,2006,220901,10,9,1,7
6,2006,220901,15,13,2,16
7,2006,220901,15,14,1,7
8,2006,220901,11,7,4,8
9,2006,220901,9,7,2,10
10,2006,220901,7,5,2,2
11,2006,220901,5,5,0,2
12,2006,220901,10,8,2,5
1,2007,220901,4,3,1,4
2,2007,220901,1,0,1,9
3,2007,220901,5,2,3,1
4,2007,220901,10,7,3,1
5,2007,220901,9,8,1,8
6,2007,220901,9,8,1,8
7,2007,220901,11,7,4,11
8,2007,220901,7,7,0,1
9,2007,220901,9,8,1,7
10,2007,220901,12,10,2,2
11,2007,220901,10,8,2,3
12,2007,220901,6,5,1,3
1,2008,220901,9,6,3,11
2,2008,220901,5,5,0,3
3,2008,220901,9,6,3,3
4,2008,220901,15,15,0,1
5,2008,220901,6,6,0,3
6,2008,220901,9,7,2,1
7,2008,220901,8,6,2,2
8,2008,220901,10,10,0,3
9,2008,220901,7,5,2,6
10,2008,220901,11,9,2,6
11,2008,220901,10,10,0,5
12,2008,220901,8,7,1,5
1,2009,220901,9,7,2,5
2,2009,220901,6,6,0,0
3,2009,220901,7,6,1,3
4,2009,220901,5,4,1,6
5,2009,220901,4,2,2,8
6,2009,220901,9,8,1,3
7,2009,220901,9,5,4,5
8,2009,220901,13,12,1,6
9,2009,220901,15,12,3,2
10,2009,220901,9,8,1,3
11,2009,220901,11,7,4,0
12,2009,220901,11,7,4,1
1,2010,220901,6,4,2,3
2,2010,220901,3,2,1,4
3,2010,220901,5,4,1,4
4,2010,220901,11,8,3,4
5,2010,220901,10,10,0,2
6,2010,220901,8,8,0,0
7,2010,220901,17,16,1,3
8,2010,220901,12,10,2,5
9,2010,220901,15,11,4,5
10,2010,220901,13,12,1,0
11,2010,220901,9,9,0,1
12,2010,220901,19,17,2,0
1,2011,220901,10,10,0,1
2,2011,220901,7,7,0,1
1,1999,221000,11,9,2,3
2,1999,221000,21,19,2,4
3,1999,221000,19,14,5,5
4,1999,221000,20,14,6,7
5,1999,221000,19,16,3,7
6,1999,221000,31,24,7,6
7,1999,221000,17,13,4,6
8,1999,221000,23,16,7,8
9,1999,221000,26,22,4,14
10,1999,221000,17,14,3,9
11,1999,221000,21,18,3,7
12,1999,221000,23,20,3,8
1,2000,221000,16,12,4,11
2,2000,221000,19,14,5,10
3,2000,221000,19,14,5,11
4,2000,221000,21,15,6,4
5,2000,221000,26,20,6,9
6,2000,221000,11,9,2,10
7,2000,221000,25,19,6,5
8,2000,221000,15,11,4,13
9,2000,221000,14,11,3,12
10,2000,221000,13,10,3,9
11,2000,221000,19,13,6,5
12,2000,221000,16,15,1,3
1,2001,221000,20,17,3,8
2,2001,221000,16,13,3,8
3,2001,221000,17,14,3,3
4,2001,221000,16,12,4,8
5,2001,221000,18,12,6,6
6,2001,221000,22,17,5,5
7,2001,221000,19,18,1,7
8,2001,221000,18,12,6,14
9,2001,221000,16,13,3,2
10,2001,221000,14,10,4,14
11,2001,221000,27,17,10,9
12,2001,221000,10,9,1,2
1,2002,221000,4,3,1,7
2,2002,221000,7,6,1,5
3,2002,221000,9,7,2,11
4,2002,221000,14,9,5,2
5,2002,221000,15,12,3,5
6,2002,221000,13,11,2,5
7,2002,221000,28,19,9,4
8,2002,221000,13,11,2,5
9,2002,221000,23,20,3,2
10,2002,221000,14,13,1,3
11,2002,221000,12,11,1,1
12,2002,221000,17,13,4,0
1,2003,221000,17,15,2,5
2,2003,221000,13,12,1,3
3,2003,221000,17,14,3,8
4,2003,221000,10,9,1,3
5,2003,221000,12,11,1,4
6,2003,221000,16,10,6,4
7,2003,221000,23,15,8,7
8,2003,221000,21,16,5,10
9,2003,221000,16,12,4,4
10,2003,221000,20,20,0,3
11,2003,221000,8,7,1,3
12,2003,221000,11,11,0,8
1,2004,221000,13,11,2,7
2,2004,221000,9,9,0,1
3,2004,221000,10,9,1,10
4,2004,221000,15,11,4,3
5,2004,221000,11,11,0,0
6,2004,221000,18,15,3,1
7,2004,221000,29,25,4,9
8,2004,221000,25,23,2,2
9,2004,221000,7,6,1,2
10,2004,221000,10,10,0,2
11,2004,221000,7,7,0,2
12,2004,221000,5,5,0,3
1,2005,221000,14,13,1,2
2,2005,221000,8,8,0,8
3,2005,221000,10,10,0,4
4,2005,221000,16,16,0,5
5,2005,221000,9,6,3,3
6,2005,221000,7,6,1,2
7,2005,221000,10,10,0,1
8,2005,221000,9,8,1,5
9,2005,221000,15,15,0,5
10,2005,221000,15,13,2,2
11,2005,221000,8,7,1,4
12,2005,221000,6,4,2,3
1,2006,221000,9,8,1,2
2,2006,221000,12,12,0,6
3,2006,221000,7,7,0,4
4,2006,221000,11,10,1,2
5,2006,221000,12,10,2,8
6,2006,221000,10,10,0,10
7,2006,221000,18,14,4,10
8,2006,221000,18,13,5,2
9,2006,221000,17,17,0,5
10,2006,221000,9,9,0,3
11,2006,221000,16,16,0,0
12,2006,221000,5,5,0,3
1,2007,221000,10,10,0,1
2,2007,221000,10,10,0,3
3,2007,221000,12,9,3,1
4,2007,221000,13,13,0,5
5,2007,221000,14,11,3,3
6,2007,221000,10,7,3,2
7,2007,221000,16,14,2,4
8,2007,221000,8,7,1,5
9,2007,221000,11,10,1,3
10,2007,221000,10,9,1,4
11,2007,221000,7,6,1,4
12,2007,221000,7,7,0,7
1,2008,221000,7,5,2,2
2,2008,221000,5,5,0,2
3,2008,221000,4,2,2,1
4,2008,221000,9,8,1,4
5,2008,221000,12,11,1,1
6,2008,221000,15,11,4,3
7,2008,221000,9,6,3,6
8,2008,221000,14,13,1,3
9,2008,221000,10,9,1,3
10,2008,221000,4,3,1,7
11,2008,221000,8,6,2,2
12,2008,221000,8,8,0,5
1,2009,221000,6,6,0,0
2,2009,221000,6,6,0,1
3,2009,221000,7,4,3,2
4,2009,221000,7,7,0,5
5,2009,221000,9,9,0,6
6,2009,221000,4,3,1,2
7,2009,221000,8,7,1,2
8,2009,221000,7,6,1,4
9,2009,221000,16,14,2,2
10,2009,221000,13,13,0,0
11,2009,221000,8,8,0,6
12,2009,221000,17,16,1,3
1,2010,221000,9,7,2,4
2,2010,221000,7,4,3,5
3,2010,221000,9,6,3,4
4,2010,221000,15,14,1,1
5,2010,221000,9,7,2,5
6,2010,221000,9,8,1,4
7,2010,221000,16,14,2,5
8,2010,221000,16,14,2,2
9,2010,221000,15,14,1,2
10,2010,221000,10,10,0,2
11,2010,221000,7,5,2,1
12,2010,221000,9,6,3,1
1,2011,221000,9,7,2,3
2,2011,221000,3,3,0,1
1,1999,221100,23,21,2,9
2,1999,221100,20,18,2,1
3,1999,221100,36,27,9,6
4,1999,221100,28,22,6,0
5,1999,221100,24,21,3,2
6,1999,221100,38,32,6,3
7,1999,221100,22,18,4,2
8,1999,221100,33,29,4,4
9,1999,221100,34,32,2,8
10,1999,221100,36,29,7,4
11,1999,221100,36,29,7,3
12,1999,221100,39,36,3,4
1,2000,221100,33,31,2,3
2,2000,221100,27,25,2,0
3,2000,221100,39,34,5,4
4,2000,221100,31,26,5,3
5,2000,221100,51,42,9,3
6,2000,221100,36,27,9,2
7,2000,221100,46,38,8,8
8,2000,221100,40,35,5,3
9,2000,221100,33,27,6,4
10,2000,221100,21,20,1,3
11,2000,221100,28,26,2,3
12,2000,221100,21,17,4,2
1,2001,221100,25,22,3,2
2,2001,221100,24,21,3,1
3,2001,221100,21,18,3,6
4,2001,221100,20,17,3,3
5,2001,221100,25,17,8,2
6,2001,221100,29,25,4,5
7,2001,221100,31,28,3,4
8,2001,221100,38,36,2,3
9,2001,221100,30,27,3,7
10,2001,221100,26,22,4,11
11,2001,221100,18,17,1,0
12,2001,221100,25,20,5,3
1,2002,221100,21,18,3,3
2,2002,221100,19,15,4,2
3,2002,221100,25,22,3,3
4,2002,221100,14,13,1,4
5,2002,221100,15,13,2,5
6,2002,221100,29,26,3,2
7,2002,221100,36,32,4,4
8,2002,221100,44,42,2,2
9,2002,221100,29,27,2,3
10,2002,221100,44,43,1,2
11,2002,221100,22,18,4,0
12,2002,221100,18,18,0,3
1,2003,221100,21,16,5,4
2,2003,221100,24,17,7,7
3,2003,221100,28,25,3,2
4,2003,221100,27,23,4,5
5,2003,221100,22,19,3,6
6,2003,221100,31,28,3,1
7,2003,221100,39,35,4,5
8,2003,221100,26,24,2,5
9,2003,221100,35,33,2,1
10,2003,221100,32,27,5,2
11,2003,221100,18,17,1,5
12,2003,221100,35,34,1,4
1,2004,221100,16,15,1,6
2,2004,221100,21,19,2,3
3,2004,221100,24,19,5,4
4,2004,221100,20,18,2,1
5,2004,221100,25,22,3,6
6,2004,221100,25,20,5,7
7,2004,221100,37,36,1,7
8,2004,221100,29,28,1,3
9,2004,221100,22,20,2,2
10,2004,221100,20,18,2,3
11,2004,221100,15,14,1,4
12,2004,221100,31,29,2,1
1,2005,221100,22,21,1,2
2,2005,221100,17,17,0,7
3,2005,221100,16,15,1,5
4,2005,221100,23,20,3,3
5,2005,221100,20,16,4,3
6,2005,221100,26,22,4,1
7,2005,221100,25,25,0,1
8,2005,221100,27,25,2,3
9,2005,221100,16,13,3,1
10,2005,221100,25,24,1,1
11,2005,221100,25,22,3,5
12,2005,221100,21,21,0,0
1,2006,221100,27,25,2,1
2,2006,221100,13,12,1,2
3,2006,221100,24,21,3,3
4,2006,221100,17,15,2,0
5,2006,221100,24,22,2,2
6,2006,221100,17,16,1,17
7,2006,221100,28,26,2,2
8,2006,221100,22,18,4,0
9,2006,221100,29,28,1,2
10,2006,221100,20,20,0,0
11,2006,221100,17,14,3,1
12,2006,221100,20,20,0,4
1,2007,221100,14,13,1,4
2,2007,221100,16,15,1,2
3,2007,221100,13,11,2,7
4,2007,221100,21,19,2,5
5,2007,221100,22,20,2,5
6,2007,221100,17,14,3,4
7,2007,221100,36,32,4,1
8,2007,221100,29,27,2,8
9,2007,221100,31,27,4,2
10,2007,221100,19,19,0,1
11,2007,221100,21,18,3,0
12,2007,221100,19,18,1,1
1,2008,221100,19,19,0,5
2,2008,221100,14,12,2,4
3,2008,221100,13,13,0,4
4,2008,221100,16,12,4,3
5,2008,221100,22,18,4,2
6,2008,221100,19,16,3,1
7,2008,221100,26,24,2,2
8,2008,221100,20,16,4,5
9,2008,221100,25,22,3,3
10,2008,221100,23,20,3,2
11,2008,221100,22,21,1,3
12,2008,221100,15,14,1,2
1,2009,221100,17,16,1,2
2,2009,221100,20,18,2,2
3,2009,221100,25,24,1,4
4,2009,221100,13,12,1,5
5,2009,221100,23,23,0,2
6,2009,221100,22,20,2,5
7,2009,221100,22,21,1,5
8,2009,221100,14,11,3,8
9,2009,221100,24,23,1,0
10,2009,221100,17,16,1,1
11,2009,221100,24,23,1,6
12,2009,221100,16,16,0,2
1,2010,221100,19,17,2,3
2,2010,221100,19,18,1,4
3,2010,221100,24,22,2,1
4,2010,221100,22,18,4,2
5,2010,221100,22,19,3,1
6,2010,221100,21,20,1,1
7,2010,221100,21,21,0,3
8,2010,221100,27,26,1,4
9,2010,221100,24,21,3,3
10,2010,221100,22,22,0,2
11,2010,221100,20,20,0,2
12,2010,221100,25,25,0,1
1,2011,221100,21,21,0,2
2,2011,221100,6,5,1,0
1,1999,221200,8,6,2,1
2,1999,221200,9,8,1,1
3,1999,221200,7,7,0,2
4,1999,221200,9,6,3,0
5,1999,221200,6,5,1,1
6,1999,221200,7,6,1,1
7,1999,221200,14,13,1,1
8,1999,221200,6,6,0,2
9,1999,221200,10,9,1,0
10,1999,221200,17,12,5,0
11,1999,221200,8,8,0,0
12,1999,221200,3,1,2,2
1,2000,221200,13,10,3,3
2,2000,221200,11,9,2,0
3,2000,221200,7,7,0,3
4,2000,221200,7,5,2,2
5,2000,221200,11,11,0,1
6,2000,221200,18,13,5,1
7,2000,221200,19,19,0,1
8,2000,221200,20,19,1,7
9,2000,221200,14,13,1,1
10,2000,221200,12,11,1,5
11,2000,221200,10,9,1,4
12,2000,221200,7,6,1,1
1,2001,221200,7,7,0,0
2,2001,221200,10,7,3,0
3,2001,221200,7,7,0,4
4,2001,221200,7,6,1,0
5,2001,221200,10,10,0,2
6,2001,221200,13,12,1,5
7,2001,221200,14,10,4,3
8,2001,221200,15,14,1,2
9,2001,221200,16,15,1,3
10,2001,221200,15,11,4,0
11,2001,221200,10,7,3,0
12,2001,221200,15,14,1,0
1,2002,221200,5,4,1,1
2,2002,221200,7,6,1,0
3,2002,221200,9,9,0,0
4,2002,221200,8,7,1,1
5,2002,221200,8,7,1,1
6,2002,221200,13,12,1,0
7,2002,221200,13,13,0,0
8,2002,221200,13,12,1,0
9,2002,221200,11,8,3,0
10,2002,221200,14,13,1,3
11,2002,221200,11,11,0,1
12,2002,221200,2,2,0,0
1,2003,221200,12,10,2,0
2,2003,221200,9,9,0,1
3,2003,221200,7,7,0,1
4,2003,221200,18,15,3,1
5,2003,221200,11,10,1,0
6,2003,221200,10,8,2,0
7,2003,221200,12,10,2,2
8,2003,221200,13,11,2,1
9,2003,221200,12,12,0,4
10,2003,221200,14,11,3,0
11,2003,221200,15,14,1,2
12,2003,221200,7,7,0,3
1,2004,221200,12,11,1,0
2,2004,221200,5,5,0,1
3,2004,221200,4,2,2,0
4,2004,221200,6,4,2,1
5,2004,221200,10,9,1,6
6,2004,221200,10,8,2,3
7,2004,221200,9,7,2,1
8,2004,221200,13,13,0,2
9,2004,221200,15,11,4,4
10,2004,221200,17,16,1,1
11,2004,221200,8,7,1,0
12,2004,221200,11,11,0,2
1,2005,221200,4,3,1,1
2,2005,221200,8,5,3,2
3,2005,221200,8,8,0,0
4,2005,221200,6,6,0,1
5,2005,221200,8,8,0,3
6,2005,221200,14,12,2,2
7,2005,221200,8,5,3,2
8,2005,221200,11,11,0,0
9,2005,221200,5,3,2,3
10,2005,221200,7,7,0,1
11,2005,221200,8,8,0,1
12,2005,221200,8,6,2,0
1,2006,221200,8,8,0,0
2,2006,221200,10,10,0,0
3,2006,221200,8,7,1,0
4,2006,221200,6,6,0,0
5,2006,221200,7,4,3,0
6,2006,221200,8,7,1,1
7,2006,221200,10,9,1,2
8,2006,221200,3,3,0,1
9,2006,221200,12,12,0,0
10,2006,221200,10,9,1,3
11,2006,221200,12,12,0,0
12,2006,221200,11,11,0,3
1,2007,221200,9,8,1,0
2,2007,221200,2,2,0,1
3,2007,221200,15,11,4,0
4,2007,221200,6,5,1,0
5,2007,221200,9,9,0,1
6,2007,221200,11,11,0,4
7,2007,221200,18,18,0,2
8,2007,221200,13,12,1,2
9,2007,221200,8,8,0,5
10,2007,221200,14,14,0,6
11,2007,221200,18,18,0,1
12,2007,221200,2,2,0,1
1,2008,221200,9,9,0,0
2,2008,221200,12,12,0,0
3,2008,221200,6,6,0,0
4,2008,221200,14,14,0,3
5,2008,221200,14,11,3,2
6,2008,221200,3,2,1,0
7,2008,221200,15,15,0,2
8,2008,221200,16,13,3,2
9,2008,221200,15,15,0,0
10,2008,221200,15,15,0,0
11,2008,221200,4,4,0,3
12,2008,221200,7,6,1,1
1,2009,221200,4,4,0,2
2,2009,221200,7,6,1,1
3,2009,221200,10,10,0,1
4,2009,221200,13,11,2,0
5,2009,221200,13,12,1,0
6,2009,221200,10,7,3,0
7,2009,221200,12,12,0,2
8,2009,221200,6,6,0,0
9,2009,221200,11,11,0,0
10,2009,221200,5,5,0,2
11,2009,221200,8,8,0,1
12,2009,221200,5,5,0,0
1,2010,221200,9,9,0,1
2,2010,221200,8,7,1,2
3,2010,221200,3,2,1,2
4,2010,221200,5,3,2,1
5,2010,221200,10,9,1,0
6,2010,221200,3,2,1,0
7,2010,221200,9,9,0,0
8,2010,221200,13,12,1,1
9,2010,221200,9,9,0,0
10,2010,221200,14,13,1,1
11,2010,221200,6,6,0,1
12,2010,221200,4,4,0,0
1,2011,221200,3,3,0,0
2,2011,221200,1,1,0,0
1,1999,221300,18,15,3,6
2,1999,221300,13,11,2,5
3,1999,221300,22,21,1,7
4,1999,221300,19,17,2,4
5,1999,221300,24,20,4,2
6,1999,221300,22,20,2,9
7,1999,221300,23,22,1,6
8,1999,221300,30,25,5,6
9,1999,221300,19,18,1,1
10,1999,221300,28,22,6,5
11,1999,221300,16,14,2,4
12,1999,221300,17,13,4,3
1,2000,221300,16,14,2,2
2,2000,221300,13,10,3,7
3,2000,221300,13,12,1,1
4,2000,221300,21,17,4,6
5,2000,221300,27,23,4,2
6,2000,221300,29,23,6,2
7,2000,221300,25,25,0,2
8,2000,221300,23,21,2,8
9,2000,221300,24,21,3,2
10,2000,221300,19,17,2,4
11,2000,221300,25,24,1,3
12,2000,221300,22,18,4,1
1,2001,221300,28,24,4,5
2,2001,221300,16,15,1,9
3,2001,221300,19,17,2,2
4,2001,221300,25,21,4,4
5,2001,221300,22,18,4,4
6,2001,221300,29,25,4,4
7,2001,221300,26,22,4,6
8,2001,221300,28,26,2,3
9,2001,221300,35,29,6,0
10,2001,221300,21,18,3,4
11,2001,221300,19,18,1,2
12,2001,221300,19,18,1,5
1,2002,221300,16,14,2,2
2,2002,221300,11,9,2,5
3,2002,221300,20,19,1,3
4,2002,221300,14,12,2,0
5,2002,221300,16,16,0,5
6,2002,221300,20,15,5,1
7,2002,221300,20,17,3,3
8,2002,221300,27,25,2,0
9,2002,221300,22,19,3,1
10,2002,221300,23,20,3,5
11,2002,221300,24,24,0,1
12,2002,221300,23,20,3,3
1,2003,221300,22,21,1,1
2,2003,221300,15,13,2,2
3,2003,221300,14,13,1,0
4,2003,221300,10,9,1,1
5,2003,221300,16,15,1,1
6,2003,221300,20,17,3,1
7,2003,221300,23,22,1,1
8,2003,221300,26,22,4,2
9,2003,221300,15,15,0,4
10,2003,221300,23,20,3,1
11,2003,221300,23,18,5,2
12,2003,221300,9,8,1,2
1,2004,221300,11,10,1,5
2,2004,221300,10,9,1,2
3,2004,221300,16,16,0,3
4,2004,221300,11,11,0,0
5,2004,221300,17,15,2,2
6,2004,221300,18,17,1,1
7,2004,221300,13,12,1,3
8,2004,221300,31,31,0,6
9,2004,221300,19,16,3,3
10,2004,221300,21,18,3,1
11,2004,221300,11,10,1,0
12,2004,221300,14,13,1,0
1,2005,221300,17,15,2,1
2,2005,221300,17,14,3,1
3,2005,221300,20,18,2,0
4,2005,221300,12,12,0,1
5,2005,221300,7,7,0,3
6,2005,221300,18,16,2,0
7,2005,221300,6,5,1,4
8,2005,221300,17,16,1,5
9,2005,221300,17,16,1,4
10,2005,221300,21,19,2,2
11,2005,221300,13,11,2,0
12,2005,221300,11,11,0,2
1,2006,221300,13,12,1,2
2,2006,221300,9,7,2,0
3,2006,221300,14,10,4,1
4,2006,221300,7,7,0,4
5,2006,221300,16,15,1,1
6,2006,221300,17,13,4,2
7,2006,221300,15,14,1,3
8,2006,221300,13,13,0,2
9,2006,221300,14,12,2,0
10,2006,221300,17,16,1,2
11,2006,221300,18,18,0,2
12,2006,221300,9,7,2,6
1,2007,221300,13,12,1,0
2,2007,221300,7,6,1,1
3,2007,221300,18,17,1,5
4,2007,221300,6,5,1,3
5,2007,221300,16,12,4,1
6,2007,221300,13,12,1,1
7,2007,221300,16,16,0,1
8,2007,221300,10,10,0,1
9,2007,221300,16,15,1,2
10,2007,221300,13,12,1,1
11,2007,221300,15,15,0,3
12,2007,221300,12,11,1,1
1,2008,221300,15,14,1,2
2,2008,221300,14,14,0,2
3,2008,221300,15,13,2,0
4,2008,221300,14,14,0,3
5,2008,221300,21,21,0,2
6,2008,221300,9,8,1,4
7,2008,221300,19,15,4,2
8,2008,221300,17,16,1,4
9,2008,221300,17,16,1,1
10,2008,221300,31,29,2,2
11,2008,221300,17,14,3,4
12,2008,221300,19,19,0,0
1,2009,221300,11,11,0,2
2,2009,221300,12,10,2,3
3,2009,221300,14,14,0,2
4,2009,221300,13,11,2,4
5,2009,221300,27,22,5,0
6,2009,221300,19,18,1,2
7,2009,221300,24,21,3,0
8,2009,221300,11,9,2,3
9,2009,221300,14,13,1,2
10,2009,221300,9,9,0,1
11,2009,221300,11,11,0,2
12,2009,221300,19,17,2,1
1,2010,221300,21,19,2,0
2,2010,221300,10,9,1,1
3,2010,221300,13,13,0,1
4,2010,221300,15,14,1,2
5,2010,221300,17,14,3,3
6,2010,221300,17,16,1,1
7,2010,221300,20,18,2,2
8,2010,221300,11,10,1,2
9,2010,221300,21,20,1,1
10,2010,221300,8,7,1,1
11,2010,221300,15,15,0,3
12,2010,221300,25,23,2,0
1,2011,221300,14,14,0,1
2,2011,221300,9,9,0,0
1,1999,221400,17,17,0,1
2,1999,221400,18,17,1,0
3,1999,221400,31,28,3,1
4,1999,221400,14,12,2,3
5,1999,221400,26,23,3,2
6,1999,221400,22,20,2,0
7,1999,221400,23,17,6,4
8,1999,221400,30,28,2,1
9,1999,221400,21,17,4,8
10,1999,221400,30,25,5,4
11,1999,221400,12,7,5,1
12,1999,221400,17,13,4,1
1,2000,221400,14,12,2,5
2,2000,221400,12,9,3,5
3,2000,221400,19,16,3,4
4,2000,221400,19,18,1,3
5,2000,221400,31,25,6,1
6,2000,221400,24,20,4,6
7,2000,221400,32,28,4,10
8,2000,221400,29,28,1,3
9,2000,221400,43,38,5,6
10,2000,221400,25,24,1,4
11,2000,221400,28,26,2,0
12,2000,221400,25,24,1,1
1,2001,221400,36,35,1,3
2,2001,221400,24,23,1,0
3,2001,221400,28,28,0,1
4,2001,221400,40,32,8,1
5,2001,221400,31,27,4,0
6,2001,221400,19,19,0,0
7,2001,221400,20,19,1,1
8,2001,221400,21,21,0,1
9,2001,221400,23,23,0,0
10,2001,221400,20,17,3,1
11,2001,221400,30,29,1,0
12,2001,221400,26,25,1,4
1,2002,221400,29,28,1,1
2,2002,221400,17,16,1,2
3,2002,221400,21,19,2,1
4,2002,221400,18,12,6,0
5,2002,221400,25,24,1,0
6,2002,221400,21,17,4,0
7,2002,221400,27,23,4,1
8,2002,221400,29,22,7,0
9,2002,221400,40,37,3,2
10,2002,221400,26,26,0,0
11,2002,221400,27,25,2,0
12,2002,221400,20,17,3,2
1,2003,221400,15,15,0,1
2,2003,221400,18,15,3,11
3,2003,221400,15,14,1,2
4,2003,221400,16,15,1,2
5,2003,221400,22,19,3,0
6,2003,221400,18,15,3,1
7,2003,221400,29,25,4,3
8,2003,221400,33,30,3,6
9,2003,221400,15,15,0,0
10,2003,221400,43,39,4,3
11,2003,221400,24,22,2,7
12,2003,221400,17,17,0,2
1,2004,221400,19,19,0,4
2,2004,221400,18,18,0,2
3,2004,221400,17,16,1,0
4,2004,221400,26,25,1,3
5,2004,221400,15,12,3,1
6,2004,221400,16,16,0,8
7,2004,221400,21,19,2,1
8,2004,221400,39,35,4,1
9,2004,221400,22,19,3,2
10,2004,221400,37,32,5,1
11,2004,221400,22,21,1,1
12,2004,221400,16,16,0,0
1,2005,221400,24,22,2,3
2,2005,221400,22,21,1,0
3,2005,221400,20,19,1,0
4,2005,221400,31,29,2,1
5,2005,221400,22,20,2,0
6,2005,221400,23,22,1,0
7,2005,221400,26,24,2,2
8,2005,221400,9,9,0,1
9,2005,221400,24,22,2,2
10,2005,221400,15,15,0,0
11,2005,221400,22,21,1,2
12,2005,221400,16,15,1,3
1,2006,221400,16,14,2,1
2,2006,221400,15,14,1,5
3,2006,221400,15,13,2,0
4,2006,221400,11,11,0,0
5,2006,221400,21,19,2,8
6,2006,221400,21,18,3,3
7,2006,221400,31,30,1,3
8,2006,221400,21,20,1,1
9,2006,221400,18,15,3,0
10,2006,221400,22,20,2,2
11,2006,221400,26,25,1,1
12,2006,221400,15,15,0,0
1,2007,221400,15,14,1,0
2,2007,221400,8,8,0,0
3,2007,221400,9,9,0,3
4,2007,221400,12,12,0,2
5,2007,221400,11,11,0,2
6,2007,221400,12,11,1,0
7,2007,221400,15,14,1,0
8,2007,221400,14,13,1,1
9,2007,221400,21,19,2,1
10,2007,221400,30,27,3,0
11,2007,221400,18,18,0,0
12,2007,221400,23,21,2,2
1,2008,221400,19,17,2,2
2,2008,221400,10,9,1,2
3,2008,221400,22,22,0,0
4,2008,221400,22,22,0,2
5,2008,221400,28,25,3,0
6,2008,221400,12,11,1,1
7,2008,221400,11,9,2,1
8,2008,221400,10,10,0,2
9,2008,221400,13,12,1,1
10,2008,221400,19,17,2,4
11,2008,221400,18,16,2,1
12,2008,221400,11,10,1,0
1,2009,221400,14,11,3,2
2,2009,221400,7,6,1,0
3,2009,221400,12,10,2,1
4,2009,221400,16,14,2,4
5,2009,221400,17,17,0,1
6,2009,221400,25,21,4,0
7,2009,221400,24,22,2,4
8,2009,221400,15,14,1,1
9,2009,221400,13,13,0,1
10,2009,221400,17,17,0,0
11,2009,221400,17,17,0,1
12,2009,221400,12,11,1,0
1,2010,221400,17,16,1,2
2,2010,221400,12,12,0,0
3,2010,221400,15,15,0,4
4,2010,221400,15,14,1,1
5,2010,221400,17,17,0,2
6,2010,221400,10,6,4,6
7,2010,221400,19,18,1,2
8,2010,221400,19,17,2,5
9,2010,221400,26,26,0,1
10,2010,221400,34,33,1,2
11,2010,221400,23,22,1,0
12,2010,221400,10,10,0,3
1,2011,221400,14,12,2,0
2,2011,221400,18,18,0,1
1,1999,221500,33,31,2,5
2,1999,221500,30,28,2,6
3,1999,221500,31,24,7,2
4,1999,221500,18,16,2,5
5,1999,221500,29,27,2,6
6,1999,221500,38,33,5,5
7,1999,221500,29,29,0,5
8,1999,221500,29,28,1,6
9,1999,221500,35,25,10,1
10,1999,221500,32,31,1,5
11,1999,221500,40,34,6,4
12,1999,221500,30,28,2,3
1,2000,221500,45,37,8,2
2,2000,221500,28,25,3,4
3,2000,221500,28,25,3,4
4,2000,221500,34,32,2,3
5,2000,221500,38,33,5,1
6,2000,221500,42,35,7,2
7,2000,221500,46,39,7,1
8,2000,221500,69,61,8,0
9,2000,221500,43,38,5,4
10,2000,221500,40,34,6,1
11,2000,221500,38,33,5,1
12,2000,221500,35,33,2,2
1,2001,221500,36,35,1,2
2,2001,221500,32,27,5,0
3,2001,221500,33,30,3,0
4,2001,221500,46,42,4,3
5,2001,221500,31,28,3,2
6,2001,221500,27,24,3,1
7,2001,221500,41,38,3,5
8,2001,221500,35,32,3,1
9,2001,221500,45,40,5,2
10,2001,221500,43,42,1,4
11,2001,221500,45,42,3,0
12,2001,221500,34,29,5,1
1,2002,221500,29,25,4,2
2,2002,221500,25,23,2,2
3,2002,221500,26,23,3,2
4,2002,221500,18,16,2,1
5,2002,221500,21,18,3,1
6,2002,221500,39,35,4,2
7,2002,221500,34,29,5,1
8,2002,221500,32,30,2,1
9,2002,221500,36,31,5,4
10,2002,221500,38,36,2,2
11,2002,221500,22,21,1,1
12,2002,221500,27,24,3,1
1,2003,221500,25,23,2,1
2,2003,221500,23,23,0,5
3,2003,221500,22,22,0,4
4,2003,221500,26,24,2,5
5,2003,221500,18,15,3,2
6,2003,221500,23,19,4,4
7,2003,221500,35,34,1,0
8,2003,221500,23,21,2,1
9,2003,221500,25,19,6,1
10,2003,221500,34,32,2,1
11,2003,221500,27,22,5,3
12,2003,221500,24,19,5,2
1,2004,221500,30,30,0,6
2,2004,221500,19,18,1,0
3,2004,221500,28,24,4,2
4,2004,221500,22,18,4,2
5,2004,221500,26,25,1,1
6,2004,221500,19,18,1,1
7,2004,221500,36,33,3,1
8,2004,221500,26,24,2,6
9,2004,221500,29,26,3,4
10,2004,221500,36,34,2,1
11,2004,221500,26,23,3,3
12,2004,221500,27,25,2,8
1,2005,221500,22,19,3,5
2,2005,221500,21,21,0,1
3,2005,221500,24,22,2,0
4,2005,221500,27,24,3,3
5,2005,221500,30,29,1,3
6,2005,221500,26,24,2,1
7,2005,221500,28,23,5,0
8,2005,221500,24,23,1,3
9,2005,221500,19,17,2,1
10,2005,221500,20,20,0,0
11,2005,221500,22,19,3,5
12,2005,221500,21,20,1,0
1,2006,221500,33,29,4,2
2,2006,221500,11,10,1,5
3,2006,221500,15,14,1,3
4,2006,221500,16,15,1,0
5,2006,221500,24,22,2,4
6,2006,221500,26,21,5,1
7,2006,221500,29,25,4,2
8,2006,221500,20,18,2,3
9,2006,221500,27,24,3,4
10,2006,221500,16,15,1,7
11,2006,221500,17,17,0,1
12,2006,221500,18,17,1,1
1,2007,221500,16,15,1,1
2,2007,221500,19,17,2,2
3,2007,221500,22,19,3,3
4,2007,221500,14,12,2,1
5,2007,221500,11,10,1,4
6,2007,221500,20,17,3,0
7,2007,221500,16,13,3,3
8,2007,221500,16,14,2,2
9,2007,221500,29,27,2,4
10,2007,221500,18,16,2,3
11,2007,221500,25,23,2,2
12,2007,221500,21,20,1,0
1,2008,221500,16,16,0,2
2,2008,221500,22,22,0,0
3,2008,221500,23,23,0,4
4,2008,221500,11,10,1,0
5,2008,221500,25,21,4,1
6,2008,221500,21,18,3,0
7,2008,221500,31,25,6,0
8,2008,221500,19,14,5,1
9,2008,221500,22,20,2,1
10,2008,221500,21,18,3,3
11,2008,221500,15,13,2,1
12,2008,221500,14,14,0,2
1,2009,221500,10,10,0,0
2,2009,221500,8,7,1,3
3,2009,221500,12,7,5,2
4,2009,221500,15,15,0,0
5,2009,221500,20,16,4,1
6,2009,221500,13,12,1,2
7,2009,221500,26,26,0,6
8,2009,221500,25,21,4,2
9,2009,221500,27,21,6,3
10,2009,221500,19,17,2,0
11,2009,221500,20,18,2,0
12,2009,221500,18,17,1,1
1,2010,221500,26,23,3,1
2,2010,221500,21,21,0,0
3,2010,221500,19,15,4,2
4,2010,221500,11,10,1,1
5,2010,221500,15,14,1,0
6,2010,221500,25,21,4,0
7,2010,221500,14,10,4,1
8,2010,221500,11,9,2,0
9,2010,221500,15,13,2,2
10,2010,221500,23,20,3,1
11,2010,221500,24,24,0,2
12,2010,221500,24,22,2,0
1,2011,221500,13,12,1,0
2,2011,221500,18,16,2,1
1,1999,221600,11,11,0,1
2,1999,221600,18,18,0,5
3,1999,221600,16,16,0,1
4,1999,221600,11,10,1,4
5,1999,221600,16,15,1,1
6,1999,221600,24,23,1,0
7,1999,221600,26,24,2,1
8,1999,221600,28,24,4,0
9,1999,221600,25,22,3,0
10,1999,221600,17,16,1,2
11,1999,221600,16,14,2,0
12,1999,221600,16,12,4,1
1,2000,221600,17,15,2,0
2,2000,221600,7,7,0,1
3,2000,221600,20,20,0,0
4,2000,221600,23,20,3,0
5,2000,221600,25,25,0,1
6,2000,221600,23,22,1,0
7,2000,221600,37,35,2,0
8,2000,221600,48,47,1,1
9,2000,221600,33,32,1,1
10,2000,221600,27,24,3,0
11,2000,221600,32,31,1,1
12,2000,221600,22,21,1,0
1,2001,221600,20,18,2,0
2,2001,221600,17,16,1,0
3,2001,221600,34,31,3,0
4,2001,221600,22,22,0,1
5,2001,221600,29,26,3,1
6,2001,221600,26,25,1,0
7,2001,221600,28,27,1,5
8,2001,221600,24,22,2,2
9,2001,221600,27,25,2,1
10,2001,221600,21,20,1,0
11,2001,221600,27,27,0,0
12,2001,221600,14,13,1,0
1,2002,221600,18,16,2,1
2,2002,221600,12,11,1,0
3,2002,221600,7,7,0,1
4,2002,221600,23,22,1,2
5,2002,221600,18,18,0,2
6,2002,221600,20,17,3,2
7,2002,221600,12,9,3,0
8,2002,221600,25,19,6,1
9,2002,221600,14,12,2,0
10,2002,221600,6,6,0,0
11,2002,221600,16,13,3,0
12,2002,221600,17,14,3,0
1,2003,221600,18,17,1,0
2,2003,221600,14,11,3,0
3,2003,221600,11,11,0,0
4,2003,221600,16,14,2,0
5,2003,221600,16,16,0,1
6,2003,221600,19,16,3,0
7,2003,221600,9,9,0,1
8,2003,221600,15,13,2,2
9,2003,221600,15,14,1,2
10,2003,221600,15,13,2,4
11,2003,221600,12,11,1,3
12,2003,221600,15,13,2,0
1,2004,221600,9,9,0,1
2,2004,221600,18,17,1,3
3,2004,221600,6,5,1,0
4,2004,221600,16,16,0,2
5,2004,221600,20,20,0,0
6,2004,221600,22,21,1,1
7,2004,221600,24,23,1,1
8,2004,221600,15,15,0,1
9,2004,221600,27,26,1,0
10,2004,221600,27,26,1,1
11,2004,221600,15,14,1,2
12,2004,221600,11,11,0,0
1,2005,221600,10,9,1,1
2,2005,221600,4,4,0,0
3,2005,221600,11,10,1,0
4,2005,221600,12,11,1,0
5,2005,221600,13,13,0,0
6,2005,221600,13,13,0,0
7,2005,221600,17,17,0,0
8,2005,221600,17,16,1,1
9,2005,221600,14,14,0,0
10,2005,221600,15,14,1,0
11,2005,221600,12,11,1,0
12,2005,221600,8,7,1,1
1,2006,221600,13,13,0,0
2,2006,221600,4,4,0,0
3,2006,221600,15,12,3,1
4,2006,221600,18,15,3,0
5,2006,221600,11,10,1,2
6,2006,221600,16,12,4,2
7,2006,221600,18,18,0,1
8,2006,221600,14,13,1,1
9,2006,221600,15,11,4,1
10,2006,221600,10,10,0,0
11,2006,221600,16,14,2,0
12,2006,221600,11,10,1,1
1,2007,221600,20,19,1,0
2,2007,221600,9,9,0,3
3,2007,221600,8,7,1,2
4,2007,221600,13,12,1,2
5,2007,221600,15,15,0,1
6,2007,221600,18,18,0,0
7,2007,221600,13,11,2,0
8,2007,221600,20,20,0,0
9,2007,221600,19,17,2,2
10,2007,221600,19,19,0,0
11,2007,221600,4,4,0,0
12,2007,221600,16,15,1,1
1,2008,221600,6,6,0,2
2,2008,221600,12,12,0,1
3,2008,221600,13,13,0,1
4,2008,221600,9,9,0,0
5,2008,221600,16,16,0,0
6,2008,221600,15,14,1,2
7,2008,221600,14,14,0,1
8,2008,221600,19,19,0,3
9,2008,221600,14,14,0,0
10,2008,221600,11,11,0,2
11,2008,221600,15,14,1,1
12,2008,221600,15,15,0,0
1,2009,221600,11,11,0,2
2,2009,221600,10,8,2,0
3,2009,221600,8,8,0,0
4,2009,221600,15,15,0,1
5,2009,221600,10,10,0,1
6,2009,221600,12,12,0,1
7,2009,221600,12,11,1,0
8,2009,221600,12,12,0,0
9,2009,221600,12,11,1,0
10,2009,221600,16,15,1,0
11,2009,221600,15,15,0,2
12,2009,221600,17,17,0,0
1,2010,221600,9,8,1,0
2,2010,221600,7,7,0,0
3,2010,221600,7,7,0,1
4,2010,221600,16,15,1,1
5,2010,221600,10,9,1,0
6,2010,221600,9,8,1,0
7,2010,221600,6,6,0,0
8,2010,221600,15,15,0,1
9,2010,221600,8,7,1,2
10,2010,221600,11,11,0,0
11,2010,221600,17,15,2,0
12,2010,221600,12,12,0,0
1,2011,221600,11,11,0,0
2,2011,221600,9,9,0,0
1,1999,071000,26,25,1,1
2,1999,071000,10,10,0,0
3,1999,071000,16,16,0,0
4,1999,071000,20,20,0,0
5,1999,071000,44,44,0,0
6,1999,071000,23,23,0,0
7,1999,071000,36,36,0,5
8,1999,071000,27,26,1,1
9,1999,071000,39,37,2,0
10,1999,071000,16,16,0,2
11,1999,071000,19,19,0,0
12,1999,071000,17,17,0,0
1,2000,071000,27,27,0,4
2,2000,071000,20,20,0,0
3,2000,071000,26,26,0,0
4,2000,071000,18,17,1,0
5,2000,071000,34,31,3,0
6,2000,071000,23,23,0,1
7,2000,071000,24,23,1,0
8,2000,071000,29,29,0,0
9,2000,071000,25,22,3,0
10,2000,071000,26,26,0,2
11,2000,071000,23,22,1,0
12,2000,071000,16,16,0,0
1,2001,071000,22,22,0,1
2,2001,071000,18,18,0,2
3,2001,071000,25,25,0,0
4,2001,071000,15,13,2,0
5,2001,071000,21,20,1,1
6,2001,071000,18,17,1,1
7,2001,071000,35,35,0,0
8,2001,071000,14,13,1,1
9,2001,071000,23,23,0,2
10,2001,071000,24,24,0,0
11,2001,071000,16,16,0,1
12,2001,071000,17,17,0,0
1,2002,071000,16,16,0,0
2,2002,071000,17,17,0,0
3,2002,071000,26,25,1,0
4,2002,071000,23,20,3,0
5,2002,071000,36,35,1,1
6,2002,071000,36,35,1,0
7,2002,071000,35,35,0,0
8,2002,071000,32,32,0,0
9,2002,071000,24,23,1,0
10,2002,071000,26,25,1,1
11,2002,071000,27,27,0,0
12,2002,071000,22,22,0,0
1,2003,071000,23,23,0,2
2,2003,071000,35,34,1,0
3,2003,071000,13,12,1,2
4,2003,071000,31,31,0,2
5,2003,071000,31,30,1,0
6,2003,071000,36,36,0,0
7,2003,071000,34,34,0,0
8,2003,071000,33,33,0,0
9,2003,071000,33,32,1,0
10,2003,071000,27,26,1,1
11,2003,071000,34,34,0,0
12,2003,071000,29,29,0,0
1,2004,071000,15,15,0,2
2,2004,071000,14,14,0,0
3,2004,071000,19,19,0,0
4,2004,071000,16,15,1,0
5,2004,071000,25,22,3,0
6,2004,071000,18,17,1,0
7,2004,071000,18,18,0,4
8,2004,071000,16,16,0,1
9,2004,071000,14,14,0,0
10,2004,071000,25,23,2,0
11,2004,071000,19,17,2,0
12,2004,071000,19,17,2,0
1,2005,071000,8,8,0,1
2,2005,071000,7,5,2,0
3,2005,071000,18,18,0,0
4,2005,071000,14,14,0,0
5,2005,071000,22,22,0,0
6,2005,071000,26,25,1,0
7,2005,071000,29,29,0,0
8,2005,071000,21,21,0,0
9,2005,071000,23,22,1,1
10,2005,071000,30,29,1,0
11,2005,071000,20,20,0,1
12,2005,071000,12,11,1,0
1,2006,071000,14,14,0,1
2,2006,071000,10,10,0,0
3,2006,071000,13,13,0,1
4,2006,071000,19,19,0,0
5,2006,071000,17,16,1,0
6,2006,071000,13,13,0,0
7,2006,071000,25,23,2,0
8,2006,071000,13,13,0,0
9,2006,071000,22,19,3,1
10,2006,071000,19,19,0,1
11,2006,071000,14,14,0,0
12,2006,071000,3,3,0,0
1,2007,071000,21,21,0,1
2,2007,071000,15,13,2,0
3,2007,071000,8,7,1,0
4,2007,071000,11,11,0,2
5,2007,071000,22,22,0,0
6,2007,071000,15,14,1,0
7,2007,071000,28,28,0,0
8,2007,071000,11,11,0,1
9,2007,071000,26,25,1,2
10,2007,071000,24,24,0,1
11,2007,071000,22,22,0,1
12,2007,071000,13,12,1,1
1,2008,071000,20,20,0,2
2,2008,071000,19,18,1,0
3,2008,071000,24,22,2,1
4,2008,071000,19,19,0,2
5,2008,071000,23,23,0,0
6,2008,071000,28,28,0,0
7,2008,071000,25,25,0,0
8,2008,071000,21,20,1,0
9,2008,071000,30,30,0,0
10,2008,071000,26,25,1,0
11,2008,071000,25,24,1,0
12,2008,071000,17,17,0,0
1,2009,071000,18,16,2,3
2,2009,071000,16,16,0,1
3,2009,071000,20,19,1,1
4,2009,071000,13,13,0,0
5,2009,071000,24,24,0,2
6,2009,071000,12,12,0,0
7,2009,071000,14,13,1,0
8,2009,071000,17,17,0,0
9,2009,071000,19,19,0,1
10,2009,071000,8,8,0,2
11,2009,071000,12,11,1,7
12,2009,071000,9,9,0,0
1,2010,071000,9,9,0,1
2,2010,071000,19,19,0,1
3,2010,071000,16,15,1,0
4,2010,071000,10,10,0,1
5,2010,071000,17,17,0,2
6,2010,071000,18,17,1,0
7,2010,071000,17,17,0,0
8,2010,071000,24,23,1,1
9,2010,071000,21,19,2,4
10,2010,071000,23,22,1,4
11,2010,071000,9,9,0,1
12,2010,071000,11,11,0,0
1,2011,071000,15,15,0,0
2,2011,071000,9,9,0,1
1,1999,071100,8,8,0,1
2,1999,071100,16,16,0,0
3,1999,071100,26,26,0,0
4,1999,071100,28,28,0,0
5,1999,071100,25,25,0,0
6,1999,071100,30,29,1,0
7,1999,071100,21,20,1,0
8,1999,071100,28,28,0,0
9,1999,071100,18,17,1,2
10,1999,071100,15,14,1,0
11,1999,071100,16,16,0,0
12,1999,071100,19,19,0,0
1,2000,071100,16,16,0,0
2,2000,071100,12,12,0,0
3,2000,071100,14,14,0,0
4,2000,071100,19,19,0,0
5,2000,071100,18,18,0,1
6,2000,071100,15,15,0,2
7,2000,071100,17,17,0,0
8,2000,071100,13,13,0,0
9,2000,071100,19,19,0,0
10,2000,071100,9,8,1,2
11,2000,071100,27,27,0,0
12,2000,071100,10,10,0,1
1,2001,071100,4,4,0,0
2,2001,071100,11,11,0,0
3,2001,071100,14,14,0,0
4,2001,071100,11,11,0,3
5,2001,071100,15,14,1,1
6,2001,071100,13,13,0,0
7,2001,071100,25,25,0,0
8,2001,071100,18,18,0,1
9,2001,071100,12,11,1,0
10,2001,071100,18,18,0,0
11,2001,071100,22,22,0,0
12,2001,071100,20,20,0,0
1,2002,071100,3,3,0,2
2,2002,071100,10,10,0,0
3,2002,071100,14,14,0,0
4,2002,071100,10,9,1,0
5,2002,071100,17,16,1,0
6,2002,071100,18,18,0,0
7,2002,071100,16,16,0,0
8,2002,071100,19,18,1,0
9,2002,071100,18,18,0,0
10,2002,071100,16,14,2,0
11,2002,071100,15,15,0,0
12,2002,071100,14,14,0,1
1,2003,071100,8,8,0,0
2,2003,071100,13,12,1,0
3,2003,071100,11,11,0,0
4,2003,071100,8,7,1,1
5,2003,071100,15,14,1,0
6,2003,071100,14,14,0,0
7,2003,071100,18,18,0,0
8,2003,071100,22,22,0,1
9,2003,071100,20,20,0,0
10,2003,071100,24,23,1,1
11,2003,071100,17,17,0,0
12,2003,071100,19,19,0,1
1,2004,071100,12,11,1,0
2,2004,071100,17,16,1,1
3,2004,071100,12,12,0,0
4,2004,071100,11,11,0,0
5,2004,071100,8,8,0,0
6,2004,071100,14,14,0,0
7,2004,071100,21,21,0,0
8,2004,071100,14,14,0,1
9,2004,071100,21,20,1,0
10,2004,071100,8,8,0,1
11,2004,071100,16,16,0,0
12,2004,071100,11,11,0,0
1,2005,071100,15,15,0,0
2,2005,071100,8,8,0,0
3,2005,071100,12,12,0,0
4,2005,071100,13,13,0,0
5,2005,071100,15,15,0,0
6,2005,071100,16,16,0,0
7,2005,071100,12,12,0,0
8,2005,071100,16,15,1,0
9,2005,071100,11,10,1,0
10,2005,071100,22,22,0,0
11,2005,071100,14,14,0,0
12,2005,071100,10,9,1,1
1,2006,071100,11,11,0,0
2,2006,071100,7,7,0,1
3,2006,071100,10,10,0,0
4,2006,071100,3,3,0,2
5,2006,071100,5,5,0,0
6,2006,071100,4,4,0,0
7,2006,071100,9,8,1,0
8,2006,071100,16,14,2,0
9,2006,071100,15,15,0,1
10,2006,071100,18,18,0,1
11,2006,071100,9,9,0,1
12,2006,071100,11,11,0,0
1,2007,071100,11,11,0,1
2,2007,071100,8,7,1,1
3,2007,071100,11,11,0,3
4,2007,071100,8,7,1,1
5,2007,071100,19,16,3,0
6,2007,071100,11,11,0,0
7,2007,071100,19,19,0,0
8,2007,071100,16,15,1,0
9,2007,071100,13,12,1,0
10,2007,071100,21,21,0,2
11,2007,071100,10,10,0,2
12,2007,071100,8,8,0,1
1,2008,071100,13,13,0,0
2,2008,071100,10,10,0,0
3,2008,071100,14,14,0,1
4,2008,071100,13,13,0,0
5,2008,071100,20,19,1,0
6,2008,071100,14,13,1,1
7,2008,071100,10,10,0,0
8,2008,071100,14,14,0,0
9,2008,071100,17,15,2,1
10,2008,071100,18,18,0,0
11,2008,071100,13,10,3,1
12,2008,071100,15,15,0,0
1,2009,071100,14,14,0,0
2,2009,071100,12,11,1,1
3,2009,071100,9,9,0,0
4,2009,071100,16,16,0,1
5,2009,071100,12,10,2,1
6,2009,071100,7,6,1,0
7,2009,071100,25,24,1,0
8,2009,071100,15,13,2,0
9,2009,071100,19,17,2,0
10,2009,071100,9,8,1,0
11,2009,071100,8,7,1,0
12,2009,071100,6,6,0,0
1,2010,071100,12,10,2,1
2,2010,071100,6,6,0,1
3,2010,071100,7,7,0,1
4,2010,071100,12,11,1,0
5,2010,071100,17,15,2,0
6,2010,071100,8,8,0,0
7,2010,071100,9,8,1,0
8,2010,071100,12,12,0,0
9,2010,071100,11,9,2,0
10,2010,071100,13,13,0,0
11,2010,071100,9,9,0,0
12,2010,071100,5,5,0,0
1,2011,071100,3,3,0,0
2,2011,071100,3,3,0,0
1,1999,071200,16,16,0,0
2,1999,071200,17,17,0,4
3,1999,071200,32,31,1,1
4,1999,071200,15,14,1,1
5,1999,071200,33,33,0,0
6,1999,071200,20,20,0,0
7,1999,071200,24,23,1,0
8,1999,071200,35,34,1,3
9,1999,071200,13,13,0,2
10,1999,071200,22,22,0,0
11,1999,071200,14,14,0,5
12,1999,071200,23,22,1,1
1,2000,071200,19,18,1,0
2,2000,071200,15,15,0,0
3,2000,071200,20,18,2,0
4,2000,071200,10,9,1,0
5,2000,071200,17,16,1,1
6,2000,071200,20,20,0,0
7,2000,071200,20,20,0,0
8,2000,071200,27,27,0,1
9,2000,071200,33,32,1,2
10,2000,071200,23,23,0,3
11,2000,071200,15,14,1,0
12,2000,071200,11,10,1,1
1,2001,071200,14,14,0,2
2,2001,071200,13,13,0,0
3,2001,071200,20,19,1,2
4,2001,071200,13,12,1,0
5,2001,071200,19,17,2,1
6,2001,071200,16,15,1,1
7,2001,071200,17,17,0,0
8,2001,071200,19,17,2,0
9,2001,071200,8,8,0,0
10,2001,071200,17,17,0,1
11,2001,071200,24,22,2,1
12,2001,071200,24,23,1,1
1,2002,071200,4,4,0,1
2,2002,071200,17,15,2,0
3,2002,071200,15,15,0,0
4,2002,071200,15,14,1,1
5,2002,071200,15,15,0,0
6,2002,071200,32,32,0,0
7,2002,071200,21,21,0,0
8,2002,071200,13,12,1,0
9,2002,071200,18,18,0,0
10,2002,071200,23,22,1,1
11,2002,071200,23,21,2,1
12,2002,071200,15,15,0,3
1,2003,071200,20,20,0,1
2,2003,071200,13,13,0,0
3,2003,071200,23,23,0,1
4,2003,071200,21,21,0,0
5,2003,071200,16,16,0,0
6,2003,071200,24,24,0,0
7,2003,071200,31,30,1,1
8,2003,071200,37,35,2,0
9,2003,071200,26,26,0,0
10,2003,071200,31,29,2,1
11,2003,071200,23,21,2,1
12,2003,071200,17,15,2,0
1,2004,071200,26,25,1,2
2,2004,071200,9,9,0,0
3,2004,071200,19,19,0,4
4,2004,071200,12,10,2,1
5,2004,071200,18,17,1,1
6,2004,071200,23,21,2,2
7,2004,071200,13,12,1,1
8,2004,071200,14,14,0,1
9,2004,071200,25,25,0,0
10,2004,071200,22,19,3,0
11,2004,071200,23,22,1,0
12,2004,071200,18,18,0,2
1,2005,071200,12,11,1,0
2,2005,071200,16,15,1,0
3,2005,071200,22,21,1,1
4,2005,071200,16,15,1,4
5,2005,071200,16,14,2,2
6,2005,071200,15,15,0,0
7,2005,071200,17,17,0,0
8,2005,071200,18,18,0,0
9,2005,071200,17,17,0,3
10,2005,071200,25,23,2,3
11,2005,071200,13,13,0,1
12,2005,071200,19,18,1,1
1,2006,071200,9,8,1,4
2,2006,071200,12,9,3,0
3,2006,071200,17,17,0,3
4,2006,071200,16,15,1,0
5,2006,071200,16,13,3,5
6,2006,071200,18,16,2,0
7,2006,071200,15,15,0,2
8,2006,071200,12,12,0,0
9,2006,071200,26,23,3,2
10,2006,071200,27,26,1,1
11,2006,071200,22,20,2,2
12,2006,071200,17,16,1,4
1,2007,071200,12,11,1,4
2,2007,071200,4,4,0,3
3,2007,071200,24,23,1,4
4,2007,071200,8,8,0,1
5,2007,071200,20,20,0,4
6,2007,071200,25,23,2,0
7,2007,071200,13,13,0,1
8,2007,071200,14,13,1,1
9,2007,071200,23,18,5,3
10,2007,071200,20,20,0,2
11,2007,071200,17,17,0,3
12,2007,071200,23,23,0,0
1,2008,071200,15,13,2,0
2,2008,071200,24,23,1,0
3,2008,071200,12,12,0,1
4,2008,071200,21,21,0,1
5,2008,071200,24,23,1,6
6,2008,071200,15,13,2,1
7,2008,071200,17,17,0,0
8,2008,071200,16,15,1,0
9,2008,071200,24,23,1,4
10,2008,071200,26,24,2,2
11,2008,071200,17,16,1,2
12,2008,071200,22,21,1,0
1,2009,071200,16,15,1,3
2,2009,071200,7,6,1,2
3,2009,071200,19,19,0,2
4,2009,071200,23,23,0,0
5,2009,071200,24,24,0,1
6,2009,071200,18,18,0,2
7,2009,071200,17,17,0,0
8,2009,071200,22,22,0,1
9,2009,071200,14,14,0,1
10,2009,071200,24,23,1,0
11,2009,071200,14,14,0,1
12,2009,071200,14,14,0,0
1,2010,071200,15,14,1,1
2,2010,071200,11,11,0,3
3,2010,071200,10,10,0,0
4,2010,071200,14,13,1,1
5,2010,071200,10,10,0,5
6,2010,071200,24,24,0,0
7,2010,071200,27,27,0,0
8,2010,071200,25,25,0,0
9,2010,071200,17,16,1,1
10,2010,071200,25,25,0,3
11,2010,071200,23,23,0,1
12,2010,071200,21,21,0,1
1,2011,071200,18,17,1,1
2,2011,071200,8,6,2,0
1,1999,071300,27,27,0,1
2,1999,071300,28,27,1,0
3,1999,071300,36,36,0,0
4,1999,071300,44,43,1,2
5,1999,071300,45,43,2,1
6,1999,071300,32,32,0,0
7,1999,071300,46,43,3,0
8,1999,071300,34,33,1,1
9,1999,071300,30,28,2,0
10,1999,071300,32,31,1,0
11,1999,071300,20,20,0,3
12,1999,071300,26,25,1,2
1,2000,071300,23,23,0,3
2,2000,071300,16,16,0,2
3,2000,071300,35,35,0,6
4,2000,071300,30,27,3,2
5,2000,071300,36,36,0,4
6,2000,071300,38,37,1,1
7,2000,071300,34,34,0,0
8,2000,071300,38,37,1,0
9,2000,071300,32,31,1,0
10,2000,071300,42,41,1,0
11,2000,071300,19,19,0,0
12,2000,071300,15,15,0,1
1,2001,071300,21,19,2,0
2,2001,071300,19,18,1,0
3,2001,071300,15,14,1,0
4,2001,071300,17,16,1,1
5,2001,071300,26,26,0,1
6,2001,071300,28,28,0,0
7,2001,071300,32,32,0,0
8,2001,071300,28,28,0,3
9,2001,071300,28,28,0,1
10,2001,071300,25,24,1,0
11,2001,071300,22,22,0,0
12,2001,071300,27,27,0,0
1,2002,071300,21,21,0,0
2,2002,071300,20,20,0,0
3,2002,071300,30,30,0,0
4,2002,071300,17,17,0,0
5,2002,071300,15,14,1,0
6,2002,071300,25,25,0,0
7,2002,071300,28,28,0,0
8,2002,071300,31,31,0,0
9,2002,071300,19,18,1,0
10,2002,071300,29,29,0,0
11,2002,071300,19,19,0,0
12,2002,071300,15,15,0,0
1,2003,071300,21,21,0,0
2,2003,071300,22,22,0,0
3,2003,071300,18,18,0,1
4,2003,071300,25,24,1,0
5,2003,071300,24,23,1,1
6,2003,071300,27,26,1,0
7,2003,071300,33,33,0,1
8,2003,071300,33,32,1,0
9,2003,071300,25,25,0,0
10,2003,071300,15,13,2,0
11,2003,071300,19,19,0,0
12,2003,071300,14,14,0,0
1,2004,071300,19,19,0,0
2,2004,071300,20,19,1,0
3,2004,071300,19,19,0,0
4,2004,071300,18,16,2,0
5,2004,071300,20,19,1,0
6,2004,071300,24,23,1,1
7,2004,071300,22,21,1,0
8,2004,071300,17,17,0,0
9,2004,071300,35,34,1,1
10,2004,071300,19,18,1,0
11,2004,071300,21,20,1,0
12,2004,071300,33,33,0,0
1,2005,071300,10,8,2,0
2,2005,071300,9,9,0,0
3,2005,071300,20,20,0,1
4,2005,071300,24,24,0,0
5,2005,071300,16,16,0,0
6,2005,071300,26,26,0,0
7,2005,071300,19,18,1,0
8,2005,071300,17,17,0,0
9,2005,071300,20,18,2,0
10,2005,071300,22,22,0,0
11,2005,071300,15,15,0,2
12,2005,071300,10,9,1,0
1,2006,071300,11,11,0,1
2,2006,071300,17,17,0,0
3,2006,071300,11,11,0,0
4,2006,071300,15,15,0,1
5,2006,071300,18,17,1,0
6,2006,071300,13,12,1,0
7,2006,071300,24,24,0,1
8,2006,071300,27,27,0,0
9,2006,071300,18,16,2,0
10,2006,071300,17,17,0,0
11,2006,071300,14,14,0,1
12,2006,071300,13,13,0,0
1,2007,071300,22,21,1,0
2,2007,071300,9,9,0,0
3,2007,071300,24,24,0,0
4,2007,071300,18,18,0,0
5,2007,071300,25,24,1,0
6,2007,071300,13,12,1,0
7,2007,071300,20,19,1,0
8,2007,071300,11,11,0,0
9,2007,071300,11,11,0,0
10,2007,071300,26,25,1,1
11,2007,071300,18,18,0,0
12,2007,071300,21,21,0,0
1,2008,071300,18,18,0,0
2,2008,071300,10,10,0,1
3,2008,071300,16,16,0,0
4,2008,071300,9,9,0,0
5,2008,071300,22,21,1,0
6,2008,071300,22,21,1,0
7,2008,071300,25,25,0,0
8,2008,071300,19,19,0,0
9,2008,071300,18,18,0,0
10,2008,071300,21,21,0,0
11,2008,071300,18,18,0,0
12,2008,071300,15,15,0,1
1,2009,071300,10,10,0,0
2,2009,071300,15,14,1,0
3,2009,071300,10,10,0,0
4,2009,071300,13,13,0,0
5,2009,071300,17,17,0,1
6,2009,071300,20,19,1,0
7,2009,071300,22,22,0,0
8,2009,071300,17,16,1,0
9,2009,071300,13,13,0,1
10,2009,071300,23,22,1,0
11,2009,071300,14,14,0,0
12,2009,071300,21,21,0,1
1,2010,071300,16,15,1,0
2,2010,071300,7,7,0,0
3,2010,071300,16,16,0,0
4,2010,071300,8,8,0,1
5,2010,071300,10,10,0,0
6,2010,071300,17,17,0,0
7,2010,071300,18,18,0,0
8,2010,071300,27,27,0,0
9,2010,071300,22,22,0,0
10,2010,071300,12,12,0,1
11,2010,071300,16,16,0,0
12,2010,071300,8,7,1,0
1,2011,071300,16,16,0,0
2,2011,071300,8,8,0,0
1,1999,071400,10,10,0,0
2,1999,071400,7,7,0,0
3,1999,071400,13,13,0,0
4,1999,071400,18,18,0,1
5,1999,071400,38,38,0,2
6,1999,071400,28,28,0,1
7,1999,071400,30,28,2,2
8,1999,071400,19,19,0,0
9,1999,071400,17,17,0,0
10,1999,071400,11,10,1,0
11,1999,071400,6,6,0,0
12,1999,071400,5,5,0,0
1,2000,071400,7,7,0,0
2,2000,071400,8,8,0,0
3,2000,071400,12,12,0,0
4,2000,071400,17,16,1,0
5,2000,071400,19,19,0,0
6,2000,071400,16,16,0,0
7,2000,071400,18,18,0,0
8,2000,071400,17,17,0,0
9,2000,071400,15,15,0,0
10,2000,071400,19,19,0,0
11,2000,071400,7,7,0,0
12,2000,071400,5,5,0,0
1,2001,071400,5,5,0,0
2,2001,071400,3,2,1,0
3,2001,071400,5,4,1,0
4,2001,071400,13,13,0,0
5,2001,071400,14,14,0,0
6,2001,071400,22,21,1,0
7,2001,071400,17,16,1,0
8,2001,071400,24,23,1,0
9,2001,071400,11,10,1,0
10,2001,071400,14,14,0,0
11,2001,071400,17,17,0,0
12,2001,071400,8,8,0,0
1,2002,071400,10,10,0,0
2,2002,071400,5,5,0,0
3,2002,071400,3,3,0,0
4,2002,071400,19,19,0,1
5,2002,071400,18,17,1,0
6,2002,071400,22,22,0,0
7,2002,071400,21,21,0,0
8,2002,071400,22,21,1,0
9,2002,071400,14,14,0,0
10,2002,071400,13,13,0,0
11,2002,071400,12,12,0,1
12,2002,071400,13,12,1,0
1,2003,071400,17,17,0,0
2,2003,071400,8,8,0,0
3,2003,071400,7,7,0,0
4,2003,071400,15,15,0,0
5,2003,071400,18,18,0,0
6,2003,071400,10,10,0,0
7,2003,071400,24,22,2,0
8,2003,071400,18,18,0,0
9,2003,071400,14,14,0,0
10,2003,071400,17,17,0,0
11,2003,071400,10,10,0,0
12,2003,071400,11,11,0,0
1,2004,071400,7,7,0,0
2,2004,071400,9,7,2,0
3,2004,071400,10,10,0,0
4,2004,071400,6,6,0,1
5,2004,071400,6,6,0,0
6,2004,071400,20,20,0,0
7,2004,071400,11,11,0,0
8,2004,071400,27,27,0,0
9,2004,071400,20,20,0,1
10,2004,071400,10,10,0,0
11,2004,071400,7,7,0,0
12,2004,071400,11,11,0,0
1,2005,071400,4,4,0,0
2,2005,071400,3,3,0,0
3,2005,071400,9,8,1,0
4,2005,071400,7,7,0,0
5,2005,071400,10,10,0,1
6,2005,071400,12,12,0,0
7,2005,071400,21,21,0,0
8,2005,071400,10,9,1,0
9,2005,071400,14,14,0,0
10,2005,071400,12,12,0,0
11,2005,071400,12,12,0,0
12,2005,071400,13,13,0,0
1,2006,071400,10,10,0,0
2,2006,071400,9,9,0,0
3,2006,071400,10,10,0,0
4,2006,071400,15,15,0,0
5,2006,071400,6,6,0,0
6,2006,071400,16,16,0,0
7,2006,071400,10,10,0,0
8,2006,071400,12,12,0,0
9,2006,071400,10,10,0,0
10,2006,071400,8,8,0,0
11,2006,071400,14,14,0,0
12,2006,071400,9,9,0,0
1,2007,071400,6,6,0,0
2,2007,071400,1,1,0,0
3,2007,071400,5,5,0,0
4,2007,071400,14,14,0,0
5,2007,071400,8,8,0,0
6,2007,071400,5,5,0,0
7,2007,071400,12,12,0,0
8,2007,071400,9,9,0,0
9,2007,071400,12,12,0,0
10,2007,071400,5,5,0,0
11,2007,071400,5,4,1,0
12,2007,071400,8,8,0,0
1,2008,071400,10,10,0,0
2,2008,071400,4,4,0,0
3,2008,071400,2,2,0,0
4,2008,071400,11,11,0,0
5,2008,071400,9,9,0,0
6,2008,071400,8,8,0,0
7,2008,071400,14,14,0,0
8,2008,071400,21,21,0,0
9,2008,071400,12,12,0,0
10,2008,071400,24,24,0,0
11,2008,071400,13,13,0,0
12,2008,071400,8,8,0,0
1,2009,071400,3,3,0,0
2,2009,071400,5,5,0,0
3,2009,071400,12,12,0,0
4,2009,071400,8,8,0,0
5,2009,071400,13,13,0,0
6,2009,071400,9,9,0,0
7,2009,071400,19,19,0,0
8,2009,071400,21,21,0,0
9,2009,071400,12,12,0,0
10,2009,071400,15,15,0,0
11,2009,071400,11,10,1,0
12,2009,071400,7,7,0,0
1,2010,071400,6,6,0,1
2,2010,071400,1,1,0,0
3,2010,071400,7,7,0,0
4,2010,071400,15,15,0,0
5,2010,071400,6,6,0,0
6,2010,071400,11,11,0,2
7,2010,071400,11,11,0,0
8,2010,071400,24,24,0,0
9,2010,071400,15,15,0,0
10,2010,071400,13,13,0,1
11,2010,071400,5,5,0,0
12,2010,071400,6,6,0,0
1,2011,071400,6,6,0,0
2,2011,071400,3,3,0,0
1,1999,200401,11,9,2,1
2,1999,200401,7,6,1,2
3,1999,200401,7,6,1,2
4,1999,200401,4,4,0,1
5,1999,200401,16,13,3,2
6,1999,200401,14,10,4,6
7,1999,200401,12,12,0,3
8,1999,200401,7,7,0,1
9,1999,200401,15,13,2,0
10,1999,200401,11,8,3,0
11,1999,200401,10,7,3,2
12,1999,200401,9,8,1,0
1,2000,200401,10,8,2,2
2,2000,200401,8,6,2,1
3,2000,200401,8,8,0,1
4,2000,200401,12,11,1,5
5,2000,200401,14,10,4,8
6,2000,200401,10,8,2,0
7,2000,200401,7,4,3,1
8,2000,200401,15,10,5,1
9,2000,200401,11,11,0,2
10,2000,200401,15,11,4,0
11,2000,200401,17,12,5,4
12,2000,200401,6,6,0,1
1,2001,200401,10,10,0,2
2,2001,200401,5,3,2,1
3,2001,200401,9,7,2,0
4,2001,200401,13,7,6,2
5,2001,200401,13,11,2,4
6,2001,200401,10,6,4,4
7,2001,200401,13,9,4,1
8,2001,200401,4,3,1,3
9,2001,200401,10,5,5,4
10,2001,200401,16,13,3,3
11,2001,200401,8,6,2,2
12,2001,200401,5,3,2,2
1,2002,200401,6,4,2,1
2,2002,200401,5,4,1,0
3,2002,200401,7,4,3,0
4,2002,200401,10,8,2,1
5,2002,200401,10,9,1,2
6,2002,200401,14,11,3,0
7,2002,200401,14,10,4,3
8,2002,200401,6,4,2,3
9,2002,200401,15,10,5,3
10,2002,200401,9,8,1,1
11,2002,200401,18,18,0,1
12,2002,200401,7,7,0,0
1,2003,200401,13,13,0,3
2,2003,200401,10,7,3,3
3,2003,200401,14,11,3,0
4,2003,200401,8,7,1,0
5,2003,200401,11,10,1,0
6,2003,200401,5,5,0,0
7,2003,200401,7,4,3,1
8,2003,200401,13,11,2,2
9,2003,200401,10,10,0,1
10,2003,200401,10,10,0,1
11,2003,200401,4,4,0,0
12,2003,200401,7,6,1,0
1,2004,200401,6,5,1,1
2,2004,200401,4,4,0,0
3,2004,200401,5,5,0,2
4,2004,200401,5,5,0,2
5,2004,200401,8,7,1,1
6,2004,200401,6,5,1,4
7,2004,200401,13,13,0,3
8,2004,200401,5,4,1,2
9,2004,200401,7,6,1,1
10,2004,200401,13,12,1,3
11,2004,200401,10,9,1,2
12,2004,200401,5,4,1,1
1,2005,200401,5,5,0,0
2,2005,200401,5,4,1,0
3,2005,200401,8,7,1,1
4,2005,200401,7,7,0,2
5,2005,200401,5,4,1,0
6,2005,200401,1,1,0,1
7,2005,200401,12,11,1,0
8,2005,200401,13,8,5,1
9,2005,200401,8,6,2,1
10,2005,200401,3,2,1,1
11,2005,200401,3,3,0,2
12,2005,200401,8,7,1,1
1,2006,200401,5,4,1,2
2,2006,200401,6,6,0,0
3,2006,200401,6,5,1,1
4,2006,200401,5,4,1,3
5,2006,200401,10,10,0,3
6,2006,200401,4,4,0,1
7,2006,200401,4,2,2,4
8,2006,200401,9,7,2,1
9,2006,200401,7,6,1,1
10,2006,200401,10,8,2,4
11,2006,200401,5,5,0,1
12,2006,200401,3,3,0,2
1,2007,200401,7,7,0,3
2,2007,200401,5,5,0,0
3,2007,200401,8,7,1,1
4,2007,200401,6,6,0,1
5,2007,200401,5,5,0,3
6,2007,200401,8,8,0,2
7,2007,200401,9,7,2,3
8,2007,200401,9,6,3,1
9,2007,200401,6,3,3,5
10,2007,200401,8,8,0,5
11,2007,200401,9,8,1,1
12,2007,200401,9,9,0,2
1,2008,200401,7,7,0,3
2,2008,200401,9,8,1,0
3,2008,200401,5,3,2,0
4,2008,200401,3,2,1,1
5,2008,200401,7,7,0,3
6,2008,200401,3,1,2,0
7,2008,200401,5,4,1,1
8,2008,200401,11,10,1,1
9,2008,200401,8,7,1,4
10,2008,200401,9,8,1,1
11,2008,200401,8,8,0,0
12,2008,200401,5,5,0,0
1,2009,200401,10,8,2,3
2,2009,200401,6,6,0,1
3,2009,200401,6,5,1,1
4,2009,200401,7,6,1,1
5,2009,200401,6,6,0,1
6,2009,200401,11,8,3,4
7,2009,200401,15,12,3,3
8,2009,200401,6,6,0,2
9,2009,200401,6,4,2,0
10,2009,200401,7,6,1,1
11,2009,200401,6,5,1,0
12,2009,200401,15,13,2,2
1,2010,200401,10,10,0,0
2,2010,200401,6,5,1,0
3,2010,200401,4,2,2,4
4,2010,200401,6,5,1,2
5,2010,200401,10,9,1,6
6,2010,200401,9,8,1,2
7,2010,200401,11,9,2,6
8,2010,200401,6,5,1,3
9,2010,200401,15,15,0,0
10,2010,200401,5,4,1,2
11,2010,200401,8,8,0,1
12,2010,200401,13,11,2,2
1,2011,200401,8,8,0,1
2,2011,200401,5,5,0,0
1,1999,831600,27,26,1,1
2,1999,831600,24,22,2,4
3,1999,831600,35,32,3,0
4,1999,831600,24,23,1,1
5,1999,831600,22,22,0,0
6,1999,831600,17,16,1,1
7,1999,831600,27,24,3,1
8,1999,831600,34,32,2,0
9,1999,831600,15,14,1,1
10,1999,831600,13,9,4,0
11,1999,831600,16,16,0,1
12,1999,831600,18,15,3,0
1,2000,831600,24,22,2,0
2,2000,831600,19,17,2,1
3,2000,831600,25,23,2,0
4,2000,831600,16,16,0,0
5,2000,831600,25,24,1,0
6,2000,831600,21,19,2,0
7,2000,831600,29,27,2,2
8,2000,831600,26,25,1,0
9,2000,831600,27,25,2,0
10,2000,831600,20,18,2,0
11,2000,831600,22,19,3,0
12,2000,831600,27,27,0,0
1,2001,831600,21,18,3,0
2,2001,831600,26,26,0,0
3,2001,831600,15,14,1,0
4,2001,831600,18,16,2,0
5,2001,831600,23,22,1,2
6,2001,831600,23,23,0,1
7,2001,831600,48,40,8,2
8,2001,831600,34,31,3,1
9,2001,831600,23,22,1,0
10,2001,831600,31,30,1,0
11,2001,831600,16,14,2,2
12,2001,831600,18,16,2,1
1,2002,831600,24,23,1,0
2,2002,831600,17,16,1,1
3,2002,831600,22,20,2,3
4,2002,831600,28,28,0,2
5,2002,831600,24,24,0,1
6,2002,831600,28,25,3,0
7,2002,831600,26,25,1,1
8,2002,831600,23,23,0,0
9,2002,831600,28,24,4,0
10,2002,831600,21,20,1,0
11,2002,831600,23,22,1,0
12,2002,831600,24,22,2,0
1,2003,831600,20,18,2,1
2,2003,831600,17,17,0,0
3,2003,831600,22,21,1,3
4,2003,831600,24,23,1,2
5,2003,831600,26,22,4,1
6,2003,831600,24,22,2,0
7,2003,831600,24,22,2,0
8,2003,831600,32,31,1,0
9,2003,831600,37,33,4,0
10,2003,831600,30,27,3,1
11,2003,831600,16,15,1,1
12,2003,831600,32,30,2,4
1,2004,831600,20,19,1,1
2,2004,831600,23,21,2,2
3,2004,831600,24,22,2,1
4,2004,831600,25,24,1,1
5,2004,831600,16,15,1,0
6,2004,831600,16,14,2,0
7,2004,831600,21,21,0,2
8,2004,831600,18,18,0,0
9,2004,831600,12,11,1,0
10,2004,831600,14,12,2,1
11,2004,831600,13,13,0,0
12,2004,831600,13,13,0,0
1,2005,831600,17,17,0,1
2,2005,831600,12,11,1,2
3,2005,831600,20,19,1,0
4,2005,831600,16,14,2,0
5,2005,831600,14,14,0,0
6,2005,831600,18,17,1,1
7,2005,831600,8,8,0,0
8,2005,831600,13,13,0,3
9,2005,831600,9,9,0,2
10,2005,831600,15,14,1,2
11,2005,831600,11,11,0,1
12,2005,831600,17,16,1,1
1,2006,831600,19,17,2,0
2,2006,831600,11,11,0,1
3,2006,831600,23,22,1,0
4,2006,831600,9,9,0,0
5,2006,831600,17,14,3,3
6,2006,831600,13,12,1,0
7,2006,831600,14,14,0,4
8,2006,831600,18,16,2,0
9,2006,831600,22,21,1,1
10,2006,831600,14,13,1,3
11,2006,831600,11,11,0,2
12,2006,831600,20,19,1,1
1,2007,831600,23,21,2,1
2,2007,831600,15,15,0,0
3,2007,831600,22,21,1,1
4,2007,831600,15,14,1,1
5,2007,831600,11,10,1,0
6,2007,831600,17,15,2,1
7,2007,831600,18,17,1,1
8,2007,831600,25,22,3,2
9,2007,831600,19,18,1,1
10,2007,831600,12,11,1,0
11,2007,831600,16,15,1,0
12,2007,831600,18,18,0,1
1,2008,831600,15,12,3,2
2,2008,831600,9,7,2,1
3,2008,831600,11,11,0,3
4,2008,831600,17,15,2,0
5,2008,831600,15,15,0,1
6,2008,831600,12,8,4,1
7,2008,831600,17,16,1,1
8,2008,831600,23,19,4,0
9,2008,831600,19,17,2,3
10,2008,831600,30,27,3,6
11,2008,831600,12,12,0,0
12,2008,831600,15,15,0,0
1,2009,831600,16,15,1,3
2,2009,831600,18,15,3,4
3,2009,831600,21,20,1,3
4,2009,831600,16,14,2,1
5,2009,831600,19,17,2,1
6,2009,831600,14,13,1,0
7,2009,831600,15,13,2,0
8,2009,831600,24,23,1,1
9,2009,831600,16,15,1,2
10,2009,831600,18,16,2,1
11,2009,831600,20,20,0,2
12,2009,831600,15,15,0,1
1,2010,831600,16,16,0,0
2,2010,831600,16,14,2,1
3,2010,831600,16,16,0,1
4,2010,831600,12,12,0,1
5,2010,831600,8,8,0,0
6,2010,831600,25,25,0,1
7,2010,831600,16,14,2,0
8,2010,831600,19,18,1,1
9,2010,831600,13,11,2,1
10,2010,831600,8,8,0,0
11,2010,831600,11,11,0,1
12,2010,831600,17,17,0,0
1,2011,831600,10,9,1,0
2,2011,831600,9,8,1,1
1,1999,220902,31,28,3,5
2,1999,220902,35,31,4,0
3,1999,220902,34,30,4,15
4,1999,220902,26,22,4,3
5,1999,220902,42,38,4,5
6,1999,220902,38,33,5,9
7,1999,220902,42,40,2,9
8,1999,220902,32,27,5,3
9,1999,220902,36,30,6,9
10,1999,220902,30,26,4,10
11,1999,220902,32,27,5,2
12,1999,220902,33,27,6,8
1,2000,220902,32,28,4,6
2,2000,220902,28,24,4,0
3,2000,220902,30,25,5,1
4,2000,220902,26,22,4,4
5,2000,220902,32,23,9,6
6,2000,220902,23,17,6,8
7,2000,220902,18,15,3,1
8,2000,220902,32,25,7,3
9,2000,220902,29,28,1,8
10,2000,220902,25,16,9,1
11,2000,220902,29,22,7,1
12,2000,220902,20,19,1,0
1,2001,220902,22,18,4,5
2,2001,220902,24,20,4,3
3,2001,220902,20,19,1,5
4,2001,220902,25,20,5,2
5,2001,220902,25,20,5,4
6,2001,220902,24,23,1,2
7,2001,220902,35,31,4,3
8,2001,220902,26,24,2,9
9,2001,220902,29,28,1,1
10,2001,220902,23,22,1,0
11,2001,220902,20,18,2,2
12,2001,220902,28,25,3,1
1,2002,220902,27,22,5,2
2,2002,220902,20,17,3,4
3,2002,220902,30,24,6,5
4,2002,220902,21,17,4,6
5,2002,220902,27,23,4,4
6,2002,220902,16,12,4,5
7,2002,220902,25,20,5,5
8,2002,220902,23,19,4,6
9,2002,220902,43,35,8,0
10,2002,220902,25,24,1,0
11,2002,220902,31,26,5,3
12,2002,220902,20,18,2,0
1,2003,220902,28,27,1,5
2,2003,220902,18,16,2,2
3,2003,220902,22,19,3,3
4,2003,220902,16,15,1,0
5,2003,220902,20,18,2,1
6,2003,220902,23,21,2,1
7,2003,220902,29,26,3,4
8,2003,220902,21,17,4,6
9,2003,220902,27,22,5,1
10,2003,220902,22,20,2,1
11,2003,220902,21,17,4,2
12,2003,220902,37,36,1,2
1,2004,220902,26,23,3,4
2,2004,220902,23,21,2,3
3,2004,220902,24,21,3,0
4,2004,220902,19,16,3,1
5,2004,220902,14,13,1,4
6,2004,220902,21,18,3,5
7,2004,220902,41,39,2,3
8,2004,220902,40,37,3,0
9,2004,220902,28,27,1,8
10,2004,220902,22,21,1,3
11,2004,220902,24,23,1,5
12,2004,220902,24,23,1,2
1,2005,220902,18,15,3,4
2,2005,220902,19,16,3,8
3,2005,220902,19,18,1,5
4,2005,220902,14,12,2,2
5,2005,220902,20,19,1,2
6,2005,220902,28,24,4,3
7,2005,220902,26,24,2,4
8,2005,220902,33,32,1,3
9,2005,220902,15,14,1,4
10,2005,220902,19,15,4,5
11,2005,220902,25,22,3,6
12,2005,220902,10,10,0,0
1,2006,220902,29,26,3,2
2,2006,220902,16,15,1,4
3,2006,220902,20,18,2,3
4,2006,220902,24,20,4,2
5,2006,220902,25,21,4,6
6,2006,220902,23,22,1,6
7,2006,220902,27,25,2,6
8,2006,220902,18,16,2,10
9,2006,220902,26,21,5,11
10,2006,220902,20,20,0,5
11,2006,220902,22,21,1,4
12,2006,220902,22,19,3,2
1,2007,220902,13,12,1,4
2,2007,220902,15,14,1,7
3,2007,220902,13,13,0,9
4,2007,220902,14,12,2,7
5,2007,220902,18,17,1,7
6,2007,220902,19,17,2,12
7,2007,220902,24,20,4,6
8,2007,220902,18,15,3,7
9,2007,220902,23,19,4,13
10,2007,220902,37,34,3,7
11,2007,220902,19,18,1,2
12,2007,220902,25,25,0,3
1,2008,220902,19,14,5,10
2,2008,220902,16,15,1,7
3,2008,220902,23,21,2,6
4,2008,220902,23,20,3,1
5,2008,220902,13,13,0,9
6,2008,220902,16,15,1,5
7,2008,220902,28,24,4,6
8,2008,220902,17,12,5,5
9,2008,220902,15,13,2,8
10,2008,220902,23,22,1,4
11,2008,220902,11,10,1,5
12,2008,220902,13,12,1,2
1,2009,220902,12,11,1,3
2,2009,220902,21,20,1,15
3,2009,220902,9,8,1,3
4,2009,220902,16,12,4,6
5,2009,220902,18,15,3,6
6,2009,220902,10,8,2,11
7,2009,220902,13,11,2,7
8,2009,220902,14,8,6,10
9,2009,220902,35,31,4,4
10,2009,220902,23,21,2,1
11,2009,220902,19,18,1,3
12,2009,220902,15,15,0,2
1,2010,220902,23,21,2,6
2,2010,220902,11,9,2,2
3,2010,220902,16,15,1,7
4,2010,220902,14,13,1,4
5,2010,220902,24,19,5,4
6,2010,220902,18,15,3,5
7,2010,220902,27,24,3,5
8,2010,220902,29,26,3,6
9,2010,220902,26,23,3,3
10,2010,220902,20,20,0,4
11,2010,220902,19,18,1,4
12,2010,220902,17,17,0,1
1,2011,220902,21,21,0,8
2,2011,220902,12,10,2,1
1,1999,200300,25,23,2,8
2,1999,200300,15,11,4,2
3,1999,200300,23,23,0,9
4,1999,200300,11,7,4,4
5,1999,200300,24,22,2,0
6,1999,200300,19,15,4,13
7,1999,200300,21,14,7,9
8,1999,200300,21,18,3,8
9,1999,200300,16,14,2,3
10,1999,200300,28,22,6,2
11,1999,200300,13,11,2,3
12,1999,200300,20,20,0,2
1,2000,200300,19,16,3,11
2,2000,200300,14,12,2,14
3,2000,200300,18,15,3,11
4,2000,200300,15,12,3,7
5,2000,200300,15,12,3,10
6,2000,200300,13,9,4,4
7,2000,200300,13,11,2,6
8,2000,200300,31,26,5,8
9,2000,200300,23,19,4,5
10,2000,200300,21,19,2,8
11,2000,200300,29,22,7,5
12,2000,200300,19,15,4,1
1,2001,200300,11,9,2,1
2,2001,200300,14,10,4,3
3,2001,200300,11,10,1,4
4,2001,200300,16,16,0,4
5,2001,200300,24,19,5,9
6,2001,200300,31,19,12,9
7,2001,200300,19,13,6,6
8,2001,200300,16,13,3,8
9,2001,200300,16,7,9,8
10,2001,200300,17,15,2,1
11,2001,200300,11,10,1,3
12,2001,200300,16,10,6,2
1,2002,200300,10,8,2,8
2,2002,200300,13,13,0,2
3,2002,200300,19,18,1,5
4,2002,200300,24,22,2,12
5,2002,200300,22,18,4,3
6,2002,200300,11,9,2,12
7,2002,200300,17,15,2,2
8,2002,200300,16,12,4,3
9,2002,200300,17,15,2,2
10,2002,200300,12,10,2,0
11,2002,200300,17,17,0,3
12,2002,200300,19,17,2,3
1,2003,200300,9,8,1,0
2,2003,200300,6,4,2,1
3,2003,200300,21,19,2,2
4,2003,200300,21,19,2,2
5,2003,200300,19,14,5,1
6,2003,200300,16,12,4,2
7,2003,200300,28,24,4,3
8,2003,200300,17,16,1,4
9,2003,200300,21,17,4,12
10,2003,200300,15,13,2,1
11,2003,200300,11,11,0,4
12,2003,200300,6,6,0,2
1,2004,200300,18,13,5,7
2,2004,200300,14,11,3,3
3,2004,200300,14,13,1,6
4,2004,200300,7,7,0,7
5,2004,200300,19,16,3,0
6,2004,200300,21,17,4,1
7,2004,200300,26,24,2,5
8,2004,200300,14,11,3,4
9,2004,200300,8,7,1,2
10,2004,200300,16,15,1,15
11,2004,200300,12,12,0,4
12,2004,200300,16,14,2,3
1,2005,200300,10,9,1,2
2,2005,200300,12,8,4,5
3,2005,200300,13,11,2,2
4,2005,200300,15,15,0,4
5,2005,200300,10,10,0,11
6,2005,200300,14,11,3,5
7,2005,200300,12,10,2,5
8,2005,200300,15,12,3,6
9,2005,200300,15,10,5,0
10,2005,200300,20,18,2,6
11,2005,200300,15,14,1,3
12,2005,200300,13,12,1,8
1,2006,200300,20,20,0,4
2,2006,200300,19,14,5,4
3,2006,200300,19,18,1,4
4,2006,200300,14,13,1,5
5,2006,200300,17,14,3,5
6,2006,200300,13,13,0,4
7,2006,200300,7,7,0,10
8,2006,200300,15,13,2,8
9,2006,200300,15,12,3,1
10,2006,200300,16,15,1,9
11,2006,200300,18,16,2,6
12,2006,200300,14,13,1,9
1,2007,200300,11,11,0,5
2,2007,200300,15,14,1,4
3,2007,200300,13,12,1,2
4,2007,200300,14,13,1,8
5,2007,200300,15,15,0,6
6,2007,200300,13,10,3,9
7,2007,200300,16,13,3,4
8,2007,200300,17,13,4,7
9,2007,200300,14,12,2,6
10,2007,200300,11,9,2,5
11,2007,200300,10,8,2,7
12,2007,200300,12,11,1,7
1,2008,200300,13,13,0,11
2,2008,200300,7,5,2,5
3,2008,200300,9,8,1,3
4,2008,200300,15,14,1,2
5,2008,200300,17,15,2,2
6,2008,200300,13,8,5,3
7,2008,200300,12,10,2,5
8,2008,200300,19,15,4,4
9,2008,200300,10,10,0,1
10,2008,200300,25,22,3,0
11,2008,200300,17,14,3,5
12,2008,200300,11,9,2,6
1,2009,200300,7,7,0,4
2,2009,200300,10,8,2,4
3,2009,200300,17,13,4,4
4,2009,200300,12,12,0,2
5,2009,200300,7,6,1,7
6,2009,200300,10,9,1,6
7,2009,200300,12,9,3,5
8,2009,200300,13,11,2,2
9,2009,200300,12,12,0,4
10,2009,200300,16,16,0,0
11,2009,200300,10,10,0,3
12,2009,200300,13,10,3,5
1,2010,200300,12,12,0,7
2,2010,200300,9,7,2,3
3,2010,200300,12,10,2,4
4,2010,200300,10,9,1,3
5,2010,200300,10,9,1,2
6,2010,200300,11,9,2,4
7,2010,200300,9,6,3,5
8,2010,200300,16,13,3,4
9,2010,200300,12,10,2,5
10,2010,200300,13,12,1,4
11,2010,200300,13,13,0,4
12,2010,200300,6,5,1,1
1,2011,200300,11,10,1,2
2,2011,200300,3,2,1,1
1,1999,190601,71,68,3,1
2,1999,190601,71,65,6,2
3,1999,190601,83,78,5,1
4,1999,190601,93,89,4,0
5,1999,190601,77,75,2,0
6,1999,190601,96,94,2,6
7,1999,190601,83,81,2,3
8,1999,190601,77,75,2,4
9,1999,190601,68,66,2,6
10,1999,190601,87,84,3,0
11,1999,190601,80,77,3,0
12,1999,190601,104,103,1,4
1,2000,190601,79,76,3,3
2,2000,190601,67,66,1,6
3,2000,190601,78,73,5,3
4,2000,190601,85,83,2,8
5,2000,190601,96,92,4,7
6,2000,190601,95,93,2,5
7,2000,190601,66,66,0,2
8,2000,190601,84,81,3,2
9,2000,190601,80,78,2,4
10,2000,190601,85,82,3,1
11,2000,190601,103,98,5,4
12,2000,190601,68,66,2,3
1,2001,190601,55,52,3,1
2,2001,190601,53,51,2,3
3,2001,190601,53,51,2,3
4,2001,190601,48,45,3,2
5,2001,190601,42,39,3,5
6,2001,190601,41,38,3,2
7,2001,190601,39,37,2,0
8,2001,190601,51,46,5,1
9,2001,190601,53,47,6,3
10,2001,190601,49,44,5,1
11,2001,190601,39,39,0,1
12,2001,190601,57,52,5,1
1,2002,190601,41,39,2,0
2,2002,190601,32,26,6,2
3,2002,190601,51,45,6,5
4,2002,190601,50,47,3,3
5,2002,190601,36,33,3,1
6,2002,190601,38,35,3,0
7,2002,190601,38,37,1,0
8,2002,190601,52,50,2,1
9,2002,190601,36,33,3,0
10,2002,190601,64,63,1,2
11,2002,190601,36,34,2,0
12,2002,190601,40,36,4,2
1,2003,190601,37,35,2,1
2,2003,190601,32,28,4,6
3,2003,190601,32,32,0,1
4,2003,190601,26,23,3,1
5,2003,190601,32,28,4,2
6,2003,190601,31,26,5,1
7,2003,190601,19,17,2,1
8,2003,190601,31,29,2,0
9,2003,190601,25,22,3,5
10,2003,190601,35,32,3,0
11,2003,190601,38,36,2,2
12,2003,190601,28,28,0,1
1,2004,190601,29,28,1,5
2,2004,190601,25,23,2,3
3,2004,190601,25,23,2,6
4,2004,190601,22,20,2,2
5,2004,190601,21,19,2,1
6,2004,190601,30,27,3,2
7,2004,190601,36,32,4,2
8,2004,190601,49,46,3,1
9,2004,190601,32,27,5,3
10,2004,190601,36,33,3,3
11,2004,190601,36,33,3,2
12,2004,190601,46,42,4,4
1,2005,190601,30,28,2,2
2,2005,190601,34,32,2,7
3,2005,190601,37,32,5,3
4,2005,190601,24,22,2,3
5,2005,190601,37,36,1,5
6,2005,190601,43,40,3,4
7,2005,190601,33,30,3,7
8,2005,190601,36,34,2,3
9,2005,190601,28,27,1,0
10,2005,190601,37,34,3,0
11,2005,190601,46,42,4,3
12,2005,190601,29,28,1,2
1,2006,190601,51,48,3,3
2,2006,190601,37,36,1,2
3,2006,190601,42,40,2,1
4,2006,190601,31,30,1,2
5,2006,190601,36,33,3,11
6,2006,190601,28,25,3,0
7,2006,190601,32,32,0,3
8,2006,190601,39,37,2,4
9,2006,190601,23,21,2,2
10,2006,190601,33,31,2,3
11,2006,190601,41,38,3,3
12,2006,190601,26,24,2,3
1,2007,190601,40,38,2,0
2,2007,190601,28,26,2,1
3,2007,190601,31,28,3,4
4,2007,190601,34,30,4,4
5,2007,190601,35,34,1,2
6,2007,190601,40,38,2,3
7,2007,190601,40,36,4,2
8,2007,190601,41,37,4,3
9,2007,190601,29,26,3,2
10,2007,190601,33,30,3,3
11,2007,190601,31,30,1,1
12,2007,190601,26,24,2,1
1,2008,190601,31,28,3,0
2,2008,190601,26,23,3,2
3,2008,190601,49,47,2,1
4,2008,190601,29,26,3,2
5,2008,190601,35,31,4,0
6,2008,190601,33,32,1,0
7,2008,190601,58,50,8,2
8,2008,190601,40,36,4,3
9,2008,190601,45,42,3,3
10,2008,190601,42,40,2,4
11,2008,190601,33,30,3,4
12,2008,190601,47,47,0,2
1,2009,190601,54,54,0,2
2,2009,190601,39,38,1,4
3,2009,190601,39,36,3,6
4,2009,190601,35,33,2,3
5,2009,190601,42,38,4,10
6,2009,190601,30,27,3,5
7,2009,190601,39,36,3,10
8,2009,190601,47,45,2,8
9,2009,190601,40,38,2,5
10,2009,190601,46,44,2,0
11,2009,190601,46,43,3,2
12,2009,190601,66,62,4,1
1,2010,190601,42,40,2,2
2,2010,190601,37,37,0,4
3,2010,190601,52,50,2,6
4,2010,190601,44,43,1,10
5,2010,190601,49,47,2,14
6,2010,190601,31,30,1,0
7,2010,190601,45,45,0,3
8,2010,190601,33,29,4,2
9,2010,190601,45,42,3,8
10,2010,190601,55,48,7,4
11,2010,190601,38,33,5,3
12,2010,190601,45,43,2,0
1,2011,190601,34,31,3,4
2,2011,190601,16,16,0,1
1,1999,190602,23,19,4,3
2,1999,190602,22,20,2,1
3,1999,190602,24,24,0,1
4,1999,190602,23,22,1,1
5,1999,190602,20,17,3,2
6,1999,190602,15,15,0,1
7,1999,190602,26,21,5,4
8,1999,190602,23,20,3,0
9,1999,190602,18,17,1,0
10,1999,190602,27,23,4,0
11,1999,190602,20,19,1,0
12,1999,190602,15,13,2,0
1,2000,190602,19,17,2,0
2,2000,190602,11,10,1,0
3,2000,190602,17,17,0,0
4,2000,190602,15,12,3,2
5,2000,190602,16,16,0,0
6,2000,190602,20,17,3,2
7,2000,190602,16,15,1,0
8,2000,190602,22,21,1,0
9,2000,190602,28,22,6,0
10,2000,190602,23,20,3,1
11,2000,190602,12,12,0,0
12,2000,190602,11,11,0,1
1,2001,190602,11,9,2,1
2,2001,190602,13,12,1,1
3,2001,190602,14,13,1,2
4,2001,190602,15,13,2,5
5,2001,190602,23,22,1,1
6,2001,190602,21,18,3,3
7,2001,190602,28,23,5,0
8,2001,190602,25,21,4,1
9,2001,190602,17,17,0,3
10,2001,190602,22,20,2,1
11,2001,190602,18,17,1,0
12,2001,190602,26,24,2,1
1,2002,190602,21,19,2,1
2,2002,190602,19,17,2,0
3,2002,190602,18,15,3,1
4,2002,190602,10,9,1,1
5,2002,190602,16,14,2,0
6,2002,190602,11,10,1,0
7,2002,190602,22,20,2,0
8,2002,190602,23,19,4,1
9,2002,190602,22,20,2,3
10,2002,190602,10,10,0,0
11,2002,190602,21,19,2,0
12,2002,190602,22,21,1,6
1,2003,190602,19,18,1,0
2,2003,190602,12,11,1,1
3,2003,190602,13,12,1,0
4,2003,190602,21,21,0,0
5,2003,190602,18,16,2,1
6,2003,190602,16,16,0,0
7,2003,190602,16,15,1,0
8,2003,190602,26,24,2,1
9,2003,190602,22,20,2,2
10,2003,190602,14,13,1,1
11,2003,190602,19,17,2,2
12,2003,190602,11,10,1,2
1,2004,190602,10,8,2,0
2,2004,190602,15,13,2,2
3,2004,190602,12,11,1,3
4,2004,190602,22,21,1,3
5,2004,190602,8,8,0,1
6,2004,190602,14,13,1,0
7,2004,190602,11,9,2,0
8,2004,190602,15,14,1,1
9,2004,190602,27,25,2,3
10,2004,190602,16,15,1,2
11,2004,190602,18,18,0,2
12,2004,190602,5,4,1,1
1,2005,190602,20,16,4,1
2,2005,190602,10,9,1,4
3,2005,190602,17,14,3,2
4,2005,190602,10,9,1,0
5,2005,190602,14,13,1,1
6,2005,190602,19,15,4,1
7,2005,190602,14,12,2,4
8,2005,190602,15,11,4,3
9,2005,190602,16,14,2,2
10,2005,190602,13,12,1,1
11,2005,190602,14,13,1,1
12,2005,190602,22,22,0,2
1,2006,190602,20,20,0,0
2,2006,190602,9,6,3,2
3,2006,190602,7,7,0,2
4,2006,190602,17,16,1,1
5,2006,190602,15,12,3,3
6,2006,190602,13,12,1,3
7,2006,190602,5,3,2,0
8,2006,190602,13,12,1,2
9,2006,190602,10,10,0,3
10,2006,190602,13,13,0,0
11,2006,190602,15,15,0,0
12,2006,190602,8,5,3,2
1,2007,190602,11,11,0,2
2,2007,190602,17,15,2,1
3,2007,190602,13,10,3,1
4,2007,190602,16,12,4,1
5,2007,190602,12,8,4,3
6,2007,190602,16,14,2,3
7,2007,190602,18,15,3,12
8,2007,190602,20,17,3,2
9,2007,190602,9,9,0,0
10,2007,190602,15,11,4,3
11,2007,190602,14,12,2,2
12,2007,190602,10,10,0,0
1,2008,190602,20,19,1,0
2,2008,190602,10,10,0,4
3,2008,190602,15,15,0,0
4,2008,190602,20,18,2,1
5,2008,190602,17,16,1,8
6,2008,190602,14,10,4,4
7,2008,190602,17,14,3,9
8,2008,190602,15,14,1,4
9,2008,190602,21,20,1,3
10,2008,190602,15,14,1,0
11,2008,190602,18,17,1,1
12,2008,190602,11,10,1,0
1,2009,190602,13,10,3,1
2,2009,190602,11,9,2,3
3,2009,190602,12,11,1,0
4,2009,190602,7,5,2,6
5,2009,190602,16,15,1,7
6,2009,190602,12,11,1,1
7,2009,190602,18,16,2,0
8,2009,190602,16,15,1,1
9,2009,190602,17,12,5,4
10,2009,190602,17,16,1,4
11,2009,190602,21,16,5,0
12,2009,190602,17,15,2,1
1,2010,190602,15,14,1,1
2,2010,190602,8,8,0,1
3,2010,190602,18,18,0,1
4,2010,190602,20,15,5,3
5,2010,190602,13,12,1,1
6,2010,190602,18,17,1,3
7,2010,190602,16,16,0,1
8,2010,190602,18,15,3,3
9,2010,190602,32,31,1,2
10,2010,190602,21,21,0,5
11,2010,190602,11,10,1,0
12,2010,190602,22,20,2,2
1,2011,190602,8,7,1,2
2,2011,190602,5,5,0,2
1,1999,190702,7,7,0,0
2,1999,190702,11,10,1,0
3,1999,190702,18,17,1,2
4,1999,190702,18,18,0,0
5,1999,190702,7,5,2,0
6,1999,190702,14,13,1,0
7,1999,190702,16,14,2,0
8,1999,190702,12,10,2,2
9,1999,190702,16,14,2,0
10,1999,190702,18,16,2,0
11,1999,190702,17,14,3,0
12,1999,190702,14,14,0,0
1,2000,190702,14,13,1,1
2,2000,190702,15,14,1,2
3,2000,190702,12,10,2,0
4,2000,190702,18,16,2,1
5,2000,190702,11,10,1,0
6,2000,190702,15,14,1,0
7,2000,190702,17,16,1,2
8,2000,190702,23,21,2,3
9,2000,190702,16,15,1,0
10,2000,190702,15,12,3,0
11,2000,190702,11,10,1,0
12,2000,190702,11,11,0,2
1,2001,190702,17,16,1,1
2,2001,190702,18,17,1,0
3,2001,190702,15,14,1,0
4,2001,190702,21,19,2,1
5,2001,190702,16,15,1,0
6,2001,190702,16,15,1,1
7,2001,190702,18,18,0,1
8,2001,190702,17,17,0,0
9,2001,190702,14,13,1,3
10,2001,190702,22,20,2,0
11,2001,190702,13,10,3,0
12,2001,190702,16,15,1,0
1,2002,190702,17,15,2,0
2,2002,190702,13,12,1,1
3,2002,190702,19,17,2,2
4,2002,190702,14,14,0,2
5,2002,190702,18,17,1,3
6,2002,190702,19,17,2,1
7,2002,190702,25,24,1,1
8,2002,190702,18,15,3,2
9,2002,190702,15,14,1,3
10,2002,190702,13,10,3,1
11,2002,190702,14,14,0,3
12,2002,190702,13,13,0,0
1,2003,190702,22,19,3,1
2,2003,190702,7,7,0,4
3,2003,190702,13,7,6,0
4,2003,190702,10,7,3,3
5,2003,190702,19,18,1,1
6,2003,190702,13,11,2,1
7,2003,190702,16,16,0,0
8,2003,190702,12,10,2,1
9,2003,190702,11,10,1,2
10,2003,190702,7,7,0,1
11,2003,190702,11,10,1,4
12,2003,190702,14,13,1,0
1,2004,190702,21,19,2,0
2,2004,190702,19,19,0,6
3,2004,190702,19,17,2,3
4,2004,190702,17,16,1,0
5,2004,190702,13,12,1,0
6,2004,190702,11,10,1,1
7,2004,190702,20,18,2,0
8,2004,190702,19,19,0,3
9,2004,190702,23,20,3,2
10,2004,190702,10,9,1,1
11,2004,190702,15,15,0,1
12,2004,190702,12,11,1,2
1,2005,190702,11,11,0,2
2,2005,190702,9,9,0,2
3,2005,190702,19,18,1,4
4,2005,190702,15,15,0,1
5,2005,190702,13,12,1,4
6,2005,190702,14,14,0,1
7,2005,190702,15,14,1,2
8,2005,190702,12,11,1,5
9,2005,190702,15,15,0,2
10,2005,190702,18,18,0,1
11,2005,190702,12,11,1,6
12,2005,190702,12,11,1,4
1,2006,190702,18,18,0,2
2,2006,190702,12,12,0,2
3,2006,190702,13,13,0,1
4,2006,190702,8,7,1,4
5,2006,190702,13,12,1,2
6,2006,190702,12,10,2,0
7,2006,190702,18,15,3,1
8,2006,190702,12,10,2,1
9,2006,190702,12,11,1,1
10,2006,190702,15,15,0,2
11,2006,190702,17,16,1,0
12,2006,190702,10,9,1,2
1,2007,190702,10,10,0,3
2,2007,190702,10,8,2,2
3,2007,190702,6,6,0,2
4,2007,190702,9,9,0,2
5,2007,190702,12,11,1,1
6,2007,190702,10,7,3,2
7,2007,190702,8,7,1,2
8,2007,190702,7,6,1,1
9,2007,190702,10,9,1,2
10,2007,190702,15,15,0,1
11,2007,190702,15,13,2,1
12,2007,190702,10,10,0,8
1,2008,190702,8,7,1,1
2,2008,190702,5,5,0,2
3,2008,190702,8,7,1,2
4,2008,190702,9,8,1,0
5,2008,190702,4,3,1,2
6,2008,190702,7,7,0,0
7,2008,190702,11,10,1,1
8,2008,190702,10,10,0,2
9,2008,190702,12,9,3,1
10,2008,190702,22,20,2,1
11,2008,190702,19,18,1,0
12,2008,190702,19,17,2,0
1,2009,190702,13,10,3,4
2,2009,190702,13,12,1,2
3,2009,190702,10,9,1,2
4,2009,190702,8,6,2,0
5,2009,190702,14,14,0,3
6,2009,190702,6,5,1,0
7,2009,190702,11,7,4,0
8,2009,190702,10,10,0,3
9,2009,190702,20,17,3,4
10,2009,190702,13,11,2,4
11,2009,190702,13,9,4,1
12,2009,190702,11,9,2,0
1,2010,190702,13,11,2,2
2,2010,190702,10,9,1,6
3,2010,190702,10,8,2,6
4,2010,190702,14,12,2,1
5,2010,190702,6,6,0,3
6,2010,190702,7,7,0,1
7,2010,190702,10,8,2,1
8,2010,190702,8,7,1,2
9,2010,190702,17,15,2,1
10,2010,190702,17,15,2,3
11,2010,190702,7,7,0,1
12,2010,190702,10,10,0,1
1,2011,190702,14,12,2,0
2,2011,190702,3,3,0,0
1,1999,190800,29,26,3,2
2,1999,190800,27,26,1,2
3,1999,190800,36,33,3,5
4,1999,190800,29,24,5,3
5,1999,190800,32,30,2,0
6,1999,190800,32,24,8,2
7,1999,190800,37,31,6,1
8,1999,190800,45,37,8,2
9,1999,190800,26,23,3,2
10,1999,190800,22,18,4,5
11,1999,190800,31,28,3,3
12,1999,190800,37,34,3,3
1,2000,190800,28,27,1,4
2,2000,190800,38,36,2,6
3,2000,190800,39,33,6,9
4,2000,190800,27,19,8,2
5,2000,190800,43,35,8,4
6,2000,190800,33,33,0,4
7,2000,190800,30,26,4,5
8,2000,190800,30,26,4,6
9,2000,190800,35,32,3,2
10,2000,190800,27,22,5,0
11,2000,190800,31,27,4,8
12,2000,190800,33,28,5,7
1,2001,190800,35,30,5,5
2,2001,190800,23,18,5,2
3,2001,190800,26,26,0,7
4,2001,190800,26,21,5,3
5,2001,190800,36,27,9,4
6,2001,190800,30,28,2,4
7,2001,190800,21,14,7,5
8,2001,190800,34,29,5,7
9,2001,190800,38,32,6,6
10,2001,190800,40,34,6,2
11,2001,190800,42,39,3,3
12,2001,190800,41,36,5,1
1,2002,190800,29,27,2,6
2,2002,190800,40,39,1,2
3,2002,190800,36,31,5,9
4,2002,190800,31,30,1,3
5,2002,190800,27,26,1,8
6,2002,190800,24,23,1,5
7,2002,190800,33,27,6,4
8,2002,190800,29,27,2,7
9,2002,190800,31,30,1,3
10,2002,190800,34,30,4,3
11,2002,190800,39,36,3,5
12,2002,190800,32,32,0,3
1,2003,190800,37,34,3,10
2,2003,190800,24,21,3,5
3,2003,190800,27,23,4,10
4,2003,190800,35,30,5,3
5,2003,190800,29,23,6,8
6,2003,190800,34,28,6,4
7,2003,190800,38,36,2,5
8,2003,190800,28,22,6,14
9,2003,190800,20,17,3,14
10,2003,190800,35,31,4,10
11,2003,190800,31,28,3,3
12,2003,190800,31,27,4,5
1,2004,190800,29,24,5,5
2,2004,190800,34,31,3,6
3,2004,190800,30,27,3,8
4,2004,190800,30,27,3,5
5,2004,190800,19,18,1,9
6,2004,190800,32,32,0,9
7,2004,190800,36,32,4,11
8,2004,190800,27,25,2,27
9,2004,190800,33,26,7,13
10,2004,190800,36,32,4,32
11,2004,190800,29,25,4,7
12,2004,190800,22,20,2,8
1,2005,190800,30,27,3,9
2,2005,190800,18,17,1,20
3,2005,190800,33,26,7,4
4,2005,190800,23,20,3,6
5,2005,190800,24,23,1,13
6,2005,190800,18,16,2,5
7,2005,190800,27,22,5,4
8,2005,190800,23,20,3,10
9,2005,190800,28,23,5,7
10,2005,190800,32,29,3,14
11,2005,190800,30,28,2,1
12,2005,190800,20,17,3,4
1,2006,190800,29,24,5,11
2,2006,190800,25,25,0,4
3,2006,190800,16,15,1,8
4,2006,190800,16,15,1,4
5,2006,190800,21,20,1,10
6,2006,190800,29,27,2,4
7,2006,190800,20,19,1,3
8,2006,190800,27,21,6,10
9,2006,190800,22,13,9,6
10,2006,190800,26,22,4,10
11,2006,190800,24,22,2,6
12,2006,190800,22,17,5,11
1,2007,190800,27,24,3,3
2,2007,190800,15,14,1,1
3,2007,190800,18,13,5,6
4,2007,190800,21,19,2,15
5,2007,190800,19,16,3,7
6,2007,190800,17,14,3,6
7,2007,190800,21,19,2,3
8,2007,190800,23,22,1,3
9,2007,190800,17,11,6,2
10,2007,190800,18,13,5,2
11,2007,190800,13,13,0,7
12,2007,190800,18,14,4,4
1,2008,190800,29,26,3,3
2,2008,190800,26,23,3,3
3,2008,190800,21,20,1,2
4,2008,190800,18,14,4,1
5,2008,190800,21,17,4,2
6,2008,190800,20,19,1,5
7,2008,190800,18,17,1,4
8,2008,190800,18,15,3,6
9,2008,190800,24,20,4,6
10,2008,190800,14,10,4,8
11,2008,190800,21,20,1,5
12,2008,190800,16,14,2,2
1,2009,190800,20,19,1,1
2,2009,190800,23,21,2,5
3,2009,190800,16,12,4,7
4,2009,190800,17,15,2,10
5,2009,190800,18,16,2,4
6,2009,190800,19,17,2,4
7,2009,190800,19,17,2,8
8,2009,190800,19,16,3,9
9,2009,190800,25,23,2,15
10,2009,190800,19,14,5,3
11,2009,190800,19,15,4,8
12,2009,190800,22,19,3,10
1,2010,190800,25,25,0,9
2,2010,190800,17,10,7,8
3,2010,190800,20,18,2,8
4,2010,190800,23,21,2,8
5,2010,190800,31,30,1,10
6,2010,190800,15,12,3,13
7,2010,190800,17,10,7,11
8,2010,190800,31,28,3,10
9,2010,190800,24,22,2,7
10,2010,190800,25,23,2,8
11,2010,190800,21,20,1,1
12,2010,190800,35,34,1,4
1,2011,190800,24,24,0,5
2,2011,190800,14,14,0,2
1,1999,220601,10,8,2,0
2,1999,220601,8,7,1,0
3,1999,220601,12,10,2,1
4,1999,220601,9,9,0,0
5,1999,220601,11,9,2,0
6,1999,220601,12,12,0,2
7,1999,220601,22,21,1,1
8,1999,220601,13,12,1,1
9,1999,220601,18,16,2,3
10,1999,220601,16,13,3,0
11,1999,220601,17,17,0,1
12,1999,220601,10,9,1,0
1,2000,220601,11,8,3,1
2,2000,220601,2,2,0,0
3,2000,220601,9,9,0,0
4,2000,220601,11,9,2,0
5,2000,220601,18,16,2,2
6,2000,220601,16,15,1,0
7,2000,220601,8,8,0,1
8,2000,220601,10,8,2,0
9,2000,220601,10,6,4,0
10,2000,220601,16,13,3,2
11,2000,220601,11,11,0,1
12,2000,220601,11,10,1,0
1,2001,220601,5,5,0,2
2,2001,220601,10,8,2,1
3,2001,220601,14,8,6,0
4,2001,220601,9,8,1,2
5,2001,220601,9,9,0,2
6,2001,220601,8,5,3,0
7,2001,220601,9,9,0,1
8,2001,220601,10,8,2,1
9,2001,220601,7,6,1,4
10,2001,220601,13,13,0,0
11,2001,220601,9,8,1,0
12,2001,220601,3,3,0,0
1,2002,220601,9,6,3,0
2,2002,220601,6,6,0,0
3,2002,220601,10,10,0,0
4,2002,220601,4,4,0,2
5,2002,220601,3,3,0,0
6,2002,220601,10,10,0,6
7,2002,220601,11,11,0,0
8,2002,220601,9,9,0,1
9,2002,220601,14,12,2,0
10,2002,220601,15,15,0,0
11,2002,220601,11,10,1,2
12,2002,220601,4,4,0,1
1,2003,220601,4,2,2,1
2,2003,220601,7,6,1,0
3,2003,220601,6,4,2,0
4,2003,220601,10,7,3,0
5,2003,220601,7,7,0,0
6,2003,220601,6,5,1,0
7,2003,220601,10,10,0,0
8,2003,220601,7,7,0,1
9,2003,220601,8,8,0,2
10,2003,220601,7,7,0,0
11,2003,220601,11,11,0,4
12,2003,220601,4,4,0,0
1,2004,220601,4,4,0,0
2,2004,220601,4,3,1,1
3,2004,220601,6,4,2,0
4,2004,220601,4,4,0,0
5,2004,220601,7,7,0,0
6,2004,220601,5,5,0,1
7,2004,220601,9,9,0,1
8,2004,220601,9,9,0,1
9,2004,220601,11,11,0,0
10,2004,220601,10,9,1,0
11,2004,220601,11,10,1,2
12,2004,220601,6,6,0,0
1,2005,220601,2,2,0,2
2,2005,220601,6,5,1,0
3,2005,220601,5,5,0,1
4,2005,220601,6,5,1,1
5,2005,220601,4,3,1,2
6,2005,220601,5,5,0,2
7,2005,220601,4,4,0,1
8,2005,220601,3,1,2,0
9,2005,220601,7,7,0,2
10,2005,220601,6,6,0,1
11,2005,220601,2,1,1,0
12,2005,220601,6,6,0,0
1,2006,220601,11,11,0,1
2,2006,220601,2,2,0,0
3,2006,220601,3,3,0,0
4,2006,220601,5,4,1,1
5,2006,220601,7,7,0,1
6,2006,220601,5,4,1,1
7,2006,220601,3,3,0,2
8,2006,220601,7,7,0,2
9,2006,220601,13,12,1,0
10,2006,220601,5,5,0,0
11,2006,220601,8,7,1,1
12,2006,220601,1,1,0,0
1,2007,220601,8,8,0,0
2,2007,220601,2,2,0,0
3,2007,220601,9,7,2,0
4,2007,220601,4,4,0,0
5,2007,220601,9,9,0,0
6,2007,220601,6,6,0,4
7,2007,220601,5,5,0,1
8,2007,220601,7,7,0,0
9,2007,220601,3,3,0,0
10,2007,220601,6,6,0,0
11,2007,220601,8,8,0,2
12,2007,220601,2,2,0,0
1,2008,220601,1,1,0,0
2,2008,220601,2,2,0,0
3,2008,220601,4,4,0,2
4,2008,220601,4,3,1,0
5,2008,220601,6,4,2,1
6,2008,220601,5,5,0,0
7,2008,220601,4,4,0,0
8,2008,220601,2,2,0,0
9,2008,220601,1,1,0,0
10,2008,220601,6,6,0,1
11,2008,220601,9,9,0,0
12,2008,220601,5,4,1,0
1,2009,220601,4,4,0,0
2,2009,220601,2,1,1,0
3,2009,220601,5,5,0,1
4,2009,220601,3,3,0,0
5,2009,220601,5,4,1,2
6,2009,220601,5,4,1,2
7,2009,220601,6,6,0,0
8,2009,220601,3,3,0,0
9,2009,220601,5,5,0,0
10,2009,220601,4,3,1,0
11,2009,220601,5,5,0,0
12,2009,220601,4,4,0,1
1,2010,220601,10,10,0,1
2,2010,220601,2,1,1,0
3,2010,220601,6,6,0,0
4,2010,220601,6,6,0,2
5,2010,220601,11,10,1,0
6,2010,220601,7,7,0,0
7,2010,220601,8,7,1,1
8,2010,220601,7,7,0,1
9,2010,220601,4,4,0,0
10,2010,220601,6,6,0,0
11,2010,220601,6,6,0,0
12,2010,220601,9,9,0,0
1,2011,220601,6,6,0,0
2,2011,220601,2,2,0,0
1,1999,220400,13,12,1,1
2,1999,220400,22,22,0,1
3,1999,220400,21,17,4,1
4,1999,220400,19,17,2,0
5,1999,220400,29,27,2,3
6,1999,220400,17,14,3,1
7,1999,220400,23,19,4,1
8,1999,220400,29,28,1,1
9,1999,220400,36,34,2,0
10,1999,220400,24,22,2,0
11,1999,220400,16,16,0,2
12,1999,220400,20,18,2,1
1,2000,220400,29,24,5,0
2,2000,220400,17,16,1,1
3,2000,220400,18,16,2,2
4,2000,220400,29,27,2,0
5,2000,220400,34,28,6,2
6,2000,220400,27,23,4,2
7,2000,220400,29,26,3,0
8,2000,220400,35,31,4,3
9,2000,220400,33,25,8,0
10,2000,220400,33,30,3,0
11,2000,220400,29,27,2,0
12,2000,220400,35,31,4,0
1,2001,220400,19,16,3,0
2,2001,220400,29,28,1,1
3,2001,220400,27,21,6,1
4,2001,220400,35,25,10,6
5,2001,220400,23,20,3,4
6,2001,220400,29,25,4,0
7,2001,220400,35,30,5,2
8,2001,220400,40,38,2,3
9,2001,220400,38,36,2,1
10,2001,220400,32,28,4,2
11,2001,220400,27,26,1,2
12,2001,220400,36,35,1,0
1,2002,220400,28,25,3,0
2,2002,220400,19,16,3,3
3,2002,220400,13,9,4,0
4,2002,220400,16,13,3,1
5,2002,220400,24,21,3,1
6,2002,220400,28,24,4,2
7,2002,220400,23,21,2,0
8,2002,220400,41,38,3,1
9,2002,220400,30,30,0,1
10,2002,220400,26,24,2,2
11,2002,220400,27,24,3,0
12,2002,220400,23,20,3,0
1,2003,220400,21,18,3,1
2,2003,220400,22,21,1,0
3,2003,220400,16,16,0,0
4,2003,220400,26,24,2,5
5,2003,220400,22,19,3,2
6,2003,220400,28,28,0,0
7,2003,220400,26,22,4,0
8,2003,220400,25,24,1,1
9,2003,220400,29,29,0,2
10,2003,220400,34,33,1,0
11,2003,220400,22,21,1,1
12,2003,220400,23,19,4,0
1,2004,220400,24,24,0,2
2,2004,220400,19,16,3,1
3,2004,220400,16,13,3,1
4,2004,220400,30,29,1,0
5,2004,220400,17,17,0,1
6,2004,220400,21,20,1,1
7,2004,220400,38,38,0,0
8,2004,220400,23,23,0,1
9,2004,220400,30,29,1,0
10,2004,220400,22,20,2,1
11,2004,220400,31,31,0,1
12,2004,220400,27,26,1,1
1,2005,220400,30,28,2,1
2,2005,220400,16,16,0,0
3,2005,220400,10,10,0,1
4,2005,220400,14,13,1,1
5,2005,220400,25,25,0,1
6,2005,220400,10,9,1,3
7,2005,220400,20,18,2,1
8,2005,220400,11,10,1,2
9,2005,220400,12,11,1,0
10,2005,220400,18,17,1,1
11,2005,220400,15,14,1,0
12,2005,220400,21,21,0,1
1,2006,220400,21,21,0,0
2,2006,220400,11,11,0,5
3,2006,220400,24,21,3,1
4,2006,220400,18,16,2,2
5,2006,220400,12,9,3,6
6,2006,220400,22,21,1,1
7,2006,220400,14,14,0,1
8,2006,220400,13,12,1,1
9,2006,220400,29,27,2,2
10,2006,220400,11,11,0,1
11,2006,220400,21,21,0,5
12,2006,220400,13,13,0,3
1,2007,220400,8,7,1,0
2,2007,220400,4,4,0,1
3,2007,220400,11,10,1,4
4,2007,220400,13,13,0,1
5,2007,220400,16,16,0,0
6,2007,220400,17,16,1,1
7,2007,220400,13,12,1,2
8,2007,220400,24,23,1,4
9,2007,220400,18,17,1,1
10,2007,220400,17,16,1,1
11,2007,220400,10,10,0,1
12,2007,220400,22,18,4,0
1,2008,220400,21,19,2,2
2,2008,220400,9,9,0,5
3,2008,220400,13,11,2,4
4,2008,220400,9,9,0,2
5,2008,220400,13,12,1,1
6,2008,220400,23,21,2,1
7,2008,220400,18,16,2,1
8,2008,220400,18,18,0,4
9,2008,220400,16,15,1,1
10,2008,220400,19,18,1,3
11,2008,220400,20,20,0,0
12,2008,220400,13,10,3,0
1,2009,220400,14,12,2,8
2,2009,220400,11,10,1,2
3,2009,220400,7,7,0,0
4,2009,220400,12,8,4,5
5,2009,220400,12,12,0,0
6,2009,220400,9,9,0,0
7,2009,220400,15,14,1,0
8,2009,220400,19,17,2,0
9,2009,220400,21,20,1,0
10,2009,220400,22,21,1,3
11,2009,220400,21,19,2,1
12,2009,220400,32,29,3,1
1,2010,220400,21,21,0,0
2,2010,220400,9,8,1,2
3,2010,220400,16,16,0,2
4,2010,220400,19,19,0,1
5,2010,220400,14,12,2,1
6,2010,220400,24,24,0,0
7,2010,220400,29,27,2,0
8,2010,220400,27,25,2,1
9,2010,220400,25,23,2,1
10,2010,220400,23,22,1,1
11,2010,220400,12,11,1,1
12,2010,220400,7,7,0,2
1,2011,220400,14,14,0,0
2,2011,220400,18,18,0,0
1,1999,220300,9,9,0,0
2,1999,220300,6,6,0,0
3,1999,220300,7,7,0,0
4,1999,220300,5,5,0,1
5,1999,220300,11,10,1,2
6,1999,220300,8,7,1,3
7,1999,220300,10,9,1,1
8,1999,220300,16,14,2,2
9,1999,220300,14,11,3,0
10,1999,220300,9,8,1,0
11,1999,220300,10,9,1,0
12,1999,220300,15,12,3,0
1,2000,220300,19,16,3,0
2,2000,220300,13,10,3,0
3,2000,220300,14,12,2,3
4,2000,220300,11,10,1,2
5,2000,220300,14,13,1,0
6,2000,220300,13,12,1,0
7,2000,220300,18,18,0,0
8,2000,220300,15,12,3,1
9,2000,220300,23,22,1,0
10,2000,220300,11,10,1,0
11,2000,220300,9,9,0,0
12,2000,220300,8,8,0,0
1,2001,220300,22,21,1,1
2,2001,220300,12,10,2,0
3,2001,220300,22,18,4,2
4,2001,220300,12,12,0,0
5,2001,220300,18,18,0,0
6,2001,220300,7,5,2,0
7,2001,220300,15,14,1,2
8,2001,220300,18,18,0,0
9,2001,220300,16,16,0,1
10,2001,220300,13,11,2,1
11,2001,220300,15,14,1,0
12,2001,220300,16,15,1,0
1,2002,220300,11,7,4,0
2,2002,220300,7,7,0,0
3,2002,220300,7,7,0,2
4,2002,220300,6,5,1,0
5,2002,220300,14,12,2,0
6,2002,220300,11,10,1,1
7,2002,220300,18,16,2,0
8,2002,220300,9,9,0,0
9,2002,220300,11,11,0,0
10,2002,220300,19,18,1,0
11,2002,220300,16,16,0,1
12,2002,220300,24,22,2,0
1,2003,220300,9,9,0,0
2,2003,220300,4,4,0,0
3,2003,220300,8,8,0,0
4,2003,220300,7,7,0,3
5,2003,220300,10,10,0,1
6,2003,220300,9,7,2,0
7,2003,220300,10,10,0,1
8,2003,220300,12,10,2,0
9,2003,220300,18,18,0,0
10,2003,220300,15,13,2,0
11,2003,220300,13,13,0,0
12,2003,220300,4,4,0,0
1,2004,220300,12,12,0,0
2,2004,220300,13,12,1,0
3,2004,220300,5,5,0,0
4,2004,220300,10,10,0,1
5,2004,220300,4,3,1,0
6,2004,220300,5,5,0,0
7,2004,220300,26,26,0,0
8,2004,220300,20,18,2,7
9,2004,220300,14,14,0,0
10,2004,220300,16,13,3,1
11,2004,220300,19,18,1,0
12,2004,220300,9,9,0,1
1,2005,220300,4,4,0,0
2,2005,220300,11,10,1,0
3,2005,220300,10,8,2,1
4,2005,220300,10,10,0,0
5,2005,220300,6,5,1,2
6,2005,220300,7,7,0,2
7,2005,220300,11,10,1,1
8,2005,220300,5,5,0,0
9,2005,220300,5,5,0,0
10,2005,220300,7,7,0,0
11,2005,220300,4,3,1,1
12,2005,220300,12,11,1,0
1,2006,220300,11,10,1,0
2,2006,220300,11,9,2,0
3,2006,220300,12,11,1,2
4,2006,220300,8,7,1,1
5,2006,220300,9,8,1,0
6,2006,220300,7,6,1,0
7,2006,220300,8,7,1,0
8,2006,220300,10,10,0,2
9,2006,220300,13,13,0,0
10,2006,220300,7,7,0,0
11,2006,220300,4,4,0,1
12,2006,220300,5,5,0,1
1,2007,220300,5,5,0,1
2,2007,220300,2,2,0,0
3,2007,220300,10,10,0,1
4,2007,220300,9,8,1,1
5,2007,220300,9,8,1,1
6,2007,220300,8,8,0,0
7,2007,220300,10,9,1,0
8,2007,220300,8,8,0,1
9,2007,220300,13,13,0,0
10,2007,220300,6,6,0,0
11,2007,220300,11,10,1,1
12,2007,220300,6,6,0,0
1,2008,220300,7,7,0,0
2,2008,220300,6,6,0,0
3,2008,220300,5,5,0,2
4,2008,220300,7,7,0,1
5,2008,220300,7,6,1,0
6,2008,220300,8,8,0,0
7,2008,220300,4,3,1,0
8,2008,220300,8,8,0,1
9,2008,220300,4,4,0,0
10,2008,220300,7,7,0,0
11,2008,220300,7,6,1,0
12,2008,220300,5,5,0,2
1,2009,220300,12,11,1,0
2,2009,220300,6,6,0,0
3,2009,220300,11,9,2,1
4,2009,220300,6,5,1,0
5,2009,220300,13,12,1,1
6,2009,220300,10,8,2,0
7,2009,220300,12,12,0,1
8,2009,220300,8,8,0,0
9,2009,220300,11,11,0,1
10,2009,220300,10,10,0,0
11,2009,220300,5,5,0,2
12,2009,220300,6,6,0,0
1,2010,220300,7,7,0,1
2,2010,220300,4,4,0,0
3,2010,220300,7,7,0,0
4,2010,220300,8,8,0,0
5,2010,220300,8,7,1,1
6,2010,220300,11,11,0,0
7,2010,220300,11,11,0,0
8,2010,220300,13,13,0,0
9,2010,220300,6,6,0,0
10,2010,220300,17,16,1,0
11,2010,220300,7,7,0,0
12,2010,220300,8,8,0,0
1,2011,220300,9,8,1,0
2,2011,220300,4,4,0,0
1,1999,830900,37,34,3,4
2,1999,830900,45,42,3,0
3,1999,830900,36,33,3,1
4,1999,830900,37,35,2,1
5,1999,830900,58,55,3,0
6,1999,830900,39,35,4,3
7,1999,830900,41,40,1,1
8,1999,830900,49,48,1,2
9,1999,830900,31,29,2,1
10,1999,830900,37,36,1,0
11,1999,830900,46,43,3,1
12,1999,830900,50,49,1,3
1,2000,830900,52,49,3,3
2,2000,830900,25,24,1,1
3,2000,830900,44,44,0,2
4,2000,830900,44,43,1,0
5,2000,830900,45,43,2,1
6,2000,830900,45,42,3,1
7,2000,830900,45,42,3,1
8,2000,830900,57,53,4,1
9,2000,830900,39,38,1,0
10,2000,830900,37,37,0,1
11,2000,830900,48,45,3,0
12,2000,830900,43,41,2,1
1,2001,830900,37,35,2,0
2,2001,830900,31,29,2,2
3,2001,830900,40,39,1,0
4,2001,830900,44,43,1,2
5,2001,830900,43,41,2,3
6,2001,830900,33,30,3,1
7,2001,830900,39,34,5,3
8,2001,830900,44,41,3,1
9,2001,830900,33,29,4,0
10,2001,830900,27,27,0,1
11,2001,830900,41,41,0,0
12,2001,830900,31,31,0,4
1,2002,830900,54,52,2,1
2,2002,830900,50,50,0,1
3,2002,830900,38,37,1,3
4,2002,830900,46,44,2,4
5,2002,830900,45,44,1,1
6,2002,830900,43,41,2,2
7,2002,830900,53,50,3,0
8,2002,830900,51,49,2,1
9,2002,830900,45,43,2,0
10,2002,830900,61,58,3,0
11,2002,830900,49,49,0,1
12,2002,830900,56,55,1,0
1,2003,830900,44,43,1,1
2,2003,830900,40,40,0,1
3,2003,830900,39,39,0,2
4,2003,830900,54,54,0,4
5,2003,830900,58,58,0,2
6,2003,830900,52,51,1,1
7,2003,830900,59,58,1,1
8,2003,830900,59,59,0,0
9,2003,830900,55,52,3,0
10,2003,830900,54,52,2,3
11,2003,830900,45,45,0,1
12,2003,830900,52,51,1,0
1,2004,830900,42,40,2,0
2,2004,830900,37,37,0,0
3,2004,830900,36,36,0,2
4,2004,830900,28,26,2,0
5,2004,830900,39,38,1,1
6,2004,830900,50,47,3,0
7,2004,830900,45,45,0,1
8,2004,830900,47,47,0,0
9,2004,830900,31,30,1,1
10,2004,830900,35,33,2,2
11,2004,830900,43,40,3,1
12,2004,830900,32,30,2,0
1,2005,830900,28,28,0,1
2,2005,830900,35,33,2,0
3,2005,830900,35,32,3,2
4,2005,830900,45,44,1,0
5,2005,830900,28,27,1,2
6,2005,830900,28,26,2,1
7,2005,830900,38,36,2,1
8,2005,830900,31,30,1,0
9,2005,830900,28,27,1,4
10,2005,830900,28,27,1,0
11,2005,830900,33,30,3,1
12,2005,830900,41,40,1,1
1,2006,830900,29,28,1,0
2,2006,830900,28,26,2,2
3,2006,830900,26,25,1,1
4,2006,830900,23,23,0,0
5,2006,830900,30,27,3,1
6,2006,830900,15,14,1,1
7,2006,830900,32,30,2,0
8,2006,830900,28,27,1,0
9,2006,830900,30,30,0,2
10,2006,830900,31,30,1,0
11,2006,830900,34,33,1,2
12,2006,830900,29,28,1,0
1,2007,830900,27,26,1,0
2,2007,830900,30,29,1,2
3,2007,830900,20,20,0,3
4,2007,830900,24,22,2,4
5,2007,830900,41,41,0,2
6,2007,830900,33,31,2,1
7,2007,830900,34,30,4,0
8,2007,830900,29,29,0,1
9,2007,830900,26,24,2,0
10,2007,830900,33,33,0,1
11,2007,830900,33,33,0,2
12,2007,830900,42,39,3,0
1,2008,830900,30,26,4,4
2,2008,830900,18,17,1,0
3,2008,830900,32,32,0,0
4,2008,830900,25,24,1,0
5,2008,830900,34,34,0,0
6,2008,830900,40,40,0,0
7,2008,830900,55,52,3,0
8,2008,830900,33,32,1,1
9,2008,830900,36,32,4,2
10,2008,830900,33,31,2,1
11,2008,830900,31,31,0,0
12,2008,830900,53,52,1,1
1,2009,830900,31,31,0,1
2,2009,830900,23,23,0,1
3,2009,830900,47,46,1,1
4,2009,830900,32,31,1,2
5,2009,830900,31,28,3,0
6,2009,830900,21,20,1,1
7,2009,830900,33,33,0,1
8,2009,830900,52,51,1,9
9,2009,830900,35,35,0,1
10,2009,830900,57,57,0,0
11,2009,830900,42,41,1,0
12,2009,830900,29,29,0,0
1,2010,830900,35,34,1,1
2,2010,830900,31,31,0,1
3,2010,830900,31,30,1,1
4,2010,830900,35,32,3,0
5,2010,830900,26,24,2,3
6,2010,830900,26,26,0,1
7,2010,830900,18,17,1,1
8,2010,830900,35,34,1,2
9,2010,830900,35,34,1,0
10,2010,830900,36,34,2,2
11,2010,830900,36,36,0,0
12,2010,830900,44,43,1,0
1,2011,830900,30,30,0,0
2,2011,830900,24,24,0,0
1,1999,070700,43,36,7,14
2,1999,070700,39,38,1,8
3,1999,070700,50,48,2,4
4,1999,070700,61,56,5,11
5,1999,070700,52,50,2,14
6,1999,070700,59,54,5,2
7,1999,070700,50,47,3,5
8,1999,070700,57,53,4,10
9,1999,070700,59,56,3,7
10,1999,070700,45,44,1,5
11,1999,070700,46,46,0,6
12,1999,070700,65,64,1,10
1,2000,070700,45,42,3,6
2,2000,070700,56,51,5,5
3,2000,070700,46,45,1,6
4,2000,070700,50,49,1,10
5,2000,070700,47,41,6,4
6,2000,070700,39,29,10,9
7,2000,070700,34,30,4,8
8,2000,070700,26,26,0,13
9,2000,070700,49,47,2,1
10,2000,070700,56,49,7,10
11,2000,070700,37,35,2,21
12,2000,070700,47,46,1,5
1,2001,070700,41,40,1,7
2,2001,070700,30,28,2,6
3,2001,070700,46,42,4,3
4,2001,070700,31,27,4,8
5,2001,070700,34,34,0,12
6,2001,070700,51,47,4,16
7,2001,070700,67,64,3,12
8,2001,070700,52,51,1,3
9,2001,070700,35,29,6,10
10,2001,070700,62,60,2,5
11,2001,070700,37,34,3,13
12,2001,070700,48,44,4,4
1,2002,070700,45,41,4,9
2,2002,070700,39,34,5,6
3,2002,070700,46,44,2,17
4,2002,070700,49,48,1,7
5,2002,070700,51,50,1,7
6,2002,070700,46,43,3,6
7,2002,070700,43,39,4,9
8,2002,070700,38,32,6,10
9,2002,070700,43,40,3,4
10,2002,070700,41,32,9,6
11,2002,070700,44,43,1,2
12,2002,070700,49,48,1,12
1,2003,070700,27,26,1,13
2,2003,070700,37,35,2,6
3,2003,070700,50,47,3,7
4,2003,070700,57,50,7,14
5,2003,070700,36,34,2,12
6,2003,070700,35,34,1,6
7,2003,070700,38,31,7,3
8,2003,070700,52,46,6,6
9,2003,070700,45,43,2,7
10,2003,070700,39,39,0,4
11,2003,070700,47,43,4,2
12,2003,070700,44,44,0,7
1,2004,070700,17,17,0,5
2,2004,070700,26,23,3,8
3,2004,070700,17,15,2,13
4,2004,070700,34,31,3,2
5,2004,070700,33,28,5,2
6,2004,070700,29,21,8,10
7,2004,070700,43,39,4,10
8,2004,070700,35,29,6,9
9,2004,070700,47,45,2,5
10,2004,070700,35,33,2,12
11,2004,070700,32,29,3,7
12,2004,070700,38,35,3,8
1,2005,070700,27,25,2,7
2,2005,070700,21,18,3,5
3,2005,070700,22,22,0,6
4,2005,070700,31,27,4,3
5,2005,070700,29,25,4,10
6,2005,070700,33,29,4,11
7,2005,070700,24,22,2,10
8,2005,070700,38,32,6,0
9,2005,070700,29,28,1,5
10,2005,070700,23,22,1,6
11,2005,070700,24,24,0,2
12,2005,070700,27,26,1,5
1,2006,070700,35,32,3,3
2,2006,070700,5,4,1,3
3,2006,070700,17,15,2,3
4,2006,070700,20,19,1,1
5,2006,070700,20,20,0,2
6,2006,070700,26,22,4,0
7,2006,070700,18,18,0,1
8,2006,070700,25,24,1,1
9,2006,070700,33,31,2,5
10,2006,070700,27,27,0,3
11,2006,070700,26,25,1,2
12,2006,070700,34,30,4,3
1,2007,070700,20,19,1,3
2,2007,070700,15,15,0,5
3,2007,070700,22,19,3,3
4,2007,070700,28,27,1,0
5,2007,070700,25,23,2,1
6,2007,070700,19,18,1,0
7,2007,070700,27,26,1,3
8,2007,070700,22,21,1,0
9,2007,070700,17,15,2,0
10,2007,070700,29,25,4,2
11,2007,070700,37,33,4,7
12,2007,070700,27,25,2,3
1,2008,070700,26,26,0,7
2,2008,070700,18,18,0,2
3,2008,070700,20,20,0,0
4,2008,070700,18,18,0,4
5,2008,070700,22,20,2,1
6,2008,070700,19,18,1,4
7,2008,070700,26,26,0,2
8,2008,070700,32,31,1,1
9,2008,070700,33,31,2,1
10,2008,070700,34,34,0,1
11,2008,070700,19,19,0,3
12,2008,070700,22,21,1,1
1,2009,070700,30,29,1,2
2,2009,070700,27,26,1,6
3,2009,070700,16,16,0,3
4,2009,070700,23,23,0,1
5,2009,070700,33,33,0,1
6,2009,070700,24,23,1,1
7,2009,070700,33,32,1,1
8,2009,070700,33,30,3,0
9,2009,070700,20,19,1,4
10,2009,070700,19,19,0,0
11,2009,070700,24,23,1,2
12,2009,070700,26,24,2,1
1,2010,070700,15,14,1,1
2,2010,070700,16,16,0,1
3,2010,070700,25,25,0,0
4,2010,070700,28,27,1,2
5,2010,070700,21,20,1,4
6,2010,070700,26,25,1,0
7,2010,070700,28,25,3,0
8,2010,070700,26,23,3,1
9,2010,070700,26,25,1,2
10,2010,070700,27,26,1,1
11,2010,070700,28,28,0,1
12,2010,070700,15,15,0,1
1,2011,070700,13,13,0,0
2,2011,070700,18,18,0,0
1,1999,190900,15,14,1,1
2,1999,190900,7,6,1,1
3,1999,190900,10,10,0,0
4,1999,190900,17,15,2,0
5,1999,190900,12,9,3,1
6,1999,190900,9,9,0,0
7,1999,190900,11,9,2,0
8,1999,190900,22,19,3,1
9,1999,190900,11,10,1,2
10,1999,190900,15,12,3,0
11,1999,190900,8,8,0,0
12,1999,190900,7,5,2,0
1,2000,190900,6,5,1,0
2,2000,190900,11,7,4,1
3,2000,190900,20,17,3,1
4,2000,190900,12,11,1,2
5,2000,190900,16,15,1,1
6,2000,190900,11,9,2,0
7,2000,190900,10,10,0,0
8,2000,190900,13,11,2,0
9,2000,190900,13,12,1,0
10,2000,190900,9,8,1,2
11,2000,190900,11,11,0,0
12,2000,190900,12,11,1,0
1,2001,190900,15,13,2,1
2,2001,190900,1,1,0,0
3,2001,190900,8,8,0,0
4,2001,190900,10,8,2,1
5,2001,190900,11,11,0,1
6,2001,190900,16,15,1,2
7,2001,190900,9,9,0,0
8,2001,190900,18,18,0,1
9,2001,190900,11,10,1,1
10,2001,190900,12,11,1,0
11,2001,190900,15,13,2,1
12,2001,190900,9,6,3,0
1,2002,190900,7,7,0,1
2,2002,190900,10,9,1,3
3,2002,190900,11,7,4,0
4,2002,190900,15,14,1,1
5,2002,190900,9,8,1,1
6,2002,190900,12,12,0,4
7,2002,190900,17,16,1,1
8,2002,190900,12,11,1,1
9,2002,190900,8,6,2,0
10,2002,190900,14,14,0,3
11,2002,190900,11,11,0,0
12,2002,190900,8,7,1,0
1,2003,190900,18,18,0,0
2,2003,190900,8,8,0,1
3,2003,190900,12,12,0,2
4,2003,190900,6,4,2,3
5,2003,190900,16,16,0,2
6,2003,190900,8,8,0,1
7,2003,190900,15,14,1,0
8,2003,190900,7,7,0,0
9,2003,190900,17,17,0,1
10,2003,190900,11,10,1,0
11,2003,190900,10,8,2,0
12,2003,190900,17,13,4,1
1,2004,190900,13,13,0,0
2,2004,190900,18,18,0,2
3,2004,190900,12,10,2,2
4,2004,190900,8,8,0,0
5,2004,190900,7,7,0,0
6,2004,190900,13,13,0,3
7,2004,190900,14,13,1,0
8,2004,190900,7,6,1,2
9,2004,190900,9,8,1,1
10,2004,190900,13,10,3,1
11,2004,190900,9,8,1,8
12,2004,190900,10,9,1,2
1,2005,190900,8,7,1,1
2,2005,190900,10,9,1,2
3,2005,190900,4,4,0,2
4,2005,190900,11,11,0,0
5,2005,190900,8,8,0,1
6,2005,190900,6,6,0,0
7,2005,190900,12,12,0,1
8,2005,190900,9,7,2,3
9,2005,190900,9,8,1,1
10,2005,190900,9,8,1,2
11,2005,190900,9,9,0,2
12,2005,190900,9,8,1,1
1,2006,190900,7,7,0,3
2,2006,190900,8,7,1,1
3,2006,190900,7,7,0,1
4,2006,190900,8,7,1,2
5,2006,190900,2,1,1,1
6,2006,190900,7,7,0,2
7,2006,190900,7,6,1,0
8,2006,190900,6,5,1,2
9,2006,190900,8,7,1,1
10,2006,190900,9,9,0,1
11,2006,190900,9,9,0,0
12,2006,190900,10,10,0,0
1,2007,190900,8,6,2,1
2,2007,190900,11,10,1,1
3,2007,190900,9,7,2,0
4,2007,190900,6,4,2,1
5,2007,190900,4,4,0,1
6,2007,190900,6,5,1,0
7,2007,190900,6,5,1,6
8,2007,190900,10,10,0,1
9,2007,190900,5,3,2,1
10,2007,190900,13,9,4,1
11,2007,190900,10,9,1,1
12,2007,190900,13,13,0,0
1,2008,190900,13,13,0,2
2,2008,190900,5,5,0,1
3,2008,190900,7,7,0,4
4,2008,190900,9,9,0,0
5,2008,190900,13,13,0,4
6,2008,190900,5,5,0,3
7,2008,190900,6,5,1,7
8,2008,190900,6,5,1,1
9,2008,190900,6,6,0,0
10,2008,190900,5,5,0,2
11,2008,190900,17,16,1,0
12,2008,190900,3,3,0,2
1,2009,190900,9,8,1,0
2,2009,190900,4,4,0,1
3,2009,190900,8,7,1,3
4,2009,190900,4,2,2,0
5,2009,190900,12,10,2,0
6,2009,190900,11,7,4,0
7,2009,190900,4,4,0,4
8,2009,190900,13,11,2,0
9,2009,190900,11,10,1,3
10,2009,190900,7,7,0,2
11,2009,190900,8,7,1,0
12,2009,190900,4,4,0,0
1,2010,190900,6,5,1,2
2,2010,190900,5,5,0,2
3,2010,190900,5,5,0,0
4,2010,190900,5,3,2,0
5,2010,190900,6,4,2,0
6,2010,190900,13,12,1,3
7,2010,190900,9,9,0,1
8,2010,190900,9,9,0,2
9,2010,190900,9,7,2,0
10,2010,190900,12,11,1,0
11,2010,190900,10,10,0,2
12,2010,190900,9,8,1,0
1,2011,190900,6,6,0,3
2,2011,190900,1,1,0,0
1,1999,200200,37,35,2,2
2,1999,200200,32,30,2,4
3,1999,200200,40,38,2,2
4,1999,200200,49,46,3,2
5,1999,200200,53,47,6,4
6,1999,200200,37,32,5,4
7,1999,200200,30,28,2,4
8,1999,200200,37,33,4,1
9,1999,200200,45,40,5,1
10,1999,200200,38,33,5,6
11,1999,200200,49,41,8,9
12,1999,200200,35,35,0,9
1,2000,200200,48,41,7,1
2,2000,200200,31,27,4,4
3,2000,200200,37,33,4,5
4,2000,200200,36,32,4,1
5,2000,200200,44,37,7,3
6,2000,200200,36,32,4,0
7,2000,200200,32,28,4,4
8,2000,200200,38,32,6,1
9,2000,200200,32,31,1,1
10,2000,200200,38,32,6,2
11,2000,200200,42,39,3,3
12,2000,200200,29,28,1,2
1,2001,200200,23,19,4,5
2,2001,200200,34,33,1,8
3,2001,200200,27,25,2,2
4,2001,200200,44,39,5,3
5,2001,200200,35,32,3,1
6,2001,200200,30,28,2,5
7,2001,200200,37,33,4,14
8,2001,200200,36,33,3,4
9,2001,200200,23,20,3,5
10,2001,200200,53,48,5,1
11,2001,200200,27,23,4,1
12,2001,200200,33,32,1,5
1,2002,200200,24,19,5,2
2,2002,200200,28,26,2,2
3,2002,200200,30,25,5,1
4,2002,200200,19,16,3,4
5,2002,200200,21,19,2,6
6,2002,200200,19,15,4,2
7,2002,200200,27,26,1,5
8,2002,200200,29,23,6,1
9,2002,200200,41,35,6,4
10,2002,200200,46,41,5,5
11,2002,200200,32,29,3,8
12,2002,200200,34,31,3,9
1,2003,200200,32,31,1,5
2,2003,200200,25,21,4,3
3,2003,200200,33,29,4,2
4,2003,200200,37,33,4,2
5,2003,200200,37,35,2,2
6,2003,200200,26,25,1,1
7,2003,200200,54,49,5,0
8,2003,200200,37,35,2,3
9,2003,200200,34,32,2,2
10,2003,200200,46,44,2,6
11,2003,200200,29,26,3,4
12,2003,200200,21,18,3,2
1,2004,200200,32,29,3,3
2,2004,200200,19,15,4,2
3,2004,200200,27,24,3,4
4,2004,200200,22,21,1,0
5,2004,200200,30,24,6,1
6,2004,200200,25,22,3,1
7,2004,200200,37,32,5,1
8,2004,200200,39,38,1,3
9,2004,200200,35,35,0,2
10,2004,200200,29,27,2,5
11,2004,200200,17,17,0,3
12,2004,200200,35,33,2,2
1,2005,200200,18,17,1,4
2,2005,200200,11,9,2,0
3,2005,200200,26,24,2,5
4,2005,200200,17,14,3,0
5,2005,200200,25,24,1,2
6,2005,200200,27,24,3,0
7,2005,200200,25,23,2,6
8,2005,200200,24,22,2,1
9,2005,200200,26,22,4,3
10,2005,200200,38,35,3,1
11,2005,200200,17,17,0,1
12,2005,200200,26,26,0,8
1,2006,200200,23,23,0,9
2,2006,200200,29,25,4,8
3,2006,200200,30,27,3,6
4,2006,200200,17,15,2,5
5,2006,200200,23,21,2,7
6,2006,200200,18,17,1,6
7,2006,200200,21,17,4,3
8,2006,200200,27,25,2,3
9,2006,200200,28,24,4,9
10,2006,200200,30,29,1,6
11,2006,200200,21,19,2,7
12,2006,200200,21,21,0,10
1,2007,200200,26,22,4,3
2,2007,200200,23,22,1,2
3,2007,200200,25,23,2,3
4,2007,200200,19,16,3,2
5,2007,200200,17,14,3,5
6,2007,200200,15,14,1,0
7,2007,200200,24,22,2,6
8,2007,200200,20,20,0,2
9,2007,200200,10,10,0,3
10,2007,200200,20,19,1,7
11,2007,200200,19,17,2,8
12,2007,200200,26,20,6,1
1,2008,200200,19,17,2,2
2,2008,200200,16,16,0,2
3,2008,200200,19,18,1,0
4,2008,200200,17,16,1,11
5,2008,200200,21,21,0,1
6,2008,200200,20,16,4,3
7,2008,200200,17,13,4,1
8,2008,200200,13,11,2,3
9,2008,200200,19,15,4,3
10,2008,200200,18,17,1,2
11,2008,200200,16,13,3,1
12,2008,200200,16,15,1,1
1,2009,200200,18,17,1,1
2,2009,200200,15,11,4,1
3,2009,200200,24,20,4,2
4,2009,200200,26,22,4,2
5,2009,200200,14,12,2,3
6,2009,200200,19,15,4,7
7,2009,200200,16,14,2,3
8,2009,200200,21,21,0,3
9,2009,200200,13,13,0,5
10,2009,200200,22,20,2,5
11,2009,200200,18,16,2,5
12,2009,200200,24,24,0,1
1,2010,200200,23,20,3,6
2,2010,200200,17,16,1,3
3,2010,200200,24,23,1,9
4,2010,200200,25,22,3,7
5,2010,200200,23,22,1,6
6,2010,200200,10,8,2,2
7,2010,200200,19,17,2,4
8,2010,200200,15,14,1,3
9,2010,200200,23,23,0,3
10,2010,200200,19,17,2,5
11,2010,200200,20,17,3,4
12,2010,200200,21,19,2,3
1,2011,200200,16,15,1,2
2,2011,200200,10,9,1,1
1,1999,070600,14,14,0,1
2,1999,070600,17,17,0,2
3,1999,070600,12,12,0,0
4,1999,070600,15,12,3,0
5,1999,070600,20,20,0,2
6,1999,070600,36,32,4,0
7,1999,070600,28,27,1,0
8,1999,070600,23,22,1,2
9,1999,070600,16,16,0,0
10,1999,070600,20,20,0,0
11,1999,070600,10,10,0,0
12,1999,070600,15,15,0,0
1,2000,070600,13,12,1,0
2,2000,070600,6,6,0,0
3,2000,070600,12,12,0,0
4,2000,070600,13,13,0,0
5,2000,070600,13,13,0,0
6,2000,070600,17,17,0,1
7,2000,070600,12,12,0,0
8,2000,070600,12,11,1,0
9,2000,070600,11,11,0,0
10,2000,070600,11,11,0,0
11,2000,070600,14,13,1,0
12,2000,070600,9,9,0,0
1,2001,070600,10,10,0,0
2,2001,070600,9,9,0,0
3,2001,070600,15,15,0,0
4,2001,070600,11,11,0,0
5,2001,070600,13,13,0,0
6,2001,070600,16,16,0,0
7,2001,070600,25,25,0,0
8,2001,070600,8,8,0,2
9,2001,070600,11,11,0,0
10,2001,070600,21,21,0,0
11,2001,070600,10,9,1,2
12,2001,070600,7,7,0,1
1,2002,070600,9,8,1,0
2,2002,070600,6,6,0,1
3,2002,070600,9,9,0,0
4,2002,070600,13,13,0,0
5,2002,070600,11,10,1,1
6,2002,070600,12,12,0,0
7,2002,070600,15,15,0,0
8,2002,070600,16,16,0,0
9,2002,070600,18,18,0,1
10,2002,070600,14,13,1,0
11,2002,070600,12,12,0,0
12,2002,070600,14,14,0,0
1,2003,070600,6,6,0,0
2,2003,070600,9,9,0,0
3,2003,070600,9,9,0,1
4,2003,070600,5,5,0,0
5,2003,070600,8,8,0,0
6,2003,070600,9,9,0,0
7,2003,070600,10,9,1,1
8,2003,070600,15,15,0,0
9,2003,070600,19,19,0,0
10,2003,070600,12,12,0,0
11,2003,070600,7,6,1,1
12,2003,070600,11,11,0,2
1,2004,070600,10,10,0,0
2,2004,070600,8,8,0,0
3,2004,070600,8,8,0,0
4,2004,070600,8,8,0,1
5,2004,070600,7,7,0,0
6,2004,070600,8,8,0,0
7,2004,070600,16,16,0,0
8,2004,070600,13,12,1,0
9,2004,070600,16,16,0,2
10,2004,070600,13,13,0,0
11,2004,070600,15,14,1,2
12,2004,070600,11,10,1,2
1,2005,070600,13,13,0,0
2,2005,070600,12,12,0,0
3,2005,070600,7,6,1,0
4,2005,070600,15,15,0,0
5,2005,070600,16,16,0,2
6,2005,070600,11,11,0,0
7,2005,070600,19,19,0,0
8,2005,070600,19,18,1,0
9,2005,070600,13,13,0,1
10,2005,070600,10,10,0,0
11,2005,070600,17,17,0,0
12,2005,070600,11,11,0,0
1,2006,070600,8,8,0,1
2,2006,070600,7,7,0,1
3,2006,070600,5,4,1,0
4,2006,070600,17,16,1,0
5,2006,070600,9,9,0,0
6,2006,070600,8,8,0,0
7,2006,070600,12,12,0,2
8,2006,070600,13,13,0,0
9,2006,070600,17,16,1,0
10,2006,070600,13,13,0,0
11,2006,070600,12,11,1,1
12,2006,070600,11,11,0,0
1,2007,070600,17,17,0,1
2,2007,070600,4,4,0,0
3,2007,070600,12,12,0,0
4,2007,070600,13,12,1,1
5,2007,070600,17,17,0,0
6,2007,070600,12,11,1,0
7,2007,070600,13,13,0,0
8,2007,070600,16,16,0,0
9,2007,070600,17,17,0,0
10,2007,070600,14,13,1,0
11,2007,070600,11,11,0,0
12,2007,070600,11,11,0,0
1,2008,070600,15,15,0,0
2,2008,070600,6,6,0,0
3,2008,070600,14,13,1,0
4,2008,070600,5,5,0,0
5,2008,070600,8,7,1,0
6,2008,070600,10,10,0,0
7,2008,070600,16,16,0,0
8,2008,070600,14,14,0,0
9,2008,070600,15,15,0,1
10,2008,070600,19,19,0,0
11,2008,070600,6,5,1,1
12,2008,070600,7,7,0,0
1,2009,070600,12,12,0,1
2,2009,070600,7,7,0,0
3,2009,070600,17,17,0,0
4,2009,070600,11,11,0,0
5,2009,070600,8,8,0,0
6,2009,070600,14,14,0,0
7,2009,070600,13,10,3,0
8,2009,070600,19,19,0,0
9,2009,070600,9,8,1,1
10,2009,070600,9,9,0,0
11,2009,070600,2,2,0,0
12,2009,070600,11,11,0,0
1,2010,070600,7,7,0,0
2,2010,070600,7,7,0,0
3,2010,070600,11,11,0,0
4,2010,070600,8,7,1,0
5,2010,070600,21,20,1,0
6,2010,070600,11,11,0,0
7,2010,070600,11,11,0,0
8,2010,070600,16,13,3,1
9,2010,070600,21,19,2,0
10,2010,070600,22,22,0,1
11,2010,070600,10,10,0,0
12,2010,070600,11,11,0,0
1,2011,070600,11,11,0,0
2,2011,070600,4,4,0,0
1,1999,070500,10,10,0,1
2,1999,070500,12,12,0,0
3,1999,070500,12,12,0,0
4,1999,070500,14,14,0,0
5,1999,070500,19,19,0,0
6,1999,070500,19,19,0,0
7,1999,070500,22,21,1,1
8,1999,070500,22,22,0,0
9,1999,070500,15,15,0,1
10,1999,070500,12,12,0,0
11,1999,070500,12,12,0,0
12,1999,070500,8,8,0,0
1,2000,070500,15,15,0,0
2,2000,070500,7,7,0,0
3,2000,070500,15,15,0,0
4,2000,070500,13,13,0,0
5,2000,070500,15,15,0,1
6,2000,070500,20,20,0,1
7,2000,070500,14,13,1,0
8,2000,070500,19,19,0,0
9,2000,070500,16,16,0,0
10,2000,070500,19,19,0,0
11,2000,070500,17,17,0,0
12,2000,070500,20,19,1,0
1,2001,070500,15,14,1,0
2,2001,070500,14,14,0,0
3,2001,070500,13,13,0,0
4,2001,070500,8,8,0,0
5,2001,070500,11,11,0,0
6,2001,070500,19,19,0,0
7,2001,070500,14,14,0,0
8,2001,070500,9,9,0,0
9,2001,070500,17,17,0,0
10,2001,070500,11,11,0,0
11,2001,070500,19,19,0,0
12,2001,070500,6,6,0,0
1,2002,070500,13,13,0,1
2,2002,070500,8,8,0,1
3,2002,070500,10,10,0,0
4,2002,070500,5,5,0,0
5,2002,070500,19,19,0,0
6,2002,070500,17,17,0,0
7,2002,070500,11,11,0,0
8,2002,070500,22,21,1,0
9,2002,070500,20,20,0,0
10,2002,070500,15,15,0,0
11,2002,070500,19,18,1,0
12,2002,070500,10,10,0,1
1,2003,070500,7,6,1,0
2,2003,070500,14,14,0,0
3,2003,070500,7,6,1,1
4,2003,070500,14,13,1,0
5,2003,070500,14,13,1,0
6,2003,070500,16,16,0,0
7,2003,070500,8,8,0,0
8,2003,070500,13,13,0,0
9,2003,070500,13,13,0,0
10,2003,070500,13,13,0,0
11,2003,070500,6,6,0,0
12,2003,070500,13,13,0,0
1,2004,070500,12,12,0,0
2,2004,070500,5,5,0,0
3,2004,070500,10,9,1,0
4,2004,070500,11,11,0,0
5,2004,070500,15,15,0,0
6,2004,070500,10,10,0,0
7,2004,070500,14,14,0,0
8,2004,070500,14,14,0,0
9,2004,070500,6,6,0,0
10,2004,070500,10,10,0,1
11,2004,070500,8,8,0,0
12,2004,070500,10,10,0,1
1,2005,070500,8,8,0,0
2,2005,070500,7,7,0,0
3,2005,070500,4,4,0,0
4,2005,070500,4,4,0,0
5,2005,070500,9,9,0,0
6,2005,070500,14,14,0,2
7,2005,070500,14,14,0,0
8,2005,070500,14,14,0,0
9,2005,070500,18,18,0,0
10,2005,070500,7,7,0,0
11,2005,070500,8,7,1,0
12,2005,070500,5,4,1,0
1,2006,070500,8,8,0,0
2,2006,070500,8,8,0,0
3,2006,070500,12,12,0,0
4,2006,070500,9,9,0,1
5,2006,070500,14,14,0,0
6,2006,070500,12,12,0,0
7,2006,070500,16,16,0,1
8,2006,070500,12,12,0,0
9,2006,070500,9,9,0,1
10,2006,070500,17,17,0,1
11,2006,070500,6,6,0,0
12,2006,070500,10,10,0,0
1,2007,070500,14,14,0,0
2,2007,070500,7,7,0,0
3,2007,070500,12,12,0,0
4,2007,070500,13,13,0,0
5,2007,070500,14,14,0,0
6,2007,070500,16,15,1,0
7,2007,070500,19,19,0,0
8,2007,070500,6,6,0,0
9,2007,070500,18,17,1,0
10,2007,070500,22,22,0,0
11,2007,070500,12,12,0,0
12,2007,070500,9,9,0,0
1,2008,070500,12,12,0,0
2,2008,070500,10,9,1,0
3,2008,070500,10,10,0,0
4,2008,070500,11,11,0,0
5,2008,070500,10,10,0,0
6,2008,070500,8,8,0,0
7,2008,070500,16,16,0,0
8,2008,070500,18,18,0,0
9,2008,070500,8,8,0,0
10,2008,070500,13,13,0,0
11,2008,070500,11,10,1,0
12,2008,070500,15,15,0,0
1,2009,070500,11,11,0,0
2,2009,070500,11,11,0,0
3,2009,070500,15,15,0,0
4,2009,070500,9,9,0,2
5,2009,070500,11,10,1,0
6,2009,070500,12,12,0,0
7,2009,070500,7,7,0,0
8,2009,070500,12,12,0,0
9,2009,070500,10,10,0,0
10,2009,070500,10,10,0,0
11,2009,070500,7,7,0,0
12,2009,070500,8,8,0,0
1,2010,070500,1,1,0,0
2,2010,070500,3,3,0,0
3,2010,070500,9,9,0,0
4,2010,070500,7,7,0,0
5,2010,070500,8,8,0,0
6,2010,070500,9,9,0,0
7,2010,070500,10,10,0,1
8,2010,070500,6,6,0,0
9,2010,070500,12,12,0,0
10,2010,070500,13,13,0,0
11,2010,070500,9,7,2,0
12,2010,070500,10,9,1,0
1,2011,070500,7,7,0,0
2,2011,070500,5,4,1,0
1,1999,070400,10,10,0,0
2,1999,070400,11,11,0,1
3,1999,070400,13,13,0,3
4,1999,070400,14,14,0,1
5,1999,070400,20,20,0,1
6,1999,070400,33,33,0,3
7,1999,070400,21,21,0,5
8,1999,070400,17,17,0,5
9,1999,070400,17,16,1,0
10,1999,070400,19,18,1,0
11,1999,070400,13,12,1,0
12,1999,070400,15,15,0,1
1,2000,070400,17,16,1,1
2,2000,070400,21,21,0,0
3,2000,070400,18,18,0,0
4,2000,070400,8,8,0,0
5,2000,070400,15,15,0,0
6,2000,070400,27,24,3,1
7,2000,070400,26,23,3,0
8,2000,070400,18,17,1,0
9,2000,070400,17,17,0,0
10,2000,070400,18,17,1,1
11,2000,070400,16,15,1,1
12,2000,070400,12,12,0,0
1,2001,070400,19,16,3,3
2,2001,070400,15,14,1,1
3,2001,070400,11,11,0,0
4,2001,070400,12,12,0,2
5,2001,070400,13,11,2,0
6,2001,070400,14,13,1,1
7,2001,070400,15,15,0,0
8,2001,070400,19,17,2,1
9,2001,070400,12,12,0,1
10,2001,070400,17,17,0,0
11,2001,070400,12,9,3,1
12,2001,070400,14,12,2,0
1,2002,070400,4,4,0,1
2,2002,070400,6,6,0,0
3,2002,070400,8,8,0,0
4,2002,070400,10,10,0,0
5,2002,070400,16,16,0,1
6,2002,070400,18,18,0,0
7,2002,070400,17,17,0,0
8,2002,070400,27,26,1,0
9,2002,070400,16,15,1,0
10,2002,070400,12,12,0,0
11,2002,070400,12,12,0,0
12,2002,070400,11,11,0,0
1,2003,070400,20,20,0,0
2,2003,070400,19,19,0,0
3,2003,070400,17,17,0,0
4,2003,070400,15,13,2,0
5,2003,070400,26,26,0,0
6,2003,070400,9,9,0,0
7,2003,070400,21,21,0,0
8,2003,070400,15,14,1,0
9,2003,070400,15,15,0,1
10,2003,070400,9,8,1,0
11,2003,070400,14,13,1,1
12,2003,070400,15,14,1,0
1,2004,070400,9,7,2,1
2,2004,070400,10,8,2,0
3,2004,070400,8,8,0,0
4,2004,070400,15,14,1,0
5,2004,070400,22,21,1,0
6,2004,070400,18,18,0,0
7,2004,070400,23,22,1,0
8,2004,070400,11,11,0,0
9,2004,070400,11,11,0,0
10,2004,070400,14,14,0,0
11,2004,070400,15,14,1,1
12,2004,070400,13,12,1,0
1,2005,070400,11,11,0,2
2,2005,070400,10,10,0,0
3,2005,070400,5,4,1,0
4,2005,070400,10,10,0,0
5,2005,070400,9,9,0,0
6,2005,070400,15,13,2,0
7,2005,070400,19,18,1,0
8,2005,070400,8,8,0,0
9,2005,070400,9,8,1,1
10,2005,070400,12,12,0,1
11,2005,070400,9,9,0,2
12,2005,070400,4,4,0,0
1,2006,070400,12,12,0,0
2,2006,070400,7,6,1,1
3,2006,070400,13,13,0,1
4,2006,070400,6,6,0,0
5,2006,070400,13,13,0,0
6,2006,070400,12,11,1,2
7,2006,070400,16,15,1,0
8,2006,070400,12,11,1,0
9,2006,070400,13,11,2,2
10,2006,070400,8,8,0,1
11,2006,070400,9,8,1,0
12,2006,070400,8,8,0,0
1,2007,070400,14,14,0,1
2,2007,070400,6,6,0,0
3,2007,070400,15,13,2,0
4,2007,070400,11,11,0,0
5,2007,070400,13,13,0,2
6,2007,070400,9,9,0,0
7,2007,070400,17,17,0,1
8,2007,070400,17,16,1,3
9,2007,070400,12,10,2,1
10,2007,070400,12,12,0,1
11,2007,070400,12,12,0,1
12,2007,070400,4,4,0,0
1,2008,070400,6,6,0,0
2,2008,070400,7,6,1,0
3,2008,070400,19,18,1,1
4,2008,070400,13,13,0,2
5,2008,070400,11,11,0,1
6,2008,070400,11,11,0,1
7,2008,070400,16,16,0,0
8,2008,070400,17,17,0,0
9,2008,070400,14,14,0,0
10,2008,070400,7,7,0,0
11,2008,070400,9,9,0,1
12,2008,070400,7,7,0,0
1,2009,070400,14,14,0,0
2,2009,070400,10,9,1,0
3,2009,070400,5,5,0,0
4,2009,070400,6,6,0,3
5,2009,070400,14,14,0,0
6,2009,070400,12,12,0,1
7,2009,070400,12,12,0,0
8,2009,070400,14,14,0,1
9,2009,070400,8,7,1,0
10,2009,070400,7,7,0,2
11,2009,070400,6,6,0,1
12,2009,070400,8,7,1,2
1,2010,070400,8,8,0,2
2,2010,070400,4,4,0,0
3,2010,070400,5,5,0,0
4,2010,070400,11,10,1,1
5,2010,070400,14,14,0,0
6,2010,070400,11,11,0,0
7,2010,070400,18,18,0,0
8,2010,070400,9,9,0,0
9,2010,070400,17,17,0,0
10,2010,070400,14,14,0,0
11,2010,070400,7,7,0,0
12,2010,070400,3,3,0,0
1,2011,070400,8,6,2,0
2,2011,070400,6,6,0,1
1,1999,070300,26,26,0,1
2,1999,070300,27,25,2,1
3,1999,070300,31,30,1,1
4,1999,070300,28,28,0,1
5,1999,070300,57,54,3,1
6,1999,070300,43,42,1,0
7,1999,070300,46,43,3,0
8,1999,070300,49,45,4,0
9,1999,070300,38,37,1,1
10,1999,070300,29,27,2,3
11,1999,070300,30,30,0,2
12,1999,070300,27,27,0,1
1,2000,070300,34,34,0,2
2,2000,070300,22,21,1,0
3,2000,070300,31,30,1,1
4,2000,070300,39,38,1,0
5,2000,070300,41,40,1,0
6,2000,070300,45,42,3,0
7,2000,070300,29,28,1,1
8,2000,070300,31,31,0,2
9,2000,070300,31,31,0,0
10,2000,070300,33,30,3,0
11,2000,070300,33,33,0,0
12,2000,070300,27,27,0,1
1,2001,070300,27,22,5,0
2,2001,070300,19,19,0,2
3,2001,070300,30,29,1,0
4,2001,070300,23,20,3,0
5,2001,070300,27,25,2,2
6,2001,070300,29,29,0,0
7,2001,070300,31,30,1,2
8,2001,070300,21,19,2,3
9,2001,070300,30,30,0,3
10,2001,070300,31,31,0,1
11,2001,070300,31,31,0,2
12,2001,070300,34,33,1,1
1,2002,070300,26,24,2,1
2,2002,070300,27,27,0,2
3,2002,070300,35,32,3,0
4,2002,070300,19,19,0,0
5,2002,070300,23,22,1,6
6,2002,070300,26,25,1,1
7,2002,070300,28,28,0,1
8,2002,070300,24,23,1,1
9,2002,070300,33,32,1,2
10,2002,070300,32,31,1,1
11,2002,070300,41,40,1,2
12,2002,070300,36,35,1,1
1,2003,070300,27,26,1,1
2,2003,070300,22,22,0,0
3,2003,070300,24,24,0,0
4,2003,070300,29,28,1,2
5,2003,070300,37,37,0,0
6,2003,070300,20,17,3,0
7,2003,070300,25,25,0,1
8,2003,070300,25,24,1,0
9,2003,070300,31,29,2,0
10,2003,070300,30,29,1,1
11,2003,070300,21,20,1,0
12,2003,070300,21,20,1,0
1,2004,070300,35,32,3,1
2,2004,070300,17,16,1,2
3,2004,070300,23,23,0,1
4,2004,070300,21,20,1,0
5,2004,070300,30,29,1,2
6,2004,070300,26,23,3,0
7,2004,070300,47,44,3,2
8,2004,070300,37,37,0,0
9,2004,070300,27,26,1,0
10,2004,070300,36,36,0,0
11,2004,070300,33,31,2,1
12,2004,070300,30,30,0,0
1,2005,070300,12,11,1,1
2,2005,070300,23,23,0,1
3,2005,070300,19,19,0,1
4,2005,070300,26,25,1,2
5,2005,070300,18,18,0,0
6,2005,070300,29,28,1,3
7,2005,070300,28,28,0,1
8,2005,070300,27,26,1,0
9,2005,070300,26,26,0,0
10,2005,070300,23,22,1,1
11,2005,070300,26,24,2,3
12,2005,070300,23,23,0,0
1,2006,070300,17,16,1,3
2,2006,070300,26,24,2,0
3,2006,070300,29,28,1,3
4,2006,070300,30,24,6,1
5,2006,070300,28,23,5,1
6,2006,070300,24,24,0,1
7,2006,070300,19,17,2,0
8,2006,070300,24,22,2,3
9,2006,070300,23,20,3,1
10,2006,070300,33,32,1,1
11,2006,070300,20,19,1,1
12,2006,070300,17,17,0,1
1,2007,070300,33,29,4,2
2,2007,070300,12,10,2,1
3,2007,070300,31,30,1,0
4,2007,070300,21,21,0,0
5,2007,070300,21,21,0,1
6,2007,070300,25,24,1,0
7,2007,070300,29,28,1,0
8,2007,070300,30,29,1,1
9,2007,070300,33,31,2,1
10,2007,070300,25,24,1,1
11,2007,070300,27,26,1,1
12,2007,070300,25,24,1,1
1,2008,070300,32,29,3,0
2,2008,070300,24,24,0,0
3,2008,070300,26,26,0,2
4,2008,070300,37,36,1,1
5,2008,070300,29,29,0,3
6,2008,070300,20,20,0,1
7,2008,070300,33,31,2,2
8,2008,070300,19,19,0,0
9,2008,070300,34,32,2,1
10,2008,070300,25,22,3,5
11,2008,070300,21,21,0,2
12,2008,070300,30,30,0,0
1,2009,070300,25,24,1,0
2,2009,070300,17,16,1,2
3,2009,070300,21,19,2,0
4,2009,070300,21,21,0,2
5,2009,070300,31,30,1,0
6,2009,070300,26,25,1,1
7,2009,070300,43,43,0,1
8,2009,070300,32,29,3,0
9,2009,070300,23,22,1,1
10,2009,070300,18,18,0,0
11,2009,070300,25,24,1,0
12,2009,070300,25,23,2,1
1,2010,070300,29,29,0,0
2,2010,070300,20,20,0,1
3,2010,070300,17,17,0,0
4,2010,070300,27,27,0,0
5,2010,070300,31,31,0,1
6,2010,070300,34,34,0,0
7,2010,070300,28,27,1,5
8,2010,070300,39,38,1,1
9,2010,070300,33,31,2,2
10,2010,070300,22,21,1,0
11,2010,070300,19,18,1,0
12,2010,070300,19,19,0,1
1,2011,070300,20,18,2,0
2,2011,070300,12,12,0,0
1,1999,070200,20,20,0,0
2,1999,070200,16,16,0,0
3,1999,070200,29,29,0,1
4,1999,070200,36,35,1,2
5,1999,070200,36,36,0,0
6,1999,070200,38,38,0,0
7,1999,070200,41,41,0,1
8,1999,070200,34,34,0,0
9,1999,070200,36,36,0,1
10,1999,070200,40,39,1,0
11,1999,070200,18,16,2,0
12,1999,070200,35,34,1,1
1,2000,070200,11,11,0,0
2,2000,070200,25,25,0,0
3,2000,070200,21,20,1,0
4,2000,070200,28,28,0,1
5,2000,070200,27,26,1,0
6,2000,070200,34,34,0,0
7,2000,070200,39,38,1,1
8,2000,070200,39,39,0,1
9,2000,070200,47,47,0,0
10,2000,070200,33,30,3,0
11,2000,070200,31,30,1,0
12,2000,070200,13,13,0,0
1,2001,070200,17,17,0,1
2,2001,070200,13,13,0,0
3,2001,070200,25,25,0,0
4,2001,070200,27,25,2,2
5,2001,070200,19,18,1,0
6,2001,070200,32,30,2,0
7,2001,070200,31,30,1,0
8,2001,070200,28,27,1,0
9,2001,070200,11,11,0,2
10,2001,070200,29,29,0,0
11,2001,070200,25,25,0,0
12,2001,070200,18,18,0,0
1,2002,070200,15,14,1,0
2,2002,070200,14,14,0,0
3,2002,070200,23,22,1,0
4,2002,070200,16,15,1,0
5,2002,070200,27,27,0,1
6,2002,070200,30,30,0,0
7,2002,070200,31,31,0,0
8,2002,070200,29,28,1,1
9,2002,070200,26,26,0,0
10,2002,070200,21,20,1,0
11,2002,070200,29,29,0,0
12,2002,070200,21,20,1,0
1,2003,070200,22,22,0,0
2,2003,070200,11,10,1,0
3,2003,070200,26,26,0,0
4,2003,070200,19,19,0,0
5,2003,070200,24,24,0,1
6,2003,070200,21,21,0,0
7,2003,070200,26,26,0,0
8,2003,070200,35,33,2,1
9,2003,070200,23,23,0,1
10,2003,070200,29,29,0,0
11,2003,070200,27,26,1,0
12,2003,070200,19,18,1,1
1,2004,070200,24,22,2,1
2,2004,070200,17,16,1,0
3,2004,070200,18,18,0,0
4,2004,070200,22,22,0,0
5,2004,070200,24,23,1,0
6,2004,070200,29,27,2,0
7,2004,070200,36,36,0,1
8,2004,070200,24,24,0,1
9,2004,070200,20,20,0,0
10,2004,070200,31,28,3,0
11,2004,070200,25,25,0,0
12,2004,070200,23,23,0,2
1,2005,070200,9,9,0,0
2,2005,070200,15,15,0,0
3,2005,070200,14,13,1,0
4,2005,070200,21,20,1,1
5,2005,070200,17,17,0,1
6,2005,070200,24,24,0,0
7,2005,070200,21,20,1,0
8,2005,070200,16,15,1,1
9,2005,070200,16,16,0,0
10,2005,070200,20,20,0,1
11,2005,070200,17,17,0,0
12,2005,070200,13,13,0,0
1,2006,070200,17,17,0,0
2,2006,070200,11,11,0,0
3,2006,070200,27,27,0,0
4,2006,070200,18,18,0,0
5,2006,070200,7,7,0,0
6,2006,070200,22,22,0,2
7,2006,070200,34,32,2,1
8,2006,070200,25,25,0,1
9,2006,070200,20,20,0,0
10,2006,070200,15,15,0,1
11,2006,070200,17,17,0,0
12,2006,070200,15,14,1,0
1,2007,070200,18,17,1,0
2,2007,070200,17,17,0,0
3,2007,070200,20,20,0,0
4,2007,070200,8,7,1,0
5,2007,070200,25,24,1,0
6,2007,070200,25,24,1,0
7,2007,070200,38,37,1,0
8,2007,070200,25,24,1,1
9,2007,070200,29,29,0,0
10,2007,070200,27,27,0,0
11,2007,070200,19,17,2,0
12,2007,070200,22,22,0,0
1,2008,070200,21,20,1,0
2,2008,070200,13,12,1,0
3,2008,070200,23,23,0,0
4,2008,070200,24,23,1,0
5,2008,070200,15,15,0,0
6,2008,070200,24,23,1,0
7,2008,070200,21,21,0,0
8,2008,070200,40,40,0,0
9,2008,070200,14,14,0,0
10,2008,070200,25,25,0,0
11,2008,070200,17,17,0,0
12,2008,070200,24,23,1,0
1,2009,070200,19,18,1,2
2,2009,070200,16,16,0,0
3,2009,070200,20,20,0,0
4,2009,070200,24,24,0,0
5,2009,070200,23,23,0,0
6,2009,070200,20,20,0,0
7,2009,070200,29,29,0,2
8,2009,070200,25,24,1,1
9,2009,070200,22,22,0,0
10,2009,070200,31,31,0,0
11,2009,070200,10,10,0,2
12,2009,070200,16,16,0,0
1,2010,070200,16,16,0,0
2,2010,070200,10,10,0,0
3,2010,070200,12,12,0,0
4,2010,070200,11,10,1,0
5,2010,070200,22,22,0,0
6,2010,070200,24,24,0,0
7,2010,070200,32,32,0,0
8,2010,070200,21,20,1,0
9,2010,070200,12,12,0,0
10,2010,070200,25,24,1,0
11,2010,070200,17,17,0,0
12,2010,070200,20,19,1,0
1,2011,070200,11,11,0,0
2,2011,070200,9,9,0,0
1,1999,220500,19,17,2,0
2,1999,220500,8,8,0,0
3,1999,220500,20,17,3,1
4,1999,220500,12,10,2,0
5,1999,220500,11,9,2,0
6,1999,220500,16,14,2,0
7,1999,220500,26,23,3,1
8,1999,220500,20,18,2,2
9,1999,220500,11,10,1,0
10,1999,220500,19,19,0,1
11,1999,220500,20,18,2,1
12,1999,220500,12,12,0,2
1,2000,220500,17,17,0,3
2,2000,220500,18,17,1,2
3,2000,220500,18,16,2,2
4,2000,220500,15,13,2,0
5,2000,220500,24,23,1,2
6,2000,220500,25,20,5,1
7,2000,220500,26,23,3,2
8,2000,220500,18,13,5,1
9,2000,220500,21,18,3,1
10,2000,220500,22,21,1,4
11,2000,220500,15,15,0,0
12,2000,220500,15,14,1,6
1,2001,220500,18,15,3,0
2,2001,220500,22,21,1,0
3,2001,220500,19,18,1,1
4,2001,220500,19,15,4,4
5,2001,220500,15,12,3,2
6,2001,220500,22,20,2,1
7,2001,220500,18,17,1,2
8,2001,220500,23,22,1,5
9,2001,220500,18,17,1,1
10,2001,220500,33,28,5,0
11,2001,220500,23,22,1,5
12,2001,220500,14,13,1,2
1,2002,220500,14,14,0,0
2,2002,220500,16,16,0,0
3,2002,220500,15,12,3,3
4,2002,220500,9,8,1,0
5,2002,220500,18,18,0,2
6,2002,220500,16,14,2,2
7,2002,220500,22,21,1,2
8,2002,220500,25,25,0,2
9,2002,220500,20,20,0,0
10,2002,220500,22,19,3,1
11,2002,220500,25,24,1,1
12,2002,220500,19,18,1,0
1,2003,220500,20,20,0,1
2,2003,220500,19,15,4,2
3,2003,220500,16,12,4,2
4,2003,220500,19,16,3,3
5,2003,220500,15,14,1,2
6,2003,220500,16,15,1,1
7,2003,220500,17,15,2,1
8,2003,220500,29,27,2,3
9,2003,220500,27,24,3,3
10,2003,220500,14,13,1,1
11,2003,220500,17,16,1,1
12,2003,220500,18,16,2,0
1,2004,220500,15,14,1,1
2,2004,220500,18,14,4,1
3,2004,220500,10,9,1,2
4,2004,220500,14,11,3,0
5,2004,220500,15,14,1,0
6,2004,220500,18,17,1,1
7,2004,220500,16,15,1,2
8,2004,220500,27,26,1,2
9,2004,220500,14,12,2,5
10,2004,220500,18,15,3,0
11,2004,220500,13,11,2,3
12,2004,220500,14,14,0,0
1,2005,220500,12,12,0,1
2,2005,220500,10,10,0,0
3,2005,220500,14,13,1,1
4,2005,220500,10,8,2,0
5,2005,220500,15,14,1,2
6,2005,220500,8,7,1,0
7,2005,220500,8,7,1,1
8,2005,220500,12,12,0,5
9,2005,220500,12,10,2,3
10,2005,220500,14,14,0,3
11,2005,220500,18,17,1,0
12,2005,220500,6,6,0,0
1,2006,220500,13,13,0,0
2,2006,220500,4,4,0,0
3,2006,220500,7,7,0,0
4,2006,220500,8,8,0,0
5,2006,220500,8,5,3,3
6,2006,220500,3,3,0,2
7,2006,220500,16,14,2,0
8,2006,220500,13,12,1,0
9,2006,220500,16,14,2,2
10,2006,220500,14,12,2,0
11,2006,220500,16,15,1,1
12,2006,220500,9,8,1,1
1,2007,220500,13,11,2,2
2,2007,220500,13,12,1,1
3,2007,220500,12,12,0,1
4,2007,220500,15,12,3,0
5,2007,220500,11,11,0,1
6,2007,220500,16,14,2,0
7,2007,220500,11,11,0,4
8,2007,220500,14,13,1,1
9,2007,220500,18,17,1,3
10,2007,220500,16,15,1,3
11,2007,220500,9,9,0,4
12,2007,220500,7,7,0,6
1,2008,220500,11,10,1,2
2,2008,220500,10,10,0,1
3,2008,220500,9,8,1,0
4,2008,220500,6,5,1,3
5,2008,220500,9,8,1,1
6,2008,220500,11,10,1,0
7,2008,220500,15,13,2,2
8,2008,220500,6,6,0,3
9,2008,220500,14,14,0,1
10,2008,220500,5,5,0,0
11,2008,220500,20,18,2,1
12,2008,220500,8,8,0,0
1,2009,220500,11,10,1,0
2,2009,220500,4,4,0,2
3,2009,220500,12,12,0,0
4,2009,220500,8,8,0,6
5,2009,220500,10,10,0,1
6,2009,220500,13,13,0,5
7,2009,220500,8,8,0,4
8,2009,220500,15,15,0,2
9,2009,220500,13,12,1,0
10,2009,220500,14,14,0,1
11,2009,220500,14,12,2,1
12,2009,220500,22,20,2,0
1,2010,220500,9,9,0,1
2,2010,220500,4,3,1,0
3,2010,220500,6,5,1,1
4,2010,220500,19,18,1,2
5,2010,220500,9,9,0,1
6,2010,220500,22,21,1,0
7,2010,220500,15,14,1,0
8,2010,220500,19,19,0,1
9,2010,220500,22,20,2,0
10,2010,220500,11,11,0,0
11,2010,220500,8,8,0,0
12,2010,220500,17,16,1,1
1,2011,220500,20,19,1,1
2,2011,220500,7,7,0,0
1,1999,070103,11,11,0,0
2,1999,070103,13,13,0,0
3,1999,070103,9,9,0,0
4,1999,070103,15,15,0,0
5,1999,070103,11,11,0,1
6,1999,070103,17,17,0,0
7,1999,070103,15,15,0,0
8,1999,070103,10,10,0,2
9,1999,070103,9,9,0,0
10,1999,070103,10,10,0,0
11,1999,070103,9,9,0,0
12,1999,070103,10,10,0,0
1,2000,070103,5,5,0,0
2,2000,070103,4,4,0,0
3,2000,070103,4,4,0,0
4,2000,070103,6,6,0,0
5,2000,070103,8,8,0,0
6,2000,070103,11,11,0,0
7,2000,070103,7,7,0,1
8,2000,070103,13,13,0,0
9,2000,070103,6,6,0,0
10,2000,070103,14,14,0,0
11,2000,070103,7,7,0,0
12,2000,070103,11,11,0,0
1,2001,070103,13,13,0,0
2,2001,070103,6,6,0,1
3,2001,070103,9,9,0,1
4,2001,070103,13,13,0,0
5,2001,070103,6,6,0,0
6,2001,070103,10,10,0,0
7,2001,070103,14,14,0,2
8,2001,070103,6,6,0,1
9,2001,070103,12,12,0,0
10,2001,070103,8,8,0,0
11,2001,070103,7,7,0,0
12,2001,070103,5,5,0,0
1,2002,070103,5,5,0,0
2,2002,070103,7,7,0,0
3,2002,070103,17,17,0,0
4,2002,070103,9,9,0,0
5,2002,070103,9,9,0,0
6,2002,070103,14,13,1,0
7,2002,070103,8,7,1,0
8,2002,070103,10,9,1,0
9,2002,070103,13,13,0,0
10,2002,070103,10,10,0,1
11,2002,070103,13,13,0,0
12,2002,070103,13,13,0,2
1,2003,070103,4,4,0,1
2,2003,070103,9,9,0,0
3,2003,070103,12,10,2,0
4,2003,070103,9,9,0,0
5,2003,070103,14,14,0,0
6,2003,070103,11,11,0,0
7,2003,070103,7,7,0,0
8,2003,070103,11,11,0,0
9,2003,070103,9,9,0,0
10,2003,070103,11,10,1,0
11,2003,070103,5,5,0,0
12,2003,070103,4,4,0,0
1,2004,070103,11,11,0,0
2,2004,070103,3,3,0,0
3,2004,070103,4,4,0,0
4,2004,070103,6,6,0,0
5,2004,070103,6,6,0,0
6,2004,070103,8,8,0,0
7,2004,070103,13,13,0,0
8,2004,070103,10,10,0,0
9,2004,070103,11,11,0,0
10,2004,070103,10,10,0,0
11,2004,070103,8,8,0,1
12,2004,070103,5,5,0,0
1,2005,070103,6,6,0,0
2,2005,070103,7,7,0,1
3,2005,070103,5,5,0,0
4,2005,070103,10,9,1,0
5,2005,070103,4,4,0,0
6,2005,070103,6,6,0,0
7,2005,070103,12,12,0,0
8,2005,070103,13,13,0,0
9,2005,070103,5,5,0,1
10,2005,070103,8,8,0,0
11,2005,070103,4,4,0,0
12,2005,070103,4,4,0,0
1,2006,070103,7,7,0,0
2,2006,070103,2,2,0,0
3,2006,070103,6,6,0,0
4,2006,070103,21,21,0,0
5,2006,070103,5,5,0,0
6,2006,070103,7,7,0,0
7,2006,070103,5,5,0,0
8,2006,070103,12,12,0,0
9,2006,070103,1,1,0,0
10,2006,070103,7,6,1,0
11,2006,070103,6,6,0,1
12,2006,070103,12,12,0,1
1,2007,070103,11,10,1,0
2,2007,070103,7,7,0,0
3,2007,070103,6,6,0,0
4,2007,070103,8,8,0,0
5,2007,070103,3,3,0,0
6,2007,070103,10,10,0,1
7,2007,070103,9,9,0,0
8,2007,070103,5,5,0,1
9,2007,070103,8,8,0,0
10,2007,070103,6,6,0,0
11,2007,070103,7,6,1,0
12,2007,070103,6,6,0,2
1,2008,070103,6,6,0,0
2,2008,070103,4,4,0,0
3,2008,070103,6,6,0,0
4,2008,070103,5,5,0,0
5,2008,070103,4,4,0,0
6,2008,070103,6,6,0,0
7,2008,070103,3,3,0,0
8,2008,070103,9,9,0,0
9,2008,070103,4,4,0,0
10,2008,070103,7,7,0,1
11,2008,070103,2,2,0,0
12,2008,070103,7,7,0,0
1,2009,070103,9,9,0,0
2,2009,070103,9,9,0,0
3,2009,070103,8,8,0,0
4,2009,070103,10,10,0,0
5,2009,070103,5,5,0,0
6,2009,070103,5,5,0,0
7,2009,070103,5,5,0,0
8,2009,070103,9,9,0,0
9,2009,070103,7,6,1,0
10,2009,070103,5,5,0,0
11,2009,070103,2,2,0,0
12,2009,070103,5,5,0,0
1,2010,070103,5,5,0,0
2,2010,070103,2,2,0,0
3,2010,070103,2,2,0,0
4,2010,070103,5,5,0,0
5,2010,070103,5,5,0,0
6,2010,070103,6,6,0,0
7,2010,070103,9,7,2,0
8,2010,070103,5,5,0,0
9,2010,070103,7,7,0,0
10,2010,070103,8,8,0,0
11,2010,070103,3,3,0,0
12,2010,070103,2,2,0,0
1,2011,070103,9,9,0,0
2,2011,070103,3,3,0,0
1,1999,070101,15,15,0,0
2,1999,070101,13,13,0,0
3,1999,070101,14,14,0,1
4,1999,070101,10,10,0,0
5,1999,070101,34,33,1,0
6,1999,070101,21,20,1,1
7,1999,070101,44,43,1,1
8,1999,070101,41,41,0,1
9,1999,070101,34,34,0,1
10,1999,070101,24,24,0,1
11,1999,070101,11,11,0,0
12,1999,070101,12,12,0,0
1,2000,070101,10,9,1,0
2,2000,070101,7,7,0,0
3,2000,070101,10,10,0,0
4,2000,070101,13,13,0,0
5,2000,070101,17,17,0,0
6,2000,070101,17,17,0,0
7,2000,070101,16,16,0,1
8,2000,070101,24,24,0,0
9,2000,070101,22,22,0,1
10,2000,070101,28,28,0,2
11,2000,070101,12,12,0,0
12,2000,070101,7,7,0,0
1,2001,070101,9,9,0,0
2,2001,070101,9,8,1,0
3,2001,070101,9,9,0,2
4,2001,070101,11,11,0,3
5,2001,070101,21,19,2,1
6,2001,070101,16,16,0,0
7,2001,070101,21,21,0,0
8,2001,070101,36,34,2,1
9,2001,070101,19,18,1,3
10,2001,070101,31,31,0,1
11,2001,070101,8,7,1,0
12,2001,070101,15,15,0,0
1,2002,070101,9,9,0,0
2,2002,070101,8,8,0,0
3,2002,070101,11,11,0,0
4,2002,070101,9,9,0,0
5,2002,070101,16,16,0,0
6,2002,070101,17,17,0,0
7,2002,070101,23,23,0,1
8,2002,070101,19,19,0,0
9,2002,070101,22,22,0,0
10,2002,070101,19,19,0,0
11,2002,070101,27,27,0,0
12,2002,070101,13,13,0,0
1,2003,070101,5,5,0,0
2,2003,070101,5,5,0,0
3,2003,070101,11,11,0,0
4,2003,070101,16,15,1,0
5,2003,070101,22,22,0,0
6,2003,070101,18,18,0,0
7,2003,070101,20,19,1,1
8,2003,070101,10,10,0,0
9,2003,070101,7,7,0,0
10,2003,070101,17,16,1,0
11,2003,070101,6,6,0,0
12,2003,070101,9,8,1,0
1,2004,070101,5,5,0,1
2,2004,070101,3,3,0,0
3,2004,070101,10,10,0,2
4,2004,070101,15,15,0,1
5,2004,070101,13,13,0,2
6,2004,070101,18,18,0,0
7,2004,070101,24,24,0,1
8,2004,070101,28,28,0,0
9,2004,070101,18,18,0,0
10,2004,070101,14,13,1,0
11,2004,070101,13,13,0,0
12,2004,070101,10,10,0,1
1,2005,070101,8,8,0,0
2,2005,070101,6,6,0,0
3,2005,070101,12,12,0,1
4,2005,070101,12,12,0,0
5,2005,070101,12,11,1,1
6,2005,070101,11,11,0,1
7,2005,070101,18,18,0,1
8,2005,070101,16,15,1,0
9,2005,070101,9,9,0,0
10,2005,070101,15,14,1,0
11,2005,070101,13,13,0,0
12,2005,070101,14,14,0,0
1,2006,070101,14,14,0,0
2,2006,070101,7,7,0,0
3,2006,070101,8,8,0,0
4,2006,070101,9,9,0,0
5,2006,070101,17,17,0,0
6,2006,070101,18,18,0,0
7,2006,070101,20,20,0,0
8,2006,070101,14,14,0,0
9,2006,070101,14,14,0,2
10,2006,070101,13,13,0,0
11,2006,070101,11,10,1,0
12,2006,070101,12,12,0,0
1,2007,070101,8,7,1,1
2,2007,070101,6,6,0,0
3,2007,070101,7,7,0,0
4,2007,070101,12,12,0,0
5,2007,070101,16,15,1,2
6,2007,070101,18,18,0,0
7,2007,070101,28,28,0,0
8,2007,070101,11,10,1,1
9,2007,070101,14,13,1,0
10,2007,070101,21,21,0,0
11,2007,070101,7,7,0,1
12,2007,070101,15,15,0,1
1,2008,070101,13,13,0,1
2,2008,070101,9,9,0,0
3,2008,070101,8,8,0,0
4,2008,070101,9,9,0,0
5,2008,070101,19,19,0,0
6,2008,070101,21,20,1,0
7,2008,070101,28,28,0,2
8,2008,070101,27,27,0,1
9,2008,070101,25,25,0,2
10,2008,070101,25,25,0,0
11,2008,070101,7,7,0,0
12,2008,070101,12,12,0,0
1,2009,070101,8,8,0,0
2,2009,070101,8,8,0,1
3,2009,070101,10,10,0,0
4,2009,070101,18,18,0,0
5,2009,070101,26,26,0,1
6,2009,070101,23,22,1,1
7,2009,070101,30,30,0,0
8,2009,070101,20,20,0,3
9,2009,070101,10,9,1,0
10,2009,070101,14,14,0,0
11,2009,070101,9,9,0,1
12,2009,070101,5,5,0,0
1,2010,070101,8,8,0,0
2,2010,070101,4,4,0,0
3,2010,070101,9,8,1,1
4,2010,070101,16,16,0,0
5,2010,070101,18,17,1,1
6,2010,070101,19,19,0,2
7,2010,070101,26,26,0,0
8,2010,070101,23,23,0,2
9,2010,070101,12,12,0,0
10,2010,070101,9,9,0,0
11,2010,070101,7,7,0,0
12,2010,070101,6,6,0,0
1,2011,070101,7,7,0,0
2,2011,070101,7,7,0,0
1,1999,220702,31,28,3,0
2,1999,220702,16,15,1,5
3,1999,220702,21,21,0,1
4,1999,220702,22,19,3,4
5,1999,220702,28,24,4,5
6,1999,220702,38,32,6,5
7,1999,220702,34,30,4,5
8,1999,220702,31,30,1,8
9,1999,220702,23,19,4,3
10,1999,220702,35,35,0,4
11,1999,220702,37,32,5,6
12,1999,220702,28,25,3,5
1,2000,220702,46,40,6,6
2,2000,220702,26,22,4,4
3,2000,220702,19,18,1,7
4,2000,220702,18,17,1,1
5,2000,220702,31,27,4,4
6,2000,220702,18,14,4,0
7,2000,220702,25,20,5,0
8,2000,220702,28,26,2,3
9,2000,220702,28,23,5,3
10,2000,220702,24,22,2,4
11,2000,220702,19,17,2,4
12,2000,220702,23,22,1,3
1,2001,220702,25,23,2,1
2,2001,220702,16,16,0,1
3,2001,220702,20,17,3,3
4,2001,220702,28,25,3,1
5,2001,220702,24,22,2,2
6,2001,220702,18,17,1,1
7,2001,220702,27,25,2,5
8,2001,220702,26,26,0,3
9,2001,220702,17,16,1,2
10,2001,220702,27,22,5,2
11,2001,220702,17,15,2,2
12,2001,220702,19,16,3,3
1,2002,220702,16,16,0,2
2,2002,220702,13,12,1,1
3,2002,220702,15,11,4,2
4,2002,220702,13,10,3,0
5,2002,220702,14,14,0,2
6,2002,220702,21,19,2,0
7,2002,220702,15,11,4,1
8,2002,220702,21,19,2,6
9,2002,220702,34,33,1,1
10,2002,220702,20,19,1,1
11,2002,220702,24,23,1,2
12,2002,220702,22,19,3,2
1,2003,220702,23,21,2,4
2,2003,220702,18,17,1,1
3,2003,220702,29,26,3,0
4,2003,220702,26,23,3,4
5,2003,220702,25,18,7,4
6,2003,220702,26,26,0,5
7,2003,220702,30,27,3,2
8,2003,220702,22,20,2,6
9,2003,220702,24,23,1,1
10,2003,220702,26,25,1,0
11,2003,220702,19,15,4,0
12,2003,220702,20,20,0,1
1,2004,220702,17,16,1,7
2,2004,220702,25,22,3,3
3,2004,220702,28,28,0,2
4,2004,220702,17,14,3,1
5,2004,220702,9,9,0,5
6,2004,220702,20,19,1,1
7,2004,220702,28,25,3,0
8,2004,220702,32,29,3,2
9,2004,220702,17,16,1,5
10,2004,220702,16,16,0,4
11,2004,220702,21,18,3,9
12,2004,220702,34,29,5,2
1,2005,220702,17,15,2,2
2,2005,220702,4,3,1,5
3,2005,220702,20,20,0,2
4,2005,220702,20,16,4,1
5,2005,220702,21,17,4,4
6,2005,220702,18,14,4,3
7,2005,220702,14,12,2,6
8,2005,220702,25,21,4,4
9,2005,220702,18,15,3,4
10,2005,220702,16,15,1,3
11,2005,220702,21,18,3,3
12,2005,220702,14,11,3,1
1,2006,220702,18,18,0,1
2,2006,220702,17,15,2,3
3,2006,220702,11,11,0,3
4,2006,220702,18,16,2,4
5,2006,220702,30,28,2,1
6,2006,220702,18,16,2,4
7,2006,220702,25,24,1,3
8,2006,220702,16,13,3,3
9,2006,220702,26,22,4,7
10,2006,220702,19,18,1,5
11,2006,220702,11,10,1,4
12,2006,220702,11,11,0,6
1,2007,220702,17,16,1,2
2,2007,220702,9,9,0,7
3,2007,220702,12,10,2,0
4,2007,220702,22,20,2,5
5,2007,220702,33,32,1,2
6,2007,220702,11,9,2,4
7,2007,220702,17,13,4,3
8,2007,220702,26,22,4,5
9,2007,220702,18,16,2,3
10,2007,220702,18,15,3,8
11,2007,220702,22,18,4,2
12,2007,220702,17,17,0,6
1,2008,220702,18,15,3,5
2,2008,220702,12,10,2,3
3,2008,220702,16,12,4,1
4,2008,220702,15,13,2,1
5,2008,220702,26,23,3,3
6,2008,220702,19,15,4,2
7,2008,220702,11,9,2,2
8,2008,220702,13,12,1,1
9,2008,220702,19,18,1,2
10,2008,220702,16,15,1,0
11,2008,220702,16,15,1,1
12,2008,220702,17,14,3,0
1,2009,220702,11,9,2,2
2,2009,220702,12,10,2,3
3,2009,220702,22,21,1,4
4,2009,220702,14,13,1,1
5,2009,220702,17,13,4,0
6,2009,220702,15,15,0,3
7,2009,220702,11,8,3,3
8,2009,220702,31,28,3,4
9,2009,220702,22,21,1,2
10,2009,220702,21,20,1,3
11,2009,220702,18,17,1,3
12,2009,220702,23,21,2,2
1,2010,220702,19,17,2,2
2,2010,220702,15,13,2,1
3,2010,220702,5,5,0,3
4,2010,220702,13,12,1,2
5,2010,220702,16,15,1,4
6,2010,220702,20,15,5,7
7,2010,220702,22,19,3,12
8,2010,220702,32,29,3,1
9,2010,220702,16,14,2,3
10,2010,220702,23,21,2,3
11,2010,220702,15,14,1,2
12,2010,220702,14,13,1,3
1,2011,220702,19,17,2,4
2,2011,220702,14,13,1,1
1,1999,220701,11,10,1,2
2,1999,220701,10,9,1,4
3,1999,220701,8,8,0,1
4,1999,220701,6,6,0,2
5,1999,220701,6,6,0,3
6,1999,220701,4,2,2,0
7,1999,220701,7,6,1,2
8,1999,220701,11,10,1,1
9,1999,220701,4,4,0,1
10,1999,220701,5,5,0,0
11,1999,220701,10,8,2,0
12,1999,220701,6,6,0,2
1,2000,220701,13,13,0,2
2,2000,220701,11,8,3,1
3,2000,220701,8,7,1,0
4,2000,220701,7,6,1,3
5,2000,220701,4,4,0,1
6,2000,220701,9,9,0,1
7,2000,220701,9,6,3,1
8,2000,220701,7,7,0,1
9,2000,220701,2,1,1,0
10,2000,220701,6,5,1,2
11,2000,220701,8,4,4,2
12,2000,220701,8,6,2,0
1,2001,220701,5,4,1,3
2,2001,220701,7,6,1,0
3,2001,220701,8,7,1,0
4,2001,220701,2,2,0,1
5,2001,220701,10,10,0,2
6,2001,220701,12,11,1,2
7,2001,220701,9,7,2,3
8,2001,220701,10,9,1,0
9,2001,220701,8,6,2,0
10,2001,220701,8,7,1,0
11,2001,220701,10,6,4,2
12,2001,220701,6,6,0,0
1,2002,220701,8,8,0,0
2,2002,220701,6,5,1,0
3,2002,220701,10,10,0,1
4,2002,220701,6,4,2,0
5,2002,220701,10,10,0,0
6,2002,220701,5,5,0,1
7,2002,220701,5,5,0,0
8,2002,220701,4,4,0,0
9,2002,220701,8,7,1,0
10,2002,220701,6,5,1,0
11,2002,220701,14,12,2,1
12,2002,220701,12,11,1,0
1,2003,220701,7,7,0,0
2,2003,220701,5,5,0,0
3,2003,220701,1,1,0,0
4,2003,220701,10,8,2,0
5,2003,220701,9,7,2,0
6,2003,220701,8,8,0,0
7,2003,220701,5,4,1,0
8,2003,220701,12,11,1,0
9,2003,220701,12,12,0,1
10,2003,220701,7,6,1,1
11,2003,220701,5,5,0,0
12,2003,220701,5,5,0,2
1,2004,220701,7,6,1,0
2,2004,220701,5,4,1,0
3,2004,220701,6,4,2,0
4,2004,220701,4,3,1,1
5,2004,220701,4,4,0,0
6,2004,220701,10,9,1,2
7,2004,220701,8,8,0,0
8,2004,220701,21,20,1,2
9,2004,220701,2,2,0,3
10,2004,220701,6,5,1,1
11,2004,220701,3,2,1,1
12,2004,220701,9,8,1,0
1,2005,220701,10,9,1,0
2,2005,220701,8,8,0,2
3,2005,220701,5,5,0,0
4,2005,220701,7,7,0,1
5,2005,220701,7,7,0,2
6,2005,220701,8,7,1,0
7,2005,220701,8,7,1,0
8,2005,220701,9,9,0,1
9,2005,220701,8,7,1,0
10,2005,220701,4,3,1,0
11,2005,220701,3,3,0,0
12,2005,220701,2,2,0,1
1,2006,220701,5,5,0,0
2,2006,220701,9,9,0,3
3,2006,220701,9,7,2,0
4,2006,220701,6,5,1,0
5,2006,220701,9,7,2,1
6,2006,220701,4,4,0,0
7,2006,220701,4,1,3,1
8,2006,220701,7,6,1,2
9,2006,220701,5,5,0,0
10,2006,220701,5,5,0,0
11,2006,220701,5,3,2,0
12,2006,220701,4,3,1,1
1,2007,220701,1,1,0,1
2,2007,220701,5,4,1,0
3,2007,220701,6,3,3,0
4,2007,220701,6,4,2,0
5,2007,220701,4,4,0,2
6,2007,220701,7,6,1,1
7,2007,220701,5,5,0,0
8,2007,220701,5,4,1,0
9,2007,220701,7,6,1,0
10,2007,220701,5,5,0,0
11,2007,220701,8,7,1,0
12,2007,220701,2,2,0,1
1,2008,220701,3,3,0,1
2,2008,220701,4,4,0,0
3,2008,220701,6,4,2,1
4,2008,220701,4,4,0,1
5,2008,220701,4,4,0,1
6,2008,220701,5,5,0,1
7,2008,220701,3,3,0,1
8,2008,220701,11,11,0,1
9,2008,220701,5,4,1,0
10,2008,220701,5,4,1,0
11,2008,220701,7,6,1,0
12,2008,220701,9,7,2,0
1,2009,220701,2,2,0,2
2,2009,220701,3,2,1,1
3,2009,220701,2,2,0,1
4,2009,220701,10,9,1,0
5,2009,220701,3,3,0,0
6,2009,220701,4,4,0,1
7,2009,220701,0,0,0,0
8,2009,220701,5,5,0,0
9,2009,220701,10,8,2,2
10,2009,220701,2,1,1,1
11,2009,220701,6,6,0,1
12,2009,220701,4,4,0,0
1,2010,220701,6,5,1,0
2,2010,220701,6,6,0,0
3,2010,220701,4,3,1,1
4,2010,220701,7,6,1,1
5,2010,220701,6,5,1,0
6,2010,220701,5,4,1,2
7,2010,220701,6,6,0,3
8,2010,220701,9,9,0,1
9,2010,220701,10,10,0,0
10,2010,220701,6,6,0,0
11,2010,220701,9,9,0,3
12,2010,220701,10,10,0,1
1,2011,220701,3,3,0,0
2,2011,220701,2,2,0,0
1,1999,220602,41,35,6,5
2,1999,220602,29,23,6,3
3,1999,220602,34,31,3,2
4,1999,220602,35,27,8,3
5,1999,220602,39,37,2,1
6,1999,220602,28,25,3,6
7,1999,220602,52,47,5,6
8,1999,220602,47,43,4,6
9,1999,220602,47,43,4,12
10,1999,220602,42,39,3,2
11,1999,220602,25,24,1,9
12,1999,220602,33,30,3,7
1,2000,220602,25,22,3,6
2,2000,220602,23,22,1,11
3,2000,220602,23,20,3,4
4,2000,220602,26,24,2,2
5,2000,220602,40,39,1,5
6,2000,220602,31,27,4,4
7,2000,220602,43,40,3,2
8,2000,220602,34,31,3,6
9,2000,220602,42,39,3,3
10,2000,220602,45,42,3,4
11,2000,220602,31,27,4,0
12,2000,220602,29,28,1,5
1,2001,220602,36,35,1,4
2,2001,220602,37,35,2,7
3,2001,220602,30,23,7,2
4,2001,220602,31,27,4,7
5,2001,220602,25,23,2,5
6,2001,220602,37,33,4,3
7,2001,220602,22,18,4,7
8,2001,220602,41,37,4,11
9,2001,220602,29,27,2,11
10,2001,220602,27,23,4,3
11,2001,220602,25,22,3,8
12,2001,220602,29,26,3,0
1,2002,220602,20,14,6,0
2,2002,220602,23,19,4,1
3,2002,220602,22,18,4,1
4,2002,220602,33,31,2,3
5,2002,220602,29,23,6,4
6,2002,220602,29,22,7,2
7,2002,220602,37,34,3,8
8,2002,220602,37,36,1,7
9,2002,220602,43,37,6,2
10,2002,220602,46,41,5,6
11,2002,220602,32,29,3,5
12,2002,220602,19,19,0,3
1,2003,220602,24,23,1,2
2,2003,220602,22,22,0,5
3,2003,220602,27,22,5,3
4,2003,220602,24,22,2,4
5,2003,220602,32,27,5,4
6,2003,220602,34,30,4,4
7,2003,220602,34,28,6,5
8,2003,220602,40,37,3,5
9,2003,220602,42,41,1,3
10,2003,220602,28,23,5,5
11,2003,220602,34,30,4,6
12,2003,220602,24,22,2,4
1,2004,220602,28,22,6,4
2,2004,220602,24,22,2,3
3,2004,220602,29,27,2,4
4,2004,220602,22,20,2,3
5,2004,220602,33,32,1,6
6,2004,220602,30,27,3,4
7,2004,220602,37,34,3,5
8,2004,220602,42,39,3,1
9,2004,220602,31,29,2,4
10,2004,220602,26,24,2,1
11,2004,220602,27,26,1,5
12,2004,220602,32,29,3,4
1,2005,220602,27,27,0,6
2,2005,220602,20,18,2,6
3,2005,220602,13,13,0,5
4,2005,220602,22,19,3,6
5,2005,220602,29,26,3,6
6,2005,220602,18,14,4,5
7,2005,220602,31,28,3,15
8,2005,220602,23,21,2,8
9,2005,220602,23,21,2,8
10,2005,220602,27,24,3,3
11,2005,220602,11,11,0,6
12,2005,220602,21,18,3,2
1,2006,220602,28,26,2,5
2,2006,220602,18,16,2,3
3,2006,220602,20,18,2,6
4,2006,220602,30,26,4,3
5,2006,220602,21,18,3,9
6,2006,220602,35,32,3,2
7,2006,220602,28,26,2,5
8,2006,220602,26,23,3,0
9,2006,220602,23,21,2,5
10,2006,220602,19,16,3,3
11,2006,220602,13,12,1,6
12,2006,220602,18,12,6,6
1,2007,220602,21,20,1,9
2,2007,220602,18,18,0,8
3,2007,220602,20,19,1,5
4,2007,220602,18,18,0,8
5,2007,220602,26,24,2,3
6,2007,220602,22,20,2,4
7,2007,220602,24,22,2,2
8,2007,220602,17,17,0,10
9,2007,220602,17,14,3,2
10,2007,220602,14,13,1,1
11,2007,220602,15,14,1,0
12,2007,220602,20,19,1,2
1,2008,220602,26,22,4,3
2,2008,220602,26,23,3,6
3,2008,220602,16,14,2,5
4,2008,220602,22,19,3,4
5,2008,220602,21,18,3,2
6,2008,220602,23,19,4,1
7,2008,220602,22,19,3,4
8,2008,220602,19,15,4,2
9,2008,220602,27,26,1,1
10,2008,220602,27,25,2,5
11,2008,220602,15,15,0,0
12,2008,220602,17,14,3,3
1,2009,220602,20,17,3,4
2,2009,220602,22,17,5,1
3,2009,220602,29,29,0,1
4,2009,220602,14,12,2,1
5,2009,220602,22,19,3,5
6,2009,220602,19,19,0,4
7,2009,220602,24,21,3,1
8,2009,220602,23,20,3,2
9,2009,220602,29,27,2,2
10,2009,220602,22,21,1,1
11,2009,220602,22,22,0,3
12,2009,220602,26,25,1,1
1,2010,220602,26,26,0,1
2,2010,220602,19,13,6,5
3,2010,220602,25,23,2,4
4,2010,220602,28,25,3,6
5,2010,220602,36,35,1,4
6,2010,220602,30,26,4,0
7,2010,220602,22,17,5,2
8,2010,220602,35,31,4,2
9,2010,220602,20,20,0,1
10,2010,220602,27,25,2,0
11,2010,220602,25,25,0,2
12,2010,220602,13,13,0,1
1,2011,220602,24,22,2,1
2,2011,220602,7,7,0,1
1,1999,190701,19,18,1,2
2,1999,190701,19,17,2,1
3,1999,190701,11,9,2,5
4,1999,190701,13,11,2,6
5,1999,190701,13,13,0,4
6,1999,190701,17,11,6,7
7,1999,190701,29,23,6,10
8,1999,190701,23,19,4,12
9,1999,190701,20,18,2,9
10,1999,190701,27,26,1,9
11,1999,190701,11,10,1,3
12,1999,190701,21,20,1,5
1,2000,190701,19,19,0,3
2,2000,190701,17,17,0,6
3,2000,190701,27,26,1,2
4,2000,190701,30,27,3,1
5,2000,190701,16,15,1,2
6,2000,190701,18,16,2,3
7,2000,190701,21,20,1,3
8,2000,190701,22,18,4,6
9,2000,190701,16,16,0,8
10,2000,190701,19,17,2,3
11,2000,190701,22,22,0,1
12,2000,190701,11,7,4,2
1,2001,190701,18,15,3,2
2,2001,190701,6,6,0,1
3,2001,190701,19,19,0,6
4,2001,190701,15,12,3,1
5,2001,190701,18,16,2,0
6,2001,190701,23,22,1,8
7,2001,190701,20,16,4,3
8,2001,190701,21,18,3,9
9,2001,190701,25,24,1,8
10,2001,190701,23,19,4,11
11,2001,190701,18,17,1,9
12,2001,190701,24,22,2,3
1,2002,190701,12,11,1,2
2,2002,190701,11,11,0,5
3,2002,190701,23,22,1,5
4,2002,190701,8,8,0,2
5,2002,190701,14,11,3,1
6,2002,190701,17,14,3,8
7,2002,190701,16,13,3,1
8,2002,190701,24,22,2,5
9,2002,190701,19,16,3,3
10,2002,190701,18,16,2,2
11,2002,190701,11,11,0,4
12,2002,190701,23,22,1,8
1,2003,190701,18,17,1,5
2,2003,190701,9,8,1,6
3,2003,190701,14,14,0,1
4,2003,190701,17,16,1,1
5,2003,190701,17,16,1,1
6,2003,190701,14,11,3,9
7,2003,190701,18,17,1,6
8,2003,190701,17,16,1,5
9,2003,190701,18,15,3,6
10,2003,190701,21,21,0,77
11,2003,190701,14,12,2,6
12,2003,190701,15,14,1,6
1,2004,190701,17,16,1,7
2,2004,190701,21,18,3,3
3,2004,190701,15,11,4,6
4,2004,190701,15,13,2,7
5,2004,190701,12,10,2,3
6,2004,190701,18,15,3,2
7,2004,190701,18,16,2,5
8,2004,190701,15,12,3,5
9,2004,190701,13,13,0,11
10,2004,190701,13,13,0,6
11,2004,190701,8,8,0,4
12,2004,190701,13,11,2,3
1,2005,190701,14,12,2,1
2,2005,190701,14,14,0,1
3,2005,190701,18,17,1,2
4,2005,190701,22,20,2,2
5,2005,190701,15,14,1,5
6,2005,190701,20,19,1,6
7,2005,190701,16,14,2,6
8,2005,190701,15,14,1,1
9,2005,190701,15,14,1,1
10,2005,190701,19,18,1,1
11,2005,190701,17,17,0,2
12,2005,190701,15,12,3,1
1,2006,190701,16,15,1,6
2,2006,190701,17,16,1,3
3,2006,190701,12,10,2,5
4,2006,190701,6,5,1,8
5,2006,190701,13,12,1,0
6,2006,190701,14,13,1,3
7,2006,190701,16,14,2,4
8,2006,190701,18,17,1,6
9,2006,190701,14,11,3,3
10,2006,190701,16,13,3,3
11,2006,190701,12,10,2,2
12,2006,190701,14,13,1,1
1,2007,190701,9,7,2,8
2,2007,190701,11,8,3,10
3,2007,190701,11,7,4,12
4,2007,190701,15,14,1,11
5,2007,190701,16,12,4,4
6,2007,190701,18,16,2,12
7,2007,190701,16,15,1,7
8,2007,190701,9,8,1,7
9,2007,190701,15,15,0,8
10,2007,190701,16,13,3,4
11,2007,190701,13,9,4,7
12,2007,190701,13,13,0,7
1,2008,190701,19,18,1,4
2,2008,190701,3,2,1,5
3,2008,190701,7,5,2,6
4,2008,190701,7,7,0,4
5,2008,190701,13,12,1,8
6,2008,190701,9,8,1,4
7,2008,190701,11,11,0,5
8,2008,190701,15,11,4,4
9,2008,190701,14,14,0,5
10,2008,190701,11,9,2,2
11,2008,190701,20,18,2,2
12,2008,190701,13,13,0,6
1,2009,190701,15,13,2,8
2,2009,190701,6,5,1,8
3,2009,190701,10,10,0,3
4,2009,190701,10,9,1,5
5,2009,190701,16,16,0,4
6,2009,190701,14,12,2,4
7,2009,190701,14,13,1,6
8,2009,190701,13,11,2,1
9,2009,190701,12,11,1,7
10,2009,190701,17,15,2,4
11,2009,190701,14,14,0,3
12,2009,190701,17,16,1,4
1,2010,190701,8,5,3,4
2,2010,190701,15,12,3,5
3,2010,190701,14,13,1,6
4,2010,190701,9,8,1,3
5,2010,190701,11,8,3,2
6,2010,190701,13,13,0,6
7,2010,190701,13,12,1,2
8,2010,190701,13,12,1,8
9,2010,190701,9,9,0,2
10,2010,190701,14,12,2,3
11,2010,190701,13,10,3,3
12,2010,190701,14,13,1,0
1,2011,190701,10,9,1,6
2,2011,190701,9,8,1,3
1,1999,070102,4,4,0,0
2,1999,070102,5,5,0,0
3,1999,070102,2,2,0,0
4,1999,070102,5,5,0,0
5,1999,070102,9,9,0,0
6,1999,070102,6,6,0,0
7,1999,070102,11,11,0,0
8,1999,070102,8,8,0,0
9,1999,070102,0,0,0,0
10,1999,070102,5,5,0,0
11,1999,070102,0,0,0,0
12,1999,070102,8,8,0,0
1,2000,070102,2,2,0,0
2,2000,070102,2,2,0,0
3,2000,070102,4,4,0,1
4,2000,070102,2,2,0,0
5,2000,070102,5,5,0,0
6,2000,070102,8,8,0,0
7,2000,070102,6,6,0,0
8,2000,070102,8,8,0,0
9,2000,070102,9,9,0,0
10,2000,070102,7,7,0,0
11,2000,070102,7,7,0,0
12,2000,070102,3,3,0,0
1,2001,070102,9,9,0,0
2,2001,070102,3,3,0,0
3,2001,070102,2,2,0,0
4,2001,070102,4,3,1,0
5,2001,070102,3,3,0,0
6,2001,070102,4,4,0,1
7,2001,070102,2,2,0,0
8,2001,070102,2,2,0,0
9,2001,070102,6,6,0,0
10,2001,070102,5,5,0,0
11,2001,070102,2,2,0,0
12,2001,070102,2,2,0,0
1,2002,070102,5,5,0,0
2,2002,070102,5,5,0,0
3,2002,070102,2,2,0,0
4,2002,070102,2,2,0,0
5,2002,070102,7,7,0,0
6,2002,070102,11,10,1,0
7,2002,070102,4,4,0,0
8,2002,070102,5,5,0,0
9,2002,070102,5,4,1,0
10,2002,070102,4,3,1,0
11,2002,070102,3,3,0,0
12,2002,070102,4,4,0,0
1,2003,070102,4,4,0,0
2,2003,070102,2,2,0,0
3,2003,070102,5,4,1,0
4,2003,070102,5,5,0,0
5,2003,070102,5,5,0,0
6,2003,070102,4,3,1,0
7,2003,070102,5,5,0,0
8,2003,070102,5,5,0,0
9,2003,070102,3,2,1,0
10,2003,070102,1,1,0,0
11,2003,070102,4,4,0,0
12,2003,070102,3,3,0,0
1,2004,070102,4,4,0,0
2,2004,070102,1,1,0,0
3,2004,070102,6,6,0,0
4,2004,070102,6,6,0,0
5,2004,070102,2,2,0,0
6,2004,070102,1,1,0,0
7,2004,070102,5,5,0,0
8,2004,070102,7,7,0,0
9,2004,070102,4,4,0,0
10,2004,070102,4,4,0,0
11,2004,070102,5,5,0,0
12,2004,070102,3,3,0,0
1,2005,070102,4,4,0,0
2,2005,070102,3,3,0,0
3,2005,070102,1,1,0,0
4,2005,070102,3,3,0,0
5,2005,070102,4,4,0,0
6,2005,070102,5,5,0,0
7,2005,070102,1,1,0,0
8,2005,070102,2,2,0,0
9,2005,070102,2,2,0,0
10,2005,070102,0,0,0,0
11,2005,070102,4,4,0,0
12,2005,070102,3,3,0,0
1,2006,070102,3,3,0,1
2,2006,070102,3,3,0,0
3,2006,070102,2,2,0,0
4,2006,070102,4,4,0,0
5,2006,070102,2,2,0,0
6,2006,070102,3,2,1,0
7,2006,070102,2,2,0,0
8,2006,070102,2,2,0,0
9,2006,070102,3,3,0,0
10,2006,070102,3,3,0,0
11,2006,070102,5,5,0,0
12,2006,070102,4,4,0,0
1,2007,070102,0,0,0,0
2,2007,070102,1,1,0,0
3,2007,070102,2,2,0,0
4,2007,070102,5,5,0,0
5,2007,070102,7,7,0,0
6,2007,070102,6,6,0,0
7,2007,070102,4,4,0,0
8,2007,070102,4,4,0,0
9,2007,070102,2,2,0,0
10,2007,070102,5,5,0,0
11,2007,070102,4,4,0,1
12,2007,070102,5,4,1,0
1,2008,070102,3,2,1,0
2,2008,070102,5,5,0,0
3,2008,070102,1,1,0,0
4,2008,070102,2,2,0,0
5,2008,070102,3,3,0,0
6,2008,070102,4,4,0,0
7,2008,070102,3,2,1,0
8,2008,070102,8,8,0,0
9,2008,070102,4,4,0,0
10,2008,070102,5,5,0,0
11,2008,070102,1,1,0,0
12,2008,070102,3,3,0,0
1,2009,070102,3,3,0,0
2,2009,070102,0,0,0,0
3,2009,070102,4,4,0,0
4,2009,070102,6,6,0,0
5,2009,070102,5,4,1,0
6,2009,070102,1,1,0,1
7,2009,070102,1,1,0,0
8,2009,070102,3,3,0,0
9,2009,070102,8,8,0,0
10,2009,070102,0,0,0,0
11,2009,070102,1,1,0,0
12,2009,070102,2,2,0,0
1,2010,070102,3,3,0,0
2,2010,070102,2,2,0,0
3,2010,070102,1,1,0,0
4,2010,070102,2,1,1,0
5,2010,070102,1,1,0,0
6,2010,070102,1,1,0,0
7,2010,070102,4,4,0,0
8,2010,070102,2,2,0,1
9,2010,070102,3,2,1,0
10,2010,070102,3,2,1,0
11,2010,070102,2,2,0,0
12,2010,070102,3,3,0,0
1,2011,070102,2,2,0,0
2,2011,070102,1,1,0,0
1,1999,180100,12,11,1,0
2,1999,180100,11,11,0,0
3,1999,180100,11,10,1,0
4,1999,180100,19,18,1,0
5,1999,180100,8,8,0,1
6,1999,180100,17,16,1,0
7,1999,180100,15,13,2,0
8,1999,180100,27,26,1,0
9,1999,180100,13,12,1,0
10,1999,180100,14,11,3,0
11,1999,180100,14,13,1,0
12,1999,180100,24,22,2,1
1,2000,180100,19,19,0,0
2,2000,180100,9,9,0,0
3,2000,180100,12,11,1,1
4,2000,180100,13,12,1,1
5,2000,180100,15,14,1,0
6,2000,180100,23,22,1,0
7,2000,180100,19,17,2,3
8,2000,180100,18,17,1,0
9,2000,180100,11,11,0,0
10,2000,180100,12,11,1,1
11,2000,180100,30,29,1,1
12,2000,180100,14,14,0,2
1,2001,180100,9,7,2,0
2,2001,180100,6,5,1,1
3,2001,180100,9,8,1,0
4,2001,180100,10,10,0,0
5,2001,180100,9,7,2,0
6,2001,180100,9,8,1,0
7,2001,180100,9,9,0,0
8,2001,180100,13,11,2,1
9,2001,180100,11,10,1,0
10,2001,180100,13,9,4,2
11,2001,180100,11,11,0,0
12,2001,180100,14,14,0,0
1,2002,180100,16,16,0,0
2,2002,180100,13,13,0,0
3,2002,180100,16,15,1,2
4,2002,180100,19,19,0,1
5,2002,180100,13,12,1,4
6,2002,180100,8,8,0,0
7,2002,180100,9,9,0,0
8,2002,180100,18,17,1,0
9,2002,180100,15,15,0,1
10,2002,180100,19,19,0,0
11,2002,180100,12,11,1,0
12,2002,180100,18,17,1,0
1,2003,180100,11,11,0,0
2,2003,180100,6,6,0,0
3,2003,180100,11,10,1,0
4,2003,180100,9,9,0,3
5,2003,180100,12,12,0,1
6,2003,180100,12,11,1,2
7,2003,180100,29,29,0,0
8,2003,180100,18,16,2,1
9,2003,180100,15,13,2,0
10,2003,180100,12,10,2,0
11,2003,180100,21,18,3,1
12,2003,180100,14,14,0,1
1,2004,180100,11,11,0,3
2,2004,180100,7,7,0,0
3,2004,180100,8,8,0,0
4,2004,180100,11,10,1,5
5,2004,180100,9,8,1,1
6,2004,180100,15,14,1,1
7,2004,180100,10,10,0,0
8,2004,180100,8,7,1,0
9,2004,180100,10,10,0,1
10,2004,180100,11,10,1,0
11,2004,180100,17,17,0,0
12,2004,180100,10,8,2,1
1,2005,180100,10,10,0,0
2,2005,180100,11,11,0,0
3,2005,180100,14,14,0,2
4,2005,180100,14,12,2,0
5,2005,180100,9,9,0,4
6,2005,180100,22,21,1,1
7,2005,180100,14,14,0,0
8,2005,180100,13,13,0,3
9,2005,180100,9,9,0,1
10,2005,180100,17,15,2,1
11,2005,180100,9,9,0,3
12,2005,180100,9,9,0,0
1,2006,180100,15,15,0,0
2,2006,180100,7,5,2,1
3,2006,180100,8,8,0,0
4,2006,180100,10,10,0,0
5,2006,180100,7,6,1,3
6,2006,180100,17,16,1,0
7,2006,180100,7,7,0,0
8,2006,180100,12,12,0,0
9,2006,180100,10,9,1,4
10,2006,180100,15,15,0,1
11,2006,180100,10,10,0,2
12,2006,180100,9,9,0,0
1,2007,180100,12,12,0,1
2,2007,180100,5,5,0,2
3,2007,180100,17,16,1,0
4,2007,180100,13,13,0,0
5,2007,180100,14,14,0,1
6,2007,180100,10,9,1,1
7,2007,180100,14,12,2,0
8,2007,180100,18,18,0,0
9,2007,180100,7,7,0,1
10,2007,180100,18,17,1,3
11,2007,180100,7,7,0,1
12,2007,180100,14,13,1,0
1,2008,180100,12,11,1,0
2,2008,180100,12,12,0,2
3,2008,180100,10,9,1,1
4,2008,180100,12,11,1,2
5,2008,180100,11,11,0,1
6,2008,180100,15,15,0,1
7,2008,180100,13,12,1,0
8,2008,180100,15,15,0,2
9,2008,180100,19,16,3,1
10,2008,180100,13,13,0,2
11,2008,180100,17,16,1,0
12,2008,180100,11,11,0,2
1,2009,180100,12,12,0,2
2,2009,180100,5,5,0,0
3,2009,180100,17,14,3,1
4,2009,180100,22,22,0,0
5,2009,180100,12,12,0,1
6,2009,180100,11,11,0,0
7,2009,180100,12,12,0,2
8,2009,180100,19,18,1,5
9,2009,180100,6,6,0,2
10,2009,180100,7,5,2,0
11,2009,180100,24,23,1,1
12,2009,180100,18,17,1,3
1,2010,180100,14,12,2,2
2,2010,180100,5,4,1,0
3,2010,180100,9,8,1,0
4,2010,180100,7,7,0,0
5,2010,180100,13,10,3,0
6,2010,180100,6,5,1,0
7,2010,180100,12,10,2,1
8,2010,180100,14,13,1,1
9,2010,180100,8,8,0,0
10,2010,180100,13,12,1,0
11,2010,180100,9,8,1,0
12,2010,180100,14,12,2,0
1,2011,180100,9,9,0,1
2,2011,180100,6,5,1,0
1,1999,210700,15,13,2,0
2,1999,210700,8,6,2,1
3,1999,210700,11,8,3,1
4,1999,210700,12,8,4,2
5,1999,210700,9,8,1,0
6,1999,210700,11,9,2,0
7,1999,210700,13,11,2,0
8,1999,210700,20,16,4,1
9,1999,210700,15,13,2,1
10,1999,210700,13,10,3,0
11,1999,210700,11,9,2,0
12,1999,210700,10,10,0,2
1,2000,210700,11,10,1,2
2,2000,210700,4,3,1,3
3,2000,210700,11,9,2,0
4,2000,210700,6,6,0,0
5,2000,210700,15,14,1,0
6,2000,210700,13,10,3,1
7,2000,210700,17,13,4,3
8,2000,210700,8,5,3,1
9,2000,210700,9,8,1,1
10,2000,210700,13,11,2,0
11,2000,210700,10,9,1,0
12,2000,210700,8,7,1,0
1,2001,210700,8,7,1,2
2,2001,210700,9,8,1,2
3,2001,210700,16,14,2,0
4,2001,210700,11,10,1,1
5,2001,210700,17,13,4,0
6,2001,210700,12,8,4,2
7,2001,210700,17,15,2,4
8,2001,210700,19,17,2,2
9,2001,210700,13,9,4,4
10,2001,210700,8,7,1,0
11,2001,210700,10,9,1,3
12,2001,210700,9,8,1,0
1,2002,210700,11,10,1,2
2,2002,210700,12,8,4,1
3,2002,210700,11,11,0,0
4,2002,210700,16,14,2,2
5,2002,210700,13,13,0,3
6,2002,210700,13,9,4,0
7,2002,210700,14,14,0,1
8,2002,210700,13,11,2,0
9,2002,210700,8,7,1,0
10,2002,210700,14,14,0,1
11,2002,210700,9,8,1,0
12,2002,210700,6,5,1,0
1,2003,210700,17,14,3,1
2,2003,210700,7,6,1,0
3,2003,210700,9,5,4,2
4,2003,210700,11,10,1,1
5,2003,210700,6,6,0,0
6,2003,210700,11,10,1,5
7,2003,210700,12,10,2,1
8,2003,210700,13,11,2,2
9,2003,210700,12,10,2,3
10,2003,210700,6,6,0,1
11,2003,210700,15,12,3,1
12,2003,210700,8,7,1,2
1,2004,210700,11,10,1,1
2,2004,210700,10,10,0,2
3,2004,210700,4,4,0,0
4,2004,210700,14,13,1,0
5,2004,210700,11,11,0,0
6,2004,210700,8,8,0,0
7,2004,210700,19,18,1,1
8,2004,210700,13,10,3,3
9,2004,210700,10,10,0,2
10,2004,210700,12,11,1,3
11,2004,210700,10,9,1,0
12,2004,210700,6,5,1,0
1,2005,210700,12,11,1,2
2,2005,210700,4,4,0,0
3,2005,210700,8,7,1,2
4,2005,210700,2,2,0,0
5,2005,210700,15,12,3,1
6,2005,210700,10,9,1,4
7,2005,210700,8,7,1,3
8,2005,210700,4,4,0,0
9,2005,210700,7,6,1,0
10,2005,210700,8,7,1,0
11,2005,210700,10,9,1,3
12,2005,210700,6,5,1,1
1,2006,210700,11,9,2,1
2,2006,210700,3,3,0,5
3,2006,210700,6,6,0,0
4,2006,210700,9,8,1,5
5,2006,210700,4,4,0,5
6,2006,210700,7,5,2,5
7,2006,210700,12,10,2,1
8,2006,210700,9,9,0,2
9,2006,210700,8,7,1,4
10,2006,210700,8,8,0,4
11,2006,210700,6,6,0,2
12,2006,210700,6,6,0,1
1,2007,210700,7,5,2,1
2,2007,210700,8,6,2,2
3,2007,210700,5,4,1,2
4,2007,210700,6,5,1,1
5,2007,210700,5,5,0,6
6,2007,210700,6,5,1,5
7,2007,210700,8,8,0,0
8,2007,210700,5,5,0,0
9,2007,210700,15,14,1,2
10,2007,210700,9,9,0,2
11,2007,210700,10,8,2,2
12,2007,210700,9,9,0,1
1,2008,210700,5,4,1,1
2,2008,210700,10,10,0,1
3,2008,210700,4,4,0,2
4,2008,210700,1,1,0,3
5,2008,210700,6,6,0,1
6,2008,210700,13,13,0,1
7,2008,210700,9,6,3,0
8,2008,210700,10,9,1,5
9,2008,210700,16,15,1,3
10,2008,210700,11,9,2,0
11,2008,210700,6,3,3,5
12,2008,210700,6,6,0,2
1,2009,210700,10,10,0,4
2,2009,210700,11,10,1,0
3,2009,210700,12,10,2,1
4,2009,210700,15,14,1,4
5,2009,210700,9,8,1,3
6,2009,210700,10,6,4,2
7,2009,210700,18,14,4,0
8,2009,210700,10,10,0,1
9,2009,210700,16,15,1,2
10,2009,210700,10,10,0,0
11,2009,210700,8,8,0,0
12,2009,210700,15,15,0,0
1,2010,210700,8,8,0,0
2,2010,210700,12,12,0,0
3,2010,210700,12,11,1,3
4,2010,210700,7,7,0,1
5,2010,210700,15,13,2,0
6,2010,210700,14,14,0,0
7,2010,210700,17,17,0,4
8,2010,210700,10,9,1,3
9,2010,210700,11,10,1,0
10,2010,210700,13,12,1,1
11,2010,210700,12,12,0,3
12,2010,210700,9,8,1,0
1,2011,210700,6,6,0,1
2,2011,210700,5,4,1,0
1,1999,190300,27,23,4,1
2,1999,190300,20,18,2,1
3,1999,190300,28,26,2,2
4,1999,190300,21,21,0,1
5,1999,190300,23,21,2,1
6,1999,190300,27,24,3,1
7,1999,190300,35,32,3,1
8,1999,190300,37,37,0,0
9,1999,190300,30,27,3,0
10,1999,190300,33,29,4,0
11,1999,190300,28,27,1,1
12,1999,190300,21,18,3,1
1,2000,190300,31,30,1,2
2,2000,190300,24,23,1,3
3,2000,190300,27,26,1,3
4,2000,190300,32,31,1,1
5,2000,190300,36,36,0,2
6,2000,190300,22,21,1,3
7,2000,190300,24,23,1,1
8,2000,190300,25,23,2,7
9,2000,190300,30,28,2,1
10,2000,190300,30,28,2,3
11,2000,190300,40,38,2,0
12,2000,190300,26,26,0,2
1,2001,190300,35,33,2,0
2,2001,190300,28,27,1,2
3,2001,190300,28,26,2,1
4,2001,190300,27,27,0,4
5,2001,190300,36,36,0,0
6,2001,190300,46,45,1,5
7,2001,190300,29,28,1,1
8,2001,190300,45,43,2,5
9,2001,190300,32,31,1,3
10,2001,190300,43,43,0,4
11,2001,190300,24,23,1,4
12,2001,190300,33,31,2,0
1,2002,190300,39,38,1,2
2,2002,190300,17,16,1,0
3,2002,190300,29,28,1,3
4,2002,190300,29,27,2,0
5,2002,190300,18,17,1,1
6,2002,190300,18,18,0,2
7,2002,190300,25,23,2,1
8,2002,190300,31,30,1,2
9,2002,190300,32,28,4,3
10,2002,190300,30,28,2,2
11,2002,190300,35,34,1,2
12,2002,190300,36,36,0,1
1,2003,190300,34,33,1,5
2,2003,190300,26,26,0,2
3,2003,190300,28,26,2,3
4,2003,190300,21,20,1,5
5,2003,190300,25,23,2,0
6,2003,190300,41,40,1,4
7,2003,190300,29,29,0,3
8,2003,190300,33,31,2,2
9,2003,190300,30,29,1,5
10,2003,190300,27,26,1,3
11,2003,190300,27,27,0,0
12,2003,190300,25,24,1,1
1,2004,190300,20,19,1,0
2,2004,190300,18,18,0,1
3,2004,190300,17,17,0,0
4,2004,190300,12,12,0,1
5,2004,190300,21,20,1,5
6,2004,190300,26,25,1,3
7,2004,190300,22,22,0,4
8,2004,190300,21,19,2,1
9,2004,190300,25,22,3,4
10,2004,190300,37,36,1,0
11,2004,190300,19,18,1,3
12,2004,190300,26,26,0,3
1,2005,190300,19,18,1,3
2,2005,190300,15,15,0,1
3,2005,190300,24,22,2,3
4,2005,190300,21,20,1,3
5,2005,190300,24,20,4,4
6,2005,190300,24,22,2,5
7,2005,190300,21,19,2,1
8,2005,190300,29,28,1,3
9,2005,190300,23,21,2,3
10,2005,190300,33,32,1,2
11,2005,190300,26,26,0,2
12,2005,190300,25,24,1,5
1,2006,190300,32,29,3,3
2,2006,190300,21,20,1,1
3,2006,190300,17,17,0,3
4,2006,190300,18,17,1,1
5,2006,190300,31,30,1,1
6,2006,190300,13,13,0,2
7,2006,190300,20,18,2,1
8,2006,190300,24,22,2,2
9,2006,190300,20,19,1,1
10,2006,190300,16,16,0,0
11,2006,190300,17,16,1,0
12,2006,190300,16,13,3,4
1,2007,190300,22,22,0,2
2,2007,190300,17,16,1,1
3,2007,190300,16,14,2,1
4,2007,190300,17,15,2,0
5,2007,190300,15,15,0,1
6,2007,190300,12,11,1,0
7,2007,190300,19,17,2,4
8,2007,190300,25,23,2,1
9,2007,190300,22,20,2,3
10,2007,190300,22,22,0,2
11,2007,190300,21,21,0,2
12,2007,190300,23,22,1,4
1,2008,190300,27,25,2,2
2,2008,190300,13,13,0,7
3,2008,190300,32,31,1,7
4,2008,190300,15,13,2,3
5,2008,190300,15,14,1,5
6,2008,190300,15,14,1,2
7,2008,190300,28,25,3,2
8,2008,190300,20,19,1,3
9,2008,190300,21,19,2,6
10,2008,190300,15,13,2,2
11,2008,190300,20,20,0,5
12,2008,190300,17,16,1,2
1,2009,190300,27,22,5,6
2,2009,190300,15,14,1,10
3,2009,190300,16,13,3,3
4,2009,190300,17,16,1,2
5,2009,190300,19,19,0,4
6,2009,190300,24,16,8,4
7,2009,190300,27,25,2,2
8,2009,190300,23,22,1,3
9,2009,190300,25,21,4,4
10,2009,190300,21,20,1,2
11,2009,190300,26,24,2,2
12,2009,190300,28,27,1,0
1,2010,190300,20,18,2,2
2,2010,190300,10,8,2,4
3,2010,190300,21,18,3,1
4,2010,190300,17,13,4,4
5,2010,190300,22,20,2,2
6,2010,190300,26,25,1,5
7,2010,190300,15,15,0,6
8,2010,190300,18,17,1,2
9,2010,190300,25,24,1,4
10,2010,190300,18,18,0,2
11,2010,190300,18,15,3,2
12,2010,190300,16,14,2,2
1,2011,190300,16,16,0,1
2,2011,190300,12,12,0,1
1,1999,190200,22,19,3,0
2,1999,190200,22,19,3,1
3,1999,190200,24,20,4,9
4,1999,190200,31,29,2,1
5,1999,190200,30,27,3,0
6,1999,190200,21,20,1,0
7,1999,190200,25,21,4,1
8,1999,190200,20,20,0,1
9,1999,190200,25,22,3,4
10,1999,190200,23,19,4,5
11,1999,190200,20,16,4,5
12,1999,190200,22,22,0,1
1,2000,190200,22,21,1,5
2,2000,190200,26,25,1,3
3,2000,190200,35,32,3,3
4,2000,190200,30,30,0,2
5,2000,190200,41,41,0,3
6,2000,190200,20,19,1,6
7,2000,190200,23,22,1,4
8,2000,190200,22,18,4,4
9,2000,190200,37,34,3,3
10,2000,190200,37,34,3,3
11,2000,190200,23,22,1,1
12,2000,190200,27,26,1,4
1,2001,190200,29,24,5,4
2,2001,190200,14,11,3,7
3,2001,190200,23,21,2,1
4,2001,190200,21,19,2,3
5,2001,190200,20,19,1,5
6,2001,190200,27,23,4,1
7,2001,190200,22,17,5,0
8,2001,190200,12,12,0,0
9,2001,190200,20,20,0,10
10,2001,190200,22,19,3,3
11,2001,190200,31,30,1,4
12,2001,190200,21,20,1,5
1,2002,190200,15,12,3,5
2,2002,190200,16,13,3,2
3,2002,190200,10,10,0,2
4,2002,190200,22,21,1,2
5,2002,190200,23,23,0,0
6,2002,190200,21,17,4,2
7,2002,190200,22,21,1,0
8,2002,190200,25,22,3,3
9,2002,190200,28,24,4,2
10,2002,190200,20,19,1,4
11,2002,190200,21,17,4,3
12,2002,190200,22,21,1,3
1,2003,190200,34,33,1,8
2,2003,190200,8,8,0,4
3,2003,190200,16,14,2,7
4,2003,190200,23,22,1,2
5,2003,190200,25,22,3,3
6,2003,190200,12,10,2,2
7,2003,190200,19,19,0,8
8,2003,190200,12,11,1,2
9,2003,190200,21,19,2,4
10,2003,190200,17,16,1,3
11,2003,190200,32,30,2,7
12,2003,190200,12,12,0,2
1,2004,190200,23,20,3,0
2,2004,190200,15,14,1,6
3,2004,190200,21,20,1,9
4,2004,190200,20,17,3,6
5,2004,190200,24,22,2,2
6,2004,190200,14,13,1,1
7,2004,190200,20,19,1,8
8,2004,190200,18,17,1,4
9,2004,190200,19,16,3,6
10,2004,190200,20,18,2,7
11,2004,190200,26,25,1,2
12,2004,190200,24,23,1,2
1,2005,190200,23,20,3,3
2,2005,190200,16,15,1,3
3,2005,190200,14,13,1,3
4,2005,190200,15,14,1,7
5,2005,190200,15,12,3,12
6,2005,190200,17,12,5,8
7,2005,190200,18,15,3,3
8,2005,190200,19,17,2,1
9,2005,190200,29,26,3,2
10,2005,190200,23,21,2,4
11,2005,190200,22,18,4,3
12,2005,190200,27,24,3,4
1,2006,190200,34,30,4,3
2,2006,190200,19,18,1,9
3,2006,190200,17,14,3,12
4,2006,190200,18,17,1,1
5,2006,190200,27,26,1,9
6,2006,190200,15,15,0,3
7,2006,190200,11,10,1,4
8,2006,190200,16,15,1,8
9,2006,190200,9,7,2,0
10,2006,190200,16,15,1,1
11,2006,190200,9,8,1,4
12,2006,190200,16,14,2,7
1,2007,190200,14,13,1,1
2,2007,190200,6,6,0,4
3,2007,190200,13,12,1,1
4,2007,190200,11,11,0,1
5,2007,190200,13,11,2,4
6,2007,190200,16,15,1,2
7,2007,190200,12,8,4,3
8,2007,190200,16,14,2,2
9,2007,190200,10,10,0,2
10,2007,190200,12,11,1,3
11,2007,190200,21,19,2,2
12,2007,190200,21,18,3,0
1,2008,190200,11,11,0,3
2,2008,190200,11,10,1,1
3,2008,190200,18,17,1,6
4,2008,190200,16,14,2,2
5,2008,190200,18,17,1,3
6,2008,190200,19,15,4,2
7,2008,190200,21,17,4,4
8,2008,190200,13,12,1,3
9,2008,190200,23,22,1,5
10,2008,190200,18,14,4,2
11,2008,190200,21,19,2,2
12,2008,190200,17,14,3,6
1,2009,190200,15,13,2,9
2,2009,190200,9,8,1,5
3,2009,190200,18,16,2,3
4,2009,190200,17,17,0,2
5,2009,190200,14,12,2,5
6,2009,190200,20,17,3,3
7,2009,190200,14,12,2,1
8,2009,190200,16,12,4,4
9,2009,190200,19,14,5,1
10,2009,190200,15,11,4,3
11,2009,190200,9,9,0,6
12,2009,190200,19,16,3,0
1,2010,190200,33,29,4,3
2,2010,190200,10,9,1,5
3,2010,190200,15,12,3,3
4,2010,190200,15,14,1,4
5,2010,190200,8,8,0,8
6,2010,190200,22,21,1,5
7,2010,190200,16,12,4,3
8,2010,190200,9,7,2,4
9,2010,190200,22,19,3,4
10,2010,190200,19,17,2,0
11,2010,190200,17,16,1,3
12,2010,190200,21,20,1,2
1,2011,190200,17,14,3,1
2,2011,190200,9,9,0,2
1,1999,210900,9,8,1,2
2,1999,210900,7,7,0,3
3,1999,210900,9,9,0,2
4,1999,210900,7,6,1,0
5,1999,210900,12,9,3,0
6,1999,210900,7,6,1,0
7,1999,210900,9,8,1,2
8,1999,210900,12,9,3,0
9,1999,210900,12,11,1,2
10,1999,210900,7,7,0,5
11,1999,210900,8,8,0,1
12,1999,210900,17,15,2,2
1,2000,210900,6,5,1,0
2,2000,210900,10,7,3,0
3,2000,210900,15,10,5,1
4,2000,210900,12,9,3,0
5,2000,210900,10,10,0,2
6,2000,210900,11,10,1,2
7,2000,210900,22,20,2,1
8,2000,210900,6,6,0,1
9,2000,210900,17,16,1,0
10,2000,210900,20,16,4,1
11,2000,210900,4,3,1,2
12,2000,210900,10,9,1,0
1,2001,210900,8,7,1,0
2,2001,210900,8,8,0,1
3,2001,210900,6,4,2,0
4,2001,210900,16,16,0,0
5,2001,210900,15,15,0,0
6,2001,210900,18,16,2,0
7,2001,210900,29,26,3,2
8,2001,210900,32,30,2,1
9,2001,210900,16,15,1,1
10,2001,210900,17,16,1,1
11,2001,210900,7,6,1,0
12,2001,210900,12,11,1,0
1,2002,210900,14,13,1,0
2,2002,210900,5,5,0,0
3,2002,210900,7,6,1,0
4,2002,210900,7,7,0,0
5,2002,210900,15,12,3,0
6,2002,210900,9,9,0,1
7,2002,210900,6,6,0,0
8,2002,210900,14,13,1,0
9,2002,210900,21,21,0,0
10,2002,210900,14,12,2,0
11,2002,210900,12,11,1,0
12,2002,210900,4,4,0,1
1,2003,210900,14,13,1,0
2,2003,210900,12,12,0,1
3,2003,210900,7,7,0,0
4,2003,210900,6,6,0,0
5,2003,210900,11,11,0,0
6,2003,210900,8,7,1,1
7,2003,210900,10,10,0,3
8,2003,210900,17,17,0,0
9,2003,210900,17,17,0,2
10,2003,210900,11,11,0,0
11,2003,210900,12,11,1,2
12,2003,210900,11,11,0,0
1,2004,210900,11,10,1,2
2,2004,210900,6,5,1,1
3,2004,210900,7,6,1,0
4,2004,210900,6,6,0,0
5,2004,210900,7,7,0,2
6,2004,210900,7,7,0,0
7,2004,210900,23,21,2,0
8,2004,210900,15,15,0,0
9,2004,210900,12,11,1,0
10,2004,210900,7,6,1,0
11,2004,210900,7,7,0,0
12,2004,210900,14,14,0,1
1,2005,210900,5,4,1,0
2,2005,210900,7,7,0,0
3,2005,210900,6,6,0,2
4,2005,210900,7,6,1,0
5,2005,210900,10,9,1,0
6,2005,210900,6,5,1,2
7,2005,210900,12,12,0,0
8,2005,210900,10,9,1,0
9,2005,210900,15,14,1,0
10,2005,210900,6,6,0,0
11,2005,210900,5,5,0,1
12,2005,210900,14,12,2,1
1,2006,210900,10,10,0,0
2,2006,210900,7,7,0,0
3,2006,210900,6,6,0,0
4,2006,210900,9,8,1,1
5,2006,210900,12,8,4,0
6,2006,210900,9,9,0,1
7,2006,210900,15,14,1,0
8,2006,210900,14,14,0,0
9,2006,210900,13,12,1,1
10,2006,210900,8,7,1,0
11,2006,210900,6,6,0,3
12,2006,210900,11,10,1,0
1,2007,210900,14,13,1,5
2,2007,210900,4,4,0,1
3,2007,210900,7,5,2,0
4,2007,210900,10,9,1,0
5,2007,210900,5,4,1,0
6,2007,210900,4,2,2,0
7,2007,210900,8,8,0,2
8,2007,210900,9,8,1,0
9,2007,210900,9,7,2,0
10,2007,210900,9,7,2,1
11,2007,210900,9,8,1,0
12,2007,210900,6,6,0,0
1,2008,210900,11,11,0,1
2,2008,210900,7,7,0,2
3,2008,210900,2,2,0,0
4,2008,210900,8,7,1,0
5,2008,210900,11,11,0,0
6,2008,210900,6,5,1,2
7,2008,210900,8,7,1,2
8,2008,210900,15,15,0,1
9,2008,210900,5,5,0,1
10,2008,210900,9,9,0,0
11,2008,210900,7,5,2,0
12,2008,210900,9,9,0,0
1,2009,210900,7,7,0,3
2,2009,210900,7,7,0,0
3,2009,210900,9,9,0,0
4,2009,210900,9,9,0,2
5,2009,210900,11,9,2,0
6,2009,210900,6,6,0,0
7,2009,210900,9,9,0,1
8,2009,210900,5,5,0,0
9,2009,210900,11,11,0,1
10,2009,210900,10,10,0,0
11,2009,210900,7,6,1,0
12,2009,210900,10,10,0,1
1,2010,210900,7,7,0,2
2,2010,210900,7,6,1,0
3,2010,210900,3,3,0,0
4,2010,210900,6,6,0,2
5,2010,210900,12,11,1,0
6,2010,210900,8,8,0,0
7,2010,210900,12,11,1,1
8,2010,210900,8,6,2,0
9,2010,210900,13,13,0,0
10,2010,210900,7,7,0,0
11,2010,210900,8,8,0,1
12,2010,210900,8,8,0,0
1,2011,210900,8,8,0,0
2,2011,210900,1,1,0,1
1,1999,210602,18,16,2,0
2,1999,210602,11,10,1,0
3,1999,210602,20,19,1,1
4,1999,210602,18,18,0,0
5,1999,210602,20,18,2,0
6,1999,210602,15,14,1,2
7,1999,210602,19,16,3,1
8,1999,210602,29,21,8,2
9,1999,210602,31,28,3,2
10,1999,210602,21,18,3,1
11,1999,210602,24,23,1,3
12,1999,210602,19,13,6,2
1,2000,210602,20,19,1,1
2,2000,210602,25,25,0,3
3,2000,210602,22,21,1,6
4,2000,210602,16,14,2,1
5,2000,210602,20,18,2,0
6,2000,210602,21,17,4,1
7,2000,210602,18,15,3,1
8,2000,210602,26,21,5,0
9,2000,210602,22,18,4,0
10,2000,210602,19,17,2,1
11,2000,210602,12,11,1,1
12,2000,210602,18,16,2,2
1,2001,210602,15,13,2,1
2,2001,210602,16,13,3,2
3,2001,210602,18,15,3,0
4,2001,210602,17,12,5,1
5,2001,210602,18,15,3,1
6,2001,210602,16,15,1,0
7,2001,210602,29,22,7,1
8,2001,210602,13,11,2,3
9,2001,210602,19,17,2,1
10,2001,210602,20,16,4,0
11,2001,210602,16,15,1,0
12,2001,210602,15,15,0,0
1,2002,210602,21,20,1,0
2,2002,210602,13,11,2,0
3,2002,210602,14,12,2,3
4,2002,210602,19,18,1,0
5,2002,210602,23,18,5,0
6,2002,210602,15,13,2,1
7,2002,210602,15,12,3,0
8,2002,210602,30,24,6,0
9,2002,210602,23,21,2,1
10,2002,210602,23,18,5,1
11,2002,210602,18,18,0,0
12,2002,210602,21,19,2,2
1,2003,210602,23,20,3,0
2,2003,210602,16,16,0,2
3,2003,210602,20,19,1,1
4,2003,210602,27,23,4,2
5,2003,210602,21,17,4,2
6,2003,210602,15,12,3,0
7,2003,210602,27,25,2,3
8,2003,210602,21,19,2,1
9,2003,210602,37,34,3,2
10,2003,210602,19,16,3,2
11,2003,210602,26,25,1,0
12,2003,210602,23,20,3,6
1,2004,210602,19,19,0,0
2,2004,210602,22,20,2,3
3,2004,210602,20,16,4,3
4,2004,210602,10,10,0,1
5,2004,210602,11,7,4,1
6,2004,210602,24,18,6,0
7,2004,210602,18,14,4,2
8,2004,210602,24,21,3,2
9,2004,210602,20,18,2,2
10,2004,210602,9,8,1,4
11,2004,210602,12,10,2,2
12,2004,210602,17,16,1,0
1,2005,210602,13,11,2,8
2,2005,210602,9,7,2,1
3,2005,210602,9,6,3,4
4,2005,210602,14,10,4,4
5,2005,210602,20,17,3,1
6,2005,210602,15,11,4,3
7,2005,210602,17,16,1,3
8,2005,210602,19,14,5,4
9,2005,210602,15,15,0,0
10,2005,210602,14,13,1,1
11,2005,210602,17,14,3,5
12,2005,210602,7,6,1,0
1,2006,210602,18,18,0,4
2,2006,210602,11,11,0,0
3,2006,210602,8,8,0,2
4,2006,210602,12,11,1,2
5,2006,210602,15,14,1,2
6,2006,210602,15,11,4,0
7,2006,210602,14,9,5,4
8,2006,210602,20,17,3,0
9,2006,210602,12,11,1,4
10,2006,210602,14,14,0,0
11,2006,210602,17,13,4,2
12,2006,210602,12,9,3,4
1,2007,210602,6,5,1,5
2,2007,210602,6,5,1,0
3,2007,210602,11,10,1,0
4,2007,210602,8,7,1,3
5,2007,210602,9,8,1,0
6,2007,210602,13,10,3,4
7,2007,210602,10,8,2,0
8,2007,210602,6,5,1,2
9,2007,210602,9,7,2,0
10,2007,210602,11,9,2,1
11,2007,210602,12,11,1,9
12,2007,210602,10,10,0,1
1,2008,210602,9,8,1,4
2,2008,210602,11,10,1,2
3,2008,210602,14,13,1,0
4,2008,210602,10,7,3,2
5,2008,210602,9,9,0,1
6,2008,210602,10,9,1,4
7,2008,210602,15,13,2,1
8,2008,210602,8,6,2,2
9,2008,210602,9,9,0,10
10,2008,210602,9,8,1,1
11,2008,210602,7,6,1,2
12,2008,210602,9,6,3,1
1,2009,210602,7,7,0,3
2,2009,210602,14,14,0,1
3,2009,210602,13,11,2,3
4,2009,210602,13,10,3,1
5,2009,210602,11,9,2,1
6,2009,210602,13,8,5,3
7,2009,210602,12,9,3,0
8,2009,210602,16,14,2,0
9,2009,210602,18,16,2,2
10,2009,210602,16,15,1,1
11,2009,210602,13,11,2,1
12,2009,210602,13,13,0,0
1,2010,210602,8,7,1,1
2,2010,210602,11,9,2,2
3,2010,210602,17,16,1,2
4,2010,210602,11,11,0,2
5,2010,210602,10,7,3,1
6,2010,210602,10,9,1,0
7,2010,210602,16,14,2,1
8,2010,210602,10,8,2,6
9,2010,210602,14,13,1,3
10,2010,210602,16,12,4,0
11,2010,210602,4,4,0,3
12,2010,210602,10,9,1,1
1,2011,210602,7,7,0,0
2,2011,210602,9,6,3,2
1,1999,190100,11,11,0,2
2,1999,190100,11,9,2,2
3,1999,190100,4,4,0,0
4,1999,190100,11,11,0,3
5,1999,190100,8,7,1,2
6,1999,190100,6,6,0,4
7,1999,190100,10,7,3,3
8,1999,190100,11,9,2,2
9,1999,190100,14,11,3,0
10,1999,190100,10,9,1,2
11,1999,190100,9,7,2,6
12,1999,190100,9,8,1,1
1,2000,190100,14,13,1,2
2,2000,190100,13,13,0,0
3,2000,190100,16,15,1,3
4,2000,190100,12,9,3,4
5,2000,190100,8,8,0,1
6,2000,190100,11,8,3,2
7,2000,190100,20,19,1,2
8,2000,190100,12,12,0,0
9,2000,190100,11,11,0,4
10,2000,190100,17,14,3,3
11,2000,190100,10,9,1,0
12,2000,190100,15,13,2,1
1,2001,190100,12,9,3,2
2,2001,190100,8,8,0,6
3,2001,190100,14,13,1,3
4,2001,190100,10,9,1,1
5,2001,190100,8,8,0,3
6,2001,190100,16,15,1,8
7,2001,190100,19,18,1,7
8,2001,190100,10,9,1,4
9,2001,190100,14,13,1,3
10,2001,190100,15,15,0,6
11,2001,190100,11,9,2,3
12,2001,190100,12,12,0,5
1,2002,190100,9,9,0,3
2,2002,190100,10,9,1,0
3,2002,190100,9,9,0,0
4,2002,190100,9,6,3,1
5,2002,190100,10,6,4,5
6,2002,190100,15,12,3,3
7,2002,190100,19,18,1,2
8,2002,190100,12,12,0,2
9,2002,190100,12,10,2,4
10,2002,190100,24,22,2,2
11,2002,190100,13,13,0,3
12,2002,190100,14,14,0,4
1,2003,190100,17,16,1,3
2,2003,190100,13,12,1,4
3,2003,190100,13,11,2,4
4,2003,190100,10,9,1,0
5,2003,190100,11,10,1,5
6,2003,190100,15,14,1,2
7,2003,190100,14,12,2,4
8,2003,190100,11,8,3,2
9,2003,190100,9,9,0,8
10,2003,190100,3,2,1,3
11,2003,190100,7,7,0,4
12,2003,190100,5,4,1,6
1,2004,190100,11,10,1,2
2,2004,190100,5,5,0,2
3,2004,190100,8,6,2,2
4,2004,190100,9,9,0,2
5,2004,190100,14,13,1,2
6,2004,190100,18,14,4,3
7,2004,190100,16,12,4,4
8,2004,190100,6,6,0,8
9,2004,190100,5,4,1,0
10,2004,190100,5,4,1,2
11,2004,190100,6,6,0,0
12,2004,190100,14,13,1,0
1,2005,190100,8,3,5,0
2,2005,190100,8,7,1,4
3,2005,190100,8,8,0,2
4,2005,190100,15,15,0,2
5,2005,190100,14,12,2,0
6,2005,190100,12,9,3,7
7,2005,190100,11,10,1,2
8,2005,190100,10,9,1,4
9,2005,190100,17,16,1,4
10,2005,190100,16,16,0,4
11,2005,190100,17,16,1,0
12,2005,190100,13,12,1,1
1,2006,190100,16,16,0,0
2,2006,190100,6,4,2,4
3,2006,190100,3,3,0,1
4,2006,190100,6,4,2,5
5,2006,190100,6,4,2,1
6,2006,190100,9,9,0,2
7,2006,190100,14,10,4,1
8,2006,190100,7,4,3,1
9,2006,190100,6,5,1,6
10,2006,190100,11,10,1,3
11,2006,190100,9,6,3,3
12,2006,190100,11,8,3,1
1,2007,190100,8,8,0,1
2,2007,190100,10,10,0,2
3,2007,190100,7,7,0,2
4,2007,190100,14,11,3,0
5,2007,190100,10,10,0,3
6,2007,190100,10,8,2,1
7,2007,190100,12,10,2,2
8,2007,190100,9,9,0,3
9,2007,190100,8,6,2,5
10,2007,190100,12,10,2,3
11,2007,190100,11,11,0,3
12,2007,190100,7,7,0,2
1,2008,190100,10,8,2,1
2,2008,190100,7,7,0,2
3,2008,190100,8,8,0,0
4,2008,190100,9,7,2,3
5,2008,190100,6,5,1,3
6,2008,190100,19,18,1,2
7,2008,190100,6,5,1,1
8,2008,190100,10,8,2,3
9,2008,190100,13,12,1,1
10,2008,190100,3,3,0,6
11,2008,190100,13,13,0,4
12,2008,190100,10,10,0,1
1,2009,190100,12,10,2,4
2,2009,190100,3,3,0,4
3,2009,190100,7,7,0,2
4,2009,190100,7,6,1,2
5,2009,190100,6,6,0,1
6,2009,190100,11,7,4,1
7,2009,190100,13,13,0,4
8,2009,190100,9,9,0,1
9,2009,190100,5,5,0,2
10,2009,190100,14,12,2,1
11,2009,190100,10,7,3,3
12,2009,190100,13,13,0,5
1,2010,190100,14,14,0,3
2,2010,190100,3,2,1,2
3,2010,190100,8,7,1,4
4,2010,190100,13,11,2,4
5,2010,190100,12,10,2,2
6,2010,190100,7,5,2,4
7,2010,190100,6,4,2,1
8,2010,190100,13,11,2,2
9,2010,190100,14,10,4,0
10,2010,190100,17,17,0,4
11,2010,190100,9,9,0,2
12,2010,190100,8,8,0,1
1,2011,190100,9,9,0,3
2,2011,190100,6,6,0,1
1,1999,051400,11,10,1,7
2,1999,051400,13,11,2,5
3,1999,051400,10,9,1,5
4,1999,051400,12,12,0,6
5,1999,051400,19,15,4,6
6,1999,051400,15,12,3,5
7,1999,051400,16,11,5,6
8,1999,051400,19,15,4,4
9,1999,051400,11,9,2,2
10,1999,051400,20,17,3,9
11,1999,051400,17,14,3,8
12,1999,051400,22,20,2,11
1,2000,051400,18,18,0,7
2,2000,051400,14,11,3,4
3,2000,051400,18,13,5,10
4,2000,051400,16,11,5,5
5,2000,051400,20,19,1,8
6,2000,051400,17,14,3,3
7,2000,051400,30,25,5,7
8,2000,051400,20,16,4,3
9,2000,051400,15,12,3,6
10,2000,051400,11,9,2,7
11,2000,051400,6,5,1,6
12,2000,051400,8,7,1,8
1,2001,051400,15,10,5,5
2,2001,051400,8,6,2,4
3,2001,051400,9,8,1,7
4,2001,051400,9,7,2,5
5,2001,051400,11,11,0,2
6,2001,051400,15,10,5,4
7,2001,051400,13,9,4,5
8,2001,051400,13,12,1,5
9,2001,051400,13,12,1,5
10,2001,051400,12,10,2,2
11,2001,051400,19,16,3,2
12,2001,051400,9,7,2,5
1,2002,051400,8,5,3,5
2,2002,051400,4,4,0,8
3,2002,051400,10,9,1,2
4,2002,051400,4,4,0,2
5,2002,051400,15,14,1,3
6,2002,051400,13,12,1,5
7,2002,051400,13,10,3,3
8,2002,051400,16,12,4,5
9,2002,051400,8,7,1,2
10,2002,051400,11,10,1,4
11,2002,051400,15,13,2,3
12,2002,051400,11,10,1,4
1,2003,051400,9,7,2,5
2,2003,051400,9,6,3,2
3,2003,051400,19,14,5,3
4,2003,051400,10,7,3,4
5,2003,051400,10,9,1,4
6,2003,051400,14,12,2,6
7,2003,051400,10,10,0,2
8,2003,051400,15,12,3,0
9,2003,051400,6,4,2,3
10,2003,051400,10,9,1,0
11,2003,051400,11,11,0,1
12,2003,051400,10,10,0,4
1,2004,051400,12,10,2,1
2,2004,051400,6,3,3,1
3,2004,051400,13,12,1,9
4,2004,051400,11,10,1,3
5,2004,051400,13,12,1,3
6,2004,051400,10,7,3,3
7,2004,051400,14,11,3,3
8,2004,051400,12,11,1,1
9,2004,051400,15,12,3,4
10,2004,051400,14,13,1,2
11,2004,051400,10,8,2,0
12,2004,051400,8,4,4,1
1,2005,051400,5,5,0,4
2,2005,051400,6,5,1,3
3,2005,051400,4,4,0,3
4,2005,051400,8,5,3,7
5,2005,051400,10,9,1,7
6,2005,051400,7,6,1,4
7,2005,051400,11,8,3,7
8,2005,051400,15,14,1,4
9,2005,051400,10,8,2,4
10,2005,051400,8,6,2,8
11,2005,051400,8,8,0,1
12,2005,051400,7,7,0,3
1,2006,051400,8,8,0,3
2,2006,051400,3,2,1,9
3,2006,051400,7,7,0,3
4,2006,051400,6,6,0,2
5,2006,051400,7,7,0,4
6,2006,051400,10,8,2,1
7,2006,051400,10,9,1,1
8,2006,051400,10,9,1,2
9,2006,051400,5,5,0,2
10,2006,051400,7,6,1,0
11,2006,051400,3,3,0,5
12,2006,051400,7,7,0,2
1,2007,051400,8,8,0,1
2,2007,051400,12,12,0,2
3,2007,051400,6,6,0,1
4,2007,051400,7,7,0,0
5,2007,051400,10,9,1,1
6,2007,051400,8,8,0,1
7,2007,051400,13,12,1,2
8,2007,051400,7,7,0,1
9,2007,051400,12,11,1,2
10,2007,051400,5,5,0,1
11,2007,051400,12,12,0,1
12,2007,051400,8,8,0,2
1,2008,051400,11,11,0,2
2,2008,051400,14,12,2,0
3,2008,051400,6,5,1,3
4,2008,051400,8,7,1,1
5,2008,051400,8,7,1,1
6,2008,051400,11,8,3,0
7,2008,051400,16,14,2,1
8,2008,051400,16,15,1,2
9,2008,051400,16,15,1,0
10,2008,051400,8,8,0,2
11,2008,051400,6,6,0,1
12,2008,051400,12,10,2,1
1,2009,051400,10,8,2,1
2,2009,051400,14,12,2,0
3,2009,051400,13,13,0,1
4,2009,051400,10,10,0,0
5,2009,051400,13,12,1,1
6,2009,051400,15,15,0,1
7,2009,051400,11,11,0,4
8,2009,051400,7,6,1,1
9,2009,051400,14,14,0,1
10,2009,051400,10,8,2,2
11,2009,051400,7,7,0,1
12,2009,051400,6,5,1,0
1,2010,051400,4,4,0,1
2,2010,051400,8,7,1,0
3,2010,051400,6,6,0,2
4,2010,051400,5,5,0,1
5,2010,051400,4,2,2,0
6,2010,051400,5,4,1,0
7,2010,051400,9,9,0,1
8,2010,051400,10,10,0,2
9,2010,051400,15,15,0,2
10,2010,051400,7,6,1,0
11,2010,051400,8,8,0,0
12,2010,051400,5,3,2,0
1,2011,051400,4,4,0,1
2,2011,051400,2,2,0,1
1,1999,051300,5,4,1,0
2,1999,051300,7,7,0,0
3,1999,051300,5,5,0,1
4,1999,051300,4,4,0,0
5,1999,051300,10,10,0,0
6,1999,051300,12,12,0,0
7,1999,051300,13,13,0,2
8,1999,051300,14,11,3,2
9,1999,051300,9,8,1,1
10,1999,051300,10,10,0,1
11,1999,051300,8,8,0,2
12,1999,051300,6,6,0,1
1,2000,051300,11,10,1,0
2,2000,051300,3,3,0,0
3,2000,051300,6,6,0,2
4,2000,051300,8,8,0,2
5,2000,051300,13,13,0,0
6,2000,051300,12,12,0,1
7,2000,051300,9,8,1,2
8,2000,051300,4,4,0,1
9,2000,051300,7,7,0,0
10,2000,051300,7,7,0,0
11,2000,051300,2,2,0,1
12,2000,051300,5,5,0,0
1,2001,051300,4,4,0,0
2,2001,051300,1,1,0,0
3,2001,051300,9,8,1,1
4,2001,051300,10,10,0,0
5,2001,051300,4,4,0,0
6,2001,051300,9,9,0,3
7,2001,051300,9,9,0,1
8,2001,051300,7,7,0,1
9,2001,051300,5,5,0,2
10,2001,051300,5,5,0,1
11,2001,051300,6,6,0,1
12,2001,051300,3,3,0,0
1,2002,051300,4,4,0,0
2,2002,051300,3,3,0,0
3,2002,051300,0,0,0,0
4,2002,051300,5,5,0,1
5,2002,051300,6,6,0,0
6,2002,051300,4,4,0,0
7,2002,051300,7,7,0,0
8,2002,051300,7,7,0,1
9,2002,051300,5,5,0,0
10,2002,051300,10,10,0,1
11,2002,051300,11,11,0,1
12,2002,051300,2,1,1,0
1,2003,051300,5,5,0,0
2,2003,051300,3,3,0,0
3,2003,051300,5,5,0,0
4,2003,051300,5,5,0,2
5,2003,051300,3,3,0,0
6,2003,051300,4,4,0,0
7,2003,051300,4,3,1,1
8,2003,051300,3,3,0,1
9,2003,051300,9,8,1,1
10,2003,051300,6,6,0,0
11,2003,051300,4,4,0,0
12,2003,051300,3,3,0,0
1,2004,051300,2,2,0,2
2,2004,051300,5,5,0,0
3,2004,051300,5,5,0,0
4,2004,051300,4,4,0,0
5,2004,051300,4,3,1,0
6,2004,051300,18,16,2,0
7,2004,051300,6,5,1,0
8,2004,051300,4,4,0,0
9,2004,051300,5,5,0,1
10,2004,051300,8,8,0,1
11,2004,051300,8,8,0,0
12,2004,051300,10,10,0,1
1,2005,051300,5,5,0,0
2,2005,051300,3,3,0,1
3,2005,051300,8,7,1,0
4,2005,051300,5,4,1,0
5,2005,051300,4,4,0,2
6,2005,051300,1,1,0,0
7,2005,051300,5,5,0,0
8,2005,051300,6,6,0,3
9,2005,051300,3,3,0,0
10,2005,051300,6,6,0,0
11,2005,051300,6,6,0,0
12,2005,051300,4,4,0,0
1,2006,051300,8,8,0,0
2,2006,051300,10,10,0,0
3,2006,051300,9,9,0,0
4,2006,051300,5,4,1,0
5,2006,051300,6,6,0,0
6,2006,051300,10,10,0,0
7,2006,051300,5,5,0,0
8,2006,051300,7,7,0,0
9,2006,051300,5,5,0,0
10,2006,051300,9,9,0,0
11,2006,051300,10,10,0,1
12,2006,051300,4,4,0,0
1,2007,051300,6,6,0,1
2,2007,051300,1,1,0,0
3,2007,051300,5,5,0,0
4,2007,051300,6,6,0,0
5,2007,051300,5,5,0,0
6,2007,051300,8,8,0,0
7,2007,051300,7,7,0,0
8,2007,051300,7,7,0,0
9,2007,051300,10,10,0,0
10,2007,051300,5,5,0,1
11,2007,051300,5,4,1,1
12,2007,051300,7,7,0,0
1,2008,051300,7,7,0,0
2,2008,051300,6,6,0,0
3,2008,051300,7,7,0,0
4,2008,051300,3,3,0,0
5,2008,051300,5,4,1,0
6,2008,051300,5,4,1,0
7,2008,051300,6,6,0,0
8,2008,051300,13,13,0,0
9,2008,051300,13,12,1,0
10,2008,051300,13,13,0,0
11,2008,051300,9,9,0,1
12,2008,051300,6,6,0,0
1,2009,051300,7,7,0,0
2,2009,051300,3,3,0,0
3,2009,051300,7,7,0,0
4,2009,051300,15,15,0,1
5,2009,051300,12,12,0,2
6,2009,051300,3,3,0,0
7,2009,051300,8,8,0,0
8,2009,051300,6,6,0,0
9,2009,051300,4,4,0,0
10,2009,051300,7,7,0,0
11,2009,051300,4,4,0,0
12,2009,051300,3,3,0,0
1,2010,051300,5,5,0,0
2,2010,051300,11,11,0,0
3,2010,051300,8,8,0,0
4,2010,051300,3,3,0,0
5,2010,051300,5,5,0,0
6,2010,051300,9,9,0,0
7,2010,051300,6,6,0,0
8,2010,051300,11,11,0,0
9,2010,051300,7,7,0,0
10,2010,051300,5,5,0,0
11,2010,051300,13,13,0,0
12,2010,051300,8,7,1,1
1,2011,051300,4,4,0,0
2,2011,051300,6,6,0,0
1,1999,062600,8,7,1,0
2,1999,062600,10,10,0,1
3,1999,062600,15,15,0,2
4,1999,062600,11,11,0,0
5,1999,062600,15,15,0,0
6,1999,062600,23,23,0,0
7,1999,062600,23,23,0,0
8,1999,062600,17,17,0,2
9,1999,062600,17,17,0,3
10,1999,062600,11,11,0,0
11,1999,062600,17,16,1,0
12,1999,062600,15,15,0,0
1,2000,062600,20,20,0,0
2,2000,062600,10,9,1,0
3,2000,062600,17,16,1,2
4,2000,062600,15,14,1,0
5,2000,062600,21,21,0,0
6,2000,062600,18,16,2,0
7,2000,062600,14,14,0,1
8,2000,062600,18,18,0,0
9,2000,062600,14,14,0,0
10,2000,062600,20,20,0,1
11,2000,062600,14,14,0,1
12,2000,062600,11,11,0,0
1,2001,062600,11,11,0,1
2,2001,062600,5,5,0,0
3,2001,062600,9,9,0,0
4,2001,062600,15,15,0,1
5,2001,062600,12,12,0,1
6,2001,062600,19,18,1,0
7,2001,062600,18,18,0,0
8,2001,062600,7,7,0,1
9,2001,062600,10,10,0,0
10,2001,062600,16,16,0,1
11,2001,062600,13,13,0,0
12,2001,062600,8,8,0,2
1,2002,062600,18,18,0,0
2,2002,062600,16,16,0,4
3,2002,062600,17,17,0,1
4,2002,062600,10,10,0,1
5,2002,062600,20,17,3,5
6,2002,062600,13,13,0,0
7,2002,062600,13,12,1,0
8,2002,062600,12,12,0,1
9,2002,062600,16,16,0,0
10,2002,062600,20,20,0,1
11,2002,062600,21,21,0,0
12,2002,062600,9,9,0,0
1,2003,062600,11,11,0,0
2,2003,062600,15,15,0,1
3,2003,062600,16,16,0,0
4,2003,062600,16,16,0,0
5,2003,062600,12,12,0,2
6,2003,062600,18,18,0,0
7,2003,062600,20,19,1,1
8,2003,062600,13,12,1,0
9,2003,062600,17,16,1,0
10,2003,062600,11,10,1,1
11,2003,062600,10,10,0,0
12,2003,062600,15,15,0,0
1,2004,062600,11,10,1,0
2,2004,062600,6,6,0,0
3,2004,062600,9,9,0,1
4,2004,062600,11,11,0,1
5,2004,062600,7,7,0,1
6,2004,062600,16,15,1,0
7,2004,062600,13,13,0,0
8,2004,062600,16,16,0,0
9,2004,062600,9,9,0,0
10,2004,062600,10,10,0,0
11,2004,062600,8,8,0,0
12,2004,062600,12,11,1,1
1,2005,062600,8,8,0,0
2,2005,062600,10,10,0,0
3,2005,062600,5,5,0,1
4,2005,062600,8,8,0,1
5,2005,062600,11,11,0,0
6,2005,062600,7,7,0,0
7,2005,062600,11,10,1,0
8,2005,062600,15,14,1,0
9,2005,062600,3,2,1,0
10,2005,062600,17,16,1,2
11,2005,062600,7,6,1,0
12,2005,062600,6,6,0,0
1,2006,062600,11,11,0,1
2,2006,062600,6,6,0,1
3,2006,062600,11,11,0,1
4,2006,062600,8,7,1,0
5,2006,062600,9,9,0,0
6,2006,062600,11,10,1,1
7,2006,062600,11,11,0,0
8,2006,062600,7,7,0,0
9,2006,062600,10,10,0,0
10,2006,062600,10,10,0,0
11,2006,062600,14,14,0,1
12,2006,062600,7,7,0,0
1,2007,062600,11,11,0,1
2,2007,062600,14,14,0,3
3,2007,062600,16,16,0,0
4,2007,062600,4,4,0,0
5,2007,062600,10,10,0,0
6,2007,062600,7,7,0,0
7,2007,062600,5,5,0,0
8,2007,062600,17,16,1,1
9,2007,062600,13,13,0,0
10,2007,062600,19,19,0,0
11,2007,062600,14,13,1,1
12,2007,062600,22,21,1,0
1,2008,062600,17,16,1,0
2,2008,062600,12,12,0,0
3,2008,062600,9,9,0,0
4,2008,062600,14,13,1,0
5,2008,062600,9,9,0,1
6,2008,062600,3,3,0,0
7,2008,062600,9,9,0,1
8,2008,062600,7,7,0,0
9,2008,062600,8,8,0,0
10,2008,062600,8,7,1,1
11,2008,062600,9,9,0,0
12,2008,062600,8,8,0,1
1,2009,062600,6,6,0,1
2,2009,062600,4,4,0,1
3,2009,062600,6,6,0,0
4,2009,062600,11,11,0,2
5,2009,062600,8,8,0,1
6,2009,062600,8,8,0,1
7,2009,062600,16,16,0,0
8,2009,062600,10,9,1,0
9,2009,062600,15,15,0,0
10,2009,062600,11,11,0,0
11,2009,062600,9,9,0,1
12,2009,062600,7,7,0,0
1,2010,062600,9,9,0,0
2,2010,062600,5,5,0,0
3,2010,062600,7,7,0,0
4,2010,062600,17,17,0,0
5,2010,062600,19,19,0,0
6,2010,062600,7,6,1,0
7,2010,062600,7,7,0,0
8,2010,062600,5,5,0,0
9,2010,062600,10,10,0,0
10,2010,062600,14,14,0,0
11,2010,062600,6,6,0,1
12,2010,062600,14,13,1,0
1,2011,062600,9,9,0,0
2,2011,062600,3,3,0,0
1,1999,062700,8,8,0,0
2,1999,062700,17,17,0,1
3,1999,062700,14,14,0,2
4,1999,062700,9,9,0,0
5,1999,062700,18,18,0,0
6,1999,062700,17,16,1,0
7,1999,062700,20,19,1,0
8,1999,062700,19,19,0,0
9,1999,062700,12,12,0,0
10,1999,062700,24,24,0,0
11,1999,062700,11,11,0,0
12,1999,062700,8,8,0,0
1,2000,062700,11,10,1,0
2,2000,062700,10,10,0,0
3,2000,062700,15,15,0,1
4,2000,062700,10,10,0,0
5,2000,062700,6,6,0,1
6,2000,062700,16,14,2,0
7,2000,062700,11,11,0,0
8,2000,062700,24,24,0,0
9,2000,062700,12,12,0,0
10,2000,062700,14,14,0,0
11,2000,062700,8,8,0,0
12,2000,062700,8,8,0,0
1,2001,062700,12,12,0,0
2,2001,062700,9,9,0,0
3,2001,062700,8,8,0,0
4,2001,062700,11,11,0,0
5,2001,062700,14,13,1,0
6,2001,062700,18,17,1,0
7,2001,062700,15,13,2,0
8,2001,062700,13,13,0,0
9,2001,062700,12,10,2,0
10,2001,062700,9,9,0,1
11,2001,062700,22,21,1,0
12,2001,062700,10,10,0,0
1,2002,062700,9,9,0,0
2,2002,062700,8,8,0,0
3,2002,062700,7,7,0,0
4,2002,062700,17,17,0,2
5,2002,062700,14,14,0,2
6,2002,062700,16,16,0,0
7,2002,062700,20,20,0,0
8,2002,062700,24,23,1,0
9,2002,062700,14,13,1,0
10,2002,062700,18,18,0,0
11,2002,062700,14,13,1,0
12,2002,062700,10,10,0,0
1,2003,062700,6,6,0,0
2,2003,062700,10,9,1,0
3,2003,062700,15,14,1,2
4,2003,062700,12,12,0,1
5,2003,062700,15,15,0,0
6,2003,062700,10,10,0,0
7,2003,062700,15,15,0,0
8,2003,062700,15,14,1,1
9,2003,062700,15,15,0,0
10,2003,062700,13,13,0,0
11,2003,062700,10,10,0,0
12,2003,062700,11,11,0,0
1,2004,062700,11,11,0,0
2,2004,062700,11,11,0,0
3,2004,062700,8,8,0,0
4,2004,062700,13,12,1,0
5,2004,062700,12,12,0,0
6,2004,062700,7,7,0,1
7,2004,062700,19,19,0,3
8,2004,062700,19,19,0,0
9,2004,062700,9,9,0,0
10,2004,062700,15,15,0,0
11,2004,062700,9,9,0,0
12,2004,062700,11,11,0,0
1,2005,062700,10,10,0,0
2,2005,062700,4,3,1,0
3,2005,062700,10,10,0,1
4,2005,062700,13,13,0,0
5,2005,062700,15,15,0,0
6,2005,062700,11,10,1,0
7,2005,062700,16,15,1,0
8,2005,062700,10,10,0,0
9,2005,062700,7,7,0,1
10,2005,062700,12,11,1,0
11,2005,062700,9,9,0,0
12,2005,062700,6,6,0,0
1,2006,062700,18,16,2,1
2,2006,062700,11,11,0,0
3,2006,062700,17,17,0,0
4,2006,062700,8,7,1,0
5,2006,062700,10,10,0,0
6,2006,062700,8,8,0,0
7,2006,062700,7,7,0,0
8,2006,062700,10,10,0,0
9,2006,062700,7,7,0,0
10,2006,062700,8,8,0,0
11,2006,062700,13,13,0,1
12,2006,062700,12,12,0,1
1,2007,062700,17,17,0,0
2,2007,062700,12,12,0,0
3,2007,062700,9,9,0,0
4,2007,062700,17,17,0,2
5,2007,062700,3,3,0,0
6,2007,062700,10,10,0,0
7,2007,062700,22,22,0,0
8,2007,062700,16,15,1,0
9,2007,062700,13,13,0,0
10,2007,062700,17,17,0,0
11,2007,062700,15,15,0,0
12,2007,062700,7,7,0,0
1,2008,062700,10,10,0,0
2,2008,062700,13,12,1,0
3,2008,062700,10,9,1,1
4,2008,062700,15,15,0,0
5,2008,062700,11,10,1,1
6,2008,062700,16,16,0,0
7,2008,062700,17,16,1,0
8,2008,062700,13,13,0,0
9,2008,062700,20,20,0,0
10,2008,062700,5,4,1,0
11,2008,062700,13,13,0,0
12,2008,062700,14,14,0,0
1,2009,062700,14,14,0,0
2,2009,062700,12,12,0,0
3,2009,062700,16,16,0,0
4,2009,062700,12,12,0,0
5,2009,062700,12,12,0,1
6,2009,062700,14,13,1,0
7,2009,062700,13,13,0,0
8,2009,062700,13,13,0,0
9,2009,062700,19,19,0,1
10,2009,062700,6,6,0,0
11,2009,062700,10,10,0,0
12,2009,062700,8,7,1,0
1,2010,062700,11,11,0,1
2,2010,062700,3,3,0,0
3,2010,062700,11,11,0,0
4,2010,062700,8,8,0,0
5,2010,062700,14,14,0,0
6,2010,062700,13,13,0,1
7,2010,062700,24,24,0,0
8,2010,062700,24,23,1,0
9,2010,062700,13,12,1,0
10,2010,062700,16,15,1,0
11,2010,062700,17,16,1,0
12,2010,062700,13,13,0,0
1,2011,062700,2,2,0,0
2,2011,062700,10,9,1,0
1,1999,062800,20,20,0,0
2,1999,062800,7,7,0,1
3,1999,062800,13,12,1,1
4,1999,062800,11,11,0,1
5,1999,062800,16,16,0,0
6,1999,062800,23,22,1,1
7,1999,062800,27,27,0,0
8,1999,062800,19,18,1,1
9,1999,062800,16,16,0,1
10,1999,062800,11,10,1,0
11,1999,062800,10,10,0,1
12,1999,062800,12,12,0,0
1,2000,062800,7,6,1,1
2,2000,062800,7,7,0,0
3,2000,062800,6,6,0,2
4,2000,062800,6,6,0,0
5,2000,062800,7,7,0,0
6,2000,062800,18,18,0,0
7,2000,062800,20,20,0,1
8,2000,062800,22,20,2,1
9,2000,062800,20,19,1,0
10,2000,062800,24,24,0,1
11,2000,062800,8,7,1,0
12,2000,062800,7,7,0,0
1,2001,062800,9,9,0,0
2,2001,062800,11,11,0,0
3,2001,062800,5,5,0,0
4,2001,062800,9,9,0,0
5,2001,062800,19,19,0,1
6,2001,062800,16,16,0,0
7,2001,062800,20,18,2,0
8,2001,062800,11,11,0,0
9,2001,062800,14,14,0,0
10,2001,062800,11,11,0,0
11,2001,062800,14,14,0,0
12,2001,062800,12,12,0,1
1,2002,062800,7,6,1,0
2,2002,062800,3,3,0,0
3,2002,062800,8,8,0,0
4,2002,062800,4,3,1,4
5,2002,062800,11,10,1,0
6,2002,062800,15,15,0,0
7,2002,062800,21,21,0,0
8,2002,062800,21,21,0,0
9,2002,062800,19,19,0,0
10,2002,062800,23,23,0,1
11,2002,062800,8,8,0,1
12,2002,062800,11,11,0,0
1,2003,062800,9,9,0,1
2,2003,062800,13,12,1,0
3,2003,062800,15,15,0,0
4,2003,062800,6,6,0,0
5,2003,062800,9,9,0,1
6,2003,062800,13,12,1,0
7,2003,062800,17,17,0,0
8,2003,062800,15,14,1,0
9,2003,062800,19,17,2,1
10,2003,062800,22,21,1,0
11,2003,062800,8,8,0,0
12,2003,062800,14,14,0,0
1,2004,062800,8,8,0,0
2,2004,062800,7,7,0,0
3,2004,062800,8,8,0,0
4,2004,062800,7,7,0,1
5,2004,062800,22,22,0,0
6,2004,062800,7,7,0,1
7,2004,062800,12,11,1,0
8,2004,062800,17,17,0,0
9,2004,062800,20,20,0,1
10,2004,062800,13,13,0,0
11,2004,062800,22,22,0,1
12,2004,062800,7,7,0,0
1,2005,062800,5,5,0,1
2,2005,062800,6,6,0,0
3,2005,062800,4,4,0,1
4,2005,062800,13,13,0,0
5,2005,062800,12,12,0,0
6,2005,062800,18,18,0,0
7,2005,062800,15,15,0,0
8,2005,062800,14,14,0,1
9,2005,062800,6,5,1,0
10,2005,062800,10,10,0,0
11,2005,062800,10,10,0,0
12,2005,062800,9,9,0,0
1,2006,062800,14,12,2,0
2,2006,062800,7,7,0,0
3,2006,062800,11,11,0,1
4,2006,062800,6,6,0,0
5,2006,062800,8,7,1,1
6,2006,062800,10,9,1,1
7,2006,062800,13,12,1,1
8,2006,062800,13,13,0,1
9,2006,062800,10,10,0,0
10,2006,062800,7,6,1,0
11,2006,062800,4,4,0,0
12,2006,062800,14,12,2,0
1,2007,062800,13,12,1,1
2,2007,062800,10,10,0,1
3,2007,062800,5,5,0,0
4,2007,062800,14,14,0,0
5,2007,062800,12,11,1,1
6,2007,062800,9,8,1,0
7,2007,062800,15,15,0,2
8,2007,062800,22,22,0,1
9,2007,062800,20,18,2,1
10,2007,062800,14,13,1,1
11,2007,062800,17,17,0,1
12,2007,062800,19,19,0,0
1,2008,062800,16,16,0,0
2,2008,062800,11,11,0,0
3,2008,062800,10,10,0,0
4,2008,062800,13,13,0,0
5,2008,062800,18,18,0,0
6,2008,062800,9,8,1,0
7,2008,062800,17,17,0,0
8,2008,062800,21,21,0,0
9,2008,062800,24,24,0,0
10,2008,062800,10,9,1,0
11,2008,062800,10,10,0,0
12,2008,062800,15,15,0,0
1,2009,062800,14,14,0,0
2,2009,062800,10,10,0,0
3,2009,062800,14,14,0,0
4,2009,062800,8,8,0,0
5,2009,062800,9,9,0,0
6,2009,062800,7,7,0,0
7,2009,062800,12,12,0,0
8,2009,062800,15,15,0,0
9,2009,062800,16,16,0,0
10,2009,062800,7,7,0,0
11,2009,062800,8,7,1,0
12,2009,062800,12,12,0,0
1,2010,062800,11,11,0,0
2,2010,062800,9,9,0,0
3,2010,062800,11,11,0,0
4,2010,062800,7,7,0,0
5,2010,062800,15,15,0,0
6,2010,062800,17,16,1,0
7,2010,062800,15,15,0,0
8,2010,062800,18,18,0,0
9,2010,062800,11,10,1,1
10,2010,062800,9,9,0,0
11,2010,062800,13,13,0,0
12,2010,062800,10,9,1,0
1,2011,062800,7,7,0,1
2,2011,062800,10,10,0,0
1,1999,062900,15,15,0,5
2,1999,062900,18,18,0,0
3,1999,062900,14,14,0,0
4,1999,062900,14,14,0,0
5,1999,062900,23,21,2,0
6,1999,062900,17,17,0,5
7,1999,062900,27,26,1,0
8,1999,062900,29,29,0,0
9,1999,062900,15,15,0,0
10,1999,062900,15,15,0,1
11,1999,062900,11,11,0,0
12,1999,062900,9,9,0,0
1,2000,062900,10,10,0,0
2,2000,062900,16,16,0,0
3,2000,062900,17,16,1,0
4,2000,062900,12,12,0,1
5,2000,062900,16,16,0,0
6,2000,062900,34,34,0,2
7,2000,062900,29,26,3,0
8,2000,062900,18,18,0,0
9,2000,062900,19,19,0,1
10,2000,062900,14,14,0,1
11,2000,062900,14,13,1,1
12,2000,062900,9,9,0,0
1,2001,062900,14,13,1,0
2,2001,062900,13,12,1,0
3,2001,062900,8,8,0,2
4,2001,062900,12,12,0,0
5,2001,062900,5,5,0,0
6,2001,062900,24,24,0,0
7,2001,062900,15,15,0,0
8,2001,062900,17,17,0,0
9,2001,062900,17,15,2,2
10,2001,062900,16,16,0,0
11,2001,062900,11,11,0,0
12,2001,062900,16,15,1,0
1,2002,062900,14,14,0,5
2,2002,062900,8,8,0,3
3,2002,062900,9,9,0,3
4,2002,062900,16,16,0,1
5,2002,062900,16,16,0,0
6,2002,062900,20,20,0,0
7,2002,062900,12,12,0,1
8,2002,062900,20,20,0,0
9,2002,062900,18,18,0,0
10,2002,062900,18,17,1,1
11,2002,062900,19,19,0,2
12,2002,062900,10,10,0,0
1,2003,062900,13,13,0,3
2,2003,062900,14,14,0,1
3,2003,062900,13,12,1,0
4,2003,062900,20,20,0,1
5,2003,062900,9,8,1,0
6,2003,062900,14,14,0,1
7,2003,062900,21,21,0,2
8,2003,062900,17,17,0,0
9,2003,062900,20,20,0,1
10,2003,062900,9,9,0,1
11,2003,062900,15,15,0,2
12,2003,062900,9,9,0,2
1,2004,062900,15,14,1,0
2,2004,062900,9,9,0,2
3,2004,062900,14,14,0,0
4,2004,062900,19,18,1,2
5,2004,062900,9,8,1,2
6,2004,062900,21,21,0,0
7,2004,062900,24,24,0,0
8,2004,062900,23,21,2,0
9,2004,062900,12,12,0,0
10,2004,062900,23,23,0,0
11,2004,062900,15,15,0,0
12,2004,062900,8,8,0,2
1,2005,062900,7,7,0,0
2,2005,062900,14,14,0,0
3,2005,062900,6,6,0,0
4,2005,062900,5,5,0,0
5,2005,062900,14,14,0,1
6,2005,062900,15,15,0,0
7,2005,062900,21,21,0,0
8,2005,062900,2,2,0,0
9,2005,062900,15,15,0,0
10,2005,062900,15,14,1,2
11,2005,062900,8,8,0,1
12,2005,062900,8,8,0,0
1,2006,062900,13,13,0,0
2,2006,062900,11,10,1,1
3,2006,062900,13,13,0,1
4,2006,062900,12,12,0,4
5,2006,062900,10,9,1,1
6,2006,062900,14,14,0,0
7,2006,062900,11,11,0,0
8,2006,062900,18,17,1,2
9,2006,062900,14,14,0,1
10,2006,062900,7,6,1,2
11,2006,062900,15,14,1,2
12,2006,062900,15,15,0,0
1,2007,062900,14,13,1,0
2,2007,062900,6,6,0,0
3,2007,062900,10,10,0,0
4,2007,062900,15,14,1,2
5,2007,062900,12,11,1,0
6,2007,062900,18,18,0,0
7,2007,062900,26,26,0,0
8,2007,062900,13,12,1,1
9,2007,062900,13,13,0,0
10,2007,062900,23,23,0,2
11,2007,062900,15,15,0,1
12,2007,062900,17,16,1,2
1,2008,062900,15,15,0,0
2,2008,062900,12,12,0,0
3,2008,062900,13,13,0,0
4,2008,062900,14,14,0,1
5,2008,062900,8,8,0,0
6,2008,062900,8,7,1,0
7,2008,062900,16,16,0,1
8,2008,062900,18,17,1,0
9,2008,062900,15,15,0,0
10,2008,062900,21,19,2,0
11,2008,062900,12,12,0,1
12,2008,062900,10,9,1,0
1,2009,062900,9,9,0,0
2,2009,062900,11,11,0,0
3,2009,062900,14,14,0,1
4,2009,062900,11,11,0,0
5,2009,062900,17,17,0,1
6,2009,062900,16,16,0,0
7,2009,062900,22,22,0,1
8,2009,062900,28,28,0,1
9,2009,062900,14,14,0,0
10,2009,062900,10,10,0,0
11,2009,062900,9,9,0,2
12,2009,062900,8,8,0,1
1,2010,062900,15,13,2,0
2,2010,062900,9,9,0,2
3,2010,062900,9,9,0,0
4,2010,062900,9,9,0,0
5,2010,062900,18,18,0,2
6,2010,062900,15,15,0,1
7,2010,062900,21,17,4,0
8,2010,062900,20,19,1,0
9,2010,062900,13,12,1,2
10,2010,062900,16,16,0,0
11,2010,062900,5,5,0,0
12,2010,062900,7,7,0,0
1,2011,062900,18,17,1,0
2,2011,062900,2,2,0,0
1,1999,190401,15,12,3,2
2,1999,190401,13,12,1,1
3,1999,190401,17,15,2,0
4,1999,190401,20,19,1,3
5,1999,190401,15,15,0,0
6,1999,190401,7,7,0,1
7,1999,190401,14,13,1,0
8,1999,190401,14,14,0,1
9,1999,190401,11,11,0,1
10,1999,190401,15,15,0,0
11,1999,190401,16,15,1,1
12,1999,190401,9,9,0,2
1,2000,190401,9,8,1,1
2,2000,190401,17,15,2,3
3,2000,190401,10,10,0,3
4,2000,190401,8,7,1,3
5,2000,190401,25,21,4,3
6,2000,190401,10,10,0,0
7,2000,190401,8,7,1,0
8,2000,190401,9,9,0,1
9,2000,190401,14,11,3,3
10,2000,190401,21,20,1,1
11,2000,190401,19,18,1,0
12,2000,190401,9,8,1,3
1,2001,190401,10,10,0,3
2,2001,190401,5,4,1,2
3,2001,190401,9,8,1,4
4,2001,190401,7,6,1,4
5,2001,190401,10,9,1,1
6,2001,190401,12,12,0,1
7,2001,190401,14,14,0,1
8,2001,190401,11,11,0,1
9,2001,190401,10,9,1,1
10,2001,190401,21,20,1,3
11,2001,190401,14,14,0,4
12,2001,190401,5,4,1,7
1,2002,190401,10,8,2,2
2,2002,190401,18,15,3,2
3,2002,190401,9,7,2,2
4,2002,190401,14,12,2,0
5,2002,190401,14,13,1,2
6,2002,190401,7,6,1,1
7,2002,190401,15,15,0,1
8,2002,190401,16,14,2,1
9,2002,190401,30,26,4,4
10,2002,190401,22,20,2,2
11,2002,190401,13,11,2,3
12,2002,190401,18,18,0,2
1,2003,190401,13,13,0,2
2,2003,190401,12,12,0,2
3,2003,190401,24,22,2,7
4,2003,190401,11,11,0,1
5,2003,190401,17,15,2,6
6,2003,190401,7,6,1,3
7,2003,190401,13,12,1,0
8,2003,190401,10,8,2,3
9,2003,190401,17,17,0,4
10,2003,190401,20,18,2,2
11,2003,190401,16,14,2,5
12,2003,190401,16,15,1,3
1,2004,190401,15,12,3,0
2,2004,190401,17,15,2,0
3,2004,190401,11,11,0,3
4,2004,190401,9,8,1,3
5,2004,190401,14,13,1,0
6,2004,190401,14,12,2,4
7,2004,190401,13,12,1,0
8,2004,190401,8,7,1,1
9,2004,190401,13,13,0,1
10,2004,190401,13,13,0,3
11,2004,190401,11,11,0,1
12,2004,190401,11,11,0,1
1,2005,190401,11,10,1,2
2,2005,190401,14,13,1,0
3,2005,190401,14,11,3,1
4,2005,190401,17,13,4,1
5,2005,190401,14,12,2,1
6,2005,190401,15,13,2,0
7,2005,190401,13,12,1,1
8,2005,190401,5,5,0,2
9,2005,190401,13,13,0,1
10,2005,190401,26,25,1,0
11,2005,190401,12,10,2,0
12,2005,190401,18,18,0,2
1,2006,190401,21,19,2,0
2,2006,190401,14,14,0,0
3,2006,190401,11,11,0,2
4,2006,190401,10,10,0,2
5,2006,190401,14,13,1,3
6,2006,190401,15,14,1,0
7,2006,190401,8,7,1,0
8,2006,190401,7,6,1,3
9,2006,190401,13,11,2,3
10,2006,190401,17,15,2,3
11,2006,190401,13,11,2,2
12,2006,190401,14,13,1,2
1,2007,190401,15,14,1,1
2,2007,190401,15,15,0,1
3,2007,190401,10,8,2,1
4,2007,190401,10,9,1,3
5,2007,190401,20,18,2,1
6,2007,190401,9,9,0,0
7,2007,190401,17,15,2,0
8,2007,190401,8,8,0,0
9,2007,190401,13,11,2,3
10,2007,190401,12,10,2,2
11,2007,190401,15,13,2,2
12,2007,190401,14,13,1,1
1,2008,190401,10,10,0,4
2,2008,190401,8,8,0,4
3,2008,190401,9,9,0,2
4,2008,190401,15,15,0,1
5,2008,190401,15,14,1,2
6,2008,190401,6,6,0,0
7,2008,190401,7,7,0,0
8,2008,190401,7,7,0,0
9,2008,190401,27,23,4,3
10,2008,190401,17,12,5,0
11,2008,190401,18,18,0,0
12,2008,190401,15,14,1,1
1,2009,190401,20,20,0,2
2,2009,190401,12,10,2,0
3,2009,190401,9,7,2,2
4,2009,190401,15,14,1,3
5,2009,190401,14,13,1,2
6,2009,190401,16,16,0,1
7,2009,190401,15,13,2,1
8,2009,190401,14,13,1,2
9,2009,190401,12,12,0,3
10,2009,190401,15,15,0,3
11,2009,190401,14,14,0,1
12,2009,190401,13,10,3,1
1,2010,190401,11,11,0,4
2,2010,190401,9,9,0,4
3,2010,190401,20,16,4,4
4,2010,190401,12,9,3,2
5,2010,190401,15,15,0,2
6,2010,190401,7,6,1,0
7,2010,190401,8,7,1,1
8,2010,190401,12,12,0,0
9,2010,190401,8,7,1,4
10,2010,190401,13,12,1,1
11,2010,190401,13,12,1,7
12,2010,190401,15,15,0,4
1,2011,190401,9,8,1,5
2,2011,190401,11,11,0,1
1,1999,210502,28,28,0,0
2,1999,210502,22,20,2,0
3,1999,210502,22,21,1,1
4,1999,210502,28,26,2,2
5,1999,210502,40,34,6,2
6,1999,210502,22,18,4,0
7,1999,210502,34,30,4,0
8,1999,210502,36,30,6,2
9,1999,210502,26,23,3,2
10,1999,210502,23,20,3,1
11,1999,210502,19,16,3,0
12,1999,210502,28,26,2,0
1,2000,210502,20,18,2,4
2,2000,210502,24,22,2,2
3,2000,210502,20,19,1,0
4,2000,210502,21,18,3,2
5,2000,210502,24,22,2,2
6,2000,210502,30,27,3,0
7,2000,210502,27,26,1,2
8,2000,210502,28,26,2,6
9,2000,210502,29,27,2,2
10,2000,210502,42,40,2,4
11,2000,210502,34,31,3,2
12,2000,210502,36,35,1,0
1,2001,210502,33,29,4,1
2,2001,210502,19,18,1,0
3,2001,210502,28,27,1,1
4,2001,210502,34,30,4,2
5,2001,210502,30,24,6,1
6,2001,210502,24,22,2,1
7,2001,210502,32,32,0,1
8,2001,210502,36,28,8,2
9,2001,210502,32,31,1,0
10,2001,210502,38,31,7,2
11,2001,210502,18,18,0,0
12,2001,210502,29,28,1,1
1,2002,210502,25,24,1,2
2,2002,210502,20,19,1,2
3,2002,210502,28,25,3,1
4,2002,210502,26,21,5,7
5,2002,210502,23,23,0,3
6,2002,210502,25,19,6,3
7,2002,210502,29,28,1,4
8,2002,210502,30,25,5,1
9,2002,210502,29,25,4,1
10,2002,210502,36,34,2,4
11,2002,210502,33,27,6,1
12,2002,210502,35,27,8,8
1,2003,210502,25,24,1,1
2,2003,210502,17,16,1,2
3,2003,210502,36,34,2,1
4,2003,210502,20,19,1,1
5,2003,210502,20,18,2,1
6,2003,210502,24,20,4,0
7,2003,210502,43,38,5,3
8,2003,210502,22,22,0,4
9,2003,210502,38,36,2,2
10,2003,210502,34,27,7,0
11,2003,210502,24,23,1,1
12,2003,210502,26,19,7,0
1,2004,210502,29,27,2,4
2,2004,210502,23,21,2,4
3,2004,210502,22,21,1,6
4,2004,210502,28,26,2,1
5,2004,210502,30,27,3,1
6,2004,210502,26,24,2,1
7,2004,210502,26,24,2,3
8,2004,210502,32,29,3,3
9,2004,210502,21,21,0,1
10,2004,210502,23,21,2,0
11,2004,210502,23,23,0,2
12,2004,210502,26,23,3,3
1,2005,210502,27,27,0,3
2,2005,210502,11,11,0,1
3,2005,210502,24,20,4,0
4,2005,210502,14,9,5,2
5,2005,210502,18,17,1,2
6,2005,210502,19,16,3,4
7,2005,210502,19,18,1,5
8,2005,210502,25,22,3,3
9,2005,210502,21,17,4,10
10,2005,210502,17,14,3,5
11,2005,210502,18,16,2,1
12,2005,210502,22,21,1,1
1,2006,210502,26,26,0,1
2,2006,210502,8,7,1,1
3,2006,210502,15,13,2,0
4,2006,210502,5,4,1,0
5,2006,210502,17,14,3,3
6,2006,210502,20,19,1,8
7,2006,210502,29,29,0,4
8,2006,210502,20,18,2,3
9,2006,210502,19,18,1,4
10,2006,210502,21,20,1,2
11,2006,210502,14,11,3,2
12,2006,210502,14,13,1,0
1,2007,210502,13,11,2,6
2,2007,210502,8,8,0,1
3,2007,210502,21,16,5,2
4,2007,210502,15,15,0,4
5,2007,210502,19,15,4,4
6,2007,210502,17,12,5,3
7,2007,210502,18,15,3,4
8,2007,210502,36,33,3,7
9,2007,210502,16,14,2,5
10,2007,210502,26,24,2,4
11,2007,210502,21,21,0,2
12,2007,210502,27,25,2,2
1,2008,210502,18,16,2,5
2,2008,210502,20,17,3,1
3,2008,210502,11,11,0,1
4,2008,210502,16,15,1,3
5,2008,210502,23,20,3,1
6,2008,210502,17,16,1,1
7,2008,210502,19,17,2,2
8,2008,210502,22,20,2,4
9,2008,210502,16,14,2,3
10,2008,210502,10,8,2,1
11,2008,210502,26,26,0,0
12,2008,210502,14,13,1,0
1,2009,210502,9,7,2,3
2,2009,210502,15,10,5,3
3,2009,210502,13,13,0,0
4,2009,210502,15,13,2,6
5,2009,210502,13,11,2,2
6,2009,210502,20,17,3,1
7,2009,210502,11,9,2,3
8,2009,210502,10,9,1,0
9,2009,210502,16,14,2,4
10,2009,210502,18,16,2,4
11,2009,210502,19,18,1,1
12,2009,210502,27,23,4,6
1,2010,210502,8,5,3,2
2,2010,210502,11,8,3,0
3,2010,210502,16,16,0,2
4,2010,210502,10,9,1,2
5,2010,210502,14,14,0,3
6,2010,210502,15,14,1,1
7,2010,210502,9,9,0,1
8,2010,210502,16,16,0,2
9,2010,210502,18,17,1,3
10,2010,210502,19,17,2,5
11,2010,210502,28,27,1,5
12,2010,210502,13,13,0,1
1,2011,210502,25,23,2,2
2,2011,210502,8,7,1,0
1,1999,063000,23,23,0,1
2,1999,063000,30,30,0,0
3,1999,063000,26,26,0,0
4,1999,063000,28,28,0,1
5,1999,063000,29,29,0,1
6,1999,063000,47,47,0,0
7,1999,063000,36,35,1,0
8,1999,063000,32,32,0,2
9,1999,063000,38,38,0,1
10,1999,063000,28,28,0,2
11,1999,063000,32,32,0,1
12,1999,063000,29,29,0,0
1,2000,063000,20,20,0,0
2,2000,063000,30,29,1,4
3,2000,063000,39,39,0,0
4,2000,063000,32,31,1,0
5,2000,063000,42,42,0,2
6,2000,063000,49,48,1,1
7,2000,063000,48,46,2,0
8,2000,063000,44,43,1,1
9,2000,063000,50,49,1,3
10,2000,063000,50,47,3,1
11,2000,063000,27,27,0,3
12,2000,063000,30,27,3,0
1,2001,063000,22,22,0,1
2,2001,063000,36,35,1,3
3,2001,063000,29,29,0,0
4,2001,063000,30,30,0,0
5,2001,063000,27,26,1,3
6,2001,063000,20,19,1,1
7,2001,063000,38,37,1,1
8,2001,063000,36,36,0,1
9,2001,063000,27,27,0,0
10,2001,063000,40,40,0,2
11,2001,063000,39,39,0,1
12,2001,063000,24,24,0,1
1,2002,063000,27,26,1,0
2,2002,063000,33,32,1,0
3,2002,063000,26,25,1,3
4,2002,063000,42,42,0,2
5,2002,063000,36,36,0,2
6,2002,063000,32,32,0,0
7,2002,063000,41,41,0,1
8,2002,063000,33,33,0,2
9,2002,063000,31,27,4,0
10,2002,063000,49,47,2,0
11,2002,063000,31,31,0,0
12,2002,063000,29,28,1,0
1,2003,063000,27,27,0,0
2,2003,063000,26,25,1,0
3,2003,063000,37,37,0,1
4,2003,063000,38,38,0,0
5,2003,063000,44,44,0,0
6,2003,063000,27,26,1,0
7,2003,063000,25,23,2,3
8,2003,063000,34,33,1,1
9,2003,063000,26,26,0,0
10,2003,063000,28,28,0,0
11,2003,063000,25,24,1,1
12,2003,063000,44,44,0,0
1,2004,063000,24,23,1,1
2,2004,063000,25,23,2,1
3,2004,063000,26,26,0,1
4,2004,063000,35,35,0,2
5,2004,063000,27,26,1,0
6,2004,063000,40,39,1,1
7,2004,063000,38,36,2,0
8,2004,063000,51,50,1,2
9,2004,063000,33,32,1,0
10,2004,063000,29,29,0,1
11,2004,063000,23,23,0,2
12,2004,063000,13,13,0,1
1,2005,063000,19,19,0,0
2,2005,063000,23,23,0,0
3,2005,063000,22,22,0,0
4,2005,063000,28,27,1,0
5,2005,063000,26,26,0,1
6,2005,063000,26,26,0,2
7,2005,063000,23,23,0,3
8,2005,063000,25,24,1,2
9,2005,063000,30,28,2,0
10,2005,063000,26,25,1,0
11,2005,063000,20,19,1,1
12,2005,063000,27,27,0,0
1,2006,063000,24,24,0,2
2,2006,063000,9,9,0,0
3,2006,063000,28,28,0,1
4,2006,063000,22,22,0,2
5,2006,063000,18,17,1,2
6,2006,063000,15,15,0,0
7,2006,063000,22,22,0,2
8,2006,063000,19,18,1,1
9,2006,063000,18,18,0,0
10,2006,063000,16,16,0,1
11,2006,063000,23,22,1,0
12,2006,063000,15,15,0,1
1,2007,063000,31,31,0,1
2,2007,063000,19,19,0,0
3,2007,063000,16,16,0,3
4,2007,063000,17,16,1,0
5,2007,063000,35,33,2,0
6,2007,063000,30,30,0,0
7,2007,063000,25,24,1,4
8,2007,063000,33,31,2,2
9,2007,063000,29,28,1,2
10,2007,063000,21,21,0,1
11,2007,063000,23,23,0,0
12,2007,063000,22,21,1,0
1,2008,063000,32,32,0,0
2,2008,063000,24,23,1,0
3,2008,063000,26,25,1,0
4,2008,063000,22,21,1,2
5,2008,063000,30,28,2,0
6,2008,063000,17,16,1,0
7,2008,063000,22,22,0,1
8,2008,063000,33,30,3,0
9,2008,063000,28,27,1,0
10,2008,063000,26,26,0,1
11,2008,063000,30,29,1,0
12,2008,063000,23,23,0,0
1,2009,063000,26,25,1,0
2,2009,063000,20,19,1,0
3,2009,063000,17,16,1,1
4,2009,063000,23,23,0,0
5,2009,063000,23,23,0,0
6,2009,063000,18,18,0,2
7,2009,063000,19,19,0,0
8,2009,063000,41,41,0,1
9,2009,063000,17,16,1,1
10,2009,063000,33,33,0,1
11,2009,063000,25,25,0,0
12,2009,063000,18,18,0,3
1,2010,063000,16,15,1,0
2,2010,063000,13,12,1,0
3,2010,063000,14,14,0,0
4,2010,063000,11,11,0,1
5,2010,063000,29,27,2,1
6,2010,063000,30,30,0,0
7,2010,063000,35,34,1,0
8,2010,063000,24,22,2,0
9,2010,063000,18,18,0,3
10,2010,063000,26,25,1,4
11,2010,063000,22,22,0,1
12,2010,063000,19,18,1,0
1,2011,063000,22,21,1,1
2,2011,063000,12,12,0,2
1,1999,190402,14,13,1,1
2,1999,190402,11,9,2,1
3,1999,190402,18,15,3,1
4,1999,190402,18,15,3,0
5,1999,190402,29,25,4,0
6,1999,190402,17,14,3,0
7,1999,190402,11,9,2,0
8,1999,190402,11,11,0,0
9,1999,190402,18,15,3,1
10,1999,190402,26,24,2,1
11,1999,190402,15,15,0,1
12,1999,190402,27,25,2,2
1,2000,190402,31,29,2,1
2,2000,190402,12,11,1,1
3,2000,190402,18,17,1,0
4,2000,190402,26,25,1,2
5,2000,190402,19,19,0,1
6,2000,190402,30,29,1,0
7,2000,190402,37,32,5,2
8,2000,190402,20,19,1,0
9,2000,190402,23,23,0,2
10,2000,190402,27,27,0,0
11,2000,190402,15,15,0,1
12,2000,190402,13,12,1,1
1,2001,190402,23,22,1,1
2,2001,190402,15,14,1,3
3,2001,190402,21,18,3,2
4,2001,190402,15,15,0,1
5,2001,190402,15,14,1,2
6,2001,190402,23,22,1,0
7,2001,190402,23,20,3,2
8,2001,190402,17,13,4,1
9,2001,190402,15,13,2,0
10,2001,190402,22,20,2,1
11,2001,190402,19,19,0,0
12,2001,190402,14,14,0,1
1,2002,190402,12,11,1,0
2,2002,190402,17,17,0,0
3,2002,190402,18,17,1,0
4,2002,190402,17,16,1,2
5,2002,190402,17,17,0,1
6,2002,190402,17,17,0,1
7,2002,190402,15,13,2,1
8,2002,190402,21,21,0,0
9,2002,190402,19,19,0,0
10,2002,190402,40,39,1,2
11,2002,190402,17,16,1,0
12,2002,190402,18,18,0,1
1,2003,190402,11,11,0,0
2,2003,190402,13,12,1,2
3,2003,190402,25,25,0,0
4,2003,190402,10,9,1,1
5,2003,190402,15,15,0,0
6,2003,190402,22,22,0,3
7,2003,190402,18,17,1,1
8,2003,190402,19,18,1,0
9,2003,190402,13,13,0,2
10,2003,190402,20,19,1,1
11,2003,190402,17,15,2,1
12,2003,190402,18,14,4,1
1,2004,190402,15,15,0,1
2,2004,190402,7,7,0,2
3,2004,190402,19,18,1,1
4,2004,190402,13,13,0,0
5,2004,190402,16,15,1,1
6,2004,190402,13,13,0,1
7,2004,190402,14,11,3,0
8,2004,190402,12,8,4,2
9,2004,190402,15,14,1,1
10,2004,190402,20,19,1,0
11,2004,190402,19,17,2,0
12,2004,190402,18,18,0,1
1,2005,190402,7,7,0,0
2,2005,190402,17,16,1,3
3,2005,190402,14,14,0,1
4,2005,190402,10,9,1,3
5,2005,190402,19,14,5,1
6,2005,190402,7,6,1,1
7,2005,190402,22,21,1,3
8,2005,190402,16,15,1,2
9,2005,190402,24,24,0,0
10,2005,190402,25,23,2,3
11,2005,190402,17,15,2,2
12,2005,190402,15,12,3,0
1,2006,190402,18,17,1,3
2,2006,190402,9,9,0,2
3,2006,190402,13,12,1,1
4,2006,190402,7,7,0,2
5,2006,190402,14,14,0,1
6,2006,190402,9,9,0,0
7,2006,190402,7,5,2,2
8,2006,190402,14,14,0,3
9,2006,190402,9,8,1,0
10,2006,190402,12,11,1,1
11,2006,190402,14,14,0,1
12,2006,190402,13,13,0,2
1,2007,190402,14,14,0,1
2,2007,190402,10,6,4,1
3,2007,190402,16,14,2,6
4,2007,190402,17,17,0,2
5,2007,190402,15,14,1,0
6,2007,190402,11,11,0,3
7,2007,190402,12,11,1,3
8,2007,190402,11,10,1,0
9,2007,190402,14,12,2,2
10,2007,190402,8,7,1,0
11,2007,190402,6,5,1,3
12,2007,190402,15,14,1,2
1,2008,190402,12,12,0,1
2,2008,190402,11,9,2,0
3,2008,190402,7,6,1,1
4,2008,190402,17,16,1,0
5,2008,190402,21,21,0,1
6,2008,190402,12,11,1,3
7,2008,190402,22,21,1,2
8,2008,190402,26,23,3,2
9,2008,190402,10,10,0,1
10,2008,190402,9,9,0,2
11,2008,190402,15,13,2,2
12,2008,190402,13,11,2,0
1,2009,190402,15,13,2,1
2,2009,190402,13,12,1,3
3,2009,190402,13,12,1,2
4,2009,190402,17,16,1,0
5,2009,190402,15,14,1,1
6,2009,190402,14,13,1,2
7,2009,190402,16,13,3,2
8,2009,190402,21,20,1,6
9,2009,190402,17,14,3,0
10,2009,190402,15,14,1,2
11,2009,190402,15,14,1,3
12,2009,190402,19,19,0,0
1,2010,190402,14,13,1,4
2,2010,190402,10,9,1,3
3,2010,190402,12,12,0,5
4,2010,190402,12,10,2,1
5,2010,190402,6,6,0,2
6,2010,190402,12,11,1,1
7,2010,190402,10,10,0,2
8,2010,190402,13,12,1,0
9,2010,190402,19,15,4,1
10,2010,190402,12,10,2,2
11,2010,190402,7,7,0,2
12,2010,190402,21,21,0,1
1,2011,190402,8,8,0,0
2,2011,190402,8,6,2,0
1,1999,063400,12,12,0,0
2,1999,063400,15,15,0,0
3,1999,063400,29,29,0,0
4,1999,063400,23,23,0,1
5,1999,063400,34,34,0,1
6,1999,063400,32,31,1,0
7,1999,063400,43,43,0,1
8,1999,063400,33,33,0,0
9,1999,063400,35,35,0,0
10,1999,063400,36,35,1,1
11,1999,063400,18,18,0,3
12,1999,063400,18,17,1,0
1,2000,063400,20,19,1,0
2,2000,063400,9,9,0,0
3,2000,063400,21,21,0,1
4,2000,063400,22,21,1,0
5,2000,063400,27,27,0,1
6,2000,063400,32,31,1,0
7,2000,063400,39,39,0,2
8,2000,063400,43,43,0,0
9,2000,063400,35,34,1,0
10,2000,063400,32,32,0,1
11,2000,063400,28,25,3,1
12,2000,063400,17,17,0,0
1,2001,063400,22,22,0,0
2,2001,063400,15,15,0,0
3,2001,063400,27,27,0,0
4,2001,063400,18,18,0,0
5,2001,063400,34,34,0,0
6,2001,063400,24,23,1,0
7,2001,063400,23,22,1,0
8,2001,063400,19,19,0,0
9,2001,063400,21,21,0,0
10,2001,063400,30,29,1,0
11,2001,063400,33,33,0,0
12,2001,063400,23,23,0,1
1,2002,063400,17,16,1,0
2,2002,063400,16,16,0,1
3,2002,063400,13,12,1,0
4,2002,063400,19,19,0,0
5,2002,063400,33,33,0,0
6,2002,063400,22,22,0,0
7,2002,063400,33,33,0,2
8,2002,063400,24,23,1,2
9,2002,063400,26,26,0,0
10,2002,063400,14,14,0,0
11,2002,063400,25,25,0,0
12,2002,063400,14,14,0,4
1,2003,063400,21,21,0,0
2,2003,063400,16,16,0,0
3,2003,063400,9,8,1,0
4,2003,063400,21,21,0,1
5,2003,063400,17,17,0,1
6,2003,063400,28,28,0,0
7,2003,063400,24,24,0,0
8,2003,063400,23,21,2,0
9,2003,063400,33,33,0,0
10,2003,063400,18,17,1,0
11,2003,063400,19,19,0,0
12,2003,063400,16,15,1,0
1,2004,063400,23,23,0,0
2,2004,063400,14,13,1,0
3,2004,063400,19,17,2,0
4,2004,063400,17,17,0,0
5,2004,063400,36,36,0,0
6,2004,063400,18,18,0,0
7,2004,063400,33,33,0,0
8,2004,063400,31,31,0,0
9,2004,063400,21,20,1,1
10,2004,063400,20,19,1,0
11,2004,063400,21,20,1,1
12,2004,063400,18,17,1,0
1,2005,063400,16,16,0,0
2,2005,063400,9,9,0,1
3,2005,063400,12,12,0,3
4,2005,063400,19,19,0,0
5,2005,063400,16,16,0,0
6,2005,063400,15,15,0,1
7,2005,063400,18,18,0,0
8,2005,063400,17,17,0,0
9,2005,063400,22,20,2,0
10,2005,063400,14,12,2,0
11,2005,063400,15,15,0,2
12,2005,063400,16,16,0,0
1,2006,063400,12,11,1,1
2,2006,063400,16,16,0,0
3,2006,063400,17,15,2,0
4,2006,063400,13,13,0,0
5,2006,063400,22,21,1,0
6,2006,063400,21,21,0,0
7,2006,063400,24,22,2,0
8,2006,063400,19,19,0,1
9,2006,063400,16,16,0,0
10,2006,063400,23,23,0,0
11,2006,063400,15,15,0,1
12,2006,063400,21,20,1,0
1,2007,063400,21,21,0,1
2,2007,063400,12,12,0,0
3,2007,063400,18,18,0,0
4,2007,063400,13,13,0,0
5,2007,063400,15,14,1,0
6,2007,063400,20,20,0,0
7,2007,063400,19,19,0,0
8,2007,063400,15,15,0,0
9,2007,063400,23,23,0,0
10,2007,063400,22,22,0,0
11,2007,063400,12,12,0,0
12,2007,063400,21,20,1,0
1,2008,063400,12,12,0,0
2,2008,063400,13,13,0,0
3,2008,063400,9,7,2,0
4,2008,063400,18,17,1,0
5,2008,063400,18,18,0,0
6,2008,063400,23,23,0,0
7,2008,063400,17,17,0,2
8,2008,063400,16,15,1,0
9,2008,063400,17,16,1,0
10,2008,063400,14,14,0,0
11,2008,063400,9,9,0,0
12,2008,063400,10,10,0,0
1,2009,063400,17,17,0,0
2,2009,063400,10,10,0,0
3,2009,063400,11,11,0,0
4,2009,063400,15,15,0,0
5,2009,063400,19,19,0,0
6,2009,063400,14,14,0,0
7,2009,063400,31,31,0,0
8,2009,063400,20,20,0,0
9,2009,063400,15,15,0,0
10,2009,063400,9,9,0,0
11,2009,063400,19,19,0,0
12,2009,063400,10,10,0,0
1,2010,063400,11,11,0,0
2,2010,063400,5,5,0,0
3,2010,063400,10,9,1,0
4,2010,063400,12,12,0,0
5,2010,063400,23,22,1,0
6,2010,063400,19,18,1,0
7,2010,063400,11,11,0,0
8,2010,063400,8,8,0,0
9,2010,063400,13,13,0,0
10,2010,063400,13,13,0,0
11,2010,063400,12,11,1,0
12,2010,063400,12,12,0,1
1,2011,063400,9,9,0,0
2,2011,063400,6,5,1,0
1,1999,063301,4,4,0,0
2,1999,063301,1,1,0,0
3,1999,063301,6,5,1,0
4,1999,063301,7,7,0,0
5,1999,063301,3,3,0,1
6,1999,063301,8,8,0,0
7,1999,063301,10,10,0,0
8,1999,063301,6,5,1,1
9,1999,063301,6,6,0,0
10,1999,063301,6,6,0,1
11,1999,063301,7,7,0,0
12,1999,063301,9,9,0,0
1,2000,063301,7,5,2,0
2,2000,063301,4,4,0,2
3,2000,063301,4,4,0,0
4,2000,063301,13,11,2,0
5,2000,063301,7,7,0,0
6,2000,063301,10,10,0,0
7,2000,063301,8,8,0,0
8,2000,063301,12,12,0,1
9,2000,063301,9,9,0,0
10,2000,063301,8,8,0,1
11,2000,063301,13,13,0,0
12,2000,063301,3,3,0,0
1,2001,063301,14,14,0,0
2,2001,063301,1,1,0,0
3,2001,063301,8,7,1,0
4,2001,063301,7,7,0,0
5,2001,063301,13,12,1,0
6,2001,063301,12,12,0,0
7,2001,063301,1,1,0,0
8,2001,063301,7,7,0,0
9,2001,063301,6,5,1,0
10,2001,063301,11,11,0,0
11,2001,063301,6,6,0,0
12,2001,063301,5,5,0,0
1,2002,063301,9,9,0,0
2,2002,063301,4,4,0,0
3,2002,063301,2,2,0,0
4,2002,063301,6,6,0,1
5,2002,063301,5,5,0,0
6,2002,063301,5,5,0,1
7,2002,063301,13,12,1,0
8,2002,063301,16,15,1,1
9,2002,063301,6,6,0,0
10,2002,063301,13,13,0,0
11,2002,063301,4,4,0,0
12,2002,063301,7,6,1,0
1,2003,063301,9,8,1,0
2,2003,063301,6,6,0,0
3,2003,063301,14,14,0,0
4,2003,063301,10,10,0,0
5,2003,063301,9,9,0,0
6,2003,063301,11,11,0,0
7,2003,063301,6,6,0,1
8,2003,063301,16,16,0,0
9,2003,063301,11,11,0,0
10,2003,063301,13,13,0,0
11,2003,063301,7,7,0,0
12,2003,063301,7,7,0,0
1,2004,063301,7,7,0,1
2,2004,063301,3,3,0,0
3,2004,063301,14,14,0,1
4,2004,063301,8,8,0,0
5,2004,063301,7,6,1,0
6,2004,063301,8,7,1,0
7,2004,063301,9,9,0,0
8,2004,063301,16,15,1,2
9,2004,063301,10,10,0,0
10,2004,063301,11,11,0,0
11,2004,063301,7,7,0,1
12,2004,063301,6,6,0,0
1,2005,063301,3,3,0,0
2,2005,063301,5,5,0,0
3,2005,063301,7,7,0,2
4,2005,063301,9,8,1,0
5,2005,063301,5,5,0,0
6,2005,063301,13,12,1,0
7,2005,063301,13,13,0,1
8,2005,063301,11,11,0,0
9,2005,063301,12,12,0,0
10,2005,063301,10,10,0,0
11,2005,063301,2,2,0,0
12,2005,063301,8,8,0,3
1,2006,063301,6,6,0,0
2,2006,063301,3,3,0,0
3,2006,063301,7,7,0,0
4,2006,063301,3,3,0,0
5,2006,063301,9,9,0,0
6,2006,063301,6,6,0,0
7,2006,063301,6,5,1,0
8,2006,063301,8,8,0,0
9,2006,063301,7,6,1,0
10,2006,063301,7,7,0,0
11,2006,063301,9,9,0,0
12,2006,063301,8,7,1,0
1,2007,063301,8,8,0,0
2,2007,063301,6,6,0,1
3,2007,063301,11,11,0,0
4,2007,063301,7,7,0,0
5,2007,063301,12,12,0,0
6,2007,063301,11,10,1,0
7,2007,063301,9,8,1,1
8,2007,063301,3,3,0,0
9,2007,063301,5,5,0,0
10,2007,063301,8,7,1,1
11,2007,063301,6,6,0,0
12,2007,063301,5,5,0,0
1,2008,063301,7,7,0,0
2,2008,063301,2,2,0,0
3,2008,063301,7,7,0,0
4,2008,063301,12,12,0,1
5,2008,063301,9,8,1,0
6,2008,063301,12,12,0,0
7,2008,063301,8,8,0,0
8,2008,063301,3,3,0,0
9,2008,063301,5,5,0,0
10,2008,063301,8,6,2,0
11,2008,063301,9,9,0,0
12,2008,063301,5,5,0,0
1,2009,063301,8,8,0,0
2,2009,063301,6,6,0,0
3,2009,063301,6,6,0,0
4,2009,063301,7,7,0,1
5,2009,063301,7,7,0,0
6,2009,063301,6,6,0,0
7,2009,063301,6,6,0,0
8,2009,063301,12,12,0,0
9,2009,063301,1,1,0,0
10,2009,063301,7,6,1,0
11,2009,063301,9,9,0,0
12,2009,063301,4,4,0,0
1,2010,063301,5,4,1,0
2,2010,063301,5,5,0,0
3,2010,063301,6,6,0,0
4,2010,063301,4,3,1,0
5,2010,063301,11,11,0,0
6,2010,063301,3,2,1,0
7,2010,063301,9,8,1,0
8,2010,063301,9,9,0,0
9,2010,063301,3,3,0,0
10,2010,063301,4,4,0,0
11,2010,063301,9,9,0,0
12,2010,063301,6,6,0,0
1,2011,063301,5,5,0,0
2,2011,063301,1,1,0,0
1,1999,063303,0,0,0,0
2,1999,063303,0,0,0,0
3,1999,063303,2,2,0,0
4,1999,063303,2,2,0,0
5,1999,063303,2,2,0,0
6,1999,063303,1,1,0,0
7,1999,063303,0,0,0,0
8,1999,063303,0,0,0,0
9,1999,063303,1,1,0,0
10,1999,063303,0,0,0,0
11,1999,063303,0,0,0,0
12,1999,063303,1,1,0,0
1,2000,063303,1,1,0,1
2,2000,063303,0,0,0,0
3,2000,063303,1,1,0,0
4,2000,063303,0,0,0,0
5,2000,063303,0,0,0,0
6,2000,063303,3,3,0,0
7,2000,063303,2,2,0,0
8,2000,063303,1,1,0,0
9,2000,063303,4,4,0,0
10,2000,063303,2,2,0,0
11,2000,063303,3,3,0,0
12,2000,063303,0,0,0,0
1,2001,063303,2,2,0,0
2,2001,063303,1,1,0,0
3,2001,063303,1,1,0,0
4,2001,063303,3,3,0,0
5,2001,063303,1,1,0,0
6,2001,063303,0,0,0,0
7,2001,063303,2,2,0,0
8,2001,063303,3,3,0,0
9,2001,063303,1,1,0,0
10,2001,063303,0,0,0,0
11,2001,063303,0,0,0,0
12,2001,063303,0,0,0,0
1,2002,063303,2,2,0,0
2,2002,063303,0,0,0,0
3,2002,063303,0,0,0,0
4,2002,063303,1,1,0,2
5,2002,063303,3,3,0,2
6,2002,063303,4,4,0,0
7,2002,063303,3,3,0,0
8,2002,063303,4,4,0,1
9,2002,063303,1,1,0,0
10,2002,063303,1,1,0,0
11,2002,063303,0,0,0,0
12,2002,063303,1,1,0,0
1,2003,063303,5,5,0,0
2,2003,063303,0,0,0,0
3,2003,063303,2,2,0,0
4,2003,063303,1,1,0,0
5,2003,063303,4,4,0,0
6,2003,063303,2,2,0,0
7,2003,063303,0,0,0,0
8,2003,063303,5,4,1,0
9,2003,063303,1,1,0,0
10,2003,063303,0,0,0,0
11,2003,063303,3,3,0,0
12,2003,063303,0,0,0,0
1,2004,063303,0,0,0,0
2,2004,063303,1,1,0,0
3,2004,063303,1,1,0,0
4,2004,063303,1,1,0,0
5,2004,063303,3,3,0,0
6,2004,063303,1,1,0,0
7,2004,063303,4,4,0,0
8,2004,063303,1,1,0,1
9,2004,063303,1,0,1,0
10,2004,063303,1,1,0,0
11,2004,063303,0,0,0,0
12,2004,063303,0,0,0,0
1,2005,063303,2,1,1,0
2,2005,063303,0,0,0,0
3,2005,063303,1,1,0,0
4,2005,063303,3,3,0,0
5,2005,063303,2,2,0,0
6,2005,063303,2,2,0,0
7,2005,063303,3,3,0,0
8,2005,063303,3,2,1,0
9,2005,063303,3,2,1,0
10,2005,063303,1,1,0,0
11,2005,063303,0,0,0,0
12,2005,063303,1,0,1,0
1,2006,063303,2,1,1,0
2,2006,063303,0,0,0,0
3,2006,063303,1,1,0,0
4,2006,063303,2,2,0,0
5,2006,063303,3,3,0,0
6,2006,063303,3,3,0,0
7,2006,063303,2,2,0,0
8,2006,063303,1,1,0,0
9,2006,063303,2,2,0,0
10,2006,063303,0,0,0,0
11,2006,063303,0,0,0,0
12,2006,063303,0,0,0,0
1,2007,063303,0,0,0,0
2,2007,063303,0,0,0,0
3,2007,063303,2,2,0,0
4,2007,063303,2,2,0,0
5,2007,063303,3,3,0,0
6,2007,063303,1,1,0,0
7,2007,063303,1,1,0,0
8,2007,063303,3,3,0,0
9,2007,063303,3,3,0,0
10,2007,063303,2,2,0,0
11,2007,063303,0,0,0,0
12,2007,063303,2,2,0,1
1,2008,063303,0,0,0,0
2,2008,063303,0,0,0,0
3,2008,063303,0,0,0,0
4,2008,063303,1,1,0,0
5,2008,063303,6,3,3,0
6,2008,063303,3,3,0,0
7,2008,063303,1,1,0,0
8,2008,063303,5,4,1,0
9,2008,063303,3,3,0,0
10,2008,063303,3,3,0,0
11,2008,063303,2,2,0,0
12,2008,063303,4,4,0,0
1,2009,063303,0,0,0,0
2,2009,063303,2,2,0,0
3,2009,063303,0,0,0,0
4,2009,063303,2,2,0,0
5,2009,063303,3,3,0,0
6,2009,063303,3,3,0,0
7,2009,063303,1,1,0,0
8,2009,063303,0,0,0,0
9,2009,063303,0,0,0,0
10,2009,063303,1,1,0,0
11,2009,063303,1,1,0,0
12,2009,063303,0,0,0,0
1,2010,063303,0,0,0,0
2,2010,063303,0,0,0,0
3,2010,063303,2,2,0,0
4,2010,063303,0,0,0,0
5,2010,063303,1,1,0,0
6,2010,063303,6,6,0,0
7,2010,063303,4,3,1,0
8,2010,063303,2,1,1,0
9,2010,063303,1,1,0,0
10,2010,063303,1,1,0,0
11,2010,063303,0,0,0,0
12,2010,063303,0,0,0,0
1,2011,063303,0,0,0,0
2,2011,063303,0,0,0,0
1,1999,063302,0,0,0,0
2,1999,063302,5,5,0,0
3,1999,063302,9,9,0,0
4,1999,063302,4,4,0,0
5,1999,063302,7,7,0,0
6,1999,063302,8,7,1,0
7,1999,063302,10,10,0,0
8,1999,063302,6,6,0,0
9,1999,063302,5,5,0,0
10,1999,063302,6,6,0,0
11,1999,063302,3,3,0,0
12,1999,063302,6,6,0,0
1,2000,063302,7,6,1,0
2,2000,063302,6,6,0,0
3,2000,063302,7,6,1,0
4,2000,063302,8,8,0,1
5,2000,063302,9,9,0,1
6,2000,063302,6,5,1,0
7,2000,063302,6,6,0,2
8,2000,063302,17,15,2,0
9,2000,063302,9,9,0,0
10,2000,063302,11,10,1,0
11,2000,063302,5,5,0,0
12,2000,063302,6,6,0,0
1,2001,063302,3,3,0,0
2,2001,063302,9,9,0,2
3,2001,063302,10,10,0,0
4,2001,063302,5,5,0,1
5,2001,063302,9,9,0,0
6,2001,063302,5,5,0,0
7,2001,063302,11,11,0,1
8,2001,063302,4,4,0,0
9,2001,063302,3,3,0,0
10,2001,063302,1,1,0,0
11,2001,063302,5,4,1,0
12,2001,063302,2,1,1,0
1,2002,063302,5,5,0,0
2,2002,063302,2,2,0,0
3,2002,063302,5,5,0,0
4,2002,063302,7,7,0,0
5,2002,063302,6,6,0,0
6,2002,063302,1,1,0,0
7,2002,063302,1,1,0,0
8,2002,063302,7,7,0,0
9,2002,063302,13,12,1,0
10,2002,063302,7,6,1,0
11,2002,063302,10,10,0,0
12,2002,063302,9,9,0,0
1,2003,063302,5,5,0,0
2,2003,063302,0,0,0,0
3,2003,063302,7,7,0,1
4,2003,063302,3,3,0,0
5,2003,063302,9,8,1,0
6,2003,063302,5,5,0,0
7,2003,063302,6,6,0,0
8,2003,063302,9,8,1,0
9,2003,063302,11,11,0,0
10,2003,063302,8,8,0,0
11,2003,063302,5,5,0,0
12,2003,063302,10,10,0,0
1,2004,063302,5,5,0,0
2,2004,063302,6,6,0,0
3,2004,063302,6,6,0,1
4,2004,063302,5,5,0,0
5,2004,063302,5,5,0,0
6,2004,063302,4,4,0,0
7,2004,063302,7,7,0,0
8,2004,063302,5,5,0,0
9,2004,063302,5,5,0,0
10,2004,063302,4,4,0,0
11,2004,063302,2,2,0,0
12,2004,063302,3,2,1,0
1,2005,063302,5,5,0,0
2,2005,063302,4,4,0,0
3,2005,063302,7,6,1,0
4,2005,063302,4,4,0,0
5,2005,063302,8,8,0,0
6,2005,063302,5,4,1,1
7,2005,063302,7,7,0,0
8,2005,063302,5,5,0,0
9,2005,063302,8,8,0,1
10,2005,063302,7,6,1,0
11,2005,063302,6,6,0,0
12,2005,063302,4,4,0,0
1,2006,063302,11,10,1,1
2,2006,063302,14,14,0,0
3,2006,063302,6,6,0,0
4,2006,063302,4,4,0,0
5,2006,063302,11,10,1,0
6,2006,063302,7,7,0,0
7,2006,063302,1,1,0,0
8,2006,063302,7,7,0,0
9,2006,063302,7,7,0,0
10,2006,063302,6,5,1,0
11,2006,063302,5,4,1,0
12,2006,063302,1,1,0,0
1,2007,063302,5,5,0,0
2,2007,063302,5,5,0,0
3,2007,063302,4,4,0,0
4,2007,063302,3,3,0,0
5,2007,063302,3,3,0,1
6,2007,063302,9,9,0,0
7,2007,063302,7,6,1,0
8,2007,063302,7,7,0,0
9,2007,063302,2,2,0,0
10,2007,063302,6,6,0,0
11,2007,063302,4,4,0,0
12,2007,063302,8,7,1,0
1,2008,063302,7,7,0,0
2,2008,063302,5,5,0,0
3,2008,063302,7,7,0,0
4,2008,063302,9,8,1,0
5,2008,063302,4,4,0,0
6,2008,063302,7,7,0,0
7,2008,063302,12,11,1,0
8,2008,063302,4,3,1,0
9,2008,063302,12,12,0,0
10,2008,063302,8,8,0,0
11,2008,063302,9,9,0,0
12,2008,063302,3,3,0,0
1,2009,063302,5,5,0,0
2,2009,063302,3,3,0,0
3,2009,063302,8,8,0,0
4,2009,063302,2,2,0,0
5,2009,063302,7,7,0,0
6,2009,063302,5,4,1,0
7,2009,063302,2,2,0,0
8,2009,063302,5,5,0,0
9,2009,063302,5,4,1,0
10,2009,063302,6,5,1,0
11,2009,063302,6,5,1,0
12,2009,063302,3,3,0,0
1,2010,063302,3,3,0,0
2,2010,063302,2,2,0,0
3,2010,063302,3,3,0,0
4,2010,063302,0,0,0,0
5,2010,063302,4,3,1,0
6,2010,063302,4,3,1,0
7,2010,063302,6,6,0,0
8,2010,063302,3,3,0,0
9,2010,063302,6,5,1,0
10,2010,063302,5,5,0,0
11,2010,063302,5,5,0,0
12,2010,063302,2,1,1,0
1,2011,063302,1,1,0,0
2,2011,063302,0,0,0,0
1,1999,200100,17,16,1,0
2,1999,200100,11,9,2,0
3,1999,200100,13,13,0,1
4,1999,200100,16,15,1,0
5,1999,200100,10,8,2,4
6,1999,200100,16,15,1,0
7,1999,200100,18,17,1,3
8,1999,200100,17,15,2,0
9,1999,200100,16,16,0,0
10,1999,200100,20,19,1,0
11,1999,200100,16,15,1,1
12,1999,200100,13,13,0,0
1,2000,200100,16,15,1,0
2,2000,200100,12,11,1,0
3,2000,200100,16,16,0,0
4,2000,200100,7,7,0,0
5,2000,200100,16,16,0,0
6,2000,200100,15,14,1,0
7,2000,200100,17,16,1,0
8,2000,200100,14,13,1,0
9,2000,200100,13,9,4,1
10,2000,200100,17,17,0,0
11,2000,200100,18,18,0,0
12,2000,200100,10,10,0,0
1,2001,200100,8,8,0,0
2,2001,200100,18,18,0,0
3,2001,200100,20,20,0,4
4,2001,200100,11,9,2,0
5,2001,200100,8,6,2,0
6,2001,200100,13,12,1,1
7,2001,200100,13,12,1,1
8,2001,200100,11,11,0,0
9,2001,200100,11,11,0,0
10,2001,200100,14,13,1,0
11,2001,200100,10,10,0,0
12,2001,200100,16,11,5,0
1,2002,200100,19,18,1,0
2,2002,200100,10,10,0,0
3,2002,200100,10,10,0,0
4,2002,200100,12,11,1,0
5,2002,200100,7,6,1,0
6,2002,200100,8,7,1,0
7,2002,200100,18,14,4,0
8,2002,200100,16,15,1,0
9,2002,200100,11,10,1,0
10,2002,200100,16,16,0,0
11,2002,200100,12,12,0,0
12,2002,200100,12,10,2,0
1,2003,200100,13,12,1,0
2,2003,200100,12,12,0,0
3,2003,200100,15,15,0,1
4,2003,200100,25,25,0,0
5,2003,200100,8,8,0,0
6,2003,200100,12,12,0,0
7,2003,200100,24,24,0,1
8,2003,200100,19,18,1,0
9,2003,200100,12,12,0,0
10,2003,200100,10,10,0,3
11,2003,200100,14,14,0,1
12,2003,200100,10,10,0,0
1,2004,200100,13,13,0,1
2,2004,200100,8,7,1,0
3,2004,200100,11,10,1,0
4,2004,200100,6,5,1,0
5,2004,200100,14,13,1,0
6,2004,200100,11,10,1,0
7,2004,200100,10,9,1,1
8,2004,200100,18,14,4,2
9,2004,200100,8,7,1,0
10,2004,200100,11,9,2,1
11,2004,200100,6,6,0,0
12,2004,200100,12,11,1,0
1,2005,200100,12,10,2,0
2,2005,200100,8,8,0,0
3,2005,200100,3,3,0,1
4,2005,200100,13,10,3,0
5,2005,200100,11,11,0,2
6,2005,200100,15,14,1,0
7,2005,200100,11,11,0,5
8,2005,200100,6,4,2,1
9,2005,200100,7,7,0,1
10,2005,200100,15,15,0,1
11,2005,200100,6,3,3,0
12,2005,200100,10,8,2,0
1,2006,200100,8,8,0,0
2,2006,200100,6,6,0,0
3,2006,200100,8,7,1,0
4,2006,200100,4,4,0,1
5,2006,200100,4,4,0,1
6,2006,200100,8,8,0,0
7,2006,200100,10,9,1,0
8,2006,200100,11,10,1,0
9,2006,200100,10,10,0,1
10,2006,200100,6,6,0,0
11,2006,200100,5,5,0,0
12,2006,200100,10,10,0,2
1,2007,200100,6,6,0,0
2,2007,200100,7,7,0,0
3,2007,200100,15,15,0,2
4,2007,200100,6,6,0,0
5,2007,200100,10,9,1,0
6,2007,200100,5,3,2,0
7,2007,200100,11,11,0,2
8,2007,200100,11,10,1,1
9,2007,200100,9,7,2,1
10,2007,200100,7,6,1,1
11,2007,200100,8,8,0,1
12,2007,200100,4,4,0,0
1,2008,200100,5,4,1,1
2,2008,200100,7,6,1,2
3,2008,200100,18,16,2,0
4,2008,200100,13,10,3,0
5,2008,200100,5,4,1,0
6,2008,200100,11,11,0,2
7,2008,200100,6,6,0,5
8,2008,200100,13,11,2,0
9,2008,200100,4,4,0,3
10,2008,200100,12,12,0,0
11,2008,200100,16,15,1,0
12,2008,200100,17,14,3,0
1,2009,200100,10,10,0,1
2,2009,200100,7,6,1,2
3,2009,200100,7,7,0,0
4,2009,200100,13,9,4,3
5,2009,200100,11,10,1,0
6,2009,200100,12,10,2,1
7,2009,200100,10,10,0,0
8,2009,200100,6,5,1,1
9,2009,200100,10,9,1,3
10,2009,200100,9,9,0,1
11,2009,200100,12,12,0,1
12,2009,200100,8,8,0,0
1,2010,200100,11,10,1,1
2,2010,200100,9,9,0,2
3,2010,200100,10,9,1,0
4,2010,200100,8,7,1,1
5,2010,200100,13,12,1,0
6,2010,200100,10,8,2,2
7,2010,200100,9,7,2,2
8,2010,200100,6,6,0,0
9,2010,200100,12,11,1,0
10,2010,200100,7,7,0,0
11,2010,200100,7,7,0,2
12,2010,200100,9,9,0,0
1,2011,200100,7,7,0,2
2,2011,200100,6,5,1,2
1,1999,210400,4,4,0,0
2,1999,210400,12,11,1,0
3,1999,210400,7,7,0,1
4,1999,210400,15,15,0,0
5,1999,210400,10,10,0,1
6,1999,210400,11,9,2,1
7,1999,210400,9,9,0,0
8,1999,210400,13,13,0,1
9,1999,210400,11,10,1,1
10,1999,210400,16,16,0,0
11,1999,210400,8,7,1,0
12,1999,210400,15,14,1,0
1,2000,210400,7,7,0,4
2,2000,210400,8,8,0,0
3,2000,210400,9,8,1,0
4,2000,210400,11,11,0,1
5,2000,210400,12,12,0,2
6,2000,210400,8,8,0,0
7,2000,210400,16,14,2,0
8,2000,210400,14,14,0,0
9,2000,210400,14,14,0,0
10,2000,210400,7,7,0,0
11,2000,210400,11,10,1,0
12,2000,210400,9,8,1,0
1,2001,210400,8,7,1,1
2,2001,210400,3,3,0,0
3,2001,210400,4,3,1,0
4,2001,210400,9,9,0,0
5,2001,210400,8,8,0,3
6,2001,210400,7,7,0,0
7,2001,210400,13,11,2,0
8,2001,210400,10,9,1,1
9,2001,210400,15,14,1,0
10,2001,210400,9,7,2,0
11,2001,210400,9,9,0,0
12,2001,210400,7,5,2,0
1,2002,210400,8,7,1,0
2,2002,210400,10,10,0,0
3,2002,210400,7,7,0,0
4,2002,210400,7,7,0,0
5,2002,210400,5,4,1,0
6,2002,210400,6,6,0,1
7,2002,210400,5,5,0,2
8,2002,210400,6,5,1,0
9,2002,210400,13,13,0,1
10,2002,210400,14,14,0,1
11,2002,210400,20,18,2,1
12,2002,210400,12,10,2,0
1,2003,210400,8,8,0,0
2,2003,210400,17,16,1,0
3,2003,210400,6,6,0,0
4,2003,210400,13,13,0,0
5,2003,210400,16,14,2,0
6,2003,210400,9,9,0,0
7,2003,210400,8,8,0,4
8,2003,210400,8,8,0,1
9,2003,210400,9,9,0,1
10,2003,210400,10,10,0,0
11,2003,210400,10,7,3,0
12,2003,210400,13,13,0,0
1,2004,210400,10,7,3,1
2,2004,210400,7,5,2,1
3,2004,210400,10,8,2,0
4,2004,210400,5,5,0,0
5,2004,210400,8,6,2,1
6,2004,210400,6,5,1,2
7,2004,210400,15,14,1,1
8,2004,210400,8,7,1,3
9,2004,210400,10,10,0,1
10,2004,210400,12,10,2,0
11,2004,210400,6,5,1,1
12,2004,210400,4,3,1,1
1,2005,210400,9,9,0,0
2,2005,210400,8,8,0,0
3,2005,210400,7,7,0,6
4,2005,210400,15,14,1,8
5,2005,210400,13,11,2,1
6,2005,210400,12,11,1,1
7,2005,210400,10,10,0,3
8,2005,210400,6,4,2,2
9,2005,210400,8,8,0,1
10,2005,210400,6,5,1,2
11,2005,210400,6,6,0,0
12,2005,210400,10,7,3,0
1,2006,210400,10,9,1,3
2,2006,210400,10,10,0,4
3,2006,210400,8,8,0,1
4,2006,210400,14,13,1,0
5,2006,210400,13,12,1,5
6,2006,210400,4,4,0,0
7,2006,210400,13,11,2,3
8,2006,210400,9,9,0,0
9,2006,210400,7,7,0,0
10,2006,210400,3,3,0,0
11,2006,210400,7,7,0,0
12,2006,210400,4,4,0,0
1,2007,210400,8,8,0,1
2,2007,210400,3,3,0,0
3,2007,210400,7,7,0,0
4,2007,210400,6,6,0,0
5,2007,210400,8,7,1,0
6,2007,210400,7,6,1,1
7,2007,210400,7,6,1,1
8,2007,210400,7,7,0,3
9,2007,210400,8,8,0,0
10,2007,210400,8,8,0,2
11,2007,210400,4,4,0,0
12,2007,210400,6,5,1,0
1,2008,210400,7,6,1,2
2,2008,210400,6,5,1,1
3,2008,210400,4,3,1,2
4,2008,210400,11,9,2,2
5,2008,210400,11,10,1,1
6,2008,210400,14,13,1,1
7,2008,210400,4,4,0,0
8,2008,210400,8,7,1,0
9,2008,210400,11,10,1,1
10,2008,210400,10,9,1,2
11,2008,210400,10,9,1,0
12,2008,210400,4,4,0,1
1,2009,210400,4,3,1,2
2,2009,210400,7,7,0,5
3,2009,210400,6,6,0,0
4,2009,210400,6,6,0,2
5,2009,210400,10,10,0,0
6,2009,210400,7,6,1,0
7,2009,210400,8,7,1,0
8,2009,210400,6,6,0,0
9,2009,210400,7,7,0,1
10,2009,210400,12,11,1,0
11,2009,210400,7,7,0,2
12,2009,210400,6,6,0,1
1,2010,210400,8,8,0,0
2,2010,210400,7,4,3,0
3,2010,210400,4,4,0,0
4,2010,210400,12,12,0,0
5,2010,210400,14,13,1,0
6,2010,210400,8,8,0,2
7,2010,210400,8,6,2,2
8,2010,210400,6,6,0,1
9,2010,210400,5,4,1,0
10,2010,210400,9,6,3,1
11,2010,210400,7,6,1,0
12,2010,210400,9,9,0,1
1,2011,210400,13,13,0,1
2,2011,210400,4,4,0,0
1,1999,210800,3,2,1,1
2,1999,210800,4,4,0,0
3,1999,210800,6,5,1,0
4,1999,210800,3,3,0,1
5,1999,210800,4,4,0,0
6,1999,210800,8,5,3,1
7,1999,210800,7,6,1,1
8,1999,210800,10,9,1,1
9,1999,210800,4,3,1,1
10,1999,210800,5,5,0,0
11,1999,210800,3,2,1,1
12,1999,210800,6,6,0,0
1,2000,210800,7,5,2,1
2,2000,210800,1,1,0,0
3,2000,210800,3,3,0,0
4,2000,210800,9,7,2,0
5,2000,210800,11,9,2,0
6,2000,210800,8,5,3,1
7,2000,210800,6,5,1,0
8,2000,210800,5,5,0,0
9,2000,210800,8,6,2,0
10,2000,210800,5,4,1,0
11,2000,210800,8,7,1,1
12,2000,210800,9,9,0,0
1,2001,210800,9,8,1,0
2,2001,210800,0,0,0,1
3,2001,210800,9,8,1,0
4,2001,210800,9,8,1,1
5,2001,210800,3,3,0,0
6,2001,210800,12,12,0,0
7,2001,210800,8,6,2,2
8,2001,210800,5,5,0,0
9,2001,210800,6,5,1,3
10,2001,210800,8,8,0,0
11,2001,210800,6,6,0,0
12,2001,210800,5,5,0,0
1,2002,210800,6,6,0,0
2,2002,210800,4,4,0,0
3,2002,210800,4,3,1,0
4,2002,210800,8,7,1,0
5,2002,210800,4,3,1,0
6,2002,210800,6,4,2,0
7,2002,210800,4,4,0,3
8,2002,210800,9,7,2,0
9,2002,210800,10,8,2,0
10,2002,210800,7,6,1,0
11,2002,210800,2,2,0,0
12,2002,210800,2,1,1,1
1,2003,210800,4,4,0,0
2,2003,210800,4,4,0,1
3,2003,210800,4,4,0,1
4,2003,210800,4,4,0,0
5,2003,210800,5,5,0,1
6,2003,210800,8,7,1,0
7,2003,210800,3,2,1,0
8,2003,210800,11,11,0,1
9,2003,210800,3,3,0,0
10,2003,210800,6,4,2,0
11,2003,210800,4,4,0,0
12,2003,210800,5,3,2,2
1,2004,210800,6,6,0,0
2,2004,210800,4,3,1,3
3,2004,210800,3,2,1,0
4,2004,210800,10,10,0,1
5,2004,210800,6,6,0,0
6,2004,210800,6,6,0,0
7,2004,210800,8,8,0,0
8,2004,210800,4,4,0,0
9,2004,210800,2,2,0,2
10,2004,210800,6,6,0,0
11,2004,210800,6,6,0,1
12,2004,210800,5,5,0,0
1,2005,210800,3,2,1,0
2,2005,210800,4,4,0,0
3,2005,210800,7,7,0,0
4,2005,210800,3,3,0,0
5,2005,210800,7,7,0,0
6,2005,210800,3,3,0,1
7,2005,210800,6,6,0,0
8,2005,210800,7,6,1,0
9,2005,210800,2,2,0,0
10,2005,210800,7,7,0,1
11,2005,210800,4,4,0,0
12,2005,210800,7,6,1,0
1,2006,210800,12,10,2,0
2,2006,210800,7,7,0,0
3,2006,210800,3,3,0,3
4,2006,210800,6,6,0,0
5,2006,210800,3,3,0,0
6,2006,210800,6,5,1,0
7,2006,210800,6,5,1,0
8,2006,210800,3,3,0,0
9,2006,210800,3,2,1,1
10,2006,210800,4,4,0,0
11,2006,210800,2,2,0,0
12,2006,210800,2,2,0,0
1,2007,210800,3,3,0,0
2,2007,210800,2,2,0,1
3,2007,210800,1,1,0,0
4,2007,210800,4,4,0,0
5,2007,210800,4,3,1,1
6,2007,210800,4,4,0,0
7,2007,210800,5,5,0,1
8,2007,210800,2,1,1,0
9,2007,210800,6,6,0,0
10,2007,210800,3,3,0,0
11,2007,210800,6,5,1,0
12,2007,210800,1,1,0,0
1,2008,210800,1,1,0,0
2,2008,210800,1,1,0,0
3,2008,210800,1,1,0,2
4,2008,210800,3,2,1,0
5,2008,210800,5,4,1,1
6,2008,210800,9,9,0,0
7,2008,210800,3,3,0,2
8,2008,210800,2,2,0,0
9,2008,210800,3,2,1,0
10,2008,210800,1,1,0,0
11,2008,210800,1,1,0,0
12,2008,210800,6,6,0,0
1,2009,210800,4,4,0,1
2,2009,210800,6,6,0,1
3,2009,210800,2,2,0,0
4,2009,210800,3,3,0,0
5,2009,210800,3,3,0,0
6,2009,210800,2,2,0,0
7,2009,210800,5,4,1,1
8,2009,210800,3,3,0,1
9,2009,210800,4,3,1,0
10,2009,210800,14,11,3,1
11,2009,210800,7,7,0,2
12,2009,210800,6,6,0,0
1,2010,210800,4,4,0,2
2,2010,210800,8,8,0,0
3,2010,210800,4,3,1,1
4,2010,210800,6,5,1,0
5,2010,210800,6,6,0,3
6,2010,210800,6,5,1,1
7,2010,210800,3,3,0,0
8,2010,210800,9,9,0,3
9,2010,210800,6,5,1,0
10,2010,210800,9,7,2,0
11,2010,210800,3,3,0,0
12,2010,210800,4,4,0,0
1,2011,210800,6,6,0,0
2,2011,210800,2,2,0,0
1,1999,170900,8,8,0,0
2,1999,170900,2,2,0,3
3,1999,170900,3,2,1,0
4,1999,170900,0,0,0,0
5,1999,170900,2,2,0,0
6,1999,170900,7,7,0,0
7,1999,170900,2,2,0,0
8,1999,170900,5,5,0,0
9,1999,170900,4,4,0,0
10,1999,170900,2,1,1,0
11,1999,170900,3,2,1,1
12,1999,170900,2,2,0,0
1,2000,170900,3,3,0,0
2,2000,170900,3,2,1,0
3,2000,170900,1,1,0,0
4,2000,170900,1,1,0,0
5,2000,170900,2,2,0,0
6,2000,170900,6,6,0,0
7,2000,170900,6,6,0,0
8,2000,170900,2,2,0,0
9,2000,170900,3,3,0,0
10,2000,170900,2,2,0,0
11,2000,170900,3,3,0,0
12,2000,170900,2,2,0,0
1,2001,170900,2,2,0,0
2,2001,170900,2,2,0,0
3,2001,170900,4,3,1,3
4,2001,170900,2,2,0,0
5,2001,170900,1,1,0,0
6,2001,170900,4,3,1,1
7,2001,170900,1,1,0,0
8,2001,170900,2,1,1,0
9,2001,170900,3,3,0,0
10,2001,170900,1,1,0,0
11,2001,170900,4,4,0,0
12,2001,170900,2,2,0,0
1,2002,170900,1,1,0,0
2,2002,170900,0,0,0,0
3,2002,170900,3,3,0,0
4,2002,170900,4,4,0,0
5,2002,170900,5,5,0,0
6,2002,170900,4,4,0,0
7,2002,170900,3,3,0,1
8,2002,170900,6,6,0,0
9,2002,170900,2,2,0,0
10,2002,170900,5,3,2,0
11,2002,170900,1,1,0,0
12,2002,170900,1,1,0,0
1,2003,170900,4,4,0,0
2,2003,170900,3,3,0,0
3,2003,170900,4,3,1,0
4,2003,170900,6,5,1,0
5,2003,170900,1,1,0,0
6,2003,170900,5,4,1,0
7,2003,170900,7,7,0,0
8,2003,170900,2,2,0,0
9,2003,170900,1,1,0,0
10,2003,170900,7,7,0,0
11,2003,170900,2,2,0,0
12,2003,170900,1,1,0,0
1,2004,170900,3,3,0,0
2,2004,170900,1,1,0,0
3,2004,170900,6,6,0,0
4,2004,170900,2,2,0,0
5,2004,170900,2,2,0,0
6,2004,170900,4,4,0,0
7,2004,170900,2,2,0,0
8,2004,170900,3,3,0,0
9,2004,170900,2,2,0,0
10,2004,170900,3,3,0,0
11,2004,170900,3,3,0,0
12,2004,170900,2,2,0,0
1,2005,170900,2,1,1,0
2,2005,170900,1,1,0,0
3,2005,170900,4,3,1,0
4,2005,170900,5,5,0,0
5,2005,170900,3,3,0,0
6,2005,170900,4,3,1,0
7,2005,170900,4,2,2,1
8,2005,170900,4,4,0,1
9,2005,170900,3,3,0,0
10,2005,170900,1,1,0,2
11,2005,170900,3,3,0,0
12,2005,170900,2,2,0,0
1,2006,170900,4,4,0,0
2,2006,170900,3,3,0,0
3,2006,170900,4,4,0,0
4,2006,170900,6,6,0,0
5,2006,170900,1,1,0,1
6,2006,170900,1,1,0,0
7,2006,170900,3,3,0,0
8,2006,170900,3,3,0,0
9,2006,170900,2,1,1,0
10,2006,170900,4,4,0,0
11,2006,170900,5,5,0,0
12,2006,170900,1,1,0,0
1,2007,170900,1,1,0,0
2,2007,170900,1,1,0,0
3,2007,170900,2,2,0,0
4,2007,170900,2,2,0,0
5,2007,170900,2,1,1,0
6,2007,170900,3,3,0,2
7,2007,170900,3,3,0,0
8,2007,170900,7,7,0,0
9,2007,170900,1,1,0,2
10,2007,170900,4,4,0,0
11,2007,170900,0,0,0,0
12,2007,170900,4,4,0,0
1,2008,170900,2,2,0,0
2,2008,170900,1,1,0,0
3,2008,170900,1,1,0,0
4,2008,170900,4,4,0,0
5,2008,170900,1,1,0,0
6,2008,170900,6,5,1,1
7,2008,170900,5,5,0,0
8,2008,170900,4,4,0,0
9,2008,170900,5,5,0,0
10,2008,170900,2,2,0,0
11,2008,170900,3,3,0,0
12,2008,170900,3,3,0,0
1,2009,170900,7,7,0,0
2,2009,170900,2,2,0,0
3,2009,170900,5,5,0,0
4,2009,170900,3,3,0,1
5,2009,170900,0,0,0,0
6,2009,170900,1,1,0,0
7,2009,170900,2,2,0,0
8,2009,170900,0,0,0,3
9,2009,170900,2,2,0,0
10,2009,170900,3,3,0,1
11,2009,170900,2,2,0,1
12,2009,170900,0,0,0,0
1,2010,170900,2,2,0,0
2,2010,170900,1,1,0,0
3,2010,170900,1,1,0,0
4,2010,170900,5,4,1,0
5,2010,170900,3,3,0,0
6,2010,170900,5,5,0,0
7,2010,170900,5,4,1,2
8,2010,170900,2,2,0,0
9,2010,170900,2,2,0,0
10,2010,170900,2,2,0,0
11,2010,170900,2,2,0,0
12,2010,170900,4,4,0,0
1,2011,170900,4,4,0,0
2,2011,170900,1,1,0,0
1,1999,210501,38,37,1,3
2,1999,210501,25,24,1,0
3,1999,210501,22,20,2,3
4,1999,210501,34,30,4,6
5,1999,210501,38,35,3,0
6,1999,210501,43,40,3,1
7,1999,210501,21,18,3,1
8,1999,210501,33,33,0,0
9,1999,210501,37,34,3,2
10,1999,210501,41,38,3,2
11,1999,210501,28,28,0,2
12,1999,210501,37,34,3,1
1,2000,210501,24,20,4,1
2,2000,210501,21,18,3,5
3,2000,210501,24,22,2,1
4,2000,210501,29,26,3,1
5,2000,210501,37,35,2,0
6,2000,210501,23,23,0,4
7,2000,210501,24,23,1,4
8,2000,210501,33,30,3,5
9,2000,210501,29,26,3,3
10,2000,210501,29,25,4,1
11,2000,210501,27,21,6,3
12,2000,210501,24,23,1,0
1,2001,210501,31,28,3,10
2,2001,210501,13,11,2,7
3,2001,210501,21,16,5,4
4,2001,210501,23,22,1,4
5,2001,210501,19,17,2,3
6,2001,210501,24,22,2,6
7,2001,210501,20,17,3,1
8,2001,210501,32,31,1,4
9,2001,210501,31,30,1,1
10,2001,210501,37,34,3,5
11,2001,210501,16,15,1,0
12,2001,210501,17,13,4,1
1,2002,210501,20,20,0,3
2,2002,210501,18,18,0,4
3,2002,210501,25,22,3,2
4,2002,210501,27,22,5,6
5,2002,210501,24,20,4,3
6,2002,210501,18,17,1,6
7,2002,210501,22,22,0,4
8,2002,210501,28,24,4,2
9,2002,210501,24,24,0,1
10,2002,210501,20,17,3,0
11,2002,210501,13,12,1,1
12,2002,210501,19,16,3,1
1,2003,210501,26,26,0,0
2,2003,210501,13,12,1,1
3,2003,210501,23,23,0,1
4,2003,210501,25,23,2,0
5,2003,210501,26,22,4,0
6,2003,210501,29,27,2,2
7,2003,210501,31,29,2,0
8,2003,210501,41,38,3,0
9,2003,210501,21,17,4,3
10,2003,210501,20,17,3,4
11,2003,210501,23,22,1,4
12,2003,210501,24,22,2,1
1,2004,210501,44,37,7,3
2,2004,210501,22,21,1,3
3,2004,210501,22,19,3,5
4,2004,210501,24,19,5,3
5,2004,210501,24,22,2,5
6,2004,210501,32,28,4,4
7,2004,210501,21,19,2,1
8,2004,210501,29,25,4,7
9,2004,210501,32,27,5,3
10,2004,210501,27,24,3,4
11,2004,210501,15,10,5,1
12,2004,210501,28,26,2,2
1,2005,210501,23,21,2,5
2,2005,210501,10,8,2,2
3,2005,210501,19,18,1,4
4,2005,210501,23,21,2,2
5,2005,210501,19,16,3,5
6,2005,210501,26,26,0,3
7,2005,210501,32,28,4,7
8,2005,210501,30,24,6,7
9,2005,210501,28,24,4,1
10,2005,210501,22,19,3,4
11,2005,210501,14,12,2,4
12,2005,210501,23,22,1,6
1,2006,210501,27,25,2,4
2,2006,210501,12,12,0,1
3,2006,210501,14,12,2,4
4,2006,210501,18,16,2,3
5,2006,210501,15,14,1,4
6,2006,210501,23,19,4,4
7,2006,210501,18,15,3,0
8,2006,210501,21,19,2,6
9,2006,210501,12,11,1,6
10,2006,210501,17,13,4,2
11,2006,210501,20,19,1,2
12,2006,210501,8,8,0,2
1,2007,210501,16,13,3,2
2,2007,210501,10,10,0,5
3,2007,210501,15,14,1,1
4,2007,210501,14,11,3,2
5,2007,210501,14,13,1,3
6,2007,210501,18,13,5,2
7,2007,210501,14,13,1,7
8,2007,210501,23,21,2,7
9,2007,210501,18,18,0,6
10,2007,210501,17,17,0,5
11,2007,210501,19,15,4,10
12,2007,210501,15,14,1,3
1,2008,210501,14,11,3,13
2,2008,210501,13,10,3,8
3,2008,210501,8,7,1,7
4,2008,210501,15,13,2,7
5,2008,210501,15,13,2,7
6,2008,210501,19,17,2,2
7,2008,210501,16,13,3,3
8,2008,210501,23,16,7,4
9,2008,210501,28,25,3,5
10,2008,210501,19,14,5,7
11,2008,210501,25,24,1,8
12,2008,210501,15,12,3,2
1,2009,210501,22,18,4,5
2,2009,210501,19,17,2,4
3,2009,210501,11,10,1,3
4,2009,210501,12,11,1,6
5,2009,210501,13,10,3,3
6,2009,210501,13,12,1,3
7,2009,210501,24,20,4,4
8,2009,210501,22,19,3,1
9,2009,210501,21,18,3,2
10,2009,210501,26,24,2,2
11,2009,210501,19,15,4,2
12,2009,210501,26,26,0,3
1,2010,210501,16,16,0,1
2,2010,210501,14,12,2,4
3,2010,210501,12,10,2,3
4,2010,210501,12,12,0,8
5,2010,210501,13,12,1,4
6,2010,210501,25,21,4,1
7,2010,210501,13,12,1,1
8,2010,210501,21,18,3,6
9,2010,210501,18,17,1,6
10,2010,210501,17,13,4,1
11,2010,210501,10,9,1,8
12,2010,210501,11,8,3,5
1,2011,210501,13,11,2,3
2,2011,210501,7,5,2,1
1,1999,843700,26,24,2,4
2,1999,843700,25,22,3,6
3,1999,843700,29,28,1,2
4,1999,843700,24,21,3,7
5,1999,843700,25,25,0,7
6,1999,843700,24,23,1,2
7,1999,843700,30,30,0,5
8,1999,843700,34,30,4,3
9,1999,843700,38,37,1,8
10,1999,843700,18,18,0,6
11,1999,843700,20,20,0,5
12,1999,843700,37,36,1,5
1,2000,843700,33,31,2,1
2,2000,843700,30,28,2,5
3,2000,843700,36,33,3,4
4,2000,843700,32,32,0,1
5,2000,843700,41,40,1,5
6,2000,843700,28,26,2,7
7,2000,843700,32,31,1,6
8,2000,843700,29,29,0,3
9,2000,843700,34,34,0,3
10,2000,843700,26,25,1,7
11,2000,843700,28,24,4,4
12,2000,843700,18,18,0,4
1,2001,843700,29,28,1,5
2,2001,843700,25,21,4,6
3,2001,843700,31,28,3,5
4,2001,843700,23,21,2,6
5,2001,843700,21,21,0,8
6,2001,843700,28,28,0,4
7,2001,843700,25,24,1,5
8,2001,843700,24,22,2,1
9,2001,843700,23,21,2,5
10,2001,843700,26,23,3,10
11,2001,843700,28,25,3,3
12,2001,843700,14,13,1,12
1,2002,843700,31,29,2,5
2,2002,843700,30,27,3,1
3,2002,843700,34,30,4,14
4,2002,843700,25,25,0,4
5,2002,843700,28,24,4,3
6,2002,843700,25,23,2,4
7,2002,843700,23,23,0,0
8,2002,843700,32,30,2,0
9,2002,843700,26,25,1,0
10,2002,843700,24,23,1,3
11,2002,843700,42,41,1,0
12,2002,843700,16,16,0,0
1,2003,843700,20,18,2,2
2,2003,843700,20,20,0,6
3,2003,843700,19,17,2,2
4,2003,843700,24,23,1,2
5,2003,843700,32,30,2,7
6,2003,843700,26,24,2,4
7,2003,843700,29,29,0,3
8,2003,843700,23,22,1,1
9,2003,843700,25,25,0,2
10,2003,843700,36,36,0,5
11,2003,843700,17,17,0,3
12,2003,843700,22,22,0,4
1,2004,843700,23,22,1,10
2,2004,843700,23,22,1,6
3,2004,843700,30,27,3,9
4,2004,843700,19,15,4,0
5,2004,843700,29,26,3,6
6,2004,843700,23,21,2,0
7,2004,843700,24,24,0,1
8,2004,843700,37,36,1,0
9,2004,843700,17,17,0,4
10,2004,843700,18,16,2,6
11,2004,843700,27,25,2,3
12,2004,843700,12,11,1,2
1,2005,843700,14,12,2,2
2,2005,843700,21,19,2,2
3,2005,843700,18,17,1,3
4,2005,843700,20,20,0,4
5,2005,843700,21,20,1,1
6,2005,843700,25,25,0,2
7,2005,843700,13,13,0,1
8,2005,843700,14,11,3,0
9,2005,843700,18,18,0,1
10,2005,843700,18,18,0,0
11,2005,843700,16,15,1,4
12,2005,843700,19,18,1,2
1,2006,843700,18,18,0,0
2,2006,843700,16,15,1,0
3,2006,843700,23,22,1,2
4,2006,843700,18,15,3,1
5,2006,843700,18,17,1,3
6,2006,843700,12,12,0,1
7,2006,843700,14,13,1,0
8,2006,843700,22,21,1,0
9,2006,843700,29,29,0,5
10,2006,843700,20,20,0,2
11,2006,843700,16,15,1,3
12,2006,843700,15,13,2,2
1,2007,843700,15,14,1,4
2,2007,843700,14,14,0,2
3,2007,843700,27,23,4,3
4,2007,843700,15,15,0,0
5,2007,843700,19,19,0,3
6,2007,843700,11,11,0,6
7,2007,843700,22,22,0,1
8,2007,843700,11,11,0,0
9,2007,843700,22,20,2,0
10,2007,843700,12,12,0,3
11,2007,843700,13,13,0,2
12,2007,843700,16,14,2,1
1,2008,843700,20,20,0,3
2,2008,843700,13,12,1,2
3,2008,843700,6,6,0,0
4,2008,843700,17,16,1,1
5,2008,843700,9,8,1,1
6,2008,843700,21,21,0,0
7,2008,843700,18,18,0,0
8,2008,843700,25,24,1,2
9,2008,843700,23,21,2,1
10,2008,843700,20,20,0,1
11,2008,843700,22,22,0,0
12,2008,843700,13,12,1,0
1,2009,843700,16,16,0,2
2,2009,843700,17,15,2,0
3,2009,843700,24,23,1,4
4,2009,843700,19,19,0,1
5,2009,843700,10,9,1,3
6,2009,843700,13,13,0,0
7,2009,843700,18,18,0,3
8,2009,843700,16,16,0,1
9,2009,843700,18,18,0,4
10,2009,843700,24,23,1,0
11,2009,843700,27,26,1,2
12,2009,843700,25,24,1,4
1,2010,843700,22,22,0,2
2,2010,843700,15,14,1,4
3,2010,843700,21,21,0,1
4,2010,843700,19,19,0,2
5,2010,843700,13,12,1,3
6,2010,843700,15,15,0,1
7,2010,843700,11,10,1,1
8,2010,843700,16,16,0,2
9,2010,843700,19,19,0,1
10,2010,843700,17,17,0,0
11,2010,843700,11,11,0,3
12,2010,843700,22,21,1,2
1,2011,843700,7,7,0,2
2,2011,843700,8,8,0,0
1,1999,063100,14,14,0,0
2,1999,063100,6,6,0,0
3,1999,063100,8,8,0,0
4,1999,063100,17,16,1,0
5,1999,063100,22,22,0,0
6,1999,063100,23,22,1,0
7,1999,063100,31,30,1,0
8,1999,063100,22,22,0,0
9,1999,063100,19,19,0,0
10,1999,063100,26,26,0,0
11,1999,063100,13,11,2,4
12,1999,063100,19,18,1,0
1,2000,063100,10,9,1,0
2,2000,063100,10,9,1,0
3,2000,063100,13,13,0,0
4,2000,063100,15,15,0,0
5,2000,063100,25,25,0,0
6,2000,063100,28,28,0,0
7,2000,063100,28,26,2,0
8,2000,063100,25,24,1,0
9,2000,063100,23,23,0,2
10,2000,063100,15,15,0,0
11,2000,063100,12,12,0,1
12,2000,063100,7,7,0,0
1,2001,063100,12,12,0,0
2,2001,063100,8,8,0,1
3,2001,063100,12,12,0,0
4,2001,063100,14,14,0,0
5,2001,063100,12,12,0,2
6,2001,063100,14,14,0,0
7,2001,063100,13,13,0,1
8,2001,063100,15,15,0,0
9,2001,063100,11,10,1,1
10,2001,063100,14,14,0,1
11,2001,063100,8,8,0,1
12,2001,063100,9,9,0,0
1,2002,063100,12,12,0,1
2,2002,063100,12,12,0,1
3,2002,063100,5,5,0,1
4,2002,063100,14,14,0,0
5,2002,063100,14,14,0,0
6,2002,063100,15,15,0,0
7,2002,063100,17,15,2,3
8,2002,063100,14,13,1,0
9,2002,063100,14,14,0,0
10,2002,063100,16,15,1,2
11,2002,063100,8,7,1,1
12,2002,063100,11,11,0,0
1,2003,063100,10,10,0,0
2,2003,063100,11,11,0,1
3,2003,063100,6,6,0,0
4,2003,063100,8,7,1,1
5,2003,063100,12,12,0,0
6,2003,063100,18,17,1,0
7,2003,063100,12,12,0,0
8,2003,063100,21,21,0,1
9,2003,063100,20,19,1,1
10,2003,063100,17,17,0,0
11,2003,063100,14,14,0,0
12,2003,063100,10,10,0,0
1,2004,063100,13,13,0,1
2,2004,063100,14,13,1,1
3,2004,063100,7,7,0,0
4,2004,063100,15,14,1,2
5,2004,063100,11,11,0,0
6,2004,063100,16,16,0,0
7,2004,063100,20,20,0,0
8,2004,063100,20,20,0,0
9,2004,063100,15,15,0,1
10,2004,063100,19,19,0,0
11,2004,063100,13,13,0,0
12,2004,063100,11,11,0,0
1,2005,063100,17,17,0,0
2,2005,063100,6,6,0,0
3,2005,063100,6,6,0,0
4,2005,063100,9,9,0,1
5,2005,063100,17,17,0,2
6,2005,063100,19,18,1,0
7,2005,063100,11,11,0,0
8,2005,063100,12,12,0,0
9,2005,063100,12,12,0,1
10,2005,063100,14,14,0,0
11,2005,063100,6,6,0,0
12,2005,063100,6,6,0,1
1,2006,063100,6,5,1,1
2,2006,063100,7,6,1,0
3,2006,063100,8,8,0,0
4,2006,063100,7,7,0,0
5,2006,063100,9,9,0,0
6,2006,063100,8,8,0,0
7,2006,063100,8,8,0,1
8,2006,063100,10,10,0,1
9,2006,063100,10,10,0,0
10,2006,063100,9,9,0,0
11,2006,063100,11,11,0,0
12,2006,063100,13,13,0,0
1,2007,063100,11,11,0,0
2,2007,063100,10,10,0,0
3,2007,063100,10,10,0,0
4,2007,063100,9,9,0,1
5,2007,063100,10,10,0,0
6,2007,063100,9,9,0,0
7,2007,063100,9,9,0,1
8,2007,063100,7,7,0,0
9,2007,063100,5,5,0,0
10,2007,063100,14,14,0,0
11,2007,063100,7,7,0,1
12,2007,063100,7,7,0,0
1,2008,063100,13,13,0,1
2,2008,063100,13,12,1,0
3,2008,063100,6,6,0,0
4,2008,063100,16,16,0,0
5,2008,063100,10,9,1,0
6,2008,063100,12,12,0,0
7,2008,063100,20,20,0,3
8,2008,063100,5,5,0,0
9,2008,063100,9,9,0,0
10,2008,063100,12,10,2,0
11,2008,063100,5,5,0,0
12,2008,063100,13,13,0,1
1,2009,063100,7,7,0,0
2,2009,063100,8,6,2,0
3,2009,063100,6,5,1,0
4,2009,063100,9,9,0,0
5,2009,063100,12,12,0,0
6,2009,063100,14,14,0,0
7,2009,063100,13,13,0,0
8,2009,063100,16,16,0,0
9,2009,063100,7,7,0,0
10,2009,063100,12,12,0,0
11,2009,063100,12,12,0,2
12,2009,063100,4,4,0,0
1,2010,063100,9,9,0,0
2,2010,063100,3,3,0,0
3,2010,063100,7,7,0,1
4,2010,063100,10,9,1,0
5,2010,063100,7,7,0,1
6,2010,063100,7,6,1,0
7,2010,063100,15,15,0,0
8,2010,063100,11,11,0,0
9,2010,063100,10,10,0,0
10,2010,063100,13,13,0,0
11,2010,063100,3,3,0,0
12,2010,063100,9,9,0,0
1,2011,063100,4,4,0,0
2,2011,063100,5,5,0,0
1,1999,063200,7,7,0,0
2,1999,063200,11,11,0,0
3,1999,063200,9,9,0,0
4,1999,063200,6,6,0,0
5,1999,063200,16,15,1,1
6,1999,063200,19,19,0,1
7,1999,063200,15,15,0,0
8,1999,063200,11,11,0,0
9,1999,063200,12,12,0,1
10,1999,063200,9,8,1,0
11,1999,063200,15,15,0,0
12,1999,063200,9,8,1,1
1,2000,063200,7,7,0,1
2,2000,063200,5,4,1,0
3,2000,063200,4,4,0,0
4,2000,063200,10,10,0,0
5,2000,063200,18,18,0,0
6,2000,063200,22,22,0,4
7,2000,063200,17,17,0,0
8,2000,063200,17,17,0,1
9,2000,063200,19,19,0,0
10,2000,063200,17,16,1,0
11,2000,063200,14,13,1,0
12,2000,063200,7,7,0,0
1,2001,063200,9,8,1,0
2,2001,063200,9,7,2,0
3,2001,063200,7,7,0,0
4,2001,063200,7,7,0,0
5,2001,063200,9,8,1,0
6,2001,063200,20,20,0,0
7,2001,063200,23,23,0,1
8,2001,063200,6,6,0,0
9,2001,063200,13,13,0,0
10,2001,063200,6,5,1,0
11,2001,063200,8,8,0,0
12,2001,063200,3,3,0,0
1,2002,063200,10,10,0,0
2,2002,063200,12,12,0,1
3,2002,063200,10,9,1,0
4,2002,063200,10,10,0,0
5,2002,063200,8,7,1,1
6,2002,063200,11,11,0,1
7,2002,063200,6,6,0,0
8,2002,063200,16,16,0,0
9,2002,063200,13,13,0,0
10,2002,063200,5,5,0,0
11,2002,063200,12,12,0,0
12,2002,063200,4,4,0,0
1,2003,063200,6,5,1,0
2,2003,063200,6,6,0,0
3,2003,063200,6,6,0,0
4,2003,063200,10,10,0,0
5,2003,063200,16,15,1,0
6,2003,063200,14,14,0,0
7,2003,063200,9,9,0,0
8,2003,063200,8,8,0,0
9,2003,063200,12,12,0,0
10,2003,063200,7,7,0,0
11,2003,063200,6,6,0,0
12,2003,063200,7,7,0,1
1,2004,063200,4,4,0,0
2,2004,063200,13,13,0,0
3,2004,063200,8,8,0,0
4,2004,063200,5,4,1,0
5,2004,063200,19,19,0,0
6,2004,063200,15,15,0,0
7,2004,063200,10,10,0,0
8,2004,063200,14,14,0,0
9,2004,063200,8,8,0,0
10,2004,063200,12,12,0,0
11,2004,063200,13,12,1,0
12,2004,063200,15,14,1,1
1,2005,063200,7,7,0,1
2,2005,063200,13,11,2,0
3,2005,063200,10,10,0,1
4,2005,063200,12,11,1,0
5,2005,063200,7,7,0,1
6,2005,063200,9,9,0,0
7,2005,063200,11,11,0,0
8,2005,063200,11,10,1,1
9,2005,063200,12,12,0,0
10,2005,063200,7,7,0,0
11,2005,063200,6,6,0,1
12,2005,063200,4,4,0,0
1,2006,063200,4,4,0,0
2,2006,063200,4,4,0,0
3,2006,063200,3,3,0,0
4,2006,063200,13,13,0,0
5,2006,063200,11,10,1,1
6,2006,063200,13,13,0,0
7,2006,063200,6,5,1,0
8,2006,063200,13,13,0,0
9,2006,063200,8,7,1,0
10,2006,063200,10,9,1,0
11,2006,063200,4,4,0,0
12,2006,063200,10,10,0,0
1,2007,063200,9,9,0,0
2,2007,063200,6,5,1,0
3,2007,063200,2,2,0,1
4,2007,063200,6,6,0,0
5,2007,063200,9,7,2,0
6,2007,063200,6,6,0,0
7,2007,063200,6,5,1,1
8,2007,063200,9,9,0,0
9,2007,063200,10,10,0,0
10,2007,063200,6,5,1,0
11,2007,063200,4,4,0,0
12,2007,063200,6,6,0,0
1,2008,063200,4,3,1,1
2,2008,063200,7,7,0,0
3,2008,063200,4,4,0,0
4,2008,063200,8,8,0,1
5,2008,063200,8,8,0,0
6,2008,063200,20,20,0,0
7,2008,063200,16,15,1,0
8,2008,063200,10,10,0,0
9,2008,063200,10,9,1,0
10,2008,063200,13,13,0,1
11,2008,063200,4,4,0,0
12,2008,063200,8,8,0,0
1,2009,063200,9,8,1,0
2,2009,063200,3,3,0,0
3,2009,063200,3,3,0,0
4,2009,063200,8,8,0,0
5,2009,063200,14,14,0,0
6,2009,063200,7,7,0,0
7,2009,063200,10,10,0,0
8,2009,063200,5,5,0,0
9,2009,063200,12,12,0,0
10,2009,063200,8,8,0,0
11,2009,063200,5,5,0,0
12,2009,063200,9,9,0,0
1,2010,063200,3,3,0,0
2,2010,063200,0,0,0,0
3,2010,063200,1,1,0,0
4,2010,063200,13,12,1,0
5,2010,063200,8,8,0,0
6,2010,063200,8,8,0,0
7,2010,063200,13,12,1,1
8,2010,063200,6,6,0,0
9,2010,063200,12,11,1,0
10,2010,063200,6,6,0,0
11,2010,063200,3,3,0,0
12,2010,063200,5,5,0,1
1,2011,063200,4,4,0,0
2,2011,063200,2,2,0,0
1,1999,210601,15,15,0,1
2,1999,210601,19,17,2,1
3,1999,210601,12,12,0,1
4,1999,210601,7,7,0,0
5,1999,210601,11,10,1,0
6,1999,210601,13,13,0,1
7,1999,210601,15,13,2,0
8,1999,210601,21,20,1,0
9,1999,210601,19,19,0,1
10,1999,210601,15,15,0,1
11,1999,210601,23,22,1,1
12,1999,210601,15,14,1,2
1,2000,210601,18,18,0,1
2,2000,210601,22,20,2,4
3,2000,210601,18,18,0,1
4,2000,210601,18,16,2,1
5,2000,210601,21,19,2,2
6,2000,210601,21,20,1,3
7,2000,210601,15,15,0,4
8,2000,210601,17,17,0,6
9,2000,210601,22,21,1,1
10,2000,210601,25,24,1,5
11,2000,210601,16,13,3,5
12,2000,210601,20,20,0,9
1,2001,210601,18,16,2,7
2,2001,210601,4,3,1,7
3,2001,210601,16,16,0,6
4,2001,210601,17,17,0,3
5,2001,210601,18,14,4,2
6,2001,210601,19,16,3,11
7,2001,210601,15,13,2,1
8,2001,210601,22,22,0,4
9,2001,210601,13,13,0,2
10,2001,210601,18,16,2,6
11,2001,210601,14,14,0,2
12,2001,210601,19,18,1,1
1,2002,210601,12,11,1,5
2,2002,210601,13,12,1,5
3,2002,210601,13,13,0,3
4,2002,210601,13,13,0,0
5,2002,210601,15,14,1,2
6,2002,210601,16,15,1,1
7,2002,210601,24,24,0,0
8,2002,210601,20,18,2,4
9,2002,210601,23,21,2,1
10,2002,210601,22,20,2,7
11,2002,210601,20,20,0,1
12,2002,210601,16,16,0,3
1,2003,210601,14,14,0,1
2,2003,210601,13,11,2,2
3,2003,210601,16,15,1,5
4,2003,210601,15,14,1,1
5,2003,210601,14,13,1,2
6,2003,210601,13,11,2,2
7,2003,210601,20,19,1,5
8,2003,210601,17,16,1,0
9,2003,210601,20,20,0,1
10,2003,210601,19,19,0,3
11,2003,210601,16,15,1,4
12,2003,210601,15,15,0,1
1,2004,210601,18,18,0,5
2,2004,210601,8,8,0,4
3,2004,210601,10,9,1,1
4,2004,210601,21,18,3,5
5,2004,210601,14,14,0,5
6,2004,210601,17,15,2,7
7,2004,210601,19,19,0,5
8,2004,210601,18,15,3,2
9,2004,210601,10,8,2,4
10,2004,210601,5,4,1,1
11,2004,210601,8,8,0,0
12,2004,210601,9,8,1,4
1,2005,210601,7,7,0,4
2,2005,210601,7,4,3,3
3,2005,210601,3,2,1,1
4,2005,210601,9,8,1,0
5,2005,210601,8,5,3,1
6,2005,210601,7,7,0,1
7,2005,210601,15,13,2,7
8,2005,210601,7,6,1,3
9,2005,210601,15,14,1,1
10,2005,210601,13,13,0,1
11,2005,210601,12,11,1,0
12,2005,210601,10,9,1,2
1,2006,210601,10,10,0,2
2,2006,210601,10,10,0,2
3,2006,210601,9,9,0,4
4,2006,210601,9,9,0,2
5,2006,210601,7,6,1,1
6,2006,210601,12,11,1,3
7,2006,210601,13,11,2,4
8,2006,210601,16,15,1,5
9,2006,210601,11,9,2,1
10,2006,210601,21,20,1,2
11,2006,210601,5,5,0,0
12,2006,210601,7,7,0,0
1,2007,210601,8,7,1,1
2,2007,210601,10,10,0,6
3,2007,210601,9,8,1,1
4,2007,210601,3,3,0,1
5,2007,210601,7,6,1,1
6,2007,210601,7,6,1,0
7,2007,210601,8,8,0,0
8,2007,210601,10,8,2,0
9,2007,210601,4,4,0,1
10,2007,210601,6,6,0,0
11,2007,210601,3,2,1,0
12,2007,210601,7,6,1,1
1,2008,210601,12,11,1,1
2,2008,210601,6,5,1,0
3,2008,210601,10,9,1,2
4,2008,210601,3,3,0,0
5,2008,210601,6,6,0,0
6,2008,210601,3,3,0,2
7,2008,210601,6,6,0,0
8,2008,210601,3,2,1,2
9,2008,210601,21,20,1,1
10,2008,210601,12,9,3,1
11,2008,210601,7,7,0,6
12,2008,210601,6,4,2,0
1,2009,210601,6,2,4,3
2,2009,210601,9,8,1,0
3,2009,210601,4,4,0,1
4,2009,210601,8,6,2,1
5,2009,210601,4,4,0,2
6,2009,210601,3,3,0,4
7,2009,210601,8,7,1,1
8,2009,210601,10,10,0,0
9,2009,210601,8,8,0,1
10,2009,210601,6,6,0,1
11,2009,210601,15,14,1,3
12,2009,210601,11,11,0,0
1,2010,210601,14,13,1,2
2,2010,210601,5,5,0,1
3,2010,210601,9,9,0,0
4,2010,210601,5,5,0,0
5,2010,210601,9,8,1,2
6,2010,210601,8,7,1,0
7,2010,210601,8,7,1,0
8,2010,210601,10,10,0,0
9,2010,210601,14,13,1,1
10,2010,210601,8,8,0,2
11,2010,210601,11,11,0,1
12,2010,210601,8,8,0,1
1,2011,210601,5,5,0,1
2,2011,210601,4,4,0,1
1,1999,760802,4,4,0,0
2,1999,760802,6,6,0,0
3,1999,760802,12,11,1,0
4,1999,760802,9,9,0,0
5,1999,760802,7,7,0,0
6,1999,760802,10,10,0,0
7,1999,760802,12,12,0,0
8,1999,760802,8,7,1,0
9,1999,760802,7,6,1,0
10,1999,760802,6,6,0,0
11,1999,760802,7,7,0,0
12,1999,760802,10,9,1,0
1,2000,760802,4,4,0,0
2,2000,760802,9,9,0,0
3,2000,760802,8,8,0,0
4,2000,760802,10,10,0,0
5,2000,760802,17,16,1,0
6,2000,760802,6,6,0,0
7,2000,760802,3,3,0,0
8,2000,760802,8,8,0,1
9,2000,760802,7,7,0,0
10,2000,760802,7,7,0,0
11,2000,760802,7,6,1,1
12,2000,760802,4,4,0,0
1,2001,760802,3,3,0,0
2,2001,760802,2,2,0,2
3,2001,760802,12,12,0,1
4,2001,760802,5,5,0,0
5,2001,760802,4,3,1,0
6,2001,760802,6,6,0,1
7,2001,760802,6,6,0,0
8,2001,760802,11,10,1,0
9,2001,760802,8,8,0,0
10,2001,760802,9,9,0,0
11,2001,760802,7,7,0,0
12,2001,760802,2,2,0,0
1,2002,760802,0,0,0,1
2,2002,760802,3,3,0,0
3,2002,760802,2,2,0,0
4,2002,760802,7,6,1,0
5,2002,760802,5,5,0,0
6,2002,760802,7,6,1,0
7,2002,760802,6,5,1,0
8,2002,760802,6,6,0,0
9,2002,760802,8,7,1,0
10,2002,760802,6,6,0,0
11,2002,760802,6,6,0,0
12,2002,760802,8,8,0,0
1,2003,760802,8,7,1,0
2,2003,760802,5,5,0,0
3,2003,760802,10,9,1,0
4,2003,760802,8,7,1,1
5,2003,760802,8,8,0,12
6,2003,760802,3,3,0,0
7,2003,760802,8,8,0,0
8,2003,760802,9,9,0,0
9,2003,760802,4,4,0,0
10,2003,760802,5,5,0,0
11,2003,760802,5,5,0,3
12,2003,760802,2,2,0,0
1,2004,760802,5,5,0,0
2,2004,760802,3,2,1,0
3,2004,760802,6,6,0,1
4,2004,760802,3,3,0,1
5,2004,760802,4,4,0,4
6,2004,760802,6,6,0,0
7,2004,760802,7,6,1,0
8,2004,760802,5,2,3,3
9,2004,760802,4,2,2,0
10,2004,760802,5,5,0,0
11,2004,760802,9,9,0,0
12,2004,760802,7,7,0,0
1,2005,760802,7,7,0,0
2,2005,760802,5,4,1,0
3,2005,760802,6,4,2,0
4,2005,760802,2,2,0,0
5,2005,760802,6,6,0,0
6,2005,760802,8,8,0,1
7,2005,760802,7,7,0,0
8,2005,760802,8,8,0,0
9,2005,760802,5,5,0,0
10,2005,760802,10,9,1,0
11,2005,760802,7,6,1,0
12,2005,760802,2,2,0,0
1,2006,760802,4,4,0,0
2,2006,760802,9,9,0,0
3,2006,760802,3,3,0,1
4,2006,760802,3,1,2,0
5,2006,760802,4,4,0,0
6,2006,760802,4,4,0,0
7,2006,760802,8,7,1,0
8,2006,760802,3,3,0,0
9,2006,760802,3,3,0,1
10,2006,760802,3,3,0,0
11,2006,760802,4,4,0,0
12,2006,760802,4,3,1,0
1,2007,760802,7,7,0,2
2,2007,760802,1,1,0,0
3,2007,760802,4,4,0,2
4,2007,760802,6,6,0,1
5,2007,760802,2,2,0,2
6,2007,760802,3,3,0,0
7,2007,760802,5,5,0,1
8,2007,760802,3,3,0,0
9,2007,760802,2,2,0,0
10,2007,760802,3,3,0,1
11,2007,760802,4,4,0,0
12,2007,760802,3,3,0,0
1,2008,760802,5,5,0,0
2,2008,760802,1,1,0,0
3,2008,760802,4,4,0,1
4,2008,760802,5,5,0,0
5,2008,760802,5,5,0,0
6,2008,760802,3,3,0,1
7,2008,760802,12,11,1,0
8,2008,760802,10,8,2,0
9,2008,760802,10,10,0,0
10,2008,760802,3,2,1,1
11,2008,760802,3,3,0,1
12,2008,760802,9,9,0,1
1,2009,760802,10,10,0,0
2,2009,760802,5,5,0,1
3,2009,760802,5,5,0,0
4,2009,760802,3,3,0,0
5,2009,760802,4,4,0,0
6,2009,760802,4,4,0,0
7,2009,760802,3,3,0,0
8,2009,760802,13,12,1,0
9,2009,760802,4,4,0,0
10,2009,760802,4,4,0,2
11,2009,760802,6,6,0,0
12,2009,760802,5,5,0,0
1,2010,760802,3,3,0,2
2,2010,760802,1,1,0,0
3,2010,760802,6,5,1,0
4,2010,760802,5,4,1,1
5,2010,760802,2,2,0,0
6,2010,760802,3,3,0,0
7,2010,760802,10,10,0,1
8,2010,760802,6,5,1,2
9,2010,760802,0,0,0,0
10,2010,760802,3,3,0,0
11,2010,760802,3,3,0,0
12,2010,760802,6,6,0,0
1,2011,760802,7,6,1,0
2,2011,760802,2,1,1,0
1,1999,171000,21,21,0,0
2,1999,171000,24,24,0,1
3,1999,171000,15,13,2,0
4,1999,171000,17,17,0,0
5,1999,171000,16,15,1,2
6,1999,171000,16,15,1,0
7,1999,171000,11,11,0,0
8,1999,171000,16,16,0,0
9,1999,171000,11,11,0,1
10,1999,171000,12,12,0,0
11,1999,171000,6,5,1,0
12,1999,171000,17,14,3,1
1,2000,171000,11,11,0,1
2,2000,171000,8,7,1,0
3,2000,171000,13,11,2,0
4,2000,171000,14,13,1,0
5,2000,171000,15,15,0,0
6,2000,171000,22,19,3,1
7,2000,171000,24,24,0,0
8,2000,171000,23,22,1,1
9,2000,171000,15,11,4,3
10,2000,171000,12,12,0,0
11,2000,171000,16,15,1,0
12,2000,171000,15,14,1,2
1,2001,171000,5,5,0,1
2,2001,171000,4,4,0,1
3,2001,171000,10,9,1,1
4,2001,171000,12,11,1,0
5,2001,171000,14,14,0,0
6,2001,171000,11,11,0,2
7,2001,171000,21,18,3,1
8,2001,171000,11,11,0,1
9,2001,171000,18,18,0,1
10,2001,171000,15,14,1,0
11,2001,171000,10,10,0,1
12,2001,171000,9,8,1,0
1,2002,171000,19,18,1,2
2,2002,171000,9,9,0,0
3,2002,171000,12,12,0,3
4,2002,171000,5,5,0,0
5,2002,171000,19,18,1,0
6,2002,171000,5,4,1,0
7,2002,171000,13,12,1,5
8,2002,171000,16,14,2,0
9,2002,171000,24,22,2,1
10,2002,171000,20,19,1,2
11,2002,171000,21,20,1,0
12,2002,171000,16,16,0,2
1,2003,171000,11,11,0,1
2,2003,171000,8,8,0,0
3,2003,171000,15,15,0,0
4,2003,171000,12,12,0,1
5,2003,171000,19,19,0,0
6,2003,171000,17,17,0,2
7,2003,171000,25,24,1,0
8,2003,171000,23,23,0,0
9,2003,171000,15,15,0,1
10,2003,171000,16,15,1,1
11,2003,171000,22,22,0,0
12,2003,171000,18,18,0,0
1,2004,171000,12,12,0,1
2,2004,171000,13,13,0,1
3,2004,171000,8,8,0,3
4,2004,171000,14,13,1,1
5,2004,171000,11,10,1,3
6,2004,171000,21,20,1,0
7,2004,171000,16,14,2,1
8,2004,171000,13,13,0,0
9,2004,171000,16,16,0,3
10,2004,171000,10,10,0,2
11,2004,171000,14,12,2,2
12,2004,171000,6,6,0,1
1,2005,171000,15,15,0,1
2,2005,171000,13,13,0,1
3,2005,171000,6,5,1,0
4,2005,171000,12,12,0,1
5,2005,171000,12,12,0,2
6,2005,171000,15,15,0,1
7,2005,171000,12,12,0,4
8,2005,171000,9,7,2,2
9,2005,171000,11,10,1,1
10,2005,171000,15,14,1,1
11,2005,171000,17,15,2,1
12,2005,171000,24,24,0,3
1,2006,171000,15,13,2,1
2,2006,171000,11,11,0,2
3,2006,171000,7,7,0,1
4,2006,171000,9,8,1,2
5,2006,171000,8,6,2,1
6,2006,171000,15,14,1,0
7,2006,171000,9,8,1,0
8,2006,171000,6,6,0,3
9,2006,171000,7,7,0,1
10,2006,171000,4,4,0,0
11,2006,171000,4,4,0,1
12,2006,171000,6,6,0,3
1,2007,171000,9,9,0,3
2,2007,171000,8,8,0,1
3,2007,171000,15,14,1,1
4,2007,171000,14,12,2,1
5,2007,171000,13,12,1,0
6,2007,171000,17,14,3,4
7,2007,171000,20,20,0,1
8,2007,171000,15,14,1,7
9,2007,171000,11,11,0,1
10,2007,171000,11,10,1,1
11,2007,171000,11,10,1,0
12,2007,171000,10,10,0,0
1,2008,171000,11,11,0,0
2,2008,171000,7,7,0,1
3,2008,171000,16,16,0,0
4,2008,171000,14,13,1,1
5,2008,171000,6,6,0,0
6,2008,171000,19,17,2,0
7,2008,171000,27,27,0,1
8,2008,171000,15,15,0,2
9,2008,171000,20,19,1,0
10,2008,171000,15,14,1,4
11,2008,171000,16,16,0,0
12,2008,171000,11,11,0,2
1,2009,171000,12,12,0,1
2,2009,171000,14,14,0,1
3,2009,171000,12,11,1,1
4,2009,171000,6,6,0,0
5,2009,171000,8,8,0,8
6,2009,171000,12,12,0,1
7,2009,171000,18,17,1,2
8,2009,171000,13,11,2,1
9,2009,171000,10,10,0,0
10,2009,171000,11,11,0,2
11,2009,171000,17,16,1,1
12,2009,171000,7,7,0,0
1,2010,171000,8,8,0,0
2,2010,171000,8,8,0,4
3,2010,171000,9,8,1,2
4,2010,171000,7,7,0,0
5,2010,171000,12,12,0,1
6,2010,171000,18,16,2,2
7,2010,171000,10,8,2,3
8,2010,171000,14,13,1,2
9,2010,171000,12,11,1,4
10,2010,171000,16,16,0,0
11,2010,171000,14,14,0,0
12,2010,171000,13,13,0,1
1,2011,171000,6,6,0,0
2,2011,171000,7,7,0,0
1,1999,171100,7,7,0,0
2,1999,171100,12,12,0,0
3,1999,171100,4,4,0,0
4,1999,171100,8,7,1,0
5,1999,171100,7,6,1,0
6,1999,171100,11,10,1,0
7,1999,171100,8,7,1,1
8,1999,171100,4,4,0,2
9,1999,171100,4,3,1,1
10,1999,171100,9,7,2,1
11,1999,171100,6,5,1,0
12,1999,171100,9,8,1,0
1,2000,171100,13,12,1,0
2,2000,171100,12,12,0,1
3,2000,171100,12,11,1,0
4,2000,171100,17,17,0,0
5,2000,171100,14,12,2,1
6,2000,171100,23,22,1,3
7,2000,171100,8,6,2,1
8,2000,171100,18,16,2,1
9,2000,171100,4,4,0,1
10,2000,171100,10,10,0,0
11,2000,171100,5,4,1,0
12,2000,171100,9,9,0,0
1,2001,171100,14,12,2,1
2,2001,171100,6,6,0,0
3,2001,171100,5,5,0,1
4,2001,171100,5,5,0,1
5,2001,171100,7,7,0,1
6,2001,171100,6,6,0,0
7,2001,171100,8,8,0,0
8,2001,171100,12,11,1,0
9,2001,171100,11,10,1,2
10,2001,171100,12,11,1,1
11,2001,171100,9,9,0,0
12,2001,171100,10,10,0,3
1,2002,171100,4,2,2,3
2,2002,171100,11,11,0,1
3,2002,171100,9,9,0,4
4,2002,171100,8,8,0,2
5,2002,171100,11,9,2,1
6,2002,171100,12,11,1,0
7,2002,171100,11,11,0,0
8,2002,171100,10,10,0,0
9,2002,171100,13,13,0,2
10,2002,171100,12,12,0,4
11,2002,171100,21,21,0,3
12,2002,171100,8,8,0,2
1,2003,171100,12,11,1,2
2,2003,171100,12,12,0,1
3,2003,171100,5,5,0,1
4,2003,171100,7,7,0,1
5,2003,171100,11,11,0,1
6,2003,171100,8,8,0,0
7,2003,171100,11,9,2,0
8,2003,171100,12,12,0,1
9,2003,171100,11,9,2,1
10,2003,171100,14,13,1,0
11,2003,171100,9,8,1,1
12,2003,171100,8,8,0,1
1,2004,171100,9,9,0,4
2,2004,171100,9,7,2,1
3,2004,171100,7,6,1,0
4,2004,171100,6,6,0,2
5,2004,171100,11,10,1,4
6,2004,171100,9,8,1,1
7,2004,171100,11,11,0,1
8,2004,171100,4,3,1,8
9,2004,171100,3,3,0,1
10,2004,171100,11,11,0,3
11,2004,171100,8,7,1,4
12,2004,171100,4,3,1,2
1,2005,171100,4,3,1,0
2,2005,171100,4,4,0,0
3,2005,171100,6,6,0,1
4,2005,171100,7,6,1,0
5,2005,171100,11,10,1,0
6,2005,171100,4,3,1,0
7,2005,171100,9,8,1,0
8,2005,171100,7,6,1,0
9,2005,171100,9,8,1,0
10,2005,171100,13,13,0,1
11,2005,171100,7,7,0,2
12,2005,171100,7,6,1,0
1,2006,171100,10,8,2,1
2,2006,171100,9,9,0,1
3,2006,171100,8,7,1,1
4,2006,171100,9,9,0,1
5,2006,171100,5,4,1,0
6,2006,171100,9,9,0,1
7,2006,171100,5,5,0,1
8,2006,171100,5,4,1,4
9,2006,171100,8,7,1,0
10,2006,171100,12,10,2,1
11,2006,171100,7,6,1,2
12,2006,171100,4,4,0,0
1,2007,171100,4,3,1,1
2,2007,171100,6,5,1,1
3,2007,171100,7,6,1,1
4,2007,171100,7,6,1,1
5,2007,171100,7,7,0,1
6,2007,171100,5,4,1,0
7,2007,171100,11,10,1,2
8,2007,171100,9,9,0,6
9,2007,171100,2,2,0,1
10,2007,171100,11,11,0,2
11,2007,171100,10,10,0,3
12,2007,171100,9,9,0,1
1,2008,171100,9,9,0,0
2,2008,171100,5,5,0,1
3,2008,171100,2,2,0,0
4,2008,171100,4,4,0,5
5,2008,171100,6,6,0,0
6,2008,171100,5,5,0,2
7,2008,171100,10,9,1,1
8,2008,171100,8,8,0,1
9,2008,171100,5,3,2,4
10,2008,171100,20,17,3,2
11,2008,171100,16,15,1,1
12,2008,171100,11,11,0,0
1,2009,171100,10,8,2,0
2,2009,171100,11,10,1,3
3,2009,171100,9,9,0,1
4,2009,171100,8,8,0,0
5,2009,171100,7,7,0,0
6,2009,171100,9,9,0,4
7,2009,171100,4,4,0,1
8,2009,171100,8,8,0,0
9,2009,171100,7,7,0,0
10,2009,171100,10,10,0,1
11,2009,171100,9,8,1,3
12,2009,171100,3,3,0,0
1,2010,171100,5,5,0,2
2,2010,171100,8,8,0,0
3,2010,171100,10,10,0,3
4,2010,171100,9,9,0,1
5,2010,171100,7,7,0,2
6,2010,171100,6,6,0,2
7,2010,171100,4,3,1,0
8,2010,171100,9,8,1,1
9,2010,171100,7,6,1,1
10,2010,171100,8,7,1,4
11,2010,171100,8,8,0,3
12,2010,171100,10,9,1,0
1,2011,171100,3,1,2,2
2,2011,171100,4,4,0,0
1,1999,170600,2,2,0,0
2,1999,170600,3,3,0,3
3,1999,170600,1,1,0,0
4,1999,170600,5,3,2,0
5,1999,170600,0,0,0,0
6,1999,170600,3,2,1,0
7,1999,170600,5,5,0,1
8,1999,170600,4,4,0,0
9,1999,170600,0,0,0,0
10,1999,170600,7,6,1,0
11,1999,170600,4,4,0,0
12,1999,170600,7,6,1,0
1,2000,170600,2,2,0,0
2,2000,170600,4,4,0,0
3,2000,170600,2,2,0,0
4,2000,170600,5,5,0,0
5,2000,170600,4,4,0,0
6,2000,170600,2,2,0,0
7,2000,170600,4,3,1,1
8,2000,170600,4,4,0,2
9,2000,170600,3,3,0,0
10,2000,170600,2,2,0,0
11,2000,170600,8,8,0,0
12,2000,170600,0,0,0,0
1,2001,170600,1,1,0,0
2,2001,170600,1,1,0,0
3,2001,170600,1,1,0,0
4,2001,170600,1,0,1,0
5,2001,170600,8,7,1,0
6,2001,170600,2,2,0,0
7,2001,170600,2,2,0,0
8,2001,170600,4,3,1,1
9,2001,170600,3,3,0,0
10,2001,170600,4,3,1,0
11,2001,170600,0,0,0,1
12,2001,170600,4,4,0,0
1,2002,170600,1,1,0,0
2,2002,170600,2,2,0,0
3,2002,170600,2,1,1,0
4,2002,170600,3,3,0,0
5,2002,170600,4,4,0,1
6,2002,170600,5,5,0,0
7,2002,170600,8,8,0,0
8,2002,170600,1,1,0,0
9,2002,170600,2,1,1,0
10,2002,170600,1,1,0,0
11,2002,170600,0,0,0,0
12,2002,170600,3,3,0,0
1,2003,170600,2,2,0,0
2,2003,170600,4,4,0,0
3,2003,170600,0,0,0,0
4,2003,170600,1,1,0,1
5,2003,170600,1,1,0,0
6,2003,170600,4,4,0,0
7,2003,170600,7,7,0,0
8,2003,170600,7,6,1,0
9,2003,170600,3,3,0,0
10,2003,170600,7,7,0,0
11,2003,170600,0,0,0,0
12,2003,170600,4,3,1,0
1,2004,170600,3,2,1,0
2,2004,170600,2,2,0,0
3,2004,170600,3,2,1,1
4,2004,170600,4,3,1,0
5,2004,170600,0,0,0,0
6,2004,170600,5,5,0,0
7,2004,170600,4,3,1,0
8,2004,170600,7,7,0,0
9,2004,170600,1,1,0,0
10,2004,170600,3,3,0,0
11,2004,170600,3,3,0,0
12,2004,170600,5,4,1,0
1,2005,170600,0,0,0,0
2,2005,170600,3,3,0,0
3,2005,170600,8,8,0,0
4,2005,170600,6,6,0,0
5,2005,170600,3,3,0,1
6,2005,170600,5,4,1,0
7,2005,170600,3,3,0,0
8,2005,170600,4,4,0,0
9,2005,170600,4,4,0,0
10,2005,170600,6,5,1,0
11,2005,170600,3,2,1,0
12,2005,170600,1,1,0,0
1,2006,170600,4,4,0,0
2,2006,170600,1,1,0,0
3,2006,170600,1,1,0,0
4,2006,170600,2,1,1,0
5,2006,170600,2,2,0,0
6,2006,170600,1,1,0,0
7,2006,170600,5,4,1,0
8,2006,170600,0,0,0,1
9,2006,170600,5,5,0,0
10,2006,170600,3,3,0,0
11,2006,170600,0,0,0,3
12,2006,170600,9,8,1,1
1,2007,170600,2,2,0,0
2,2007,170600,3,3,0,0
3,2007,170600,0,0,0,1
4,2007,170600,1,1,0,0
5,2007,170600,1,1,0,0
6,2007,170600,4,4,0,0
7,2007,170600,7,7,0,1
8,2007,170600,3,3,0,0
9,2007,170600,6,5,1,0
10,2007,170600,1,0,1,0
11,2007,170600,1,1,0,0
12,2007,170600,3,3,0,0
1,2008,170600,1,1,0,0
2,2008,170600,0,0,0,0
3,2008,170600,2,2,0,0
4,2008,170600,5,5,0,0
5,2008,170600,7,5,2,0
6,2008,170600,5,5,0,0
7,2008,170600,3,3,0,0
8,2008,170600,1,1,0,0
9,2008,170600,4,4,0,0
10,2008,170600,6,6,0,0
11,2008,170600,5,5,0,0
12,2008,170600,3,3,0,0
1,2009,170600,2,2,0,0
2,2009,170600,4,4,0,0
3,2009,170600,1,1,0,0
4,2009,170600,2,2,0,0
5,2009,170600,3,3,0,0
6,2009,170600,6,6,0,1
7,2009,170600,3,3,0,1
8,2009,170600,1,1,0,0
9,2009,170600,7,7,0,0
10,2009,170600,2,2,0,0
11,2009,170600,2,2,0,1
12,2009,170600,1,1,0,0
1,2010,170600,0,0,0,0
2,2010,170600,4,4,0,0
3,2010,170600,3,3,0,0
4,2010,170600,2,1,1,1
5,2010,170600,1,1,0,0
6,2010,170600,2,2,0,0
7,2010,170600,1,1,0,0
8,2010,170600,1,1,0,0
9,2010,170600,2,2,0,2
10,2010,170600,0,0,0,0
11,2010,170600,0,0,0,0
12,2010,170600,2,2,0,0
1,2011,170600,2,1,1,0
2,2011,170600,1,0,1,0
1,1999,151200,11,11,0,0
2,1999,151200,12,12,0,2
3,1999,151200,13,13,0,1
4,1999,151200,5,4,1,0
5,1999,151200,9,8,1,0
6,1999,151200,13,12,1,1
7,1999,151200,15,14,1,0
8,1999,151200,11,11,0,3
9,1999,151200,14,13,1,4
10,1999,151200,21,21,0,0
11,1999,151200,21,20,1,2
12,1999,151200,11,11,0,0
1,2000,151200,8,8,0,2
2,2000,151200,20,17,3,1
3,2000,151200,10,9,1,2
4,2000,151200,20,18,2,0
5,2000,151200,17,17,0,1
6,2000,151200,14,14,0,1
7,2000,151200,12,11,1,6
8,2000,151200,11,10,1,5
9,2000,151200,15,14,1,1
10,2000,151200,6,6,0,3
11,2000,151200,14,14,0,2
12,2000,151200,13,13,0,0
1,2001,151200,12,10,2,1
2,2001,151200,6,6,0,0
3,2001,151200,6,6,0,4
4,2001,151200,7,4,3,1
5,2001,151200,15,15,0,1
6,2001,151200,16,16,0,1
7,2001,151200,18,17,1,1
8,2001,151200,9,9,0,4
9,2001,151200,10,10,0,1
10,2001,151200,20,19,1,1
11,2001,151200,10,9,1,3
12,2001,151200,10,10,0,0
1,2002,151200,17,15,2,0
2,2002,151200,13,12,1,2
3,2002,151200,14,13,1,1
4,2002,151200,12,12,0,1
5,2002,151200,15,14,1,1
6,2002,151200,8,8,0,0
7,2002,151200,13,13,0,1
8,2002,151200,11,11,0,5
9,2002,151200,11,11,0,0
10,2002,151200,18,17,1,2
11,2002,151200,13,12,1,2
12,2002,151200,14,12,2,1
1,2003,151200,8,8,0,4
2,2003,151200,16,15,1,0
3,2003,151200,12,11,1,7
4,2003,151200,11,11,0,9
5,2003,151200,10,10,0,5
6,2003,151200,14,14,0,0
7,2003,151200,21,20,1,3
8,2003,151200,16,15,1,2
9,2003,151200,14,13,1,0
10,2003,151200,15,15,0,3
11,2003,151200,13,13,0,3
12,2003,151200,12,11,1,1
1,2004,151200,8,8,0,4
2,2004,151200,3,3,0,5
3,2004,151200,13,13,0,5
4,2004,151200,9,9,0,2
5,2004,151200,14,11,3,0
6,2004,151200,8,8,0,1
7,2004,151200,11,9,2,0
8,2004,151200,14,13,1,2
9,2004,151200,7,7,0,3
10,2004,151200,7,7,0,6
11,2004,151200,8,6,2,2
12,2004,151200,13,13,0,3
1,2005,151200,6,6,0,6
2,2005,151200,6,6,0,2
3,2005,151200,6,4,2,2
4,2005,151200,14,14,0,1
5,2005,151200,8,8,0,0
6,2005,151200,14,14,0,1
7,2005,151200,11,11,0,1
8,2005,151200,8,8,0,1
9,2005,151200,10,10,0,1
10,2005,151200,7,7,0,1
11,2005,151200,11,10,1,3
12,2005,151200,8,8,0,3
1,2006,151200,11,10,1,1
2,2006,151200,5,5,0,1
3,2006,151200,8,8,0,1
4,2006,151200,11,11,0,1
5,2006,151200,14,14,0,1
6,2006,151200,5,5,0,2
7,2006,151200,13,13,0,0
8,2006,151200,4,4,0,5
9,2006,151200,7,6,1,3
10,2006,151200,10,9,1,0
11,2006,151200,4,3,1,0
12,2006,151200,8,8,0,2
1,2007,151200,10,10,0,0
2,2007,151200,8,6,2,0
3,2007,151200,7,6,1,0
4,2007,151200,10,10,0,2
5,2007,151200,14,14,0,1
6,2007,151200,8,7,1,3
7,2007,151200,15,15,0,1
8,2007,151200,10,10,0,2
9,2007,151200,5,4,1,2
10,2007,151200,13,12,1,0
11,2007,151200,16,14,2,0
12,2007,151200,3,2,1,2
1,2008,151200,11,9,2,2
2,2008,151200,5,5,0,5
3,2008,151200,7,7,0,1
4,2008,151200,8,8,0,0
5,2008,151200,12,12,0,0
6,2008,151200,10,10,0,1
7,2008,151200,12,11,1,3
8,2008,151200,10,10,0,3
9,2008,151200,14,13,1,2
10,2008,151200,11,11,0,5
11,2008,151200,15,15,0,1
12,2008,151200,14,14,0,2
1,2009,151200,8,6,2,1
2,2009,151200,14,14,0,1
3,2009,151200,12,12,0,3
4,2009,151200,15,14,1,1
5,2009,151200,9,7,2,2
6,2009,151200,7,7,0,2
7,2009,151200,14,13,1,1
8,2009,151200,8,8,0,1
9,2009,151200,11,10,1,1
10,2009,151200,14,14,0,0
11,2009,151200,6,6,0,1
12,2009,151200,8,8,0,0
1,2010,151200,14,14,0,1
2,2010,151200,8,4,4,0
3,2010,151200,9,9,0,0
4,2010,151200,12,12,0,3
5,2010,151200,3,3,0,2
6,2010,151200,11,10,1,1
7,2010,151200,9,8,1,1
8,2010,151200,5,4,1,1
9,2010,151200,9,9,0,1
10,2010,151200,19,19,0,2
11,2010,151200,9,7,2,2
12,2010,151200,19,19,0,0
1,2011,151200,8,7,1,1
2,2011,151200,4,4,0,0
1,1999,151100,22,21,1,1
2,1999,151100,20,19,1,1
3,1999,151100,20,18,2,1
4,1999,151100,27,26,1,1
5,1999,151100,32,31,1,3
6,1999,151100,34,32,2,2
7,1999,151100,28,26,2,1
8,1999,151100,29,27,2,1
9,1999,151100,27,27,0,0
10,1999,151100,22,20,2,1
11,1999,151100,10,10,0,2
12,1999,151100,12,12,0,2
1,2000,151100,18,18,0,0
2,2000,151100,10,10,0,0
3,2000,151100,22,20,2,3
4,2000,151100,22,21,1,3
5,2000,151100,30,29,1,1
6,2000,151100,25,23,2,1
7,2000,151100,31,29,2,1
8,2000,151100,23,23,0,2
9,2000,151100,20,16,4,2
10,2000,151100,17,17,0,4
11,2000,151100,21,21,0,1
12,2000,151100,17,17,0,0
1,2001,151100,30,29,1,2
2,2001,151100,12,12,0,1
3,2001,151100,9,9,0,2
4,2001,151100,12,12,0,2
5,2001,151100,20,19,1,2
6,2001,151100,13,12,1,6
7,2001,151100,18,17,1,2
8,2001,151100,26,25,1,2
9,2001,151100,21,20,1,3
10,2001,151100,20,18,2,6
11,2001,151100,14,14,0,2
12,2001,151100,14,14,0,0
1,2002,151100,21,21,0,6
2,2002,151100,21,21,0,4
3,2002,151100,13,13,0,1
4,2002,151100,25,24,1,2
5,2002,151100,25,23,2,0
6,2002,151100,19,16,3,2
7,2002,151100,17,16,1,4
8,2002,151100,21,19,2,0
9,2002,151100,18,18,0,2
10,2002,151100,23,22,1,2
11,2002,151100,20,18,2,2
12,2002,151100,33,33,0,2
1,2003,151100,26,25,1,5
2,2003,151100,15,14,1,7
3,2003,151100,24,24,0,2
4,2003,151100,17,17,0,1
5,2003,151100,14,14,0,1
6,2003,151100,23,22,1,4
7,2003,151100,22,22,0,5
8,2003,151100,27,25,2,2
9,2003,151100,22,20,2,3
10,2003,151100,24,23,1,1
11,2003,151100,15,13,2,1
12,2003,151100,26,26,0,4
1,2004,151100,12,12,0,3
2,2004,151100,16,14,2,3
3,2004,151100,14,14,0,4
4,2004,151100,16,16,0,2
5,2004,151100,20,18,2,2
6,2004,151100,11,11,0,6
7,2004,151100,12,11,1,2
8,2004,151100,12,12,0,3
9,2004,151100,11,10,1,5
10,2004,151100,10,9,1,1
11,2004,151100,15,15,0,2
12,2004,151100,21,20,1,4
1,2005,151100,12,12,0,2
2,2005,151100,11,10,1,3
3,2005,151100,14,13,1,1
4,2005,151100,10,9,1,4
5,2005,151100,6,6,0,1
6,2005,151100,8,8,0,0
7,2005,151100,10,10,0,3
8,2005,151100,20,18,2,3
9,2005,151100,9,8,1,2
10,2005,151100,17,15,2,2
11,2005,151100,12,12,0,2
12,2005,151100,18,15,3,0
1,2006,151100,14,14,0,2
2,2006,151100,9,9,0,0
3,2006,151100,9,9,0,1
4,2006,151100,9,9,0,5
5,2006,151100,21,21,0,3
6,2006,151100,12,12,0,2
7,2006,151100,10,10,0,4
8,2006,151100,10,10,0,0
9,2006,151100,7,7,0,4
10,2006,151100,10,9,1,3
11,2006,151100,12,11,1,2
12,2006,151100,15,15,0,2
1,2007,151100,13,13,0,1
2,2007,151100,9,9,0,1
3,2007,151100,7,6,1,1
4,2007,151100,9,7,2,4
5,2007,151100,8,8,0,1
6,2007,151100,16,16,0,1
7,2007,151100,15,14,1,0
8,2007,151100,9,8,1,1
9,2007,151100,11,11,0,0
10,2007,151100,17,14,3,3
11,2007,151100,15,12,3,4
12,2007,151100,11,11,0,2
1,2008,151100,12,12,0,4
2,2008,151100,5,5,0,5
3,2008,151100,9,8,1,1
4,2008,151100,13,13,0,5
5,2008,151100,11,10,1,8
6,2008,151100,14,14,0,2
7,2008,151100,15,14,1,2
8,2008,151100,19,16,3,4
9,2008,151100,20,18,2,4
10,2008,151100,13,12,1,5
11,2008,151100,10,9,1,2
12,2008,151100,19,18,1,4
1,2009,151100,28,28,0,1
2,2009,151100,9,9,0,0
3,2009,151100,10,10,0,3
4,2009,151100,7,7,0,4
5,2009,151100,13,12,1,1
6,2009,151100,10,9,1,1
7,2009,151100,11,11,0,1
8,2009,151100,10,9,1,4
9,2009,151100,11,8,3,2
10,2009,151100,7,7,0,0
11,2009,151100,14,13,1,0
12,2009,151100,11,10,1,0
1,2010,151100,14,13,1,1
2,2010,151100,7,7,0,0
3,2010,151100,5,5,0,7
4,2010,151100,10,10,0,0
5,2010,151100,11,10,1,1
6,2010,151100,7,7,0,2
7,2010,151100,11,10,1,2
8,2010,151100,9,9,0,0
9,2010,151100,14,14,0,0
10,2010,151100,16,14,2,2
11,2010,151100,4,4,0,3
12,2010,151100,15,13,2,1
1,2011,151100,15,14,1,1
2,2011,151100,5,5,0,1
1,1999,831100,33,32,1,4
2,1999,831100,52,50,2,5
3,1999,831100,30,28,2,4
4,1999,831100,54,51,3,4
5,1999,831100,62,57,5,3
6,1999,831100,57,54,3,2
7,1999,831100,46,42,4,1
8,1999,831100,65,59,6,8
9,1999,831100,49,43,6,2
10,1999,831100,74,73,1,1
11,1999,831100,59,57,2,3
12,1999,831100,50,47,3,0
1,2000,831100,49,44,5,2
2,2000,831100,42,40,2,1
3,2000,831100,51,46,5,2
4,2000,831100,38,33,5,5
5,2000,831100,49,44,5,4
6,2000,831100,50,50,0,6
7,2000,831100,50,48,2,3
8,2000,831100,45,43,2,9
9,2000,831100,64,61,3,1
10,2000,831100,63,59,4,7
11,2000,831100,50,47,3,7
12,2000,831100,40,38,2,3
1,2001,831100,39,36,3,6
2,2001,831100,33,29,4,2
3,2001,831100,38,35,3,6
4,2001,831100,38,31,7,5
5,2001,831100,50,49,1,4
6,2001,831100,50,47,3,2
7,2001,831100,64,59,5,4
8,2001,831100,71,62,9,3
9,2001,831100,72,68,4,4
10,2001,831100,45,42,3,6
11,2001,831100,44,42,2,6
12,2001,831100,42,41,1,2
1,2002,831100,45,43,2,4
2,2002,831100,29,27,2,2
3,2002,831100,34,34,0,4
4,2002,831100,44,40,4,5
5,2002,831100,41,36,5,2
6,2002,831100,47,42,5,7
7,2002,831100,40,37,3,1
8,2002,831100,56,55,1,3
9,2002,831100,64,54,10,4
10,2002,831100,48,45,3,1
11,2002,831100,58,53,5,3
12,2002,831100,35,33,2,8
1,2003,831100,50,48,2,3
2,2003,831100,46,43,3,1
3,2003,831100,48,45,3,5
4,2003,831100,44,38,6,4
5,2003,831100,32,31,1,1
6,2003,831100,33,32,1,0
7,2003,831100,51,49,2,3
8,2003,831100,59,55,4,5
9,2003,831100,46,44,2,6
10,2003,831100,38,38,0,5
11,2003,831100,42,39,3,6
12,2003,831100,39,38,1,2
1,2004,831100,44,41,3,4
2,2004,831100,35,32,3,5
3,2004,831100,37,33,4,7
4,2004,831100,39,36,3,6
5,2004,831100,35,33,2,7
6,2004,831100,43,39,4,1
7,2004,831100,46,44,2,4
8,2004,831100,44,41,3,5
9,2004,831100,35,32,3,4
10,2004,831100,33,26,7,0
11,2004,831100,30,29,1,5
12,2004,831100,51,49,2,1
1,2005,831100,43,41,2,4
2,2005,831100,29,25,4,8
3,2005,831100,41,39,2,5
4,2005,831100,35,32,3,5
5,2005,831100,30,29,1,5
6,2005,831100,39,36,3,6
7,2005,831100,43,40,3,10
8,2005,831100,42,40,2,3
9,2005,831100,37,36,1,1
10,2005,831100,34,32,2,5
11,2005,831100,30,28,2,2
12,2005,831100,31,30,1,2
1,2006,831100,50,49,1,4
2,2006,831100,23,22,1,6
3,2006,831100,22,21,1,1
4,2006,831100,37,30,7,5
5,2006,831100,39,34,5,5
6,2006,831100,38,33,5,4
7,2006,831100,29,26,3,9
8,2006,831100,33,32,1,5
9,2006,831100,26,25,1,4
10,2006,831100,29,29,0,2
11,2006,831100,20,20,0,1
12,2006,831100,21,20,1,1
1,2007,831100,29,27,2,8
2,2007,831100,18,16,2,3
3,2007,831100,34,33,1,4
4,2007,831100,37,36,1,6
5,2007,831100,29,24,5,4
6,2007,831100,49,47,2,6
7,2007,831100,40,36,4,5
8,2007,831100,28,26,2,2
9,2007,831100,29,27,2,5
10,2007,831100,31,29,2,4
11,2007,831100,26,22,4,1
12,2007,831100,25,25,0,5
1,2008,831100,34,33,1,1
2,2008,831100,22,18,4,6
3,2008,831100,18,16,2,8
4,2008,831100,27,24,3,3
5,2008,831100,29,26,3,4
6,2008,831100,35,32,3,0
7,2008,831100,28,26,2,1
8,2008,831100,28,24,4,2
9,2008,831100,32,32,0,1
10,2008,831100,39,37,2,5
11,2008,831100,39,35,4,4
12,2008,831100,35,32,3,0
1,2009,831100,34,32,2,6
2,2009,831100,22,20,2,2
3,2009,831100,27,24,3,1
4,2009,831100,28,26,2,6
5,2009,831100,36,34,2,6
6,2009,831100,38,33,5,10
7,2009,831100,38,35,3,7
8,2009,831100,35,33,2,0
9,2009,831100,30,28,2,8
10,2009,831100,32,27,5,1
11,2009,831100,42,38,4,4
12,2009,831100,43,43,0,5
1,2010,831100,38,35,3,6
2,2010,831100,25,24,1,2
3,2010,831100,35,31,4,4
4,2010,831100,30,29,1,4
5,2010,831100,33,29,4,4
6,2010,831100,31,29,2,2
7,2010,831100,41,40,1,3
8,2010,831100,36,32,4,3
9,2010,831100,33,31,2,3
10,2010,831100,42,39,3,3
11,2010,831100,46,41,5,4
12,2010,831100,30,28,2,6
1,2011,831100,25,25,0,9
2,2011,831100,19,16,3,2
1,1999,170700,2,2,0,0
2,1999,170700,3,3,0,0
3,1999,170700,6,5,1,0
4,1999,170700,1,1,0,0
5,1999,170700,4,2,2,1
6,1999,170700,6,5,1,0
7,1999,170700,4,4,0,0
8,1999,170700,4,3,1,2
9,1999,170700,3,3,0,1
10,1999,170700,3,2,1,0
11,1999,170700,5,5,0,0
12,1999,170700,3,3,0,0
1,2000,170700,1,1,0,0
2,2000,170700,8,8,0,0
3,2000,170700,1,1,0,0
4,2000,170700,6,6,0,0
5,2000,170700,6,6,0,0
6,2000,170700,7,7,0,0
7,2000,170700,6,5,1,1
8,2000,170700,3,2,1,0
9,2000,170700,5,5,0,0
10,2000,170700,6,6,0,1
11,2000,170700,6,6,0,0
12,2000,170700,4,4,0,0
1,2001,170700,4,4,0,0
2,2001,170700,1,1,0,0
3,2001,170700,1,1,0,0
4,2001,170700,6,4,2,0
5,2001,170700,4,4,0,0
6,2001,170700,4,3,1,0
7,2001,170700,3,3,0,0
8,2001,170700,2,2,0,0
9,2001,170700,2,1,1,0
10,2001,170700,4,3,1,0
11,2001,170700,3,3,0,0
12,2001,170700,8,8,0,0
1,2002,170700,7,7,0,0
2,2002,170700,4,4,0,0
3,2002,170700,1,1,0,1
4,2002,170700,1,0,1,0
5,2002,170700,4,3,1,0
6,2002,170700,9,8,1,0
7,2002,170700,3,3,0,0
8,2002,170700,4,4,0,0
9,2002,170700,2,2,0,0
10,2002,170700,5,5,0,0
11,2002,170700,5,5,0,0
12,2002,170700,5,5,0,0
1,2003,170700,6,6,0,0
2,2003,170700,4,4,0,0
3,2003,170700,3,2,1,0
4,2003,170700,8,8,0,0
5,2003,170700,5,5,0,0
6,2003,170700,5,5,0,0
7,2003,170700,5,4,1,0
8,2003,170700,8,8,0,0
9,2003,170700,3,3,0,0
10,2003,170700,1,1,0,0
11,2003,170700,1,1,0,0
12,2003,170700,5,5,0,0
1,2004,170700,2,2,0,0
2,2004,170700,3,3,0,0
3,2004,170700,5,4,1,1
4,2004,170700,1,1,0,0
5,2004,170700,6,6,0,1
6,2004,170700,2,2,0,0
7,2004,170700,5,5,0,0
8,2004,170700,5,4,1,0
9,2004,170700,7,7,0,0
10,2004,170700,6,6,0,1
11,2004,170700,2,2,0,0
12,2004,170700,3,3,0,1
1,2005,170700,3,3,0,0
2,2005,170700,5,4,1,0
3,2005,170700,8,7,1,0
4,2005,170700,5,5,0,1
5,2005,170700,4,4,0,2
6,2005,170700,2,2,0,0
7,2005,170700,4,3,1,0
8,2005,170700,3,3,0,0
9,2005,170700,4,3,1,0
10,2005,170700,4,4,0,1
11,2005,170700,9,9,0,0
12,2005,170700,7,6,1,0
1,2006,170700,1,1,0,0
2,2006,170700,0,0,0,0
3,2006,170700,1,1,0,0
4,2006,170700,3,3,0,0
5,2006,170700,3,3,0,0
6,2006,170700,5,4,1,0
7,2006,170700,1,0,1,0
8,2006,170700,3,3,0,0
9,2006,170700,5,5,0,0
10,2006,170700,3,3,0,0
11,2006,170700,4,4,0,0
12,2006,170700,0,0,0,1
1,2007,170700,3,3,0,0
2,2007,170700,3,3,0,0
3,2007,170700,3,3,0,0
4,2007,170700,7,6,1,0
5,2007,170700,3,2,1,0
6,2007,170700,6,6,0,0
7,2007,170700,9,9,0,0
8,2007,170700,2,2,0,0
9,2007,170700,2,2,0,0
10,2007,170700,3,3,0,0
11,2007,170700,1,1,0,0
12,2007,170700,8,8,0,0
1,2008,170700,2,2,0,0
2,2008,170700,4,4,0,0
3,2008,170700,5,5,0,0
4,2008,170700,7,6,1,3
5,2008,170700,6,5,1,0
6,2008,170700,5,5,0,0
7,2008,170700,2,2,0,1
8,2008,170700,4,3,1,0
9,2008,170700,6,6,0,0
10,2008,170700,7,7,0,0
11,2008,170700,2,2,0,0
12,2008,170700,6,6,0,0
1,2009,170700,6,6,0,0
2,2009,170700,4,4,0,0
3,2009,170700,2,2,0,0
4,2009,170700,6,5,1,0
5,2009,170700,5,5,0,0
6,2009,170700,6,5,1,1
7,2009,170700,5,4,1,3
8,2009,170700,5,5,0,0
9,2009,170700,11,11,0,0
10,2009,170700,0,0,0,0
11,2009,170700,2,2,0,0
12,2009,170700,3,3,0,0
1,2010,170700,2,2,0,0
2,2010,170700,1,1,0,1
3,2010,170700,4,3,1,0
4,2010,170700,5,4,1,3
5,2010,170700,4,4,0,1
6,2010,170700,2,1,1,1
7,2010,170700,3,3,0,0
8,2010,170700,2,2,0,0
9,2010,170700,3,3,0,0
10,2010,170700,7,6,1,1
11,2010,170700,4,4,0,0
12,2010,170700,4,4,0,0
1,2011,170700,0,0,0,1
2,2011,170700,1,0,1,0
1,1999,151001,4,4,0,0
2,1999,151001,6,6,0,1
3,1999,151001,8,7,1,1
4,1999,151001,9,8,1,0
5,1999,151001,13,13,0,1
6,1999,151001,4,3,1,0
7,1999,151001,9,8,1,1
8,1999,151001,9,9,0,8
9,1999,151001,5,5,0,1
10,1999,151001,8,7,1,2
11,1999,151001,4,4,0,1
12,1999,151001,5,5,0,1
1,2000,151001,7,6,1,1
2,2000,151001,5,4,1,2
3,2000,151001,6,5,1,1
4,2000,151001,3,3,0,1
5,2000,151001,15,14,1,2
6,2000,151001,10,10,0,0
7,2000,151001,16,15,1,1
8,2000,151001,5,3,2,1
9,2000,151001,9,9,0,1
10,2000,151001,7,7,0,2
11,2000,151001,12,12,0,1
12,2000,151001,9,8,1,1
1,2001,151001,9,8,1,0
2,2001,151001,2,2,0,1
3,2001,151001,3,3,0,0
4,2001,151001,8,8,0,0
5,2001,151001,3,3,0,2
6,2001,151001,10,10,0,0
7,2001,151001,5,4,1,0
8,2001,151001,9,9,0,0
9,2001,151001,10,10,0,5
10,2001,151001,15,14,1,1
11,2001,151001,9,8,1,3
12,2001,151001,5,5,0,0
1,2002,151001,5,4,1,0
2,2002,151001,5,5,0,1
3,2002,151001,5,5,0,1
4,2002,151001,3,3,0,3
5,2002,151001,8,8,0,0
6,2002,151001,8,7,1,3
7,2002,151001,11,11,0,1
8,2002,151001,3,2,1,7
9,2002,151001,8,7,1,1
10,2002,151001,5,5,0,0
11,2002,151001,11,11,0,2
12,2002,151001,13,10,3,0
1,2003,151001,10,10,0,3
2,2003,151001,7,6,1,4
3,2003,151001,7,7,0,2
4,2003,151001,10,9,1,2
5,2003,151001,7,7,0,3
6,2003,151001,11,11,0,4
7,2003,151001,12,12,0,3
8,2003,151001,4,4,0,4
9,2003,151001,9,9,0,1
10,2003,151001,10,10,0,1
11,2003,151001,13,13,0,1
12,2003,151001,6,6,0,4
1,2004,151001,9,6,3,3
2,2004,151001,7,7,0,8
3,2004,151001,13,12,1,5
4,2004,151001,6,3,3,2
5,2004,151001,4,4,0,1
6,2004,151001,13,13,0,0
7,2004,151001,9,7,2,8
8,2004,151001,10,9,1,4
9,2004,151001,4,4,0,2
10,2004,151001,6,6,0,1
11,2004,151001,3,3,0,2
12,2004,151001,3,3,0,2
1,2005,151001,9,8,1,2
2,2005,151001,4,3,1,3
3,2005,151001,7,7,0,0
4,2005,151001,13,12,1,5
5,2005,151001,10,9,1,5
6,2005,151001,5,3,2,5
7,2005,151001,7,5,2,2
8,2005,151001,12,9,3,1
9,2005,151001,13,13,0,1
10,2005,151001,11,11,0,1
11,2005,151001,10,10,0,3
12,2005,151001,13,13,0,4
1,2006,151001,10,8,2,5
2,2006,151001,4,4,0,1
3,2006,151001,9,8,1,0
4,2006,151001,1,1,0,2
5,2006,151001,8,8,0,2
6,2006,151001,5,4,1,1
7,2006,151001,6,4,2,0
8,2006,151001,5,5,0,1
9,2006,151001,4,4,0,4
10,2006,151001,1,1,0,4
11,2006,151001,5,5,0,0
12,2006,151001,5,3,2,2
1,2007,151001,5,5,0,1
2,2007,151001,5,5,0,0
3,2007,151001,6,4,2,4
4,2007,151001,7,4,3,1
5,2007,151001,2,2,0,0
6,2007,151001,5,5,0,1
7,2007,151001,5,4,1,1
8,2007,151001,9,9,0,0
9,2007,151001,5,3,2,2
10,2007,151001,5,5,0,0
11,2007,151001,9,9,0,0
12,2007,151001,7,6,1,1
1,2008,151001,3,3,0,2
2,2008,151001,3,3,0,1
3,2008,151001,5,5,0,4
4,2008,151001,7,5,2,2
5,2008,151001,7,7,0,2
6,2008,151001,4,3,1,3
7,2008,151001,9,8,1,2
8,2008,151001,6,6,0,2
9,2008,151001,6,6,0,3
10,2008,151001,8,8,0,1
11,2008,151001,5,4,1,3
12,2008,151001,2,2,0,4
1,2009,151001,7,6,1,2
2,2009,151001,4,4,0,1
3,2009,151001,4,4,0,3
4,2009,151001,10,8,2,4
5,2009,151001,4,4,0,2
6,2009,151001,3,3,0,1
7,2009,151001,2,1,1,2
8,2009,151001,7,6,1,5
9,2009,151001,4,4,0,5
10,2009,151001,6,6,0,1
11,2009,151001,2,2,0,2
12,2009,151001,2,2,0,1
1,2010,151001,9,8,1,4
2,2010,151001,0,0,0,4
3,2010,151001,7,5,2,2
4,2010,151001,4,3,1,2
5,2010,151001,4,4,0,1
6,2010,151001,9,8,1,3
7,2010,151001,8,6,2,2
8,2010,151001,6,5,1,3
9,2010,151001,8,8,0,1
10,2010,151001,6,6,0,0
11,2010,151001,0,0,0,1
12,2010,151001,4,4,0,1
1,2011,151001,6,5,1,0
2,2011,151001,1,1,0,0
1,1999,210100,21,19,2,1
2,1999,210100,21,20,1,1
3,1999,210100,18,18,0,2
4,1999,210100,22,21,1,1
5,1999,210100,27,24,3,4
6,1999,210100,31,29,2,0
7,1999,210100,25,22,3,5
8,1999,210100,34,29,5,4
9,1999,210100,26,24,2,0
10,1999,210100,33,30,3,3
11,1999,210100,25,24,1,2
12,1999,210100,24,22,2,2
1,2000,210100,15,13,2,2
2,2000,210100,13,13,0,3
3,2000,210100,19,16,3,2
4,2000,210100,29,27,2,2
5,2000,210100,28,24,4,4
6,2000,210100,24,22,2,2
7,2000,210100,31,26,5,4
8,2000,210100,23,20,3,5
9,2000,210100,17,15,2,1
10,2000,210100,15,15,0,5
11,2000,210100,24,23,1,3
12,2000,210100,20,17,3,5
1,2001,210100,18,14,4,1
2,2001,210100,15,15,0,3
3,2001,210100,21,19,2,2
4,2001,210100,15,11,4,2
5,2001,210100,22,20,2,1
6,2001,210100,21,20,1,1
7,2001,210100,37,35,2,1
8,2001,210100,34,33,1,3
9,2001,210100,40,40,0,6
10,2001,210100,25,25,0,1
11,2001,210100,26,26,0,1
12,2001,210100,23,22,1,0
1,2002,210100,15,12,3,3
2,2002,210100,21,19,2,3
3,2002,210100,21,20,1,1
4,2002,210100,14,13,1,1
5,2002,210100,40,35,5,0
6,2002,210100,27,24,3,4
7,2002,210100,18,17,1,0
8,2002,210100,25,22,3,0
9,2002,210100,26,24,2,4
10,2002,210100,21,21,0,0
11,2002,210100,32,31,1,0
12,2002,210100,16,14,2,1
1,2003,210100,21,21,0,3
2,2003,210100,21,19,2,0
3,2003,210100,16,16,0,4
4,2003,210100,33,32,1,0
5,2003,210100,17,13,4,3
6,2003,210100,13,12,1,0
7,2003,210100,14,14,0,1
8,2003,210100,18,15,3,1
9,2003,210100,18,15,3,2
10,2003,210100,26,25,1,4
11,2003,210100,9,8,1,1
12,2003,210100,20,19,1,1
1,2004,210100,27,27,0,3
2,2004,210100,16,16,0,3
3,2004,210100,20,19,1,2
4,2004,210100,27,25,2,2
5,2004,210100,26,23,3,2
6,2004,210100,19,18,1,0
7,2004,210100,22,20,2,5
8,2004,210100,19,16,3,1
9,2004,210100,22,19,3,2
10,2004,210100,16,15,1,1
11,2004,210100,14,13,1,3
12,2004,210100,27,26,1,1
1,2005,210100,29,27,2,7
2,2005,210100,17,13,4,0
3,2005,210100,13,13,0,0
4,2005,210100,26,25,1,1
5,2005,210100,25,23,2,1
6,2005,210100,25,21,4,0
7,2005,210100,17,15,2,1
8,2005,210100,33,32,1,0
9,2005,210100,18,16,2,0
10,2005,210100,19,18,1,1
11,2005,210100,13,11,2,1
12,2005,210100,13,13,0,2
1,2006,210100,17,17,0,3
2,2006,210100,16,14,2,2
3,2006,210100,21,20,1,0
4,2006,210100,14,13,1,2
5,2006,210100,13,10,3,0
6,2006,210100,20,18,2,6
7,2006,210100,16,11,5,0
8,2006,210100,25,22,3,0
9,2006,210100,23,22,1,0
10,2006,210100,16,15,1,4
11,2006,210100,16,16,0,3
12,2006,210100,16,14,2,1
1,2007,210100,15,13,2,2
2,2007,210100,8,8,0,3
3,2007,210100,15,14,1,1
4,2007,210100,7,6,1,1
5,2007,210100,24,23,1,5
6,2007,210100,12,10,2,0
7,2007,210100,24,19,5,4
8,2007,210100,14,13,1,1
9,2007,210100,15,13,2,2
10,2007,210100,22,22,0,2
11,2007,210100,21,20,1,0
12,2007,210100,12,12,0,0
1,2008,210100,21,20,1,0
2,2008,210100,12,11,1,2
3,2008,210100,17,16,1,1
4,2008,210100,11,9,2,1
5,2008,210100,15,15,0,0
6,2008,210100,18,18,0,0
7,2008,210100,23,22,1,1
8,2008,210100,15,14,1,1
9,2008,210100,21,18,3,1
10,2008,210100,20,19,1,0
11,2008,210100,19,19,0,0
12,2008,210100,15,15,0,0
1,2009,210100,17,16,1,0
2,2009,210100,16,16,0,1
3,2009,210100,15,13,2,1
4,2009,210100,15,14,1,0
5,2009,210100,17,17,0,0
6,2009,210100,12,12,0,0
7,2009,210100,14,14,0,1
8,2009,210100,19,17,2,0
9,2009,210100,16,15,1,1
10,2009,210100,19,18,1,2
11,2009,210100,22,22,0,0
12,2009,210100,27,23,4,0
1,2010,210100,21,21,0,2
2,2010,210100,12,12,0,0
3,2010,210100,22,21,1,1
4,2010,210100,20,17,3,0
5,2010,210100,24,24,0,0
6,2010,210100,26,21,5,0
7,2010,210100,18,17,1,3
8,2010,210100,15,15,0,2
9,2010,210100,20,19,1,2
10,2010,210100,24,21,3,0
11,2010,210100,13,13,0,1
12,2010,210100,13,13,0,3
1,2011,210100,13,12,1,2
2,2011,210100,10,10,0,1
1,1999,170800,2,2,0,1
2,1999,170800,4,4,0,0
3,1999,170800,2,2,0,0
4,1999,170800,4,4,0,0
5,1999,170800,3,3,0,0
6,1999,170800,5,3,2,0
7,1999,170800,11,11,0,0
8,1999,170800,4,4,0,0
9,1999,170800,3,3,0,0
10,1999,170800,10,10,0,3
11,1999,170800,8,8,0,0
12,1999,170800,15,15,0,0
1,2000,170800,7,7,0,0
2,2000,170800,1,1,0,0
3,2000,170800,7,7,0,0
4,2000,170800,2,2,0,0
5,2000,170800,9,8,1,0
6,2000,170800,8,8,0,0
7,2000,170800,9,9,0,0
8,2000,170800,4,4,0,0
9,2000,170800,6,6,0,1
10,2000,170800,9,9,0,0
11,2000,170800,10,10,0,0
12,2000,170800,4,3,1,0
1,2001,170800,5,4,1,3
2,2001,170800,6,6,0,0
3,2001,170800,8,6,2,0
4,2001,170800,1,1,0,0
5,2001,170800,4,4,0,0
6,2001,170800,5,5,0,0
7,2001,170800,6,6,0,0
8,2001,170800,4,4,0,0
9,2001,170800,3,3,0,0
10,2001,170800,3,3,0,0
11,2001,170800,5,4,1,0
12,2001,170800,4,4,0,0
1,2002,170800,7,5,2,1
2,2002,170800,3,3,0,0
3,2002,170800,7,6,1,0
4,2002,170800,5,4,1,2
5,2002,170800,5,5,0,0
6,2002,170800,4,3,1,1
7,2002,170800,4,2,2,0
8,2002,170800,0,0,0,0
9,2002,170800,3,2,1,0
10,2002,170800,4,4,0,0
11,2002,170800,7,6,1,0
12,2002,170800,6,5,1,0
1,2003,170800,3,3,0,1
2,2003,170800,3,3,0,0
3,2003,170800,9,9,0,0
4,2003,170800,2,2,0,0
5,2003,170800,7,6,1,0
6,2003,170800,2,2,0,2
7,2003,170800,10,9,1,0
8,2003,170800,14,14,0,0
9,2003,170800,12,12,0,2
10,2003,170800,3,3,0,1
11,2003,170800,4,4,0,0
12,2003,170800,5,5,0,1
1,2004,170800,8,7,1,1
2,2004,170800,5,5,0,0
3,2004,170800,7,7,0,0
4,2004,170800,9,9,0,0
5,2004,170800,2,2,0,1
6,2004,170800,5,5,0,1
7,2004,170800,5,5,0,1
8,2004,170800,1,1,0,0
9,2004,170800,3,1,2,0
10,2004,170800,8,6,2,0
11,2004,170800,3,3,0,1
12,2004,170800,1,1,0,0
1,2005,170800,5,5,0,1
2,2005,170800,5,5,0,2
3,2005,170800,11,10,1,0
4,2005,170800,6,5,1,2
5,2005,170800,6,5,1,1
6,2005,170800,5,5,0,0
7,2005,170800,8,8,0,1
8,2005,170800,3,3,0,1
9,2005,170800,4,3,1,0
10,2005,170800,5,5,0,1
11,2005,170800,4,4,0,0
12,2005,170800,6,6,0,0
1,2006,170800,7,7,0,0
2,2006,170800,3,2,1,0
3,2006,170800,6,6,0,0
4,2006,170800,5,5,0,1
5,2006,170800,4,4,0,0
6,2006,170800,4,4,0,0
7,2006,170800,4,2,2,0
8,2006,170800,0,0,0,2
9,2006,170800,1,1,0,0
10,2006,170800,3,3,0,0
11,2006,170800,3,3,0,0
12,2006,170800,4,3,1,0
1,2007,170800,5,5,0,0
2,2007,170800,8,8,0,0
3,2007,170800,6,6,0,1
4,2007,170800,5,5,0,1
5,2007,170800,4,4,0,0
6,2007,170800,3,3,0,0
7,2007,170800,3,3,0,0
8,2007,170800,5,5,0,1
9,2007,170800,5,5,0,0
10,2007,170800,4,4,0,1
11,2007,170800,9,9,0,0
12,2007,170800,9,9,0,0
1,2008,170800,4,4,0,0
2,2008,170800,7,7,0,0
3,2008,170800,4,4,0,2
4,2008,170800,3,3,0,0
5,2008,170800,6,5,1,0
6,2008,170800,10,10,0,0
7,2008,170800,7,5,2,1
8,2008,170800,2,1,1,0
9,2008,170800,12,11,1,1
10,2008,170800,12,12,0,1
11,2008,170800,5,5,0,0
12,2008,170800,4,4,0,0
1,2009,170800,7,7,0,0
2,2009,170800,3,3,0,0
3,2009,170800,3,3,0,0
4,2009,170800,10,9,1,0
5,2009,170800,3,2,1,0
6,2009,170800,6,6,0,0
7,2009,170800,10,9,1,0
8,2009,170800,8,7,1,0
9,2009,170800,6,6,0,0
10,2009,170800,4,3,1,0
11,2009,170800,1,1,0,1
12,2009,170800,2,2,0,0
1,2010,170800,3,2,1,0
2,2010,170800,2,2,0,0
3,2010,170800,4,4,0,0
4,2010,170800,2,1,1,2
5,2010,170800,5,5,0,0
6,2010,170800,7,6,1,0
7,2010,170800,4,4,0,0
8,2010,170800,5,3,2,2
9,2010,170800,8,7,1,0
10,2010,170800,4,3,1,0
11,2010,170800,6,6,0,0
12,2010,170800,8,7,1,2
1,2011,170800,3,3,0,0
2,2011,170800,2,1,1,0
1,1999,151002,10,9,1,1
2,1999,151002,7,6,1,5
3,1999,151002,13,12,1,0
4,1999,151002,11,11,0,1
5,1999,151002,10,10,0,6
6,1999,151002,16,16,0,2
7,1999,151002,16,14,2,1
8,1999,151002,16,14,2,2
9,1999,151002,18,17,1,2
10,1999,151002,5,3,2,6
11,1999,151002,15,15,0,3
12,1999,151002,9,7,2,3
1,2000,151002,12,11,1,5
2,2000,151002,12,10,2,3
3,2000,151002,14,12,2,0
4,2000,151002,23,23,0,3
5,2000,151002,14,13,1,2
6,2000,151002,15,13,2,3
7,2000,151002,16,15,1,1
8,2000,151002,22,20,2,2
9,2000,151002,17,12,5,6
10,2000,151002,12,11,1,0
11,2000,151002,15,14,1,4
12,2000,151002,13,12,1,4
1,2001,151002,16,16,0,0
2,2001,151002,17,16,1,3
3,2001,151002,15,15,0,1
4,2001,151002,12,11,1,3
5,2001,151002,16,15,1,2
6,2001,151002,19,17,2,2
7,2001,151002,16,13,3,0
8,2001,151002,8,8,0,1
9,2001,151002,23,20,3,0
10,2001,151002,14,13,1,2
11,2001,151002,12,12,0,1
12,2001,151002,12,12,0,1
1,2002,151002,19,17,2,3
2,2002,151002,14,11,3,1
3,2002,151002,15,14,1,1
4,2002,151002,24,23,1,4
5,2002,151002,16,15,1,2
6,2002,151002,8,7,1,0
7,2002,151002,21,19,2,0
8,2002,151002,16,15,1,5
9,2002,151002,19,18,1,0
10,2002,151002,19,18,1,1
11,2002,151002,17,16,1,2
12,2002,151002,20,19,1,3
1,2003,151002,20,20,0,1
2,2003,151002,13,13,0,1
3,2003,151002,17,17,0,1
4,2003,151002,13,12,1,5
5,2003,151002,19,16,3,4
6,2003,151002,14,12,2,7
7,2003,151002,15,13,2,2
8,2003,151002,13,11,2,5
9,2003,151002,26,25,1,1
10,2003,151002,24,19,5,4
11,2003,151002,18,16,2,2
12,2003,151002,20,18,2,5
1,2004,151002,14,13,1,1
2,2004,151002,8,8,0,2
3,2004,151002,12,12,0,4
4,2004,151002,18,18,0,3
5,2004,151002,11,11,0,2
6,2004,151002,23,20,3,2
7,2004,151002,16,14,2,7
8,2004,151002,18,15,3,2
9,2004,151002,7,5,2,5
10,2004,151002,10,8,2,5
11,2004,151002,10,7,3,3
12,2004,151002,10,10,0,3
1,2005,151002,9,9,0,1
2,2005,151002,6,6,0,1
3,2005,151002,12,11,1,2
4,2005,151002,18,15,3,6
5,2005,151002,11,9,2,2
6,2005,151002,6,6,0,5
7,2005,151002,9,8,1,3
8,2005,151002,15,11,4,4
9,2005,151002,19,17,2,4
10,2005,151002,9,8,1,4
11,2005,151002,18,15,3,4
12,2005,151002,12,12,0,1
1,2006,151002,21,20,1,4
2,2006,151002,18,16,2,3
3,2006,151002,8,7,1,6
4,2006,151002,11,6,5,0
5,2006,151002,11,11,0,9
6,2006,151002,18,15,3,2
7,2006,151002,8,7,1,2
8,2006,151002,26,25,1,8
9,2006,151002,14,13,1,4
10,2006,151002,11,11,0,3
11,2006,151002,10,9,1,2
12,2006,151002,9,9,0,3
1,2007,151002,9,7,2,1
2,2007,151002,4,4,0,2
3,2007,151002,12,12,0,3
4,2007,151002,6,4,2,5
5,2007,151002,9,9,0,4
6,2007,151002,16,11,5,2
7,2007,151002,16,16,0,3
8,2007,151002,15,11,4,3
9,2007,151002,9,8,1,3
10,2007,151002,11,11,0,9
11,2007,151002,14,11,3,6
12,2007,151002,11,10,1,4
1,2008,151002,10,10,0,4
2,2008,151002,11,11,0,3
3,2008,151002,11,10,1,2
4,2008,151002,6,5,1,3
5,2008,151002,16,15,1,1
6,2008,151002,14,13,1,2
7,2008,151002,17,16,1,3
8,2008,151002,20,16,4,3
9,2008,151002,15,13,2,5
10,2008,151002,17,17,0,2
11,2008,151002,6,6,0,5
12,2008,151002,12,11,1,2
1,2009,151002,13,13,0,4
2,2009,151002,8,8,0,4
3,2009,151002,17,15,2,5
4,2009,151002,12,11,1,1
5,2009,151002,13,10,3,3
6,2009,151002,10,8,2,4
7,2009,151002,12,12,0,2
8,2009,151002,8,8,0,2
9,2009,151002,16,15,1,5
10,2009,151002,12,12,0,1
11,2009,151002,14,14,0,3
12,2009,151002,13,12,1,0
1,2010,151002,10,10,0,1
2,2010,151002,6,5,1,3
3,2010,151002,12,12,0,1
4,2010,151002,13,13,0,1
5,2010,151002,6,3,3,2
6,2010,151002,11,7,4,2
7,2010,151002,11,9,2,5
8,2010,151002,11,10,1,2
9,2010,151002,12,11,1,4
10,2010,151002,22,22,0,0
11,2010,151002,14,13,1,3
12,2010,151002,9,9,0,0
1,2011,151002,14,14,0,0
2,2011,151002,6,5,1,1
1,1999,051000,6,5,1,1
2,1999,051000,8,8,0,3
3,1999,051000,3,3,0,4
4,1999,051000,2,2,0,1
5,1999,051000,7,7,0,4
6,1999,051000,8,7,1,1
7,1999,051000,10,10,0,4
8,1999,051000,8,6,2,5
9,1999,051000,7,6,1,3
10,1999,051000,6,6,0,1
11,1999,051000,4,3,1,2
12,1999,051000,8,7,1,5
1,2000,051000,8,8,0,0
2,2000,051000,4,4,0,4
3,2000,051000,6,6,0,4
4,2000,051000,1,1,0,8
5,2000,051000,6,6,0,5
6,2000,051000,9,9,0,1
7,2000,051000,7,7,0,3
8,2000,051000,5,4,1,3
9,2000,051000,11,9,2,3
10,2000,051000,5,5,0,2
11,2000,051000,2,2,0,3
12,2000,051000,5,5,0,2
1,2001,051000,3,3,0,1
2,2001,051000,1,0,1,1
3,2001,051000,7,7,0,2
4,2001,051000,5,5,0,2
5,2001,051000,7,5,2,4
6,2001,051000,5,5,0,1
7,2001,051000,0,0,0,1
8,2001,051000,6,6,0,2
9,2001,051000,5,5,0,3
10,2001,051000,9,9,0,4
11,2001,051000,2,2,0,3
12,2001,051000,7,6,1,1
1,2002,051000,11,10,1,1
2,2002,051000,4,4,0,3
3,2002,051000,8,7,1,1
4,2002,051000,7,5,2,0
5,2002,051000,5,4,1,1
6,2002,051000,2,1,1,0
7,2002,051000,6,4,2,1
8,2002,051000,5,3,2,1
9,2002,051000,7,6,1,1
10,2002,051000,8,6,2,1
11,2002,051000,12,11,1,0
12,2002,051000,7,6,1,0
1,2003,051000,11,11,0,3
2,2003,051000,8,8,0,0
3,2003,051000,6,5,1,0
4,2003,051000,11,11,0,2
5,2003,051000,3,3,0,2
6,2003,051000,6,6,0,0
7,2003,051000,6,3,3,0
8,2003,051000,8,8,0,0
9,2003,051000,3,2,1,1
10,2003,051000,5,5,0,2
11,2003,051000,3,3,0,0
12,2003,051000,1,1,0,0
1,2004,051000,9,9,0,0
2,2004,051000,2,2,0,1
3,2004,051000,3,3,0,3
4,2004,051000,2,2,0,2
5,2004,051000,6,6,0,1
6,2004,051000,5,5,0,1
7,2004,051000,10,9,1,1
8,2004,051000,11,10,1,0
9,2004,051000,4,3,1,0
10,2004,051000,8,6,2,0
11,2004,051000,3,3,0,2
12,2004,051000,2,2,0,0
1,2005,051000,3,2,1,1
2,2005,051000,5,3,2,1
3,2005,051000,1,1,0,0
4,2005,051000,3,2,1,0
5,2005,051000,6,6,0,0
6,2005,051000,5,4,1,3
7,2005,051000,5,5,0,0
8,2005,051000,11,11,0,0
9,2005,051000,2,2,0,0
10,2005,051000,2,2,0,2
11,2005,051000,2,2,0,1
12,2005,051000,2,2,0,0
1,2006,051000,5,5,0,1
2,2006,051000,5,5,0,1
3,2006,051000,2,2,0,0
4,2006,051000,9,9,0,0
5,2006,051000,5,5,0,0
6,2006,051000,2,2,0,1
7,2006,051000,9,9,0,2
8,2006,051000,10,8,2,1
9,2006,051000,2,2,0,0
10,2006,051000,8,7,1,0
11,2006,051000,2,2,0,0
12,2006,051000,3,3,0,0
1,2007,051000,10,8,2,0
2,2007,051000,5,5,0,1
3,2007,051000,5,5,0,0
4,2007,051000,5,5,0,1
5,2007,051000,6,5,1,1
6,2007,051000,2,2,0,0
7,2007,051000,6,6,0,0
8,2007,051000,5,5,0,1
9,2007,051000,6,6,0,0
10,2007,051000,5,4,1,0
11,2007,051000,6,6,0,0
12,2007,051000,1,1,0,0
1,2008,051000,3,3,0,2
2,2008,051000,4,4,0,0
3,2008,051000,5,5,0,1
4,2008,051000,1,1,0,0
5,2008,051000,8,8,0,1
6,2008,051000,5,5,0,0
7,2008,051000,4,3,1,0
8,2008,051000,9,9,0,1
9,2008,051000,5,5,0,0
10,2008,051000,3,2,1,1
11,2008,051000,6,6,0,0
12,2008,051000,6,5,1,0
1,2009,051000,10,10,0,0
2,2009,051000,2,2,0,1
3,2009,051000,5,4,1,1
4,2009,051000,6,6,0,0
5,2009,051000,7,7,0,1
6,2009,051000,2,2,0,0
7,2009,051000,6,4,2,1
8,2009,051000,8,6,2,1
9,2009,051000,7,6,1,1
10,2009,051000,8,7,1,0
11,2009,051000,3,3,0,0
12,2009,051000,9,9,0,1
1,2010,051000,4,4,0,1
2,2010,051000,2,2,0,2
3,2010,051000,4,4,0,1
4,2010,051000,4,4,0,2
5,2010,051000,2,2,0,0
6,2010,051000,5,4,1,1
7,2010,051000,11,10,1,0
8,2010,051000,3,3,0,1
9,2010,051000,3,3,0,0
10,2010,051000,8,8,0,0
11,2010,051000,3,3,0,1
12,2010,051000,6,6,0,0
1,2011,051000,4,4,0,0
2,2011,051000,4,4,0,0
1,1999,051100,3,3,0,0
2,1999,051100,2,2,0,1
3,1999,051100,3,3,0,1
4,1999,051100,0,0,0,0
5,1999,051100,4,4,0,1
6,1999,051100,5,5,0,0
7,1999,051100,3,3,0,1
8,1999,051100,2,2,0,1
9,1999,051100,4,4,0,1
10,1999,051100,0,0,0,0
11,1999,051100,2,2,0,0
12,1999,051100,3,3,0,0
1,2000,051100,8,8,0,1
2,2000,051100,4,4,0,4
3,2000,051100,6,6,0,0
4,2000,051100,9,9,0,0
5,2000,051100,5,4,1,3
6,2000,051100,2,2,0,0
7,2000,051100,3,3,0,0
8,2000,051100,1,1,0,0
9,2000,051100,4,4,0,1
10,2000,051100,2,2,0,1
11,2000,051100,5,5,0,0
12,2000,051100,1,1,0,2
1,2001,051100,5,5,0,0
2,2001,051100,0,0,0,1
3,2001,051100,6,6,0,1
4,2001,051100,0,0,0,0
5,2001,051100,4,4,0,0
6,2001,051100,3,3,0,0
7,2001,051100,6,6,0,0
8,2001,051100,3,3,0,2
9,2001,051100,7,7,0,0
10,2001,051100,2,2,0,0
11,2001,051100,3,2,1,0
12,2001,051100,2,2,0,0
1,2002,051100,2,2,0,0
2,2002,051100,0,0,0,0
3,2002,051100,2,2,0,0
4,2002,051100,2,2,0,0
5,2002,051100,5,5,0,0
6,2002,051100,6,6,0,0
7,2002,051100,2,2,0,0
8,2002,051100,4,4,0,0
9,2002,051100,2,2,0,0
10,2002,051100,6,6,0,0
11,2002,051100,3,3,0,0
12,2002,051100,1,1,0,1
1,2003,051100,4,3,1,0
2,2003,051100,7,6,1,0
3,2003,051100,9,9,0,0
4,2003,051100,3,3,0,1
5,2003,051100,4,4,0,0
6,2003,051100,5,5,0,1
7,2003,051100,3,3,0,1
8,2003,051100,6,5,1,1
9,2003,051100,2,1,1,1
10,2003,051100,3,3,0,0
11,2003,051100,2,2,0,0
12,2003,051100,1,1,0,0
1,2004,051100,5,5,0,0
2,2004,051100,0,0,0,0
3,2004,051100,1,1,0,0
4,2004,051100,2,2,0,0
5,2004,051100,4,4,0,0
6,2004,051100,3,3,0,0
7,2004,051100,3,3,0,0
8,2004,051100,6,6,0,0
9,2004,051100,5,5,0,0
10,2004,051100,6,6,0,1
11,2004,051100,8,8,0,0
12,2004,051100,0,0,0,0
1,2005,051100,5,4,1,0
2,2005,051100,0,0,0,0
3,2005,051100,1,1,0,0
4,2005,051100,0,0,0,1
5,2005,051100,6,6,0,0
6,2005,051100,1,1,0,2
7,2005,051100,4,3,1,0
8,2005,051100,4,3,1,0
9,2005,051100,2,2,0,0
10,2005,051100,3,3,0,0
11,2005,051100,3,3,0,1
12,2005,051100,1,1,0,0
1,2006,051100,5,5,0,0
2,2006,051100,1,1,0,0
3,2006,051100,1,1,0,0
4,2006,051100,2,2,0,0
5,2006,051100,2,2,0,1
6,2006,051100,3,3,0,0
7,2006,051100,6,5,1,0
8,2006,051100,1,1,0,1
9,2006,051100,5,5,0,0
10,2006,051100,3,3,0,0
11,2006,051100,1,1,0,0
12,2006,051100,4,4,0,0
1,2007,051100,2,2,0,0
2,2007,051100,2,2,0,0
3,2007,051100,5,5,0,0
4,2007,051100,3,3,0,0
5,2007,051100,3,2,1,1
6,2007,051100,5,5,0,0
7,2007,051100,4,4,0,0
8,2007,051100,5,5,0,0
9,2007,051100,6,6,0,0
10,2007,051100,5,5,0,0
11,2007,051100,2,2,0,0
12,2007,051100,0,0,0,0
1,2008,051100,1,1,0,0
2,2008,051100,9,9,0,0
3,2008,051100,3,3,0,1
4,2008,051100,4,4,0,0
5,2008,051100,3,3,0,0
6,2008,051100,5,5,0,0
7,2008,051100,3,3,0,0
8,2008,051100,6,6,0,0
9,2008,051100,7,7,0,0
10,2008,051100,2,2,0,0
11,2008,051100,4,4,0,1
12,2008,051100,3,2,1,0
1,2009,051100,1,1,0,0
2,2009,051100,0,0,0,0
3,2009,051100,4,4,0,0
4,2009,051100,5,5,0,0
5,2009,051100,6,5,1,0
6,2009,051100,4,4,0,0
7,2009,051100,6,6,0,0
8,2009,051100,5,4,1,0
9,2009,051100,2,2,0,0
10,2009,051100,4,4,0,0
11,2009,051100,1,1,0,0
12,2009,051100,2,2,0,0
1,2010,051100,0,0,0,0
2,2010,051100,0,0,0,0
3,2010,051100,6,6,0,0
4,2010,051100,5,5,0,0
5,2010,051100,6,5,1,0
6,2010,051100,2,2,0,0
7,2010,051100,4,4,0,0
8,2010,051100,6,5,1,0
9,2010,051100,5,5,0,0
10,2010,051100,1,1,0,0
11,2010,051100,2,2,0,0
12,2010,051100,1,1,0,1
1,2011,051100,1,1,0,0
2,2011,051100,3,3,0,0
1,1999,051200,2,2,0,1
2,1999,051200,3,3,0,0
3,1999,051200,3,3,0,0
4,1999,051200,2,1,1,1
5,1999,051200,3,3,0,0
6,1999,051200,8,8,0,0
7,1999,051200,2,2,0,0
8,1999,051200,2,2,0,0
9,1999,051200,7,7,0,0
10,1999,051200,3,3,0,0
11,1999,051200,6,6,0,0
12,1999,051200,5,5,0,0
1,2000,051200,2,2,0,2
2,2000,051200,3,3,0,0
3,2000,051200,8,8,0,0
4,2000,051200,7,7,0,2
5,2000,051200,7,7,0,0
6,2000,051200,8,8,0,0
7,2000,051200,7,7,0,0
8,2000,051200,6,6,0,0
9,2000,051200,2,2,0,0
10,2000,051200,3,3,0,0
11,2000,051200,1,1,0,0
12,2000,051200,2,2,0,0
1,2001,051200,11,11,0,0
2,2001,051200,2,2,0,0
3,2001,051200,8,8,0,2
4,2001,051200,4,4,0,0
5,2001,051200,5,5,0,0
6,2001,051200,4,4,0,0
7,2001,051200,4,4,0,0
8,2001,051200,7,7,0,0
9,2001,051200,3,3,0,0
10,2001,051200,6,6,0,2
11,2001,051200,5,4,1,0
12,2001,051200,5,4,1,0
1,2002,051200,4,4,0,0
2,2002,051200,2,2,0,1
3,2002,051200,2,2,0,0
4,2002,051200,2,2,0,3
5,2002,051200,2,2,0,0
6,2002,051200,2,2,0,0
7,2002,051200,4,4,0,0
8,2002,051200,3,3,0,1
9,2002,051200,3,2,1,1
10,2002,051200,6,6,0,1
11,2002,051200,3,3,0,0
12,2002,051200,5,5,0,0
1,2003,051200,7,7,0,0
2,2003,051200,1,1,0,0
3,2003,051200,3,3,0,0
4,2003,051200,2,2,0,1
5,2003,051200,2,2,0,1
6,2003,051200,8,8,0,0
7,2003,051200,7,4,3,0
8,2003,051200,7,7,0,0
9,2003,051200,5,5,0,0
10,2003,051200,5,5,0,0
11,2003,051200,0,0,0,0
12,2003,051200,3,3,0,0
1,2004,051200,4,4,0,0
2,2004,051200,0,0,0,1
3,2004,051200,2,2,0,1
4,2004,051200,5,5,0,0
5,2004,051200,4,4,0,0
6,2004,051200,7,6,1,0
7,2004,051200,5,5,0,0
8,2004,051200,5,5,0,0
9,2004,051200,2,2,0,0
10,2004,051200,0,0,0,0
11,2004,051200,10,9,1,0
12,2004,051200,5,5,0,0
1,2005,051200,4,4,0,0
2,2005,051200,1,1,0,2
3,2005,051200,3,3,0,1
4,2005,051200,5,5,0,0
5,2005,051200,2,2,0,0
6,2005,051200,1,1,0,0
7,2005,051200,6,6,0,0
8,2005,051200,1,1,0,0
9,2005,051200,2,2,0,0
10,2005,051200,4,4,0,0
11,2005,051200,5,5,0,0
12,2005,051200,4,4,0,0
1,2006,051200,3,3,0,0
2,2006,051200,2,1,1,0
3,2006,051200,2,2,0,0
4,2006,051200,5,4,1,0
5,2006,051200,2,2,0,0
6,2006,051200,5,4,1,0
7,2006,051200,4,4,0,0
8,2006,051200,5,5,0,0
9,2006,051200,1,1,0,0
10,2006,051200,1,1,0,0
11,2006,051200,1,1,0,0
12,2006,051200,2,2,0,0
1,2007,051200,10,9,1,0
2,2007,051200,3,3,0,0
3,2007,051200,3,3,0,0
4,2007,051200,4,4,0,0
5,2007,051200,4,4,0,0
6,2007,051200,5,5,0,0
7,2007,051200,2,2,0,0
8,2007,051200,5,5,0,0
9,2007,051200,11,11,0,1
10,2007,051200,5,5,0,0
11,2007,051200,1,1,0,0
12,2007,051200,12,12,0,0
1,2008,051200,4,4,0,0
2,2008,051200,2,2,0,1
3,2008,051200,4,4,0,0
4,2008,051200,3,3,0,0
5,2008,051200,6,6,0,0
6,2008,051200,6,6,0,0
7,2008,051200,10,10,0,0
8,2008,051200,8,7,1,1
9,2008,051200,6,6,0,0
10,2008,051200,10,10,0,0
11,2008,051200,3,3,0,0
12,2008,051200,2,2,0,0
1,2009,051200,2,2,0,0
2,2009,051200,2,2,0,1
3,2009,051200,4,4,0,0
4,2009,051200,3,3,0,0
5,2009,051200,6,6,0,0
6,2009,051200,5,5,0,0
7,2009,051200,1,1,0,0
8,2009,051200,5,5,0,1
9,2009,051200,4,4,0,1
10,2009,051200,5,5,0,0
11,2009,051200,3,3,0,0
12,2009,051200,4,4,0,0
1,2010,051200,1,0,1,0
2,2010,051200,4,4,0,0
3,2010,051200,4,4,0,0
4,2010,051200,4,4,0,0
5,2010,051200,3,3,0,0
6,2010,051200,2,2,0,0
7,2010,051200,1,1,0,0
8,2010,051200,4,4,0,0
9,2010,051200,2,2,0,0
10,2010,051200,4,3,1,0
11,2010,051200,3,3,0,0
12,2010,051200,1,1,0,0
1,2011,051200,2,2,0,0
2,2011,051200,4,4,0,0
1,1999,161300,17,17,0,1
2,1999,161300,10,9,1,0
3,1999,161300,11,11,0,4
4,1999,161300,10,8,2,3
5,1999,161300,16,14,2,3
6,1999,161300,20,18,2,1
7,1999,161300,17,16,1,0
8,1999,161300,20,18,2,0
9,1999,161300,16,15,1,1
10,1999,161300,17,15,2,1
11,1999,161300,9,9,0,0
12,1999,161300,10,10,0,0
1,2000,161300,9,8,1,2
2,2000,161300,7,6,1,1
3,2000,161300,16,16,0,0
4,2000,161300,11,10,1,2
5,2000,161300,11,10,1,0
6,2000,161300,12,10,2,1
7,2000,161300,20,20,0,1
8,2000,161300,21,21,0,2
9,2000,161300,20,19,1,2
10,2000,161300,13,10,3,0
11,2000,161300,21,20,1,1
12,2000,161300,7,7,0,2
1,2001,161300,5,4,1,0
2,2001,161300,11,9,2,5
3,2001,161300,12,10,2,7
4,2001,161300,11,9,2,3
5,2001,161300,10,9,1,1
6,2001,161300,15,13,2,2
7,2001,161300,14,13,1,3
8,2001,161300,13,13,0,0
9,2001,161300,16,16,0,1
10,2001,161300,20,19,1,5
11,2001,161300,15,15,0,2
12,2001,161300,16,16,0,0
1,2002,161300,14,14,0,2
2,2002,161300,11,11,0,3
3,2002,161300,18,17,1,2
4,2002,161300,14,14,0,0
5,2002,161300,12,12,0,0
6,2002,161300,12,11,1,1
7,2002,161300,20,18,2,0
8,2002,161300,16,16,0,1
9,2002,161300,24,24,0,0
10,2002,161300,14,13,1,4
11,2002,161300,20,19,1,2
12,2002,161300,12,11,1,0
1,2003,161300,14,11,3,1
2,2003,161300,11,10,1,9
3,2003,161300,12,12,0,2
4,2003,161300,17,16,1,0
5,2003,161300,20,17,3,0
6,2003,161300,15,14,1,1
7,2003,161300,16,16,0,0
8,2003,161300,13,11,2,1
9,2003,161300,10,10,0,1
10,2003,161300,16,14,2,1
11,2003,161300,4,4,0,4
12,2003,161300,10,10,0,1
1,2004,161300,14,13,1,3
2,2004,161300,10,8,2,1
3,2004,161300,12,8,4,0
4,2004,161300,9,8,1,4
5,2004,161300,6,6,0,1
6,2004,161300,15,15,0,0
7,2004,161300,14,14,0,0
8,2004,161300,14,14,0,1
9,2004,161300,11,9,2,0
10,2004,161300,8,8,0,4
11,2004,161300,12,12,0,3
12,2004,161300,14,14,0,2
1,2005,161300,6,6,0,0
2,2005,161300,10,10,0,3
3,2005,161300,9,9,0,2
4,2005,161300,13,11,2,2
5,2005,161300,7,7,0,4
6,2005,161300,10,10,0,1
7,2005,161300,10,8,2,1
8,2005,161300,10,9,1,0
9,2005,161300,10,10,0,1
10,2005,161300,10,10,0,1
11,2005,161300,12,12,0,1
12,2005,161300,9,8,1,0
1,2006,161300,13,12,1,3
2,2006,161300,7,6,1,3
3,2006,161300,10,10,0,3
4,2006,161300,8,8,0,1
5,2006,161300,11,11,0,1
6,2006,161300,9,9,0,4
7,2006,161300,9,8,1,1
8,2006,161300,13,12,1,0
9,2006,161300,11,9,2,0
10,2006,161300,8,8,0,1
11,2006,161300,10,8,2,6
12,2006,161300,13,12,1,4
1,2007,161300,6,6,0,0
2,2007,161300,8,7,1,1
3,2007,161300,14,14,0,2
4,2007,161300,11,10,1,1
5,2007,161300,10,10,0,0
6,2007,161300,11,10,1,1
7,2007,161300,16,14,2,4
8,2007,161300,23,22,1,4
9,2007,161300,14,13,1,0
10,2007,161300,3,3,0,0
11,2007,161300,8,8,0,1
12,2007,161300,6,6,0,0
1,2008,161300,15,14,1,2
2,2008,161300,10,9,1,1
3,2008,161300,10,10,0,2
4,2008,161300,13,10,3,0
5,2008,161300,16,14,2,3
6,2008,161300,10,9,1,2
7,2008,161300,13,9,4,2
8,2008,161300,10,10,0,0
9,2008,161300,11,10,1,4
10,2008,161300,10,10,0,1
11,2008,161300,11,11,0,0
12,2008,161300,5,4,1,4
1,2009,161300,7,4,3,4
2,2009,161300,4,4,0,2
3,2009,161300,8,8,0,7
4,2009,161300,14,12,2,1
5,2009,161300,6,6,0,3
6,2009,161300,9,6,3,1
7,2009,161300,14,11,3,1
8,2009,161300,10,10,0,1
9,2009,161300,6,6,0,2
10,2009,161300,15,12,3,3
11,2009,161300,14,13,1,2
12,2009,161300,9,7,2,0
1,2010,161300,5,5,0,6
2,2010,161300,12,10,2,2
3,2010,161300,11,11,0,3
4,2010,161300,7,6,1,1
5,2010,161300,14,12,2,2
6,2010,161300,11,10,1,1
7,2010,161300,10,10,0,1
8,2010,161300,11,10,1,1
9,2010,161300,8,6,2,0
10,2010,161300,15,14,1,5
11,2010,161300,14,14,0,0
12,2010,161300,9,8,1,4
1,2011,161300,15,13,2,0
2,2011,161300,5,4,1,3
1,1999,062500,11,11,0,3
2,1999,062500,8,8,0,1
3,1999,062500,15,15,0,2
4,1999,062500,13,12,1,0
5,1999,062500,12,11,1,0
6,1999,062500,7,7,0,0
7,1999,062500,18,18,0,0
8,1999,062500,19,18,1,0
9,1999,062500,15,15,0,1
10,1999,062500,13,13,0,1
11,1999,062500,7,7,0,0
12,1999,062500,12,10,2,0
1,2000,062500,13,12,1,0
2,2000,062500,10,10,0,0
3,2000,062500,14,13,1,0
4,2000,062500,11,11,0,0
5,2000,062500,18,18,0,0
6,2000,062500,11,11,0,3
7,2000,062500,6,6,0,1
8,2000,062500,11,11,0,1
9,2000,062500,14,14,0,1
10,2000,062500,16,16,0,3
11,2000,062500,8,8,0,0
12,2000,062500,16,14,2,1
1,2001,062500,8,8,0,0
2,2001,062500,14,14,0,0
3,2001,062500,8,8,0,0
4,2001,062500,13,11,2,1
5,2001,062500,16,16,0,0
6,2001,062500,17,15,2,0
7,2001,062500,18,18,0,0
8,2001,062500,14,13,1,0
9,2001,062500,20,19,1,1
10,2001,062500,8,6,2,0
11,2001,062500,9,9,0,0
12,2001,062500,15,14,1,0
1,2002,062500,8,7,1,0
2,2002,062500,13,13,0,0
3,2002,062500,11,11,0,1
4,2002,062500,9,9,0,0
5,2002,062500,5,5,0,1
6,2002,062500,16,14,2,0
7,2002,062500,12,11,1,0
8,2002,062500,17,17,0,2
9,2002,062500,10,10,0,0
10,2002,062500,20,19,1,0
11,2002,062500,16,15,1,0
12,2002,062500,9,8,1,0
1,2003,062500,11,11,0,0
2,2003,062500,4,4,0,0
3,2003,062500,9,9,0,2
4,2003,062500,14,13,1,0
5,2003,062500,19,19,0,0
6,2003,062500,18,17,1,0
7,2003,062500,14,14,0,0
8,2003,062500,17,17,0,1
9,2003,062500,15,14,1,0
10,2003,062500,8,8,0,2
11,2003,062500,20,20,0,1
12,2003,062500,16,16,0,1
1,2004,062500,18,16,2,0
2,2004,062500,13,13,0,0
3,2004,062500,7,7,0,0
4,2004,062500,14,13,1,0
5,2004,062500,20,20,0,0
6,2004,062500,13,13,0,0
7,2004,062500,13,13,0,0
8,2004,062500,12,12,0,0
9,2004,062500,11,9,2,0
10,2004,062500,15,15,0,0
11,2004,062500,12,12,0,0
12,2004,062500,7,7,0,0
1,2005,062500,15,15,0,0
2,2005,062500,14,14,0,0
3,2005,062500,11,10,1,0
4,2005,062500,5,5,0,0
5,2005,062500,2,2,0,1
6,2005,062500,8,8,0,0
7,2005,062500,15,15,0,0
8,2005,062500,3,3,0,0
9,2005,062500,13,13,0,0
10,2005,062500,4,4,0,0
11,2005,062500,15,14,1,0
12,2005,062500,10,10,0,0
1,2006,062500,15,15,0,0
2,2006,062500,13,13,0,0
3,2006,062500,13,13,0,0
4,2006,062500,9,9,0,0
5,2006,062500,18,18,0,0
6,2006,062500,13,13,0,0
7,2006,062500,15,15,0,0
8,2006,062500,8,8,0,1
9,2006,062500,12,12,0,0
10,2006,062500,8,8,0,0
11,2006,062500,10,10,0,0
12,2006,062500,11,10,1,0
1,2007,062500,13,13,0,0
2,2007,062500,12,12,0,0
3,2007,062500,12,11,1,0
4,2007,062500,11,11,0,0
5,2007,062500,9,9,0,0
6,2007,062500,7,7,0,0
7,2007,062500,11,11,0,0
8,2007,062500,16,16,0,0
9,2007,062500,11,11,0,0
10,2007,062500,12,12,0,0
11,2007,062500,10,10,0,0
12,2007,062500,7,7,0,1
1,2008,062500,14,14,0,0
2,2008,062500,9,9,0,0
3,2008,062500,12,11,1,0
4,2008,062500,9,9,0,0
5,2008,062500,7,7,0,0
6,2008,062500,6,6,0,0
7,2008,062500,7,7,0,0
8,2008,062500,14,13,1,0
9,2008,062500,13,13,0,0
10,2008,062500,9,9,0,0
11,2008,062500,5,4,1,0
12,2008,062500,13,13,0,0
1,2009,062500,19,19,0,0
2,2009,062500,9,9,0,0
3,2009,062500,9,9,0,0
4,2009,062500,7,7,0,0
5,2009,062500,12,12,0,0
6,2009,062500,12,12,0,0
7,2009,062500,16,16,0,0
8,2009,062500,16,16,0,3
9,2009,062500,14,13,1,0
10,2009,062500,15,15,0,1
11,2009,062500,8,7,1,1
12,2009,062500,12,12,0,0
1,2010,062500,9,9,0,0
2,2010,062500,5,5,0,0
3,2010,062500,8,8,0,1
4,2010,062500,4,4,0,0
5,2010,062500,10,10,0,0
6,2010,062500,6,6,0,0
7,2010,062500,8,8,0,0
8,2010,062500,8,8,0,0
9,2010,062500,9,9,0,0
10,2010,062500,9,9,0,1
11,2010,062500,11,11,0,0
12,2010,062500,9,9,0,1
1,2011,062500,6,6,0,0
2,2011,062500,7,7,0,0
1,1999,062400,3,3,0,0
2,1999,062400,2,2,0,0
3,1999,062400,2,2,0,0
4,1999,062400,3,3,0,0
5,1999,062400,3,3,0,0
6,1999,062400,2,2,0,0
7,1999,062400,11,11,0,0
8,1999,062400,5,5,0,0
9,1999,062400,5,5,0,0
10,1999,062400,10,9,1,0
11,1999,062400,3,3,0,0
12,1999,062400,2,2,0,0
1,2000,062400,6,6,0,0
2,2000,062400,3,3,0,0
3,2000,062400,2,2,0,1
4,2000,062400,3,3,0,0
5,2000,062400,10,10,0,0
6,2000,062400,6,6,0,1
7,2000,062400,5,5,0,0
8,2000,062400,9,9,0,0
9,2000,062400,2,2,0,0
10,2000,062400,3,3,0,0
11,2000,062400,5,4,1,0
12,2000,062400,1,1,0,0
1,2001,062400,0,0,0,0
2,2001,062400,9,8,1,0
3,2001,062400,2,2,0,0
4,2001,062400,2,2,0,0
5,2001,062400,2,2,0,0
6,2001,062400,4,3,1,0
7,2001,062400,4,4,0,0
8,2001,062400,4,4,0,0
9,2001,062400,4,4,0,0
10,2001,062400,2,2,0,0
11,2001,062400,3,2,1,0
12,2001,062400,1,1,0,0
1,2002,062400,2,1,1,0
2,2002,062400,2,2,0,0
3,2002,062400,1,1,0,0
4,2002,062400,3,3,0,0
5,2002,062400,4,4,0,0
6,2002,062400,4,4,0,0
7,2002,062400,6,6,0,0
8,2002,062400,6,6,0,0
9,2002,062400,8,7,1,0
10,2002,062400,0,0,0,0
11,2002,062400,1,1,0,0
12,2002,062400,2,2,0,0
1,2003,062400,5,5,0,0
2,2003,062400,2,2,0,0
3,2003,062400,7,7,0,0
4,2003,062400,7,7,0,1
5,2003,062400,2,2,0,0
6,2003,062400,2,2,0,0
7,2003,062400,3,3,0,0
8,2003,062400,2,2,0,0
9,2003,062400,4,4,0,0
10,2003,062400,7,7,0,0
11,2003,062400,6,6,0,0
12,2003,062400,1,1,0,0
1,2004,062400,0,0,0,0
2,2004,062400,3,2,1,0
3,2004,062400,5,5,0,0
4,2004,062400,0,0,0,0
5,2004,062400,3,3,0,0
6,2004,062400,2,2,0,0
7,2004,062400,4,4,0,0
8,2004,062400,3,3,0,2
9,2004,062400,8,8,0,0
10,2004,062400,5,5,0,0
11,2004,062400,5,5,0,0
12,2004,062400,2,2,0,0
1,2005,062400,3,3,0,0
2,2005,062400,3,3,0,0
3,2005,062400,2,2,0,0
4,2005,062400,2,2,0,0
5,2005,062400,1,1,0,0
6,2005,062400,3,3,0,0
7,2005,062400,5,5,0,0
8,2005,062400,1,1,0,1
9,2005,062400,1,1,0,0
10,2005,062400,1,1,0,0
11,2005,062400,1,1,0,0
12,2005,062400,7,7,0,0
1,2006,062400,3,3,0,0
2,2006,062400,4,4,0,0
3,2006,062400,4,4,0,0
4,2006,062400,4,4,0,0
5,2006,062400,1,1,0,0
6,2006,062400,2,2,0,1
7,2006,062400,3,3,0,0
8,2006,062400,2,2,0,0
9,2006,062400,6,6,0,0
10,2006,062400,2,1,1,0
11,2006,062400,4,4,0,0
12,2006,062400,1,1,0,0
1,2007,062400,2,2,0,0
2,2007,062400,2,2,0,0
3,2007,062400,3,3,0,0
4,2007,062400,3,3,0,0
5,2007,062400,2,2,0,0
6,2007,062400,2,2,0,0
7,2007,062400,3,3,0,0
8,2007,062400,3,3,0,0
9,2007,062400,1,1,0,0
10,2007,062400,11,10,1,0
11,2007,062400,4,4,0,0
12,2007,062400,3,3,0,0
1,2008,062400,4,4,0,0
2,2008,062400,3,3,0,1
3,2008,062400,7,7,0,0
4,2008,062400,0,0,0,0
5,2008,062400,4,4,0,0
6,2008,062400,0,0,0,0
7,2008,062400,2,2,0,0
8,2008,062400,4,4,0,1
9,2008,062400,8,8,0,0
10,2008,062400,4,4,0,0
11,2008,062400,3,3,0,0
12,2008,062400,6,6,0,0
1,2009,062400,7,7,0,0
2,2009,062400,3,3,0,0
3,2009,062400,5,5,0,0
4,2009,062400,3,3,0,0
5,2009,062400,2,2,0,0
6,2009,062400,6,5,1,0
7,2009,062400,2,2,0,0
8,2009,062400,5,5,0,0
9,2009,062400,2,2,0,0
10,2009,062400,6,6,0,1
11,2009,062400,3,3,0,0
12,2009,062400,3,2,1,0
1,2010,062400,5,5,0,0
2,2010,062400,1,1,0,0
3,2010,062400,1,1,0,0
4,2010,062400,3,3,0,0
5,2010,062400,5,5,0,0
6,2010,062400,4,4,0,0
7,2010,062400,3,3,0,0
8,2010,062400,12,12,0,0
9,2010,062400,4,4,0,0
10,2010,062400,7,7,0,0
11,2010,062400,1,1,0,0
12,2010,062400,2,2,0,0
1,2011,062400,2,2,0,0
2,2011,062400,2,2,0,0
1,1999,062300,5,5,0,1
2,1999,062300,6,5,1,0
3,1999,062300,3,3,0,0
4,1999,062300,3,3,0,0
5,1999,062300,4,4,0,0
6,1999,062300,11,11,0,0
7,1999,062300,5,5,0,0
8,1999,062300,6,6,0,0
9,1999,062300,7,7,0,1
10,1999,062300,5,5,0,1
11,1999,062300,5,5,0,0
12,1999,062300,4,4,0,0
1,2000,062300,1,1,0,0
2,2000,062300,1,1,0,0
3,2000,062300,7,7,0,0
4,2000,062300,8,8,0,0
5,2000,062300,5,4,1,1
6,2000,062300,5,5,0,0
7,2000,062300,6,6,0,0
8,2000,062300,8,8,0,0
9,2000,062300,6,6,0,0
10,2000,062300,3,3,0,0
11,2000,062300,11,11,0,0
12,2000,062300,2,2,0,0
1,2001,062300,6,6,0,0
2,2001,062300,2,2,0,0
3,2001,062300,1,1,0,0
4,2001,062300,4,4,0,0
5,2001,062300,1,1,0,0
6,2001,062300,8,8,0,0
7,2001,062300,0,0,0,0
8,2001,062300,5,5,0,0
9,2001,062300,4,4,0,1
10,2001,062300,6,6,0,0
11,2001,062300,5,5,0,0
12,2001,062300,3,3,0,0
1,2002,062300,5,5,0,0
2,2002,062300,2,2,0,0
3,2002,062300,1,1,0,0
4,2002,062300,3,3,0,0
5,2002,062300,3,3,0,0
6,2002,062300,2,2,0,0
7,2002,062300,5,5,0,0
8,2002,062300,10,9,1,0
9,2002,062300,3,3,0,0
10,2002,062300,6,6,0,0
11,2002,062300,7,7,0,0
12,2002,062300,4,4,0,0
1,2003,062300,4,4,0,0
2,2003,062300,0,0,0,0
3,2003,062300,2,2,0,2
4,2003,062300,3,3,0,0
5,2003,062300,1,1,0,0
6,2003,062300,1,1,0,0
7,2003,062300,9,9,0,0
8,2003,062300,2,2,0,0
9,2003,062300,8,8,0,1
10,2003,062300,7,7,0,0
11,2003,062300,3,2,1,1
12,2003,062300,1,1,0,0
1,2004,062300,5,5,0,0
2,2004,062300,1,1,0,0
3,2004,062300,5,5,0,0
4,2004,062300,4,4,0,0
5,2004,062300,3,2,1,0
6,2004,062300,3,3,0,0
7,2004,062300,8,8,0,0
8,2004,062300,9,9,0,0
9,2004,062300,3,3,0,0
10,2004,062300,3,3,0,0
11,2004,062300,3,3,0,0
12,2004,062300,3,3,0,0
1,2005,062300,2,2,0,0
2,2005,062300,2,2,0,0
3,2005,062300,1,1,0,0
4,2005,062300,2,2,0,0
5,2005,062300,1,1,0,0
6,2005,062300,6,6,0,0
7,2005,062300,6,6,0,0
8,2005,062300,7,7,0,0
9,2005,062300,1,1,0,0
10,2005,062300,4,4,0,0
11,2005,062300,4,4,0,0
12,2005,062300,2,2,0,0
1,2006,062300,5,5,0,0
2,2006,062300,3,3,0,0
3,2006,062300,3,3,0,0
4,2006,062300,0,0,0,0
5,2006,062300,2,2,0,0
6,2006,062300,8,8,0,0
7,2006,062300,4,4,0,0
8,2006,062300,3,3,0,0
9,2006,062300,2,2,0,0
10,2006,062300,1,1,0,0
11,2006,062300,0,0,0,0
12,2006,062300,2,2,0,0
1,2007,062300,2,2,0,0
2,2007,062300,2,1,1,0
3,2007,062300,1,1,0,0
4,2007,062300,4,4,0,0
5,2007,062300,4,4,0,0
6,2007,062300,6,6,0,0
7,2007,062300,2,2,0,0
8,2007,062300,5,5,0,0
9,2007,062300,0,0,0,0
10,2007,062300,2,2,0,0
11,2007,062300,8,8,0,0
12,2007,062300,9,9,0,0
1,2008,062300,5,5,0,0
2,2008,062300,3,3,0,0
3,2008,062300,4,4,0,0
4,2008,062300,5,5,0,0
5,2008,062300,4,4,0,0
6,2008,062300,4,4,0,0
7,2008,062300,0,0,0,0
8,2008,062300,3,3,0,0
9,2008,062300,8,8,0,1
10,2008,062300,5,5,0,0
11,2008,062300,7,6,1,0
12,2008,062300,8,8,0,0
1,2009,062300,6,6,0,0
2,2009,062300,6,6,0,0
3,2009,062300,8,8,0,0
4,2009,062300,7,7,0,0
5,2009,062300,0,0,0,0
6,2009,062300,3,3,0,0
7,2009,062300,5,5,0,0
8,2009,062300,1,1,0,0
9,2009,062300,2,2,0,0
10,2009,062300,4,4,0,0
11,2009,062300,2,2,0,0
12,2009,062300,3,3,0,0
1,2010,062300,8,8,0,0
2,2010,062300,2,2,0,0
3,2010,062300,4,4,0,0
4,2010,062300,3,3,0,1
5,2010,062300,3,3,0,0
6,2010,062300,6,6,0,0
7,2010,062300,9,9,0,0
8,2010,062300,7,7,0,0
9,2010,062300,4,4,0,0
10,2010,062300,1,1,0,0
11,2010,062300,5,5,0,0
12,2010,062300,0,0,0,0
1,2011,062300,1,1,0,0
2,2011,062300,3,3,0,1
1,1999,062200,12,12,0,1
2,1999,062200,15,14,1,0
3,1999,062200,13,13,0,0
4,1999,062200,14,13,1,2
5,1999,062200,20,16,4,3
6,1999,062200,28,28,0,2
7,1999,062200,26,24,2,2
8,1999,062200,27,25,2,1
9,1999,062200,21,20,1,2
10,1999,062200,10,10,0,6
11,1999,062200,19,18,1,5
12,1999,062200,13,13,0,0
1,2000,062200,19,18,1,0
2,2000,062200,17,16,1,0
3,2000,062200,13,12,1,0
4,2000,062200,15,15,0,1
5,2000,062200,20,20,0,2
6,2000,062200,24,23,1,4
7,2000,062200,25,23,2,3
8,2000,062200,33,29,4,4
9,2000,062200,20,17,3,1
10,2000,062200,19,17,2,4
11,2000,062200,17,17,0,6
12,2000,062200,16,15,1,4
1,2001,062200,11,11,0,2
2,2001,062200,12,12,0,3
3,2001,062200,18,15,3,4
4,2001,062200,16,15,1,2
5,2001,062200,14,12,2,2
6,2001,062200,8,8,0,2
7,2001,062200,20,19,1,0
8,2001,062200,18,18,0,10
9,2001,062200,15,13,2,9
10,2001,062200,23,21,2,1
11,2001,062200,17,16,1,3
12,2001,062200,14,13,1,2
1,2002,062200,18,16,2,2
2,2002,062200,13,12,1,4
3,2002,062200,14,14,0,1
4,2002,062200,15,14,1,1
5,2002,062200,20,18,2,1
6,2002,062200,26,22,4,3
7,2002,062200,20,18,2,0
8,2002,062200,17,16,1,5
9,2002,062200,21,21,0,4
10,2002,062200,14,14,0,3
11,2002,062200,17,17,0,1
12,2002,062200,13,11,2,0
1,2003,062200,15,13,2,2
2,2003,062200,11,11,0,1
3,2003,062200,20,20,0,2
4,2003,062200,15,14,1,1
5,2003,062200,13,13,0,4
6,2003,062200,12,12,0,1
7,2003,062200,19,19,0,2
8,2003,062200,18,15,3,3
9,2003,062200,20,19,1,3
10,2003,062200,26,22,4,5
11,2003,062200,12,11,1,3
12,2003,062200,11,10,1,3
1,2004,062200,14,13,1,3
2,2004,062200,13,12,1,3
3,2004,062200,10,9,1,0
4,2004,062200,7,6,1,0
5,2004,062200,17,17,0,1
6,2004,062200,9,8,1,2
7,2004,062200,21,19,2,1
8,2004,062200,13,12,1,5
9,2004,062200,25,24,1,2
10,2004,062200,18,17,1,2
11,2004,062200,8,8,0,2
12,2004,062200,12,12,0,3
1,2005,062200,10,10,0,1
2,2005,062200,3,3,0,5
3,2005,062200,13,10,3,1
4,2005,062200,11,11,0,4
5,2005,062200,14,13,1,2
6,2005,062200,15,15,0,1
7,2005,062200,27,25,2,1
8,2005,062200,19,19,0,3
9,2005,062200,6,6,0,2
10,2005,062200,10,10,0,2
11,2005,062200,16,15,1,1
12,2005,062200,6,6,0,0
1,2006,062200,12,12,0,3
2,2006,062200,13,13,0,0
3,2006,062200,11,11,0,1
4,2006,062200,10,10,0,0
5,2006,062200,12,11,1,4
6,2006,062200,15,15,0,0
7,2006,062200,15,14,1,0
8,2006,062200,19,17,2,3
9,2006,062200,11,11,0,0
10,2006,062200,18,17,1,1
11,2006,062200,7,7,0,0
12,2006,062200,10,10,0,4
1,2007,062200,6,6,0,0
2,2007,062200,6,6,0,1
3,2007,062200,11,11,0,1
4,2007,062200,14,13,1,2
5,2007,062200,12,12,0,1
6,2007,062200,20,18,2,0
7,2007,062200,15,15,0,1
8,2007,062200,17,16,1,5
9,2007,062200,13,12,1,2
10,2007,062200,18,18,0,3
11,2007,062200,16,16,0,1
12,2007,062200,12,12,0,1
1,2008,062200,9,8,1,0
2,2008,062200,7,7,0,2
3,2008,062200,17,16,1,2
4,2008,062200,16,15,1,2
5,2008,062200,15,14,1,1
6,2008,062200,13,13,0,1
7,2008,062200,16,15,1,1
8,2008,062200,17,17,0,1
9,2008,062200,19,19,0,2
10,2008,062200,24,22,2,1
11,2008,062200,17,17,0,0
12,2008,062200,9,8,1,1
1,2009,062200,19,17,2,0
2,2009,062200,10,10,0,0
3,2009,062200,6,5,1,0
4,2009,062200,9,9,0,0
5,2009,062200,15,14,1,3
6,2009,062200,12,12,0,0
7,2009,062200,23,22,1,2
8,2009,062200,23,21,2,1
9,2009,062200,15,14,1,0
10,2009,062200,9,9,0,2
11,2009,062200,9,8,1,2
12,2009,062200,13,13,0,1
1,2010,062200,16,15,1,3
2,2010,062200,4,4,0,0
3,2010,062200,13,13,0,0
4,2010,062200,15,15,0,4
5,2010,062200,13,13,0,4
6,2010,062200,16,15,1,2
7,2010,062200,13,13,0,4
8,2010,062200,17,17,0,3
9,2010,062200,12,12,0,5
10,2010,062200,18,18,0,3
11,2010,062200,16,16,0,5
12,2010,062200,12,10,2,0
1,2011,062200,12,11,1,0
2,2011,062200,13,12,1,2
1,1999,062100,23,21,2,1
2,1999,062100,29,29,0,1
3,1999,062100,25,24,1,5
4,1999,062100,35,32,3,0
5,1999,062100,38,35,3,4
6,1999,062100,30,30,0,3
7,1999,062100,47,44,3,4
8,1999,062100,42,40,2,8
9,1999,062100,27,27,0,4
10,1999,062100,32,28,4,0
11,1999,062100,23,22,1,7
12,1999,062100,34,33,1,2
1,2000,062100,22,19,3,4
2,2000,062100,23,23,0,4
3,2000,062100,26,25,1,1
4,2000,062100,41,39,2,2
5,2000,062100,48,46,2,7
6,2000,062100,51,48,3,5
7,2000,062100,53,50,3,8
8,2000,062100,67,60,7,16
9,2000,062100,42,40,2,8
10,2000,062100,44,42,2,17
11,2000,062100,43,42,1,11
12,2000,062100,33,30,3,9
1,2001,062100,33,32,1,9
2,2001,062100,33,31,2,7
3,2001,062100,30,29,1,7
4,2001,062100,35,33,2,8
5,2001,062100,15,14,1,8
6,2001,062100,37,35,2,16
7,2001,062100,37,31,6,8
8,2001,062100,28,23,5,13
9,2001,062100,35,33,2,9
10,2001,062100,38,34,4,16
11,2001,062100,26,24,2,8
12,2001,062100,21,21,0,4
1,2002,062100,29,29,0,4
2,2002,062100,21,19,2,8
3,2002,062100,38,32,6,6
4,2002,062100,29,28,1,10
5,2002,062100,32,29,3,11
6,2002,062100,31,30,1,7
7,2002,062100,42,36,6,6
8,2002,062100,50,45,5,5
9,2002,062100,26,23,3,3
10,2002,062100,35,33,2,8
11,2002,062100,31,30,1,4
12,2002,062100,32,30,2,5
1,2003,062100,19,16,3,11
2,2003,062100,20,18,2,4
3,2003,062100,30,30,0,7
4,2003,062100,33,31,2,11
5,2003,062100,34,31,3,9
6,2003,062100,33,29,4,11
7,2003,062100,36,36,0,6
8,2003,062100,34,31,3,11
9,2003,062100,35,34,1,5
10,2003,062100,27,26,1,5
11,2003,062100,28,25,3,5
12,2003,062100,20,19,1,9
1,2004,062100,21,21,0,5
2,2004,062100,26,25,1,7
3,2004,062100,29,27,2,6
4,2004,062100,24,20,4,9
5,2004,062100,25,24,1,8
6,2004,062100,29,27,2,4
7,2004,062100,38,32,6,6
8,2004,062100,45,42,3,16
9,2004,062100,31,31,0,10
10,2004,062100,31,29,2,7
11,2004,062100,35,33,2,10
12,2004,062100,35,34,1,19
1,2005,062100,28,26,2,6
2,2005,062100,20,19,1,7
3,2005,062100,27,25,2,6
4,2005,062100,15,12,3,12
5,2005,062100,26,25,1,5
6,2005,062100,33,30,3,10
7,2005,062100,26,25,1,9
8,2005,062100,36,34,2,10
9,2005,062100,27,27,0,11
10,2005,062100,40,36,4,8
11,2005,062100,31,29,2,8
12,2005,062100,17,16,1,5
1,2006,062100,29,28,1,2
2,2006,062100,11,11,0,7
3,2006,062100,25,24,1,2
4,2006,062100,31,31,0,1
5,2006,062100,28,24,4,7
6,2006,062100,35,29,6,3
7,2006,062100,42,37,5,6
8,2006,062100,40,38,2,6
9,2006,062100,21,21,0,2
10,2006,062100,34,34,0,4
11,2006,062100,20,18,2,5
12,2006,062100,29,26,3,1
1,2007,062100,20,20,0,6
2,2007,062100,20,20,0,4
3,2007,062100,12,10,2,5
4,2007,062100,17,17,0,5
5,2007,062100,40,36,4,3
6,2007,062100,46,43,3,8
7,2007,062100,44,37,7,4
8,2007,062100,26,25,1,3
9,2007,062100,42,38,4,3
10,2007,062100,30,28,2,4
11,2007,062100,25,24,1,2
12,2007,062100,29,27,2,6
1,2008,062100,28,26,2,4
2,2008,062100,18,18,0,3
3,2008,062100,31,30,1,2
4,2008,062100,31,28,3,2
5,2008,062100,32,29,3,4
6,2008,062100,43,41,2,3
7,2008,062100,44,37,7,3
8,2008,062100,32,27,5,3
9,2008,062100,42,42,0,5
10,2008,062100,28,28,0,0
11,2008,062100,39,36,3,0
12,2008,062100,30,30,0,5
1,2009,062100,21,21,0,2
2,2009,062100,12,11,1,1
3,2009,062100,24,22,2,4
4,2009,062100,28,26,2,2
5,2009,062100,23,22,1,6
6,2009,062100,37,33,4,3
7,2009,062100,50,48,2,6
8,2009,062100,44,39,5,4
9,2009,062100,26,24,2,6
10,2009,062100,35,32,3,4
11,2009,062100,31,29,2,5
12,2009,062100,33,32,1,3
1,2010,062100,27,27,0,4
2,2010,062100,21,20,1,5
3,2010,062100,38,36,2,8
4,2010,062100,28,24,4,10
5,2010,062100,46,43,3,2
6,2010,062100,47,43,4,10
7,2010,062100,44,43,1,10
8,2010,062100,50,48,2,9
9,2010,062100,49,43,6,10
10,2010,062100,32,30,2,8
11,2010,062100,31,27,4,6
12,2010,062100,25,24,1,3
1,2011,062100,28,25,3,3
2,2011,062100,18,18,0,7
1,1999,062000,17,17,0,0
2,1999,062000,14,14,0,0
3,1999,062000,18,18,0,0
4,1999,062000,24,23,1,0
5,1999,062000,14,14,0,1
6,1999,062000,21,21,0,0
7,1999,062000,33,32,1,2
8,1999,062000,29,28,1,0
9,1999,062000,12,12,0,1
10,1999,062000,28,26,2,1
11,1999,062000,14,13,1,2
12,1999,062000,10,9,1,0
1,2000,062000,20,17,3,0
2,2000,062000,11,10,1,1
3,2000,062000,13,12,1,3
4,2000,062000,16,15,1,1
5,2000,062000,29,29,0,2
6,2000,062000,18,18,0,0
7,2000,062000,31,30,1,1
8,2000,062000,27,26,1,1
9,2000,062000,21,21,0,0
10,2000,062000,13,12,1,1
11,2000,062000,10,10,0,1
12,2000,062000,12,12,0,0
1,2001,062000,10,9,1,3
2,2001,062000,14,14,0,0
3,2001,062000,16,16,0,1
4,2001,062000,13,11,2,0
5,2001,062000,19,18,1,3
6,2001,062000,18,18,0,0
7,2001,062000,19,16,3,2
8,2001,062000,11,10,1,1
9,2001,062000,25,24,1,1
10,2001,062000,21,20,1,1
11,2001,062000,10,9,1,0
12,2001,062000,9,8,1,0
1,2002,062000,9,9,0,0
2,2002,062000,8,7,1,0
3,2002,062000,10,10,0,0
4,2002,062000,16,16,0,2
5,2002,062000,22,21,1,1
6,2002,062000,19,19,0,0
7,2002,062000,25,25,0,1
8,2002,062000,17,15,2,2
9,2002,062000,23,22,1,0
10,2002,062000,22,21,1,0
11,2002,062000,10,9,1,1
12,2002,062000,14,14,0,1
1,2003,062000,10,10,0,0
2,2003,062000,15,14,1,1
3,2003,062000,19,18,1,0
4,2003,062000,16,16,0,1
5,2003,062000,15,15,0,2
6,2003,062000,14,13,1,0
7,2003,062000,13,12,1,0
8,2003,062000,22,21,1,2
9,2003,062000,16,16,0,1
10,2003,062000,14,14,0,0
11,2003,062000,9,9,0,0
12,2003,062000,8,6,2,0
1,2004,062000,11,11,0,1
2,2004,062000,2,2,0,1
3,2004,062000,13,12,1,0
4,2004,062000,20,18,2,0
5,2004,062000,13,13,0,0
6,2004,062000,19,19,0,0
7,2004,062000,22,22,0,1
8,2004,062000,22,22,0,2
9,2004,062000,18,18,0,5
10,2004,062000,7,7,0,2
11,2004,062000,15,15,0,1
12,2004,062000,15,15,0,2
1,2005,062000,12,11,1,0
2,2005,062000,12,12,0,0
3,2005,062000,11,11,0,1
4,2005,062000,12,12,0,2
5,2005,062000,12,12,0,4
6,2005,062000,15,15,0,0
7,2005,062000,16,15,1,3
8,2005,062000,21,21,0,2
9,2005,062000,15,15,0,2
10,2005,062000,9,9,0,0
11,2005,062000,8,7,1,1
12,2005,062000,21,21,0,1
1,2006,062000,18,17,1,0
2,2006,062000,13,13,0,1
3,2006,062000,14,13,1,0
4,2006,062000,13,13,0,0
5,2006,062000,9,9,0,1
6,2006,062000,19,17,2,3
7,2006,062000,24,24,0,0
8,2006,062000,28,28,0,3
9,2006,062000,8,8,0,0
10,2006,062000,8,8,0,3
11,2006,062000,15,15,0,0
12,2006,062000,15,15,0,0
1,2007,062000,16,16,0,3
2,2007,062000,4,4,0,1
3,2007,062000,8,8,0,2
4,2007,062000,15,15,0,0
5,2007,062000,8,8,0,1
6,2007,062000,9,9,0,0
7,2007,062000,21,19,2,1
8,2007,062000,13,13,0,2
9,2007,062000,11,9,2,0
10,2007,062000,12,12,0,1
11,2007,062000,11,11,0,0
12,2007,062000,13,13,0,0
1,2008,062000,16,16,0,0
2,2008,062000,12,12,0,0
3,2008,062000,12,12,0,0
4,2008,062000,14,14,0,0
5,2008,062000,18,18,0,0
6,2008,062000,15,14,1,0
7,2008,062000,17,15,2,1
8,2008,062000,21,21,0,0
9,2008,062000,16,15,1,2
10,2008,062000,23,23,0,1
11,2008,062000,12,11,1,1
12,2008,062000,14,14,0,0
1,2009,062000,13,13,0,2
2,2009,062000,13,13,0,0
3,2009,062000,10,10,0,0
4,2009,062000,22,21,1,0
5,2009,062000,7,6,1,2
6,2009,062000,10,9,1,1
7,2009,062000,26,26,0,0
8,2009,062000,21,21,0,0
9,2009,062000,24,24,0,1
10,2009,062000,9,9,0,0
11,2009,062000,15,15,0,1
12,2009,062000,15,15,0,1
1,2010,062000,12,12,0,0
2,2010,062000,12,12,0,2
3,2010,062000,15,14,1,4
4,2010,062000,2,2,0,0
5,2010,062000,17,17,0,0
6,2010,062000,29,29,0,1
7,2010,062000,15,13,2,0
8,2010,062000,18,18,0,0
9,2010,062000,15,15,0,0
10,2010,062000,10,10,0,3
11,2010,062000,20,20,0,0
12,2010,062000,9,9,0,0
1,2011,062000,17,17,0,0
2,2011,062000,7,7,0,0
1,1999,061901,3,2,1,0
2,1999,061901,3,3,0,0
3,1999,061901,1,1,0,0
4,1999,061901,1,0,1,0
5,1999,061901,3,3,0,0
6,1999,061901,2,2,0,0
7,1999,061901,4,4,0,0
8,1999,061901,1,1,0,0
9,1999,061901,1,1,0,0
10,1999,061901,4,4,0,0
11,1999,061901,3,3,0,0
12,1999,061901,5,5,0,0
1,2000,061901,1,0,1,0
2,2000,061901,2,2,0,0
3,2000,061901,5,5,0,0
4,2000,061901,2,2,0,0
5,2000,061901,6,6,0,0
6,2000,061901,4,4,0,0
7,2000,061901,2,2,0,0
8,2000,061901,10,10,0,0
9,2000,061901,0,0,0,0
10,2000,061901,9,9,0,0
11,2000,061901,5,5,0,0
12,2000,061901,2,2,0,0
1,2001,061901,3,3,0,0
2,2001,061901,4,4,0,0
3,2001,061901,2,2,0,0
4,2001,061901,1,1,0,0
5,2001,061901,3,3,0,0
6,2001,061901,2,2,0,0
7,2001,061901,4,4,0,0
8,2001,061901,4,4,0,0
9,2001,061901,4,4,0,0
10,2001,061901,5,5,0,0
11,2001,061901,1,1,0,0
12,2001,061901,3,3,0,0
1,2002,061901,2,2,0,0
2,2002,061901,3,3,0,0
3,2002,061901,3,3,0,0
4,2002,061901,1,1,0,0
5,2002,061901,3,3,0,0
6,2002,061901,2,2,0,0
7,2002,061901,2,2,0,0
8,2002,061901,5,5,0,0
9,2002,061901,4,4,0,0
10,2002,061901,2,2,0,0
11,2002,061901,2,2,0,0
12,2002,061901,2,2,0,0
1,2003,061901,7,7,0,0
2,2003,061901,3,3,0,0
3,2003,061901,6,6,0,0
4,2003,061901,3,3,0,0
5,2003,061901,2,2,0,0
6,2003,061901,2,2,0,0
7,2003,061901,2,2,0,0
8,2003,061901,6,6,0,0
9,2003,061901,5,5,0,0
10,2003,061901,5,5,0,0
11,2003,061901,2,2,0,0
12,2003,061901,3,3,0,0
1,2004,061901,3,3,0,0
2,2004,061901,8,8,0,0
3,2004,061901,6,6,0,1
4,2004,061901,4,4,0,0
5,2004,061901,6,6,0,0
6,2004,061901,11,11,0,1
7,2004,061901,3,3,0,1
8,2004,061901,5,5,0,0
9,2004,061901,5,5,0,0
10,2004,061901,4,4,0,0
11,2004,061901,2,2,0,0
12,2004,061901,0,0,0,0
1,2005,061901,4,4,0,0
2,2005,061901,6,6,0,0
3,2005,061901,3,2,1,0
4,2005,061901,0,0,0,0
5,2005,061901,1,1,0,0
6,2005,061901,4,4,0,0
7,2005,061901,2,2,0,0
8,2005,061901,5,5,0,0
9,2005,061901,3,3,0,0
10,2005,061901,2,2,0,0
11,2005,061901,1,1,0,2
12,2005,061901,1,1,0,0
1,2006,061901,1,1,0,0
2,2006,061901,0,0,0,0
3,2006,061901,2,2,0,0
4,2006,061901,5,5,0,0
5,2006,061901,0,0,0,0
6,2006,061901,2,2,0,0
7,2006,061901,11,11,0,0
8,2006,061901,3,3,0,0
9,2006,061901,1,1,0,0
10,2006,061901,1,1,0,0
11,2006,061901,3,3,0,0
12,2006,061901,6,6,0,0
1,2007,061901,3,2,1,0
2,2007,061901,1,1,0,0
3,2007,061901,4,4,0,0
4,2007,061901,2,2,0,0
5,2007,061901,5,5,0,0
6,2007,061901,2,1,1,0
7,2007,061901,3,3,0,0
8,2007,061901,5,5,0,0
9,2007,061901,6,6,0,0
10,2007,061901,2,2,0,0
11,2007,061901,4,4,0,0
12,2007,061901,2,2,0,0
1,2008,061901,3,2,1,0
2,2008,061901,1,1,0,0
3,2008,061901,3,2,1,0
4,2008,061901,2,2,0,0
5,2008,061901,6,6,0,1
6,2008,061901,4,4,0,0
7,2008,061901,5,5,0,0
8,2008,061901,9,9,0,0
9,2008,061901,5,4,1,0
10,2008,061901,1,1,0,0
11,2008,061901,1,1,0,0
12,2008,061901,5,5,0,0
1,2009,061901,5,5,0,0
2,2009,061901,3,3,0,0
3,2009,061901,6,6,0,1
4,2009,061901,3,3,0,0
5,2009,061901,2,2,0,1
6,2009,061901,3,3,0,0
7,2009,061901,4,4,0,0
8,2009,061901,2,2,0,0
9,2009,061901,4,4,0,0
10,2009,061901,1,1,0,0
11,2009,061901,4,2,2,0
12,2009,061901,1,1,0,0
1,2010,061901,3,3,0,0
2,2010,061901,1,1,0,0
3,2010,061901,4,4,0,0
4,2010,061901,2,2,0,1
5,2010,061901,3,3,0,0
6,2010,061901,7,6,1,0
7,2010,061901,4,4,0,0
8,2010,061901,4,3,1,1
9,2010,061901,3,3,0,0
10,2010,061901,1,1,0,0
11,2010,061901,4,4,0,0
12,2010,061901,1,1,0,0
1,2011,061901,3,3,0,0
2,2011,061901,1,1,0,1
1,1999,061902,11,11,0,1
2,1999,061902,4,3,1,0
3,1999,061902,6,6,0,0
4,1999,061902,8,6,2,3
5,1999,061902,9,7,2,4
6,1999,061902,8,8,0,1
7,1999,061902,14,14,0,3
8,1999,061902,12,12,0,1
9,1999,061902,10,9,1,0
10,1999,061902,9,9,0,1
11,1999,061902,19,18,1,0
12,1999,061902,3,2,1,0
1,2000,061902,11,11,0,1
2,2000,061902,7,7,0,1
3,2000,061902,6,6,0,0
4,2000,061902,6,5,1,1
5,2000,061902,7,7,0,0
6,2000,061902,8,8,0,4
7,2000,061902,17,17,0,3
8,2000,061902,24,22,2,0
9,2000,061902,8,8,0,1
10,2000,061902,11,11,0,0
11,2000,061902,9,9,0,0
12,2000,061902,11,11,0,0
1,2001,061902,10,10,0,0
2,2001,061902,3,3,0,0
3,2001,061902,4,4,0,0
4,2001,061902,5,5,0,1
5,2001,061902,8,8,0,0
6,2001,061902,8,8,0,0
7,2001,061902,11,11,0,2
8,2001,061902,4,4,0,0
9,2001,061902,9,9,0,0
10,2001,061902,6,6,0,1
11,2001,061902,6,6,0,0
12,2001,061902,4,4,0,0
1,2002,061902,3,3,0,0
2,2002,061902,2,2,0,0
3,2002,061902,7,7,0,0
4,2002,061902,8,8,0,1
5,2002,061902,5,2,3,0
6,2002,061902,9,8,1,0
7,2002,061902,3,3,0,0
8,2002,061902,9,8,1,0
9,2002,061902,8,8,0,0
10,2002,061902,4,4,0,0
11,2002,061902,6,6,0,0
12,2002,061902,1,1,0,0
1,2003,061902,1,0,1,0
2,2003,061902,6,6,0,1
3,2003,061902,8,7,1,0
4,2003,061902,9,9,0,0
5,2003,061902,3,2,1,0
6,2003,061902,11,11,0,1
7,2003,061902,17,16,1,3
8,2003,061902,10,10,0,0
9,2003,061902,9,8,1,0
10,2003,061902,2,2,0,0
11,2003,061902,2,2,0,0
12,2003,061902,3,3,0,0
1,2004,061902,8,7,1,0
2,2004,061902,14,14,0,0
3,2004,061902,3,3,0,0
4,2004,061902,5,5,0,0
5,2004,061902,6,6,0,0
6,2004,061902,5,5,0,1
7,2004,061902,7,7,0,1
8,2004,061902,6,6,0,0
9,2004,061902,5,5,0,0
10,2004,061902,4,4,0,0
11,2004,061902,6,6,0,0
12,2004,061902,7,6,1,2
1,2005,061902,5,3,2,0
2,2005,061902,4,3,1,0
3,2005,061902,3,2,1,0
4,2005,061902,2,2,0,3
5,2005,061902,6,6,0,0
6,2005,061902,8,8,0,0
7,2005,061902,3,3,0,1
8,2005,061902,10,9,1,0
9,2005,061902,3,3,0,1
10,2005,061902,5,5,0,0
11,2005,061902,7,7,0,0
12,2005,061902,6,6,0,1
1,2006,061902,5,4,1,1
2,2006,061902,1,1,0,3
3,2006,061902,6,6,0,0
4,2006,061902,8,8,0,0
5,2006,061902,6,6,0,0
6,2006,061902,2,2,0,1
7,2006,061902,11,11,0,0
8,2006,061902,8,8,0,0
9,2006,061902,5,5,0,0
10,2006,061902,2,1,1,0
11,2006,061902,3,3,0,0
12,2006,061902,4,4,0,0
1,2007,061902,1,1,0,0
2,2007,061902,0,0,0,0
3,2007,061902,3,3,0,0
4,2007,061902,2,2,0,0
5,2007,061902,11,11,0,0
6,2007,061902,9,9,0,0
7,2007,061902,5,5,0,0
8,2007,061902,6,6,0,0
9,2007,061902,4,4,0,0
10,2007,061902,5,4,1,0
11,2007,061902,3,3,0,0
12,2007,061902,3,3,0,0
1,2008,061902,4,4,0,0
2,2008,061902,5,5,0,0
3,2008,061902,3,2,1,0
4,2008,061902,5,5,0,0
5,2008,061902,5,5,0,0
6,2008,061902,8,7,1,0
7,2008,061902,11,11,0,2
8,2008,061902,5,3,2,0
9,2008,061902,6,6,0,0
10,2008,061902,6,6,0,0
11,2008,061902,3,3,0,0
12,2008,061902,4,4,0,0
1,2009,061902,4,4,0,0
2,2009,061902,6,6,0,0
3,2009,061902,4,4,0,0
4,2009,061902,5,5,0,0
5,2009,061902,5,5,0,0
6,2009,061902,6,6,0,0
7,2009,061902,3,3,0,0
8,2009,061902,8,7,1,0
9,2009,061902,9,9,0,0
10,2009,061902,3,3,0,0
11,2009,061902,5,5,0,0
12,2009,061902,3,3,0,0
1,2010,061902,3,3,0,1
2,2010,061902,4,4,0,0
3,2010,061902,1,1,0,0
4,2010,061902,6,6,0,0
5,2010,061902,5,4,1,0
6,2010,061902,4,4,0,0
7,2010,061902,11,9,2,0
8,2010,061902,9,9,0,0
9,2010,061902,11,11,0,0
10,2010,061902,5,5,0,0
11,2010,061902,9,9,0,0
12,2010,061902,2,2,0,0
1,2011,061902,4,4,0,0
2,2011,061902,1,1,0,0
1,1999,161200,1,1,0,0
2,1999,161200,13,10,3,2
3,1999,161200,5,4,1,1
4,1999,161200,9,8,1,1
5,1999,161200,12,9,3,1
6,1999,161200,8,8,0,1
7,1999,161200,6,6,0,0
8,1999,161200,13,12,1,0
9,1999,161200,9,8,1,3
10,1999,161200,12,11,1,4
11,1999,161200,8,7,1,1
12,1999,161200,6,6,0,2
1,2000,161200,7,7,0,0
2,2000,161200,9,8,1,1
3,2000,161200,14,13,1,1
4,2000,161200,5,5,0,1
5,2000,161200,13,12,1,5
6,2000,161200,7,6,1,1
7,2000,161200,6,5,1,0
8,2000,161200,4,4,0,2
9,2000,161200,9,7,2,3
10,2000,161200,13,11,2,1
11,2000,161200,14,12,2,3
12,2000,161200,3,3,0,1
1,2001,161200,8,6,2,4
2,2001,161200,5,3,2,2
3,2001,161200,11,9,2,6
4,2001,161200,2,2,0,4
5,2001,161200,6,6,0,2
6,2001,161200,11,10,1,3
7,2001,161200,10,8,2,2
8,2001,161200,9,8,1,2
9,2001,161200,12,11,1,2
10,2001,161200,10,9,1,0
11,2001,161200,6,6,0,0
12,2001,161200,4,3,1,2
1,2002,161200,11,10,1,1
2,2002,161200,11,11,0,7
3,2002,161200,11,10,1,3
4,2002,161200,3,2,1,5
5,2002,161200,8,8,0,0
6,2002,161200,7,6,1,0
7,2002,161200,14,14,0,0
8,2002,161200,12,11,1,0
9,2002,161200,13,12,1,1
10,2002,161200,15,13,2,2
11,2002,161200,8,6,2,2
12,2002,161200,3,3,0,3
1,2003,161200,10,5,5,0
2,2003,161200,2,2,0,4
3,2003,161200,9,8,1,0
4,2003,161200,12,12,0,0
5,2003,161200,10,9,1,1
6,2003,161200,16,14,2,0
7,2003,161200,12,12,0,1
8,2003,161200,6,5,1,0
9,2003,161200,10,9,1,7
10,2003,161200,12,11,1,4
11,2003,161200,7,4,3,2
12,2003,161200,4,4,0,0
1,2004,161200,6,6,0,5
2,2004,161200,6,6,0,6
3,2004,161200,7,5,2,8
4,2004,161200,7,7,0,2
5,2004,161200,9,6,3,3
6,2004,161200,4,2,2,0
7,2004,161200,9,8,1,6
8,2004,161200,9,9,0,0
9,2004,161200,5,4,1,0
10,2004,161200,7,7,0,8
11,2004,161200,0,0,0,7
12,2004,161200,7,6,1,1
1,2005,161200,3,3,0,2
2,2005,161200,6,5,1,6
3,2005,161200,5,4,1,2
4,2005,161200,10,9,1,0
5,2005,161200,8,7,1,2
6,2005,161200,14,13,1,1
7,2005,161200,6,5,1,2
8,2005,161200,12,12,0,1
9,2005,161200,5,4,1,4
10,2005,161200,7,7,0,1
11,2005,161200,9,8,1,1
12,2005,161200,4,4,0,2
1,2006,161200,7,6,1,1
2,2006,161200,8,7,1,4
3,2006,161200,8,6,2,5
4,2006,161200,5,5,0,1
5,2006,161200,6,6,0,2
6,2006,161200,4,4,0,0
7,2006,161200,3,3,0,1
8,2006,161200,7,6,1,1
9,2006,161200,4,4,0,0
10,2006,161200,8,7,1,1
11,2006,161200,7,6,1,1
12,2006,161200,14,13,1,3
1,2007,161200,4,4,0,4
2,2007,161200,6,6,0,0
3,2007,161200,14,12,2,6
4,2007,161200,9,7,2,3
5,2007,161200,11,11,0,4
6,2007,161200,10,9,1,1
7,2007,161200,6,6,0,2
8,2007,161200,6,5,1,1
9,2007,161200,12,10,2,3
10,2007,161200,6,5,1,1
11,2007,161200,3,3,0,3
12,2007,161200,6,6,0,3
1,2008,161200,4,4,0,1
2,2008,161200,8,5,3,5
3,2008,161200,7,6,1,1
4,2008,161200,9,9,0,0
5,2008,161200,11,9,2,1
6,2008,161200,6,5,1,1
7,2008,161200,5,3,2,0
8,2008,161200,6,6,0,1
9,2008,161200,8,7,1,1
10,2008,161200,10,9,1,3
11,2008,161200,6,5,1,1
12,2008,161200,5,5,0,1
1,2009,161200,7,6,1,2
2,2009,161200,5,5,0,0
3,2009,161200,10,8,2,2
4,2009,161200,4,4,0,1
5,2009,161200,7,4,3,1
6,2009,161200,8,6,2,0
7,2009,161200,9,7,2,2
8,2009,161200,6,6,0,1
9,2009,161200,7,6,1,1
10,2009,161200,14,12,2,1
11,2009,161200,10,10,0,0
12,2009,161200,9,8,1,2
1,2010,161200,3,1,2,4
2,2010,161200,3,2,1,4
3,2010,161200,5,5,0,4
4,2010,161200,7,7,0,5
5,2010,161200,5,5,0,3
6,2010,161200,5,5,0,2
7,2010,161200,6,5,1,3
8,2010,161200,8,7,1,0
9,2010,161200,11,9,2,3
10,2010,161200,8,7,1,3
11,2010,161200,6,6,0,3
12,2010,161200,11,11,0,5
1,2011,161200,12,12,0,2
2,2011,161200,3,3,0,2
1,1999,050900,4,4,0,0
2,1999,050900,2,2,0,1
3,1999,050900,0,0,0,0
4,1999,050900,1,1,0,0
5,1999,050900,7,7,0,0
6,1999,050900,7,7,0,0
7,1999,050900,8,8,0,0
8,1999,050900,7,7,0,0
9,1999,050900,5,5,0,0
10,1999,050900,6,6,0,1
11,1999,050900,1,1,0,0
12,1999,050900,0,0,0,0
1,2000,050900,6,6,0,0
2,2000,050900,1,1,0,2
3,2000,050900,1,1,0,0
4,2000,050900,2,2,0,0
5,2000,050900,5,5,0,0
6,2000,050900,5,5,0,0
7,2000,050900,4,4,0,0
8,2000,050900,5,5,0,0
9,2000,050900,1,1,0,0
10,2000,050900,7,7,0,0
11,2000,050900,3,3,0,1
12,2000,050900,3,3,0,1
1,2001,050900,4,3,1,0
2,2001,050900,5,5,0,1
3,2001,050900,2,2,0,1
4,2001,050900,1,1,0,0
5,2001,050900,4,4,0,0
6,2001,050900,2,2,0,0
7,2001,050900,5,5,0,2
8,2001,050900,4,4,0,0
9,2001,050900,6,6,0,0
10,2001,050900,5,4,1,8
11,2001,050900,4,4,0,0
12,2001,050900,5,5,0,1
1,2002,050900,5,5,0,0
2,2002,050900,3,3,0,0
3,2002,050900,1,1,0,1
4,2002,050900,5,5,0,0
5,2002,050900,3,3,0,1
6,2002,050900,5,5,0,0
7,2002,050900,6,5,1,0
8,2002,050900,2,2,0,1
9,2002,050900,5,5,0,0
10,2002,050900,4,4,0,1
11,2002,050900,6,6,0,0
12,2002,050900,0,0,0,0
1,2003,050900,1,1,0,4
2,2003,050900,4,4,0,3
3,2003,050900,4,4,0,0
4,2003,050900,5,4,1,0
5,2003,050900,0,0,0,0
6,2003,050900,4,4,0,0
7,2003,050900,5,4,1,0
8,2003,050900,6,6,0,0
9,2003,050900,3,3,0,0
10,2003,050900,1,1,0,0
11,2003,050900,5,5,0,0
12,2003,050900,3,3,0,1
1,2004,050900,3,2,1,0
2,2004,050900,3,3,0,0
3,2004,050900,4,4,0,1
4,2004,050900,2,2,0,0
5,2004,050900,5,5,0,0
6,2004,050900,4,4,0,0
7,2004,050900,2,2,0,0
8,2004,050900,3,3,0,0
9,2004,050900,0,0,0,0
10,2004,050900,3,3,0,0
11,2004,050900,2,2,0,0
12,2004,050900,1,1,0,0
1,2005,050900,3,2,1,0
2,2005,050900,3,2,1,0
3,2005,050900,2,2,0,0
4,2005,050900,3,3,0,2
5,2005,050900,5,5,0,0
6,2005,050900,3,3,0,0
7,2005,050900,4,4,0,0
8,2005,050900,9,9,0,0
9,2005,050900,2,1,1,0
10,2005,050900,2,2,0,0
11,2005,050900,2,2,0,0
12,2005,050900,2,2,0,1
1,2006,050900,1,1,0,2
2,2006,050900,3,3,0,0
3,2006,050900,3,3,0,1
4,2006,050900,2,2,0,1
5,2006,050900,2,2,0,0
6,2006,050900,2,2,0,0
7,2006,050900,6,6,0,0
8,2006,050900,2,2,0,0
9,2006,050900,3,3,0,0
10,2006,050900,5,5,0,1
11,2006,050900,0,0,0,0
12,2006,050900,3,3,0,0
1,2007,050900,2,2,0,0
2,2007,050900,2,2,0,0
3,2007,050900,1,1,0,0
4,2007,050900,5,5,0,1
5,2007,050900,5,5,0,0
6,2007,050900,3,2,1,0
7,2007,050900,5,5,0,0
8,2007,050900,0,0,0,0
9,2007,050900,3,3,0,2
10,2007,050900,3,3,0,0
11,2007,050900,3,3,0,0
12,2007,050900,4,4,0,1
1,2008,050900,0,0,0,0
2,2008,050900,2,2,0,0
3,2008,050900,3,3,0,0
4,2008,050900,3,3,0,0
5,2008,050900,4,4,0,0
6,2008,050900,2,2,0,0
7,2008,050900,2,2,0,0
8,2008,050900,4,4,0,0
9,2008,050900,4,4,0,2
10,2008,050900,3,3,0,0
11,2008,050900,3,3,0,0
12,2008,050900,1,1,0,0
1,2009,050900,1,1,0,0
2,2009,050900,3,3,0,0
3,2009,050900,5,5,0,0
4,2009,050900,1,1,0,0
5,2009,050900,9,8,1,0
6,2009,050900,3,3,0,0
7,2009,050900,0,0,0,0
8,2009,050900,3,3,0,0
9,2009,050900,6,6,0,0
10,2009,050900,2,2,0,0
11,2009,050900,3,3,0,0
12,2009,050900,1,0,1,1
1,2010,050900,1,1,0,0
2,2010,050900,2,2,0,0
3,2010,050900,5,5,0,0
4,2010,050900,4,4,0,2
5,2010,050900,2,2,0,0
6,2010,050900,3,3,0,0
7,2010,050900,3,3,0,0
8,2010,050900,4,4,0,0
9,2010,050900,4,4,0,0
10,2010,050900,2,2,0,0
11,2010,050900,0,0,0,0
12,2010,050900,2,2,0,0
1,2011,050900,1,1,0,0
2,2011,050900,1,1,0,0
1,1999,050800,5,5,0,2
2,1999,050800,5,5,0,0
3,1999,050800,3,3,0,1
4,1999,050800,5,4,1,0
5,1999,050800,6,6,0,1
6,1999,050800,11,10,1,0
7,1999,050800,12,11,1,0
8,1999,050800,6,6,0,0
9,1999,050800,5,5,0,0
10,1999,050800,5,4,1,0
11,1999,050800,7,6,1,0
12,1999,050800,7,7,0,0
1,2000,050800,7,7,0,0
2,2000,050800,5,4,1,0
3,2000,050800,7,6,1,0
4,2000,050800,10,9,1,1
5,2000,050800,5,5,0,0
6,2000,050800,5,5,0,0
7,2000,050800,10,10,0,1
8,2000,050800,8,8,0,0
9,2000,050800,9,9,0,0
10,2000,050800,4,3,1,0
11,2000,050800,4,4,0,0
12,2000,050800,3,3,0,1
1,2001,050800,5,3,2,0
2,2001,050800,5,5,0,1
3,2001,050800,4,3,1,0
4,2001,050800,3,3,0,0
5,2001,050800,9,9,0,0
6,2001,050800,3,2,1,0
7,2001,050800,7,7,0,1
8,2001,050800,3,3,0,0
9,2001,050800,3,3,0,0
10,2001,050800,6,6,0,0
11,2001,050800,10,9,1,0
12,2001,050800,4,4,0,0
1,2002,050800,11,11,0,2
2,2002,050800,1,1,0,0
3,2002,050800,2,2,0,0
4,2002,050800,7,7,0,0
5,2002,050800,5,5,0,0
6,2002,050800,7,5,2,1
7,2002,050800,6,6,0,0
8,2002,050800,8,6,2,0
9,2002,050800,7,7,0,0
10,2002,050800,5,5,0,0
11,2002,050800,8,8,0,0
12,2002,050800,11,10,1,0
1,2003,050800,2,2,0,0
2,2003,050800,2,2,0,0
3,2003,050800,7,7,0,0
4,2003,050800,3,3,0,0
5,2003,050800,4,4,0,0
6,2003,050800,3,3,0,0
7,2003,050800,2,2,0,1
8,2003,050800,5,5,0,1
9,2003,050800,3,3,0,0
10,2003,050800,3,3,0,0
11,2003,050800,7,7,0,1
12,2003,050800,5,5,0,0
1,2004,050800,9,9,0,0
2,2004,050800,3,3,0,0
3,2004,050800,2,2,0,1
4,2004,050800,12,12,0,0
5,2004,050800,8,8,0,0
6,2004,050800,8,8,0,0
7,2004,050800,3,3,0,0
8,2004,050800,7,6,1,0
9,2004,050800,1,1,0,0
10,2004,050800,6,6,0,0
11,2004,050800,6,6,0,1
12,2004,050800,4,4,0,0
1,2005,050800,9,8,1,0
2,2005,050800,7,6,1,2
3,2005,050800,3,3,0,0
4,2005,050800,6,6,0,0
5,2005,050800,4,4,0,0
6,2005,050800,9,9,0,0
7,2005,050800,3,3,0,0
8,2005,050800,11,11,0,0
9,2005,050800,5,5,0,0
10,2005,050800,7,7,0,0
11,2005,050800,6,6,0,0
12,2005,050800,3,3,0,1
1,2006,050800,2,1,1,0
2,2006,050800,3,2,1,0
3,2006,050800,3,3,0,0
4,2006,050800,4,4,0,0
5,2006,050800,3,3,0,0
6,2006,050800,9,9,0,0
7,2006,050800,4,4,0,0
8,2006,050800,7,7,0,0
9,2006,050800,5,5,0,1
10,2006,050800,11,10,1,1
11,2006,050800,4,4,0,0
12,2006,050800,6,6,0,0
1,2007,050800,10,10,0,0
2,2007,050800,5,4,1,0
3,2007,050800,2,2,0,0
4,2007,050800,6,6,0,1
5,2007,050800,5,5,0,0
6,2007,050800,4,4,0,0
7,2007,050800,5,5,0,0
8,2007,050800,9,8,1,0
9,2007,050800,6,6,0,0
10,2007,050800,9,9,0,0
11,2007,050800,9,9,0,0
12,2007,050800,7,7,0,0
1,2008,050800,4,4,0,0
2,2008,050800,3,2,1,0
3,2008,050800,2,2,0,0
4,2008,050800,13,13,0,0
5,2008,050800,7,7,0,0
6,2008,050800,5,5,0,0
7,2008,050800,7,7,0,0
8,2008,050800,5,4,1,0
9,2008,050800,8,8,0,0
10,2008,050800,7,7,0,0
11,2008,050800,6,5,1,0
12,2008,050800,5,5,0,2
1,2009,050800,6,6,0,0
2,2009,050800,2,2,0,0
3,2009,050800,0,0,0,0
4,2009,050800,6,6,0,0
5,2009,050800,9,9,0,0
6,2009,050800,5,4,1,0
7,2009,050800,5,5,0,0
8,2009,050800,9,9,0,0
9,2009,050800,7,7,0,0
10,2009,050800,8,8,0,0
11,2009,050800,7,7,0,0
12,2009,050800,1,1,0,0
1,2010,050800,5,5,0,0
2,2010,050800,2,2,0,0
3,2010,050800,6,5,1,2
4,2010,050800,3,3,0,0
5,2010,050800,4,4,0,0
6,2010,050800,1,1,0,0
7,2010,050800,12,12,0,0
8,2010,050800,9,9,0,0
9,2010,050800,7,7,0,0
10,2010,050800,3,3,0,0
11,2010,050800,5,5,0,0
12,2010,050800,4,4,0,0
1,2011,050800,4,3,1,0
2,2011,050800,0,0,0,0
1,1999,050700,2,2,0,0
2,1999,050700,4,4,0,0
3,1999,050700,2,2,0,2
4,1999,050700,2,1,1,1
5,1999,050700,4,4,0,3
6,1999,050700,5,5,0,0
7,1999,050700,5,5,0,0
8,1999,050700,8,8,0,0
9,1999,050700,3,3,0,0
10,1999,050700,6,6,0,1
11,1999,050700,4,4,0,0
12,1999,050700,2,2,0,0
1,2000,050700,2,2,0,0
2,2000,050700,2,2,0,1
3,2000,050700,4,3,1,0
4,2000,050700,3,3,0,0
5,2000,050700,5,5,0,0
6,2000,050700,8,8,0,0
7,2000,050700,2,2,0,0
8,2000,050700,4,4,0,0
9,2000,050700,2,2,0,0
10,2000,050700,7,7,0,0
11,2000,050700,3,3,0,0
12,2000,050700,4,4,0,0
1,2001,050700,2,2,0,1
2,2001,050700,2,2,0,0
3,2001,050700,1,1,0,0
4,2001,050700,6,5,1,1
5,2001,050700,7,6,1,1
6,2001,050700,1,1,0,0
7,2001,050700,3,3,0,0
8,2001,050700,6,5,1,0
9,2001,050700,2,2,0,1
10,2001,050700,3,3,0,0
11,2001,050700,5,5,0,0
12,2001,050700,4,4,0,0
1,2002,050700,8,7,1,0
2,2002,050700,2,2,0,0
3,2002,050700,1,0,1,0
4,2002,050700,3,3,0,0
5,2002,050700,7,7,0,1
6,2002,050700,1,1,0,0
7,2002,050700,2,2,0,0
8,2002,050700,5,5,0,0
9,2002,050700,2,2,0,0
10,2002,050700,5,4,1,0
11,2002,050700,7,6,1,0
12,2002,050700,3,3,0,0
1,2003,050700,6,6,0,0
2,2003,050700,2,2,0,0
3,2003,050700,3,2,1,0
4,2003,050700,4,4,0,0
5,2003,050700,1,1,0,1
6,2003,050700,1,1,0,0
7,2003,050700,6,6,0,1
8,2003,050700,4,4,0,0
9,2003,050700,4,3,1,0
10,2003,050700,3,3,0,1
11,2003,050700,1,1,0,0
12,2003,050700,2,2,0,0
1,2004,050700,3,3,0,0
2,2004,050700,1,1,0,0
3,2004,050700,2,2,0,0
4,2004,050700,1,1,0,0
5,2004,050700,2,1,1,0
6,2004,050700,2,2,0,0
7,2004,050700,5,5,0,0
8,2004,050700,0,0,0,0
9,2004,050700,3,3,0,0
10,2004,050700,5,5,0,0
11,2004,050700,0,0,0,0
12,2004,050700,6,6,0,0
1,2005,050700,2,2,0,0
2,2005,050700,3,3,0,0
3,2005,050700,2,2,0,0
4,2005,050700,4,2,2,0
5,2005,050700,2,2,0,0
6,2005,050700,2,2,0,0
7,2005,050700,4,4,0,0
8,2005,050700,4,4,0,0
9,2005,050700,2,2,0,0
10,2005,050700,2,2,0,0
11,2005,050700,1,1,0,0
12,2005,050700,4,4,0,0
1,2006,050700,3,3,0,0
2,2006,050700,2,2,0,0
3,2006,050700,1,1,0,0
4,2006,050700,3,2,1,0
5,2006,050700,4,4,0,0
6,2006,050700,3,3,0,0
7,2006,050700,8,8,0,0
8,2006,050700,1,1,0,0
9,2006,050700,3,3,0,0
10,2006,050700,5,5,0,0
11,2006,050700,1,1,0,1
12,2006,050700,2,2,0,0
1,2007,050700,1,1,0,0
2,2007,050700,1,1,0,0
3,2007,050700,2,2,0,0
4,2007,050700,4,4,0,0
5,2007,050700,5,5,0,0
6,2007,050700,1,1,0,0
7,2007,050700,7,7,0,0
8,2007,050700,5,5,0,0
9,2007,050700,6,6,0,0
10,2007,050700,6,6,0,0
11,2007,050700,4,4,0,0
12,2007,050700,4,4,0,0
1,2008,050700,2,2,0,0
2,2008,050700,1,1,0,1
3,2008,050700,4,4,0,0
4,2008,050700,3,3,0,0
5,2008,050700,3,3,0,0
6,2008,050700,1,1,0,0
7,2008,050700,3,3,0,1
8,2008,050700,3,3,0,1
9,2008,050700,5,5,0,1
10,2008,050700,6,4,2,0
11,2008,050700,3,3,0,0
12,2008,050700,6,6,0,0
1,2009,050700,1,1,0,0
2,2009,050700,3,3,0,0
3,2009,050700,3,3,0,1
4,2009,050700,1,1,0,0
5,2009,050700,3,3,0,0
6,2009,050700,5,4,1,0
7,2009,050700,5,5,0,1
8,2009,050700,2,2,0,1
9,2009,050700,3,3,0,2
10,2009,050700,9,9,0,0
11,2009,050700,2,2,0,0
12,2009,050700,4,4,0,1
1,2010,050700,3,3,0,0
2,2010,050700,3,3,0,1
3,2010,050700,2,2,0,0
4,2010,050700,4,4,0,0
5,2010,050700,5,5,0,2
6,2010,050700,5,5,0,1
7,2010,050700,2,2,0,0
8,2010,050700,2,2,0,1
9,2010,050700,2,2,0,1
10,2010,050700,6,6,0,0
11,2010,050700,4,4,0,0
12,2010,050700,0,0,0,0
1,2011,050700,5,4,1,0
2,2011,050700,2,2,0,0
1,1999,831900,10,10,0,2
2,1999,831900,9,8,1,0
3,1999,831900,18,17,1,1
4,1999,831900,10,9,1,1
5,1999,831900,15,14,1,4
6,1999,831900,10,8,2,0
7,1999,831900,25,23,2,4
8,1999,831900,21,21,0,3
9,1999,831900,19,19,0,4
10,1999,831900,11,10,1,0
11,1999,831900,20,20,0,0
12,1999,831900,13,13,0,1
1,2000,831900,12,12,0,0
2,2000,831900,10,8,2,1
3,2000,831900,16,16,0,0
4,2000,831900,12,12,0,0
5,2000,831900,14,13,1,1
6,2000,831900,11,11,0,0
7,2000,831900,8,8,0,0
8,2000,831900,20,20,0,0
9,2000,831900,22,22,0,1
10,2000,831900,9,8,1,0
11,2000,831900,7,7,0,0
12,2000,831900,7,7,0,0
1,2001,831900,7,7,0,0
2,2001,831900,9,9,0,0
3,2001,831900,10,9,1,0
4,2001,831900,8,6,2,0
5,2001,831900,13,11,2,0
6,2001,831900,10,10,0,0
7,2001,831900,13,13,0,0
8,2001,831900,10,10,0,1
9,2001,831900,13,13,0,0
10,2001,831900,7,7,0,0
11,2001,831900,7,7,0,1
12,2001,831900,7,7,0,0
1,2002,831900,15,14,1,0
2,2002,831900,8,8,0,1
3,2002,831900,12,11,1,0
4,2002,831900,8,8,0,0
5,2002,831900,18,18,0,0
6,2002,831900,12,11,1,1
7,2002,831900,7,7,0,0
8,2002,831900,18,18,0,2
9,2002,831900,18,18,0,0
10,2002,831900,17,17,0,0
11,2002,831900,14,13,1,0
12,2002,831900,11,11,0,0
1,2003,831900,16,15,1,0
2,2003,831900,13,13,0,0
3,2003,831900,8,8,0,0
4,2003,831900,7,7,0,1
5,2003,831900,14,14,0,0
6,2003,831900,4,3,1,1
7,2003,831900,10,9,1,0
8,2003,831900,6,6,0,0
9,2003,831900,9,8,1,0
10,2003,831900,14,13,1,0
11,2003,831900,11,9,2,1
12,2003,831900,6,6,0,0
1,2004,831900,6,5,1,0
2,2004,831900,7,7,0,0
3,2004,831900,8,8,0,0
4,2004,831900,9,8,1,0
5,2004,831900,10,10,0,0
6,2004,831900,6,6,0,0
7,2004,831900,12,12,0,0
8,2004,831900,13,13,0,2
9,2004,831900,13,13,0,0
10,2004,831900,5,4,1,1
11,2004,831900,12,12,0,1
12,2004,831900,11,11,0,1
1,2005,831900,9,9,0,0
2,2005,831900,12,12,0,0
3,2005,831900,7,7,0,0
4,2005,831900,10,10,0,0
5,2005,831900,12,12,0,3
6,2005,831900,12,12,0,2
7,2005,831900,16,16,0,0
8,2005,831900,12,12,0,0
9,2005,831900,5,5,0,1
10,2005,831900,10,10,0,0
11,2005,831900,9,9,0,0
12,2005,831900,9,9,0,0
1,2006,831900,8,8,0,0
2,2006,831900,9,9,0,0
3,2006,831900,9,8,1,0
4,2006,831900,3,3,0,0
5,2006,831900,12,11,1,0
6,2006,831900,10,10,0,1
7,2006,831900,12,12,0,0
8,2006,831900,9,9,0,0
9,2006,831900,9,9,0,0
10,2006,831900,11,11,0,0
11,2006,831900,2,2,0,0
12,2006,831900,3,3,0,0
1,2007,831900,5,5,0,0
2,2007,831900,7,6,1,0
3,2007,831900,10,10,0,0
4,2007,831900,10,9,1,0
5,2007,831900,14,13,1,0
6,2007,831900,13,13,0,0
7,2007,831900,10,10,0,0
8,2007,831900,6,6,0,2
9,2007,831900,15,15,0,0
10,2007,831900,14,14,0,0
11,2007,831900,8,7,1,0
12,2007,831900,7,7,0,0
1,2008,831900,9,9,0,0
2,2008,831900,13,13,0,1
3,2008,831900,9,8,1,0
4,2008,831900,11,11,0,0
5,2008,831900,13,13,0,0
6,2008,831900,17,17,0,0
7,2008,831900,9,9,0,1
8,2008,831900,12,11,1,0
9,2008,831900,17,17,0,1
10,2008,831900,21,20,1,0
11,2008,831900,10,10,0,1
12,2008,831900,15,15,0,1
1,2009,831900,16,16,0,0
2,2009,831900,10,8,2,1
3,2009,831900,17,17,0,0
4,2009,831900,19,19,0,0
5,2009,831900,19,18,1,0
6,2009,831900,17,17,0,0
7,2009,831900,18,18,0,1
8,2009,831900,21,20,1,0
9,2009,831900,11,11,0,0
10,2009,831900,18,18,0,0
11,2009,831900,12,12,0,1
12,2009,831900,8,8,0,1
1,2010,831900,7,6,1,0
2,2010,831900,12,12,0,0
3,2010,831900,13,13,0,2
4,2010,831900,12,12,0,4
5,2010,831900,19,17,2,0
6,2010,831900,16,16,0,1
7,2010,831900,21,20,1,2
8,2010,831900,26,26,0,1
9,2010,831900,14,13,1,1
10,2010,831900,13,12,1,1
11,2010,831900,13,13,0,2
12,2010,831900,14,13,1,0
1,2011,831900,17,17,0,0
2,2011,831900,7,7,0,3
1,1999,061500,6,6,0,0
2,1999,061500,5,5,0,0
3,1999,061500,2,2,0,0
4,1999,061500,4,3,1,0
5,1999,061500,9,9,0,0
6,1999,061500,20,20,0,0
7,1999,061500,4,4,0,0
8,1999,061500,7,6,1,0
9,1999,061500,14,13,1,1
10,1999,061500,4,4,0,0
11,1999,061500,7,7,0,1
12,1999,061500,3,3,0,0
1,2000,061500,12,11,1,0
2,2000,061500,7,7,0,0
3,2000,061500,10,10,0,0
4,2000,061500,5,5,0,1
5,2000,061500,7,7,0,0
6,2000,061500,11,11,0,0
7,2000,061500,7,7,0,0
8,2000,061500,7,7,0,0
9,2000,061500,12,12,0,1
10,2000,061500,12,10,2,0
11,2000,061500,1,1,0,0
12,2000,061500,5,5,0,0
1,2001,061500,4,4,0,0
2,2001,061500,3,3,0,0
3,2001,061500,9,9,0,0
4,2001,061500,7,7,0,0
5,2001,061500,4,4,0,0
6,2001,061500,4,4,0,0
7,2001,061500,5,5,0,0
8,2001,061500,8,7,1,0
9,2001,061500,7,6,1,0
10,2001,061500,10,10,0,0
11,2001,061500,3,3,0,0
12,2001,061500,4,4,0,0
1,2002,061500,8,8,0,0
2,2002,061500,5,5,0,0
3,2002,061500,3,3,0,1
4,2002,061500,8,8,0,0
5,2002,061500,9,9,0,0
6,2002,061500,12,12,0,0
7,2002,061500,8,8,0,0
8,2002,061500,6,6,0,0
9,2002,061500,7,7,0,0
10,2002,061500,13,13,0,0
11,2002,061500,19,19,0,0
12,2002,061500,8,8,0,0
1,2003,061500,6,6,0,0
2,2003,061500,7,7,0,0
3,2003,061500,5,4,1,0
4,2003,061500,8,8,0,1
5,2003,061500,7,7,0,0
6,2003,061500,7,7,0,0
7,2003,061500,7,7,0,0
8,2003,061500,7,7,0,0
9,2003,061500,7,7,0,1
10,2003,061500,4,4,0,0
11,2003,061500,2,2,0,0
12,2003,061500,8,8,0,0
1,2004,061500,0,0,0,0
2,2004,061500,6,5,1,0
3,2004,061500,4,4,0,1
4,2004,061500,5,5,0,0
5,2004,061500,4,4,0,0
6,2004,061500,3,3,0,0
7,2004,061500,7,7,0,0
8,2004,061500,14,13,1,1
9,2004,061500,6,6,0,0
10,2004,061500,5,5,0,0
11,2004,061500,5,5,0,0
12,2004,061500,6,6,0,0
1,2005,061500,6,6,0,0
2,2005,061500,7,7,0,0
3,2005,061500,3,3,0,1
4,2005,061500,6,5,1,0
5,2005,061500,3,3,0,0
6,2005,061500,4,4,0,0
7,2005,061500,6,6,0,2
8,2005,061500,11,11,0,0
9,2005,061500,9,9,0,0
10,2005,061500,4,4,0,0
11,2005,061500,2,2,0,0
12,2005,061500,2,2,0,0
1,2006,061500,6,6,0,0
2,2006,061500,3,3,0,0
3,2006,061500,5,5,0,0
4,2006,061500,2,2,0,0
5,2006,061500,5,5,0,0
6,2006,061500,7,7,0,0
7,2006,061500,8,8,0,0
8,2006,061500,2,2,0,0
9,2006,061500,3,3,0,0
10,2006,061500,11,11,0,0
11,2006,061500,6,6,0,1
12,2006,061500,5,4,1,0
1,2007,061500,2,2,0,0
2,2007,061500,2,2,0,1
3,2007,061500,4,4,0,0
4,2007,061500,2,2,0,1
5,2007,061500,3,3,0,0
6,2007,061500,5,5,0,0
7,2007,061500,7,7,0,0
8,2007,061500,7,7,0,0
9,2007,061500,4,4,0,0
10,2007,061500,11,10,1,0
11,2007,061500,13,13,0,0
12,2007,061500,2,2,0,0
1,2008,061500,11,11,0,0
2,2008,061500,5,5,0,0
3,2008,061500,12,11,1,0
4,2008,061500,11,11,0,0
5,2008,061500,12,12,0,0
6,2008,061500,3,3,0,1
7,2008,061500,5,5,0,0
8,2008,061500,3,3,0,0
9,2008,061500,5,5,0,0
10,2008,061500,14,14,0,0
11,2008,061500,11,11,0,0
12,2008,061500,11,11,0,0
1,2009,061500,7,7,0,0
2,2009,061500,8,8,0,0
3,2009,061500,8,8,0,0
4,2009,061500,6,6,0,0
5,2009,061500,10,9,1,0
6,2009,061500,3,3,0,0
7,2009,061500,9,9,0,0
8,2009,061500,5,5,0,0
9,2009,061500,7,7,0,0
10,2009,061500,9,9,0,0
11,2009,061500,4,4,0,0
12,2009,061500,3,3,0,0
1,2010,061500,8,8,0,0
2,2010,061500,10,10,0,0
3,2010,061500,8,8,0,0
4,2010,061500,4,4,0,0
5,2010,061500,6,6,0,0
6,2010,061500,9,8,1,0
7,2010,061500,9,9,0,0
8,2010,061500,7,7,0,0
9,2010,061500,6,6,0,0
10,2010,061500,5,4,1,0
11,2010,061500,5,5,0,0
12,2010,061500,1,1,0,0
1,2011,061500,5,5,0,0
2,2011,061500,5,5,0,0
1,1999,170500,8,7,1,0
2,1999,170500,6,4,2,0
3,1999,170500,9,7,2,0
4,1999,170500,6,6,0,0
5,1999,170500,7,5,2,0
6,1999,170500,5,5,0,0
7,1999,170500,7,7,0,0
8,1999,170500,9,9,0,0
9,1999,170500,6,6,0,0
10,1999,170500,8,8,0,0
11,1999,170500,5,5,0,0
12,1999,170500,5,5,0,0
1,2000,170500,10,8,2,1
2,2000,170500,3,2,1,0
3,2000,170500,9,8,1,0
4,2000,170500,2,2,0,0
5,2000,170500,5,5,0,0
6,2000,170500,5,3,2,1
7,2000,170500,10,8,2,1
8,2000,170500,15,14,1,0
9,2000,170500,6,6,0,1
10,2000,170500,8,8,0,0
11,2000,170500,14,14,0,0
12,2000,170500,7,7,0,0
1,2001,170500,5,4,1,0
2,2001,170500,6,4,2,0
3,2001,170500,4,4,0,0
4,2001,170500,2,2,0,0
5,2001,170500,6,6,0,1
6,2001,170500,2,1,1,0
7,2001,170500,7,7,0,0
8,2001,170500,7,7,0,0
9,2001,170500,3,3,0,1
10,2001,170500,10,10,0,0
11,2001,170500,6,4,2,0
12,2001,170500,2,2,0,0
1,2002,170500,9,8,1,0
2,2002,170500,2,2,0,0
3,2002,170500,1,1,0,2
4,2002,170500,6,6,0,0
5,2002,170500,4,4,0,0
6,2002,170500,4,4,0,0
7,2002,170500,6,6,0,0
8,2002,170500,7,7,0,0
9,2002,170500,4,4,0,0
10,2002,170500,7,7,0,0
11,2002,170500,9,8,1,0
12,2002,170500,4,4,0,1
1,2003,170500,10,10,0,0
2,2003,170500,4,4,0,1
3,2003,170500,4,4,0,1
4,2003,170500,4,4,0,3
5,2003,170500,6,5,1,1
6,2003,170500,11,11,0,0
7,2003,170500,3,3,0,1
8,2003,170500,5,4,1,0
9,2003,170500,5,5,0,0
10,2003,170500,4,4,0,1
11,2003,170500,5,4,1,0
12,2003,170500,4,4,0,0
1,2004,170500,6,6,0,0
2,2004,170500,2,2,0,0
3,2004,170500,10,10,0,0
4,2004,170500,6,6,0,0
5,2004,170500,7,6,1,2
6,2004,170500,3,3,0,0
7,2004,170500,7,6,1,0
8,2004,170500,8,7,1,3
9,2004,170500,11,9,2,0
10,2004,170500,1,1,0,0
11,2004,170500,10,10,0,0
12,2004,170500,5,5,0,2
1,2005,170500,5,4,1,1
2,2005,170500,7,7,0,0
3,2005,170500,3,3,0,0
4,2005,170500,1,1,0,2
5,2005,170500,5,5,0,1
6,2005,170500,4,4,0,2
7,2005,170500,7,7,0,1
8,2005,170500,4,3,1,1
9,2005,170500,6,5,1,0
10,2005,170500,7,7,0,0
11,2005,170500,10,9,1,0
12,2005,170500,8,8,0,1
1,2006,170500,5,5,0,2
2,2006,170500,1,1,0,0
3,2006,170500,5,5,0,0
4,2006,170500,1,1,0,0
5,2006,170500,6,6,0,1
6,2006,170500,8,8,0,0
7,2006,170500,9,8,1,2
8,2006,170500,2,2,0,0
9,2006,170500,4,4,0,2
10,2006,170500,3,3,0,0
11,2006,170500,2,2,0,2
12,2006,170500,7,7,0,0
1,2007,170500,3,3,0,0
2,2007,170500,4,4,0,0
3,2007,170500,0,0,0,0
4,2007,170500,2,2,0,0
5,2007,170500,4,4,0,3
6,2007,170500,2,2,0,0
7,2007,170500,3,3,0,0
8,2007,170500,3,2,1,2
9,2007,170500,3,3,0,0
10,2007,170500,8,7,1,0
11,2007,170500,4,4,0,0
12,2007,170500,4,4,0,0
1,2008,170500,5,5,0,0
2,2008,170500,2,2,0,0
3,2008,170500,4,4,0,0
4,2008,170500,6,6,0,0
5,2008,170500,12,12,0,0
6,2008,170500,10,10,0,0
7,2008,170500,5,4,1,0
8,2008,170500,7,7,0,0
9,2008,170500,6,6,0,0
10,2008,170500,8,8,0,0
11,2008,170500,9,8,1,0
12,2008,170500,5,5,0,0
1,2009,170500,5,5,0,1
2,2009,170500,11,11,0,0
3,2009,170500,6,6,0,1
4,2009,170500,4,4,0,0
5,2009,170500,7,6,1,0
6,2009,170500,12,11,1,0
7,2009,170500,14,14,0,0
8,2009,170500,3,3,0,1
9,2009,170500,11,11,0,1
10,2009,170500,2,2,0,0
11,2009,170500,5,5,0,0
12,2009,170500,5,5,0,0
1,2010,170500,5,5,0,3
2,2010,170500,5,5,0,0
3,2010,170500,7,7,0,0
4,2010,170500,4,4,0,0
5,2010,170500,2,2,0,0
6,2010,170500,6,4,2,0
7,2010,170500,1,1,0,2
8,2010,170500,5,4,1,0
9,2010,170500,5,5,0,1
10,2010,170500,5,4,1,1
11,2010,170500,4,4,0,0
12,2010,170500,3,3,0,1
1,2011,170500,3,2,1,0
2,2011,170500,3,3,0,0
1,1999,832000,11,11,0,0
2,1999,832000,10,9,1,0
3,1999,832000,5,5,0,0
4,1999,832000,11,9,2,3
5,1999,832000,17,16,1,1
6,1999,832000,20,20,0,0
7,1999,832000,27,27,0,2
8,1999,832000,17,14,3,0
9,1999,832000,14,14,0,0
10,1999,832000,14,14,0,0
11,1999,832000,7,7,0,1
12,1999,832000,8,6,2,1
1,2000,832000,13,13,0,1
2,2000,832000,10,10,0,2
3,2000,832000,4,4,0,0
4,2000,832000,17,15,2,0
5,2000,832000,14,13,1,1
6,2000,832000,18,18,0,2
7,2000,832000,15,14,1,4
8,2000,832000,12,12,0,1
9,2000,832000,11,11,0,1
10,2000,832000,10,10,0,1
11,2000,832000,15,14,1,0
12,2000,832000,18,15,3,0
1,2001,832000,11,10,1,0
2,2001,832000,13,12,1,0
3,2001,832000,13,11,2,0
4,2001,832000,18,17,1,0
5,2001,832000,20,20,0,2
6,2001,832000,20,19,1,0
7,2001,832000,22,21,1,0
8,2001,832000,11,11,0,0
9,2001,832000,9,9,0,1
10,2001,832000,23,20,3,2
11,2001,832000,18,18,0,0
12,2001,832000,11,11,0,0
1,2002,832000,14,13,1,1
2,2002,832000,8,6,2,2
3,2002,832000,5,4,1,0
4,2002,832000,11,11,0,0
5,2002,832000,11,10,1,0
6,2002,832000,15,15,0,0
7,2002,832000,9,8,1,0
8,2002,832000,16,16,0,2
9,2002,832000,11,11,0,2
10,2002,832000,14,11,3,0
11,2002,832000,12,11,1,1
12,2002,832000,9,9,0,1
1,2003,832000,6,5,1,0
2,2003,832000,11,11,0,1
3,2003,832000,10,10,0,1
4,2003,832000,14,12,2,0
5,2003,832000,14,11,3,1
6,2003,832000,8,6,2,2
7,2003,832000,17,15,2,1
8,2003,832000,25,24,1,0
9,2003,832000,14,12,2,2
10,2003,832000,14,14,0,0
11,2003,832000,11,11,0,0
12,2003,832000,12,12,0,0
1,2004,832000,12,12,0,0
2,2004,832000,3,3,0,1
3,2004,832000,10,10,0,3
4,2004,832000,16,11,5,1
5,2004,832000,18,16,2,2
6,2004,832000,13,13,0,1
7,2004,832000,16,14,2,2
8,2004,832000,19,16,3,2
9,2004,832000,11,11,0,2
10,2004,832000,14,13,1,0
11,2004,832000,24,23,1,0
12,2004,832000,13,11,2,0
1,2005,832000,9,9,0,0
2,2005,832000,7,7,0,0
3,2005,832000,7,7,0,0
4,2005,832000,21,20,1,3
5,2005,832000,10,8,2,2
6,2005,832000,16,14,2,0
7,2005,832000,15,15,0,1
8,2005,832000,9,8,1,5
9,2005,832000,12,9,3,2
10,2005,832000,13,13,0,1
11,2005,832000,15,14,1,0
12,2005,832000,9,9,0,0
1,2006,832000,4,3,1,4
2,2006,832000,8,8,0,0
3,2006,832000,10,9,1,1
4,2006,832000,13,12,1,2
5,2006,832000,10,10,0,0
6,2006,832000,11,9,2,1
7,2006,832000,13,11,2,3
8,2006,832000,13,11,2,1
9,2006,832000,14,13,1,0
10,2006,832000,16,15,1,0
11,2006,832000,15,14,1,2
12,2006,832000,7,6,1,1
1,2007,832000,5,5,0,3
2,2007,832000,8,8,0,0
3,2007,832000,18,12,6,0
4,2007,832000,13,11,2,1
5,2007,832000,19,16,3,2
6,2007,832000,12,10,2,1
7,2007,832000,12,12,0,0
8,2007,832000,10,10,0,2
9,2007,832000,12,11,1,1
10,2007,832000,11,11,0,1
11,2007,832000,12,11,1,0
12,2007,832000,12,11,1,0
1,2008,832000,19,19,0,0
2,2008,832000,12,11,1,0
3,2008,832000,13,13,0,0
4,2008,832000,15,14,1,1
5,2008,832000,23,23,0,1
6,2008,832000,24,23,1,0
7,2008,832000,15,12,3,0
8,2008,832000,19,17,2,4
9,2008,832000,17,17,0,0
10,2008,832000,10,10,0,0
11,2008,832000,11,11,0,0
12,2008,832000,8,8,0,0
1,2009,832000,11,11,0,0
2,2009,832000,14,14,0,0
3,2009,832000,10,9,1,2
4,2009,832000,17,16,1,0
5,2009,832000,15,15,0,1
6,2009,832000,15,13,2,1
7,2009,832000,19,18,1,3
8,2009,832000,27,24,3,0
9,2009,832000,20,19,1,2
10,2009,832000,11,10,1,0
11,2009,832000,17,17,0,1
12,2009,832000,18,17,1,2
1,2010,832000,9,9,0,0
2,2010,832000,6,6,0,3
3,2010,832000,17,17,0,0
4,2010,832000,24,22,2,3
5,2010,832000,25,25,0,0
6,2010,832000,24,24,0,0
7,2010,832000,29,28,1,3
8,2010,832000,24,23,1,0
9,2010,832000,15,15,0,2
10,2010,832000,21,17,4,6
11,2010,832000,6,5,1,0
12,2010,832000,9,9,0,0
1,2011,832000,11,9,2,0
2,2011,832000,4,4,0,0
1,1999,061800,29,29,0,0
2,1999,061800,17,17,0,0
3,1999,061800,18,18,0,1
4,1999,061800,28,26,2,1
5,1999,061800,26,24,2,1
6,1999,061800,16,16,0,1
7,1999,061800,31,29,2,3
8,1999,061800,21,18,3,1
9,1999,061800,27,27,0,4
10,1999,061800,22,22,0,2
11,1999,061800,25,22,3,1
12,1999,061800,24,24,0,0
1,2000,061800,20,20,0,2
2,2000,061800,23,22,1,3
3,2000,061800,31,31,0,1
4,2000,061800,23,22,1,1
5,2000,061800,22,22,0,1
6,2000,061800,20,19,1,3
7,2000,061800,25,24,1,2
8,2000,061800,23,23,0,2
9,2000,061800,18,18,0,2
10,2000,061800,30,30,0,3
11,2000,061800,24,23,1,4
12,2000,061800,24,23,1,0
1,2001,061800,27,27,0,0
2,2001,061800,14,13,1,2
3,2001,061800,20,19,1,1
4,2001,061800,32,31,1,2
5,2001,061800,25,25,0,4
6,2001,061800,24,22,2,0
7,2001,061800,18,17,1,0
8,2001,061800,21,20,1,3
9,2001,061800,16,16,0,1
10,2001,061800,27,26,1,2
11,2001,061800,18,18,0,1
12,2001,061800,22,21,1,3
1,2002,061800,17,17,0,2
2,2002,061800,18,18,0,1
3,2002,061800,27,26,1,1
4,2002,061800,21,21,0,0
5,2002,061800,16,16,0,5
6,2002,061800,16,15,1,1
7,2002,061800,27,27,0,0
8,2002,061800,25,25,0,0
9,2002,061800,27,26,1,2
10,2002,061800,22,22,0,0
11,2002,061800,21,21,0,3
12,2002,061800,22,22,0,6
1,2003,061800,25,24,1,3
2,2003,061800,23,23,0,5
3,2003,061800,20,20,0,0
4,2003,061800,24,23,1,2
5,2003,061800,24,24,0,1
6,2003,061800,11,11,0,1
7,2003,061800,22,22,0,1
8,2003,061800,28,28,0,0
9,2003,061800,20,19,1,1
10,2003,061800,24,24,0,1
11,2003,061800,19,19,0,2
12,2003,061800,19,18,1,1
1,2004,061800,15,14,1,0
2,2004,061800,19,19,0,4
3,2004,061800,30,30,0,4
4,2004,061800,22,22,0,1
5,2004,061800,17,17,0,0
6,2004,061800,19,17,2,0
7,2004,061800,14,14,0,0
8,2004,061800,21,21,0,5
9,2004,061800,25,25,0,2
10,2004,061800,14,12,2,3
11,2004,061800,21,20,1,1
12,2004,061800,22,21,1,5
1,2005,061800,16,16,0,0
2,2005,061800,21,21,0,1
3,2005,061800,18,18,0,5
4,2005,061800,23,23,0,4
5,2005,061800,19,18,1,2
6,2005,061800,15,15,0,1
7,2005,061800,15,15,0,1
8,2005,061800,19,19,0,3
9,2005,061800,12,11,1,1
10,2005,061800,14,14,0,1
11,2005,061800,13,13,0,0
12,2005,061800,14,14,0,0
1,2006,061800,12,12,0,0
2,2006,061800,19,18,1,0
3,2006,061800,22,20,2,2
4,2006,061800,13,13,0,1
5,2006,061800,16,15,1,3
6,2006,061800,21,20,1,1
7,2006,061800,21,20,1,0
8,2006,061800,16,14,2,2
9,2006,061800,18,18,0,2
10,2006,061800,23,23,0,0
11,2006,061800,13,13,0,0
12,2006,061800,23,23,0,2
1,2007,061800,11,11,0,0
2,2007,061800,21,21,0,0
3,2007,061800,12,11,1,1
4,2007,061800,6,5,1,2
5,2007,061800,14,14,0,2
6,2007,061800,18,17,1,0
7,2007,061800,20,20,0,2
8,2007,061800,22,18,4,1
9,2007,061800,17,16,1,0
10,2007,061800,20,20,0,0
11,2007,061800,12,12,0,0
12,2007,061800,10,10,0,2
1,2008,061800,15,15,0,0
2,2008,061800,9,9,0,0
3,2008,061800,11,11,0,1
4,2008,061800,13,13,0,0
5,2008,061800,14,14,0,1
6,2008,061800,14,13,1,1
7,2008,061800,10,10,0,0
8,2008,061800,10,10,0,0
9,2008,061800,13,13,0,1
10,2008,061800,20,20,0,0
11,2008,061800,10,10,0,0
12,2008,061800,11,11,0,1
1,2009,061800,5,5,0,1
2,2009,061800,10,9,1,1
3,2009,061800,10,10,0,2
4,2009,061800,7,7,0,0
5,2009,061800,19,18,1,0
6,2009,061800,8,8,0,1
7,2009,061800,15,14,1,0
8,2009,061800,23,23,0,0
9,2009,061800,20,20,0,0
10,2009,061800,16,16,0,0
11,2009,061800,11,11,0,2
12,2009,061800,14,14,0,0
1,2010,061800,18,17,1,1
2,2010,061800,10,10,0,3
3,2010,061800,10,10,0,0
4,2010,061800,17,16,1,1
5,2010,061800,9,9,0,1
6,2010,061800,18,17,1,1
7,2010,061800,15,14,1,0
8,2010,061800,16,14,2,1
9,2010,061800,14,14,0,0
10,2010,061800,16,14,2,2
11,2010,061800,13,13,0,0
12,2010,061800,10,10,0,0
1,2011,061800,4,4,0,1
2,2011,061800,7,7,0,0
1,1999,170200,19,18,1,0
2,1999,170200,19,19,0,1
3,1999,170200,15,14,1,0
4,1999,170200,11,11,0,0
5,1999,170200,19,18,1,0
6,1999,170200,13,13,0,2
7,1999,170200,12,11,1,0
8,1999,170200,21,19,2,2
9,1999,170200,20,17,3,3
10,1999,170200,13,13,0,0
11,1999,170200,16,14,2,0
12,1999,170200,12,12,0,1
1,2000,170200,11,11,0,0
2,2000,170200,17,16,1,2
3,2000,170200,14,14,0,3
4,2000,170200,16,15,1,0
5,2000,170200,27,25,2,2
6,2000,170200,17,17,0,0
7,2000,170200,15,15,0,1
8,2000,170200,16,16,0,2
9,2000,170200,16,15,1,0
10,2000,170200,15,13,2,1
11,2000,170200,8,7,1,0
12,2000,170200,10,10,0,0
1,2001,170200,11,11,0,2
2,2001,170200,3,3,0,1
3,2001,170200,10,10,0,0
4,2001,170200,14,14,0,0
5,2001,170200,12,12,0,4
6,2001,170200,7,7,0,3
7,2001,170200,19,17,2,0
8,2001,170200,13,12,1,0
9,2001,170200,13,13,0,1
10,2001,170200,17,16,1,0
11,2001,170200,10,10,0,0
12,2001,170200,9,9,0,0
1,2002,170200,11,11,0,2
2,2002,170200,15,14,1,0
3,2002,170200,11,10,1,2
4,2002,170200,8,8,0,2
5,2002,170200,16,16,0,1
6,2002,170200,13,11,2,2
7,2002,170200,16,16,0,0
8,2002,170200,11,11,0,0
9,2002,170200,13,13,0,2
10,2002,170200,15,13,2,2
11,2002,170200,16,16,0,1
12,2002,170200,27,25,2,1
1,2003,170200,10,10,0,1
2,2003,170200,5,5,0,1
3,2003,170200,14,14,0,4
4,2003,170200,7,6,1,0
5,2003,170200,11,11,0,2
6,2003,170200,21,21,0,2
7,2003,170200,16,15,1,1
8,2003,170200,21,20,1,0
9,2003,170200,18,18,0,0
10,2003,170200,7,7,0,0
11,2003,170200,9,9,0,2
12,2003,170200,13,11,2,3
1,2004,170200,12,12,0,3
2,2004,170200,3,3,0,0
3,2004,170200,12,12,0,2
4,2004,170200,7,6,1,2
5,2004,170200,13,12,1,2
6,2004,170200,16,16,0,0
7,2004,170200,11,11,0,0
8,2004,170200,14,14,0,5
9,2004,170200,14,14,0,2
10,2004,170200,10,9,1,5
11,2004,170200,13,12,1,3
12,2004,170200,12,12,0,0
1,2005,170200,7,7,0,0
2,2005,170200,11,11,0,0
3,2005,170200,10,10,0,1
4,2005,170200,8,8,0,0
5,2005,170200,15,15,0,3
6,2005,170200,15,15,0,2
7,2005,170200,10,10,0,0
8,2005,170200,13,13,0,0
9,2005,170200,13,13,0,2
10,2005,170200,10,9,1,0
11,2005,170200,12,12,0,0
12,2005,170200,18,18,0,3
1,2006,170200,13,13,0,2
2,2006,170200,19,18,1,1
3,2006,170200,13,13,0,2
4,2006,170200,7,7,0,3
5,2006,170200,14,14,0,0
6,2006,170200,11,8,3,1
7,2006,170200,12,10,2,1
8,2006,170200,13,13,0,1
9,2006,170200,18,18,0,2
10,2006,170200,10,10,0,0
11,2006,170200,8,8,0,0
12,2006,170200,13,13,0,0
1,2007,170200,12,12,0,1
2,2007,170200,10,10,0,0
3,2007,170200,14,14,0,1
4,2007,170200,16,14,2,4
5,2007,170200,19,18,1,3
6,2007,170200,15,15,0,2
7,2007,170200,11,11,0,2
8,2007,170200,11,11,0,0
9,2007,170200,12,12,0,1
10,2007,170200,15,13,2,0
11,2007,170200,14,13,1,2
12,2007,170200,14,13,1,2
1,2008,170200,13,12,1,0
2,2008,170200,11,10,1,1
3,2008,170200,13,13,0,1
4,2008,170200,13,13,0,4
5,2008,170200,9,8,1,0
6,2008,170200,17,16,1,5
7,2008,170200,12,11,1,3
8,2008,170200,11,11,0,1
9,2008,170200,14,14,0,1
10,2008,170200,15,14,1,2
11,2008,170200,16,16,0,1
12,2008,170200,9,9,0,2
1,2009,170200,21,20,1,0
2,2009,170200,15,14,1,2
3,2009,170200,10,10,0,0
4,2009,170200,8,8,0,2
5,2009,170200,3,3,0,0
6,2009,170200,11,9,2,4
7,2009,170200,10,10,0,4
8,2009,170200,16,15,1,0
9,2009,170200,9,8,1,1
10,2009,170200,19,18,1,0
11,2009,170200,17,16,1,1
12,2009,170200,12,12,0,0
1,2010,170200,8,8,0,3
2,2010,170200,13,13,0,1
3,2010,170200,8,8,0,0
4,2010,170200,8,8,0,1
5,2010,170200,8,8,0,1
6,2010,170200,18,18,0,0
7,2010,170200,7,7,0,0
8,2010,170200,6,6,0,1
9,2010,170200,13,10,3,2
10,2010,170200,8,6,2,3
11,2010,170200,13,13,0,2
12,2010,170200,13,12,1,1
1,2011,170200,14,13,1,1
2,2011,170200,4,3,1,0
1,1999,170400,9,9,0,0
2,1999,170400,5,4,1,0
3,1999,170400,5,5,0,0
4,1999,170400,2,2,0,0
5,1999,170400,2,1,1,2
6,1999,170400,9,8,1,0
7,1999,170400,7,7,0,0
8,1999,170400,4,4,0,1
9,1999,170400,3,3,0,0
10,1999,170400,1,1,0,0
11,1999,170400,3,3,0,0
12,1999,170400,10,10,0,0
1,2000,170400,3,2,1,0
2,2000,170400,4,4,0,0
3,2000,170400,5,5,0,0
4,2000,170400,5,5,0,1
5,2000,170400,5,5,0,0
6,2000,170400,2,2,0,0
7,2000,170400,7,7,0,0
8,2000,170400,3,3,0,0
9,2000,170400,4,4,0,0
10,2000,170400,9,8,1,1
11,2000,170400,11,11,0,0
12,2000,170400,8,8,0,1
1,2001,170400,1,1,0,1
2,2001,170400,4,4,0,1
3,2001,170400,1,1,0,0
4,2001,170400,3,3,0,1
5,2001,170400,3,2,1,0
6,2001,170400,5,5,0,0
7,2001,170400,6,4,2,0
8,2001,170400,7,6,1,0
9,2001,170400,1,1,0,0
10,2001,170400,1,1,0,0
11,2001,170400,7,7,0,0
12,2001,170400,3,3,0,0
1,2002,170400,6,6,0,0
2,2002,170400,4,4,0,0
3,2002,170400,3,3,0,0
4,2002,170400,2,2,0,0
5,2002,170400,6,6,0,0
6,2002,170400,2,2,0,0
7,2002,170400,6,6,0,0
8,2002,170400,0,0,0,1
9,2002,170400,4,4,0,1
10,2002,170400,5,5,0,0
11,2002,170400,9,9,0,0
12,2002,170400,5,5,0,0
1,2003,170400,6,6,0,0
2,2003,170400,4,4,0,1
3,2003,170400,6,6,0,0
4,2003,170400,3,3,0,0
5,2003,170400,3,3,0,0
6,2003,170400,8,8,0,0
7,2003,170400,3,3,0,2
8,2003,170400,9,9,0,1
9,2003,170400,4,4,0,0
10,2003,170400,2,2,0,0
11,2003,170400,1,1,0,0
12,2003,170400,9,9,0,0
1,2004,170400,6,6,0,0
2,2004,170400,3,3,0,1
3,2004,170400,2,1,1,1
4,2004,170400,5,5,0,1
5,2004,170400,5,5,0,0
6,2004,170400,7,4,3,0
7,2004,170400,7,7,0,0
8,2004,170400,5,5,0,0
9,2004,170400,3,3,0,1
10,2004,170400,4,4,0,1
11,2004,170400,12,10,2,0
12,2004,170400,3,2,1,0
1,2005,170400,4,4,0,0
2,2005,170400,5,5,0,0
3,2005,170400,9,8,1,0
4,2005,170400,7,6,1,0
5,2005,170400,6,6,0,0
6,2005,170400,6,6,0,0
7,2005,170400,8,8,0,1
8,2005,170400,5,4,1,1
9,2005,170400,5,5,0,0
10,2005,170400,8,8,0,0
11,2005,170400,2,2,0,0
12,2005,170400,5,5,0,0
1,2006,170400,7,6,1,1
2,2006,170400,3,3,0,0
3,2006,170400,6,6,0,0
4,2006,170400,2,2,0,0
5,2006,170400,2,2,0,0
6,2006,170400,3,3,0,0
7,2006,170400,4,4,0,2
8,2006,170400,4,4,0,0
9,2006,170400,9,9,0,0
10,2006,170400,3,3,0,0
11,2006,170400,3,3,0,0
12,2006,170400,6,6,0,0
1,2007,170400,5,5,0,0
2,2007,170400,3,3,0,0
3,2007,170400,7,7,0,0
4,2007,170400,1,1,0,1
5,2007,170400,9,9,0,0
6,2007,170400,3,3,0,0
7,2007,170400,8,8,0,2
8,2007,170400,6,6,0,0
9,2007,170400,3,2,1,2
10,2007,170400,5,5,0,0
11,2007,170400,2,2,0,0
12,2007,170400,4,4,0,1
1,2008,170400,4,4,0,0
2,2008,170400,6,6,0,2
3,2008,170400,9,8,1,0
4,2008,170400,4,4,0,0
5,2008,170400,9,9,0,0
6,2008,170400,5,5,0,0
7,2008,170400,11,11,0,0
8,2008,170400,5,5,0,1
9,2008,170400,10,10,0,0
10,2008,170400,8,7,1,0
11,2008,170400,7,6,1,0
12,2008,170400,5,5,0,0
1,2009,170400,10,10,0,0
2,2009,170400,3,3,0,0
3,2009,170400,9,8,1,0
4,2009,170400,2,2,0,1
5,2009,170400,10,10,0,0
6,2009,170400,6,6,0,0
7,2009,170400,8,8,0,0
8,2009,170400,9,9,0,0
9,2009,170400,4,4,0,0
10,2009,170400,6,4,2,0
11,2009,170400,7,6,1,1
12,2009,170400,7,7,0,0
1,2010,170400,2,2,0,2
2,2010,170400,5,5,0,0
3,2010,170400,4,2,2,0
4,2010,170400,4,4,0,0
5,2010,170400,5,3,2,1
6,2010,170400,6,5,1,0
7,2010,170400,3,3,0,0
8,2010,170400,6,6,0,0
9,2010,170400,7,7,0,0
10,2010,170400,4,4,0,1
11,2010,170400,2,2,0,0
12,2010,170400,4,4,0,0
1,2011,170400,3,3,0,0
2,2011,170400,4,4,0,0
1,1999,170300,7,5,2,0
2,1999,170300,17,15,2,1
3,1999,170300,17,16,1,0
4,1999,170300,11,10,1,0
5,1999,170300,15,12,3,0
6,1999,170300,15,13,2,0
7,1999,170300,11,11,0,1
8,1999,170300,6,5,1,0
9,1999,170300,12,12,0,1
10,1999,170300,14,12,2,1
11,1999,170300,16,15,1,0
12,1999,170300,14,14,0,0
1,2000,170300,12,11,1,1
2,2000,170300,9,9,0,1
3,2000,170300,10,9,1,0
4,2000,170300,14,14,0,1
5,2000,170300,16,16,0,1
6,2000,170300,18,17,1,0
7,2000,170300,14,14,0,0
8,2000,170300,14,12,2,0
9,2000,170300,13,11,2,1
10,2000,170300,8,8,0,0
11,2000,170300,13,13,0,0
12,2000,170300,14,13,1,0
1,2001,170300,9,9,0,0
2,2001,170300,7,6,1,1
3,2001,170300,9,8,1,1
4,2001,170300,11,10,1,1
5,2001,170300,11,11,0,0
6,2001,170300,14,13,1,0
7,2001,170300,7,7,0,0
8,2001,170300,13,13,0,3
9,2001,170300,9,8,1,1
10,2001,170300,5,5,0,0
11,2001,170300,8,8,0,0
12,2001,170300,13,13,0,0
1,2002,170300,9,8,1,0
2,2002,170300,6,5,1,1
3,2002,170300,15,13,2,1
4,2002,170300,10,10,0,1
5,2002,170300,5,5,0,2
6,2002,170300,12,12,0,2
7,2002,170300,11,11,0,0
8,2002,170300,13,10,3,0
9,2002,170300,8,8,0,1
10,2002,170300,14,14,0,0
11,2002,170300,7,7,0,1
12,2002,170300,7,6,1,2
1,2003,170300,3,3,0,0
2,2003,170300,7,5,2,0
3,2003,170300,14,14,0,1
4,2003,170300,11,11,0,0
5,2003,170300,13,13,0,0
6,2003,170300,11,11,0,1
7,2003,170300,6,6,0,0
8,2003,170300,15,15,0,0
9,2003,170300,10,9,1,2
10,2003,170300,13,13,0,1
11,2003,170300,9,9,0,2
12,2003,170300,5,5,0,0
1,2004,170300,9,9,0,1
2,2004,170300,9,8,1,3
3,2004,170300,6,6,0,1
4,2004,170300,7,7,0,0
5,2004,170300,6,6,0,4
6,2004,170300,8,8,0,3
7,2004,170300,16,15,1,0
8,2004,170300,10,9,1,0
9,2004,170300,9,9,0,1
10,2004,170300,15,15,0,3
11,2004,170300,11,11,0,3
12,2004,170300,6,5,1,0
1,2005,170300,6,5,1,0
2,2005,170300,5,5,0,2
3,2005,170300,12,10,2,1
4,2005,170300,14,13,1,6
5,2005,170300,7,7,0,2
6,2005,170300,11,11,0,0
7,2005,170300,6,6,0,0
8,2005,170300,9,9,0,0
9,2005,170300,4,4,0,1
10,2005,170300,7,7,0,2
11,2005,170300,6,6,0,1
12,2005,170300,7,7,0,0
1,2006,170300,11,11,0,1
2,2006,170300,7,7,0,0
3,2006,170300,3,3,0,1
4,2006,170300,6,5,1,1
5,2006,170300,4,2,2,1
6,2006,170300,9,9,0,0
7,2006,170300,10,10,0,1
8,2006,170300,5,5,0,2
9,2006,170300,10,10,0,0
10,2006,170300,8,7,1,0
11,2006,170300,7,7,0,2
12,2006,170300,2,2,0,0
1,2007,170300,5,5,0,1
2,2007,170300,3,3,0,1
3,2007,170300,5,4,1,0
4,2007,170300,7,4,3,1
5,2007,170300,5,5,0,1
6,2007,170300,4,4,0,0
7,2007,170300,11,11,0,1
8,2007,170300,12,12,0,1
9,2007,170300,5,5,0,0
10,2007,170300,10,8,2,1
11,2007,170300,10,10,0,0
12,2007,170300,8,8,0,0
1,2008,170300,9,7,2,1
2,2008,170300,8,8,0,0
3,2008,170300,7,7,0,1
4,2008,170300,13,10,3,2
5,2008,170300,9,9,0,2
6,2008,170300,3,3,0,1
7,2008,170300,10,9,1,1
8,2008,170300,8,7,1,3
9,2008,170300,13,13,0,2
10,2008,170300,7,7,0,1
11,2008,170300,13,13,0,0
12,2008,170300,14,14,0,2
1,2009,170300,12,12,0,0
2,2009,170300,6,6,0,0
3,2009,170300,9,9,0,1
4,2009,170300,8,7,1,0
5,2009,170300,11,11,0,0
6,2009,170300,6,6,0,1
7,2009,170300,12,11,1,1
8,2009,170300,18,16,2,0
9,2009,170300,12,12,0,1
10,2009,170300,11,11,0,0
11,2009,170300,11,10,1,0
12,2009,170300,12,12,0,1
1,2010,170300,4,4,0,0
2,2010,170300,5,5,0,0
3,2010,170300,5,5,0,2
4,2010,170300,5,4,1,0
5,2010,170300,6,6,0,3
6,2010,170300,9,8,1,0
7,2010,170300,12,12,0,0
8,2010,170300,10,10,0,0
9,2010,170300,12,12,0,0
10,2010,170300,10,10,0,0
11,2010,170300,6,5,1,1
12,2010,170300,9,9,0,0
1,2011,170300,1,1,0,0
2,2011,170300,4,4,0,0
1,1999,150600,12,11,1,0
2,1999,150600,6,6,0,1
3,1999,150600,13,12,1,1
4,1999,150600,17,16,1,2
5,1999,150600,11,9,2,2
6,1999,150600,7,6,1,0
7,1999,150600,24,21,3,2
8,1999,150600,12,10,2,1
9,1999,150600,15,15,0,1
10,1999,150600,25,20,5,0
11,1999,150600,9,8,1,2
12,1999,150600,15,14,1,1
1,2000,150600,13,13,0,4
2,2000,150600,13,12,1,1
3,2000,150600,12,12,0,1
4,2000,150600,15,12,3,2
5,2000,150600,21,21,0,0
6,2000,150600,26,24,2,3
7,2000,150600,20,17,3,2
8,2000,150600,15,11,4,2
9,2000,150600,24,18,6,0
10,2000,150600,17,17,0,1
11,2000,150600,11,11,0,2
12,2000,150600,12,11,1,0
1,2001,150600,11,9,2,1
2,2001,150600,7,7,0,1
3,2001,150600,15,14,1,1
4,2001,150600,7,7,0,2
5,2001,150600,13,13,0,1
6,2001,150600,18,16,2,3
7,2001,150600,17,17,0,1
8,2001,150600,14,11,3,1
9,2001,150600,11,11,0,0
10,2001,150600,10,10,0,6
11,2001,150600,7,7,0,1
12,2001,150600,14,14,0,1
1,2002,150600,13,13,0,0
2,2002,150600,15,14,1,3
3,2002,150600,10,8,2,1
4,2002,150600,17,16,1,5
5,2002,150600,13,12,1,5
6,2002,150600,13,12,1,0
7,2002,150600,9,9,0,0
8,2002,150600,11,11,0,1
9,2002,150600,17,15,2,0
10,2002,150600,25,24,1,2
11,2002,150600,16,16,0,3
12,2002,150600,18,15,3,3
1,2003,150600,13,13,0,2
2,2003,150600,11,10,1,0
3,2003,150600,11,11,0,3
4,2003,150600,20,19,1,2
5,2003,150600,6,5,1,3
6,2003,150600,13,13,0,4
7,2003,150600,16,15,1,1
8,2003,150600,17,17,0,3
9,2003,150600,14,13,1,1
10,2003,150600,19,19,0,1
11,2003,150600,15,14,1,0
12,2003,150600,5,4,1,7
1,2004,150600,3,3,0,1
2,2004,150600,16,16,0,0
3,2004,150600,10,9,1,0
4,2004,150600,7,7,0,1
5,2004,150600,10,10,0,2
6,2004,150600,8,8,0,1
7,2004,150600,13,12,1,4
8,2004,150600,18,17,1,4
9,2004,150600,10,10,0,1
10,2004,150600,9,9,0,7
11,2004,150600,12,12,0,2
12,2004,150600,8,7,1,2
1,2005,150600,17,17,0,2
2,2005,150600,10,9,1,1
3,2005,150600,14,12,2,1
4,2005,150600,9,8,1,2
5,2005,150600,10,10,0,2
6,2005,150600,11,9,2,2
7,2005,150600,9,8,1,1
8,2005,150600,13,13,0,1
9,2005,150600,9,9,0,0
10,2005,150600,20,18,2,0
11,2005,150600,15,15,0,3
12,2005,150600,6,6,0,1
1,2006,150600,18,17,1,0
2,2006,150600,8,7,1,1
3,2006,150600,12,12,0,0
4,2006,150600,15,14,1,1
5,2006,150600,4,4,0,1
6,2006,150600,10,8,2,1
7,2006,150600,11,11,0,0
8,2006,150600,9,9,0,0
9,2006,150600,10,10,0,0
10,2006,150600,9,9,0,5
11,2006,150600,9,9,0,1
12,2006,150600,8,8,0,1
1,2007,150600,9,9,0,0
2,2007,150600,3,3,0,0
3,2007,150600,12,8,4,2
4,2007,150600,17,15,2,1
5,2007,150600,15,14,1,1
6,2007,150600,5,4,1,2
7,2007,150600,9,9,0,1
8,2007,150600,16,15,1,3
9,2007,150600,5,5,0,1
10,2007,150600,9,9,0,1
11,2007,150600,9,9,0,2
12,2007,150600,8,8,0,2
1,2008,150600,10,10,0,1
2,2008,150600,7,7,0,1
3,2008,150600,11,10,1,1
4,2008,150600,6,6,0,2
5,2008,150600,17,16,1,1
6,2008,150600,9,8,1,3
7,2008,150600,12,11,1,1
8,2008,150600,6,6,0,2
9,2008,150600,8,8,0,1
10,2008,150600,10,9,1,0
11,2008,150600,13,12,1,0
12,2008,150600,7,7,0,3
1,2009,150600,12,12,0,2
2,2009,150600,11,10,1,0
3,2009,150600,14,11,3,1
4,2009,150600,5,4,1,1
5,2009,150600,7,7,0,0
6,2009,150600,12,12,0,2
7,2009,150600,14,14,0,3
8,2009,150600,16,14,2,1
9,2009,150600,16,15,1,0
10,2009,150600,9,7,2,5
11,2009,150600,10,9,1,2
12,2009,150600,9,9,0,1
1,2010,150600,7,6,1,0
2,2010,150600,9,9,0,2
3,2010,150600,14,12,2,5
4,2010,150600,12,12,0,0
5,2010,150600,4,3,1,0
6,2010,150600,8,7,1,3
7,2010,150600,7,7,0,0
8,2010,150600,11,11,0,1
9,2010,150600,7,7,0,1
10,2010,150600,13,12,1,0
11,2010,150600,9,9,0,3
12,2010,150600,12,12,0,0
1,2011,150600,7,7,0,0
2,2011,150600,4,4,0,0
1,1999,160800,22,22,0,1
2,1999,160800,22,19,3,0
3,1999,160800,18,17,1,0
4,1999,160800,17,15,2,2
5,1999,160800,21,21,0,1
6,1999,160800,17,17,0,3
7,1999,160800,27,24,3,0
8,1999,160800,22,19,3,3
9,1999,160800,22,19,3,1
10,1999,160800,27,24,3,1
11,1999,160800,15,12,3,6
12,1999,160800,24,22,2,2
1,2000,160800,25,25,0,2
2,2000,160800,15,14,1,1
3,2000,160800,14,12,2,4
4,2000,160800,10,10,0,4
5,2000,160800,17,15,2,2
6,2000,160800,25,19,6,1
7,2000,160800,30,25,5,1
8,2000,160800,21,20,1,0
9,2000,160800,21,19,2,3
10,2000,160800,22,17,5,1
11,2000,160800,15,12,3,2
12,2000,160800,9,8,1,0
1,2001,160800,20,18,2,2
2,2001,160800,19,18,1,3
3,2001,160800,22,20,2,1
4,2001,160800,20,19,1,2
5,2001,160800,25,23,2,2
6,2001,160800,15,14,1,2
7,2001,160800,21,20,1,3
8,2001,160800,21,18,3,0
9,2001,160800,29,26,3,2
10,2001,160800,23,21,2,0
11,2001,160800,24,22,2,2
12,2001,160800,24,24,0,0
1,2002,160800,16,15,1,2
2,2002,160800,14,13,1,1
3,2002,160800,28,22,6,2
4,2002,160800,22,19,3,1
5,2002,160800,19,15,4,2
6,2002,160800,18,17,1,3
7,2002,160800,27,17,10,2
8,2002,160800,17,15,2,2
9,2002,160800,21,17,4,2
10,2002,160800,21,16,5,2
11,2002,160800,22,22,0,1
12,2002,160800,12,10,2,3
1,2003,160800,22,22,0,1
2,2003,160800,25,22,3,2
3,2003,160800,19,18,1,0
4,2003,160800,26,24,2,2
5,2003,160800,25,22,3,0
6,2003,160800,15,13,2,0
7,2003,160800,26,22,4,2
8,2003,160800,19,14,5,2
9,2003,160800,24,23,1,3
10,2003,160800,32,30,2,7
11,2003,160800,16,16,0,3
12,2003,160800,25,25,0,4
1,2004,160800,15,14,1,3
2,2004,160800,12,11,1,2
3,2004,160800,23,20,3,3
4,2004,160800,12,11,1,5
5,2004,160800,16,14,2,1
6,2004,160800,13,13,0,4
7,2004,160800,17,17,0,0
8,2004,160800,11,11,0,2
9,2004,160800,20,17,3,2
10,2004,160800,12,12,0,2
11,2004,160800,19,17,2,1
12,2004,160800,22,22,0,2
1,2005,160800,16,15,1,0
2,2005,160800,12,11,1,4
3,2005,160800,24,24,0,3
4,2005,160800,18,18,0,3
5,2005,160800,11,11,0,3
6,2005,160800,24,21,3,3
7,2005,160800,18,15,3,1
8,2005,160800,18,17,1,1
9,2005,160800,12,10,2,1
10,2005,160800,24,24,0,2
11,2005,160800,20,19,1,3
12,2005,160800,11,11,0,0
1,2006,160800,14,12,2,2
2,2006,160800,15,14,1,3
3,2006,160800,10,8,2,0
4,2006,160800,9,9,0,4
5,2006,160800,16,16,0,2
6,2006,160800,13,13,0,0
7,2006,160800,23,20,3,2
8,2006,160800,19,17,2,0
9,2006,160800,26,24,2,1
10,2006,160800,26,26,0,3
11,2006,160800,16,16,0,3
12,2006,160800,15,13,2,1
1,2007,160800,14,14,0,2
2,2007,160800,7,7,0,1
3,2007,160800,13,8,5,0
4,2007,160800,17,16,1,0
5,2007,160800,26,25,1,1
6,2007,160800,18,17,1,4
7,2007,160800,12,12,0,4
8,2007,160800,12,10,2,0
9,2007,160800,17,15,2,2
10,2007,160800,28,26,2,2
11,2007,160800,20,20,0,2
12,2007,160800,16,15,1,0
1,2008,160800,19,16,3,0
2,2008,160800,16,12,4,0
3,2008,160800,24,24,0,1
4,2008,160800,24,24,0,0
5,2008,160800,21,19,2,0
6,2008,160800,16,15,1,0
7,2008,160800,18,18,0,1
8,2008,160800,22,22,0,1
9,2008,160800,19,18,1,1
10,2008,160800,17,16,1,2
11,2008,160800,19,18,1,1
12,2008,160800,9,9,0,0
1,2009,160800,18,18,0,2
2,2009,160800,7,7,0,1
3,2009,160800,12,10,2,2
4,2009,160800,13,11,2,3
5,2009,160800,13,12,1,0
6,2009,160800,14,11,3,1
7,2009,160800,14,13,1,0
8,2009,160800,11,8,3,2
9,2009,160800,17,16,1,1
10,2009,160800,23,22,1,2
11,2009,160800,16,16,0,1
12,2009,160800,13,13,0,3
1,2010,160800,16,14,2,0
2,2010,160800,17,14,3,0
3,2010,160800,14,13,1,6
4,2010,160800,14,13,1,2
5,2010,160800,13,13,0,1
6,2010,160800,15,13,2,1
7,2010,160800,22,21,1,5
8,2010,160800,23,19,4,0
9,2010,160800,23,19,4,0
10,2010,160800,22,20,2,2
11,2010,160800,17,16,1,2
12,2010,160800,18,15,3,6
1,2011,160800,16,15,1,4
2,2011,160800,17,16,1,3
1,1999,150700,11,9,2,1
2,1999,150700,9,8,1,0
3,1999,150700,14,13,1,1
4,1999,150700,17,15,2,0
5,1999,150700,19,17,2,0
6,1999,150700,22,20,2,1
7,1999,150700,23,22,1,1
8,1999,150700,18,17,1,4
9,1999,150700,18,16,2,2
10,1999,150700,17,15,2,2
11,1999,150700,16,16,0,1
12,1999,150700,14,13,1,1
1,2000,150700,17,17,0,0
2,2000,150700,10,10,0,0
3,2000,150700,13,13,0,1
4,2000,150700,23,22,1,3
5,2000,150700,15,15,0,1
6,2000,150700,18,18,0,2
7,2000,150700,35,32,3,5
8,2000,150700,31,29,2,2
9,2000,150700,17,15,2,1
10,2000,150700,21,20,1,0
11,2000,150700,8,8,0,0
12,2000,150700,11,10,1,1
1,2001,150700,18,17,1,6
2,2001,150700,16,16,0,2
3,2001,150700,20,19,1,5
4,2001,150700,12,12,0,3
5,2001,150700,10,9,1,3
6,2001,150700,16,16,0,4
7,2001,150700,21,21,0,1
8,2001,150700,24,23,1,0
9,2001,150700,13,11,2,0
10,2001,150700,12,11,1,4
11,2001,150700,8,7,1,0
12,2001,150700,16,16,0,0
1,2002,150700,12,12,0,0
2,2002,150700,10,9,1,2
3,2002,150700,11,11,0,1
4,2002,150700,16,16,0,2
5,2002,150700,13,13,0,7
6,2002,150700,13,12,1,2
7,2002,150700,12,12,0,0
8,2002,150700,18,15,3,2
9,2002,150700,21,19,2,1
10,2002,150700,10,9,1,2
11,2002,150700,17,17,0,2
12,2002,150700,14,14,0,4
1,2003,150700,17,17,0,8
2,2003,150700,8,8,0,0
3,2003,150700,13,13,0,2
4,2003,150700,16,16,0,2
5,2003,150700,10,10,0,2
6,2003,150700,13,13,0,7
7,2003,150700,17,15,2,1
8,2003,150700,21,20,1,2
9,2003,150700,18,17,1,1
10,2003,150700,14,13,1,2
11,2003,150700,7,7,0,1
12,2003,150700,17,14,3,1
1,2004,150700,11,10,1,5
2,2004,150700,8,7,1,4
3,2004,150700,10,10,0,8
4,2004,150700,11,10,1,1
5,2004,150700,15,15,0,5
6,2004,150700,16,15,1,1
7,2004,150700,21,21,0,1
8,2004,150700,16,16,0,3
9,2004,150700,13,11,2,5
10,2004,150700,11,11,0,3
11,2004,150700,10,10,0,3
12,2004,150700,8,8,0,4
1,2005,150700,11,9,2,6
2,2005,150700,8,8,0,3
3,2005,150700,13,13,0,3
4,2005,150700,16,15,1,5
5,2005,150700,10,8,2,1
6,2005,150700,13,12,1,4
7,2005,150700,14,13,1,11
8,2005,150700,14,13,1,6
9,2005,150700,20,20,0,1
10,2005,150700,7,6,1,1
11,2005,150700,10,10,0,3
12,2005,150700,16,15,1,6
1,2006,150700,15,13,2,4
2,2006,150700,7,6,1,3
3,2006,150700,5,4,1,2
4,2006,150700,11,11,0,7
5,2006,150700,14,12,2,0
6,2006,150700,17,17,0,2
7,2006,150700,29,27,2,7
8,2006,150700,14,13,1,3
9,2006,150700,16,14,2,3
10,2006,150700,10,9,1,4
11,2006,150700,10,10,0,2
12,2006,150700,12,12,0,4
1,2007,150700,9,9,0,3
2,2007,150700,6,6,0,3
3,2007,150700,10,7,3,6
4,2007,150700,9,9,0,5
5,2007,150700,12,11,1,5
6,2007,150700,8,7,1,2
7,2007,150700,12,11,1,2
8,2007,150700,6,6,0,2
9,2007,150700,9,8,1,3
10,2007,150700,8,8,0,6
11,2007,150700,8,8,0,1
12,2007,150700,9,9,0,1
1,2008,150700,7,6,1,1
2,2008,150700,4,4,0,3
3,2008,150700,8,8,0,2
4,2008,150700,14,13,1,4
5,2008,150700,11,9,2,5
6,2008,150700,13,13,0,3
7,2008,150700,20,20,0,3
8,2008,150700,15,13,2,4
9,2008,150700,17,16,1,2
10,2008,150700,13,13,0,9
11,2008,150700,14,14,0,5
12,2008,150700,11,11,0,0
1,2009,150700,8,8,0,1
2,2009,150700,9,9,0,4
3,2009,150700,8,7,1,3
4,2009,150700,9,8,1,4
5,2009,150700,13,13,0,2
6,2009,150700,10,10,0,3
7,2009,150700,8,7,1,2
8,2009,150700,11,9,2,5
9,2009,150700,11,11,0,2
10,2009,150700,13,12,1,4
11,2009,150700,13,13,0,2
12,2009,150700,9,8,1,0
1,2010,150700,9,9,0,1
2,2010,150700,5,4,1,1
3,2010,150700,9,7,2,2
4,2010,150700,14,13,1,1
5,2010,150700,14,13,1,2
6,2010,150700,16,16,0,2
7,2010,150700,12,11,1,1
8,2010,150700,9,8,1,3
9,2010,150700,11,11,0,2
10,2010,150700,15,15,0,3
11,2010,150700,13,12,1,3
12,2010,150700,6,5,1,0
1,2011,150700,5,5,0,2
2,2011,150700,3,2,1,1
1,1999,150800,8,6,2,2
2,1999,150800,11,11,0,2
3,1999,150800,17,16,1,4
4,1999,150800,11,11,0,1
5,1999,150800,16,15,1,2
6,1999,150800,14,12,2,3
7,1999,150800,16,13,3,1
8,1999,150800,10,9,1,5
9,1999,150800,14,11,3,0
10,1999,150800,22,21,1,1
11,1999,150800,9,7,2,3
12,1999,150800,15,15,0,3
1,2000,150800,6,6,0,5
2,2000,150800,12,12,0,8
3,2000,150800,19,18,1,4
4,2000,150800,21,20,1,10
5,2000,150800,24,19,5,8
6,2000,150800,20,17,3,9
7,2000,150800,13,13,0,2
8,2000,150800,19,19,0,2
9,2000,150800,11,11,0,3
10,2000,150800,24,23,1,5
11,2000,150800,25,24,1,10
12,2000,150800,12,11,1,16
1,2001,150800,27,26,1,16
2,2001,150800,22,22,0,12
3,2001,150800,14,11,3,37
4,2001,150800,18,17,1,4
5,2001,150800,9,8,1,1
6,2001,150800,6,5,1,2
7,2001,150800,9,9,0,2
8,2001,150800,10,10,0,2
9,2001,150800,16,15,1,2
10,2001,150800,18,17,1,1
11,2001,150800,13,12,1,6
12,2001,150800,13,13,0,1
1,2002,150800,16,16,0,2
2,2002,150800,11,9,2,5
3,2002,150800,12,12,0,3
4,2002,150800,14,13,1,3
5,2002,150800,15,11,4,2
6,2002,150800,7,6,1,6
7,2002,150800,8,8,0,4
8,2002,150800,10,9,1,4
9,2002,150800,14,12,2,0
10,2002,150800,15,15,0,7
11,2002,150800,14,13,1,5
12,2002,150800,9,9,0,4
1,2003,150800,13,12,1,3
2,2003,150800,11,10,1,1
3,2003,150800,20,19,1,2
4,2003,150800,8,8,0,9
5,2003,150800,11,9,2,3
6,2003,150800,12,12,0,3
7,2003,150800,16,14,2,1
8,2003,150800,18,18,0,5
9,2003,150800,8,7,1,1
10,2003,150800,15,13,2,9
11,2003,150800,12,11,1,7
12,2003,150800,8,8,0,4
1,2004,150800,15,15,0,1
2,2004,150800,7,7,0,2
3,2004,150800,10,8,2,3
4,2004,150800,6,6,0,0
5,2004,150800,13,12,1,1
6,2004,150800,16,15,1,0
7,2004,150800,10,9,1,1
8,2004,150800,10,10,0,7
9,2004,150800,8,7,1,1
10,2004,150800,4,3,1,5
11,2004,150800,16,16,0,2
12,2004,150800,12,11,1,3
1,2005,150800,13,13,0,6
2,2005,150800,13,11,2,3
3,2005,150800,9,9,0,11
4,2005,150800,18,17,1,5
5,2005,150800,16,15,1,6
6,2005,150800,11,11,0,5
7,2005,150800,8,6,2,11
8,2005,150800,6,5,1,9
9,2005,150800,9,7,2,4
10,2005,150800,15,14,1,1
11,2005,150800,16,16,0,8
12,2005,150800,10,10,0,13
1,2006,150800,17,17,0,7
2,2006,150800,11,10,1,2
3,2006,150800,13,13,0,3
4,2006,150800,15,15,0,2
5,2006,150800,7,6,1,3
6,2006,150800,13,10,3,8
7,2006,150800,13,13,0,6
8,2006,150800,12,11,1,4
9,2006,150800,6,6,0,4
10,2006,150800,15,15,0,3
11,2006,150800,11,9,2,2
12,2006,150800,12,12,0,7
1,2007,150800,10,10,0,3
2,2007,150800,9,8,1,7
3,2007,150800,8,7,1,38
4,2007,150800,8,6,2,3
5,2007,150800,9,8,1,9
6,2007,150800,6,5,1,2
7,2007,150800,11,10,1,5
8,2007,150800,12,12,0,3
9,2007,150800,7,6,1,7
10,2007,150800,9,8,1,8
11,2007,150800,8,7,1,12
12,2007,150800,8,8,0,15
1,2008,150800,8,8,0,5
2,2008,150800,5,5,0,6
3,2008,150800,8,7,1,5
4,2008,150800,16,16,0,8
5,2008,150800,15,15,0,8
6,2008,150800,10,8,2,5
7,2008,150800,20,16,4,5
8,2008,150800,11,11,0,5
9,2008,150800,10,9,1,6
10,2008,150800,14,13,1,5
11,2008,150800,4,4,0,5
12,2008,150800,12,12,0,12
1,2009,150800,10,9,1,3
2,2009,150800,9,9,0,4
3,2009,150800,14,13,1,22
4,2009,150800,8,8,0,8
5,2009,150800,15,15,0,10
6,2009,150800,8,8,0,10
7,2009,150800,8,8,0,2
8,2009,150800,9,7,2,4
9,2009,150800,9,9,0,4
10,2009,150800,16,14,2,9
11,2009,150800,15,14,1,5
12,2009,150800,13,9,4,3
1,2010,150800,13,13,0,17
2,2010,150800,13,11,2,7
3,2010,150800,9,7,2,10
4,2010,150800,7,6,1,11
5,2010,150800,15,13,2,10
6,2010,150800,10,9,1,1
7,2010,150800,12,10,2,2
8,2010,150800,12,12,0,5
9,2010,150800,12,11,1,0
10,2010,150800,14,14,0,5
11,2010,150800,6,5,1,1
12,2010,150800,14,13,1,9
1,2011,150800,9,8,1,13
2,2011,150800,4,4,0,6
1,1999,160700,23,20,3,5
2,1999,160700,27,26,1,6
3,1999,160700,31,30,1,5
4,1999,160700,33,29,4,3
5,1999,160700,38,36,2,1
6,1999,160700,30,28,2,5
7,1999,160700,39,37,2,3
8,1999,160700,49,46,3,3
9,1999,160700,44,41,3,2
10,1999,160700,49,43,6,5
11,1999,160700,32,28,4,4
12,1999,160700,33,28,5,1
1,2000,160700,33,30,3,5
2,2000,160700,30,27,3,4
3,2000,160700,30,28,2,1
4,2000,160700,24,22,2,4
5,2000,160700,46,39,7,6
6,2000,160700,29,27,2,7
7,2000,160700,32,28,4,0
8,2000,160700,32,26,6,4
9,2000,160700,27,21,6,3
10,2000,160700,32,31,1,4
11,2000,160700,30,29,1,1
12,2000,160700,24,22,2,3
1,2001,160700,18,14,4,5
2,2001,160700,19,15,4,6
3,2001,160700,17,15,2,1
4,2001,160700,18,15,3,0
5,2001,160700,29,26,3,0
6,2001,160700,22,19,3,6
7,2001,160700,21,20,1,2
8,2001,160700,26,21,5,1
9,2001,160700,29,22,7,1
10,2001,160700,22,18,4,8
11,2001,160700,21,20,1,0
12,2001,160700,19,15,4,1
1,2002,160700,12,8,4,2
2,2002,160700,14,12,2,3
3,2002,160700,16,15,1,1
4,2002,160700,9,9,0,4
5,2002,160700,18,17,1,2
6,2002,160700,21,18,3,3
7,2002,160700,21,18,3,1
8,2002,160700,22,18,4,3
9,2002,160700,19,18,1,2
10,2002,160700,21,21,0,1
11,2002,160700,9,8,1,0
12,2002,160700,24,22,2,2
1,2003,160700,15,15,0,1
2,2003,160700,11,9,2,2
3,2003,160700,18,14,4,1
4,2003,160700,23,22,1,1
5,2003,160700,12,11,1,2
6,2003,160700,19,19,0,2
7,2003,160700,22,20,2,2
8,2003,160700,24,23,1,1
9,2003,160700,26,24,2,1
10,2003,160700,24,23,1,0
11,2003,160700,20,17,3,2
12,2003,160700,19,17,2,1
1,2004,160700,17,15,2,3
2,2004,160700,19,18,1,4
3,2004,160700,25,21,4,2
4,2004,160700,16,14,2,3
5,2004,160700,21,16,5,1
6,2004,160700,24,22,2,2
7,2004,160700,22,20,2,2
8,2004,160700,28,28,0,0
9,2004,160700,14,12,2,1
10,2004,160700,20,20,0,2
11,2004,160700,23,23,0,6
12,2004,160700,23,23,0,1
1,2005,160700,25,24,1,8
2,2005,160700,10,9,1,2
3,2005,160700,19,19,0,3
4,2005,160700,26,26,0,1
5,2005,160700,21,19,2,3
6,2005,160700,23,22,1,3
7,2005,160700,23,20,3,5
8,2005,160700,28,26,2,1
9,2005,160700,23,20,3,0
10,2005,160700,14,12,2,1
11,2005,160700,11,10,1,2
12,2005,160700,16,15,1,1
1,2006,160700,15,13,2,2
2,2006,160700,19,16,3,1
3,2006,160700,12,11,1,0
4,2006,160700,19,18,1,0
5,2006,160700,25,22,3,2
6,2006,160700,37,35,2,2
7,2006,160700,14,12,2,2
8,2006,160700,12,11,1,0
9,2006,160700,20,19,1,2
10,2006,160700,22,22,0,3
11,2006,160700,19,19,0,0
12,2006,160700,28,25,3,0
1,2007,160700,19,19,0,1
2,2007,160700,21,21,0,1
3,2007,160700,23,22,1,2
4,2007,160700,16,16,0,1
5,2007,160700,21,19,2,4
6,2007,160700,21,19,2,0
7,2007,160700,21,20,1,3
8,2007,160700,21,18,3,6
9,2007,160700,19,19,0,2
10,2007,160700,24,23,1,0
11,2007,160700,12,11,1,1
12,2007,160700,20,18,2,1
1,2008,160700,18,17,1,1
2,2008,160700,11,9,2,1
3,2008,160700,19,19,0,1
4,2008,160700,37,32,5,2
5,2008,160700,17,17,0,1
6,2008,160700,17,17,0,1
7,2008,160700,37,35,2,0
8,2008,160700,21,21,0,2
9,2008,160700,21,19,2,1
10,2008,160700,26,26,0,1
11,2008,160700,13,13,0,0
12,2008,160700,18,16,2,0
1,2009,160700,20,19,1,1
2,2009,160700,15,13,2,0
3,2009,160700,18,17,1,2
4,2009,160700,13,12,1,1
5,2009,160700,16,15,1,1
6,2009,160700,16,13,3,3
7,2009,160700,15,14,1,2
8,2009,160700,24,22,2,0
9,2009,160700,24,23,1,0
10,2009,160700,18,18,0,5
11,2009,160700,24,22,2,2
12,2009,160700,20,20,0,4
1,2010,160700,18,17,1,1
2,2010,160700,14,14,0,1
3,2010,160700,17,16,1,2
4,2010,160700,18,17,1,3
5,2010,160700,22,21,1,0
6,2010,160700,18,18,0,1
7,2010,160700,24,24,0,3
8,2010,160700,26,26,0,2
9,2010,160700,29,26,3,3
10,2010,160700,29,24,5,1
11,2010,160700,15,14,1,4
12,2010,160700,23,22,1,0
1,2011,160700,13,11,2,0
2,2011,160700,3,3,0,0
1,1999,161100,10,10,0,0
2,1999,161100,10,10,0,0
3,1999,161100,11,9,2,2
4,1999,161100,16,16,0,0
5,1999,161100,20,20,0,1
6,1999,161100,23,23,0,0
7,1999,161100,12,12,0,2
8,1999,161100,18,17,1,0
9,1999,161100,13,13,0,0
10,1999,161100,22,22,0,0
11,1999,161100,18,16,2,2
12,1999,161100,22,22,0,0
1,2000,161100,17,15,2,0
2,2000,161100,15,14,1,0
3,2000,161100,23,22,1,1
4,2000,161100,20,20,0,1
5,2000,161100,13,13,0,3
6,2000,161100,22,22,0,0
7,2000,161100,20,20,0,1
8,2000,161100,26,24,2,1
9,2000,161100,29,27,2,1
10,2000,161100,20,20,0,0
11,2000,161100,14,14,0,0
12,2000,161100,21,21,0,0
1,2001,161100,13,13,0,1
2,2001,161100,12,11,1,2
3,2001,161100,15,10,5,4
4,2001,161100,13,13,0,0
5,2001,161100,10,8,2,4
6,2001,161100,20,20,0,0
7,2001,161100,21,20,1,0
8,2001,161100,21,19,2,0
9,2001,161100,20,18,2,3
10,2001,161100,13,13,0,0
11,2001,161100,17,16,1,1
12,2001,161100,11,10,1,0
1,2002,161100,9,9,0,0
2,2002,161100,13,13,0,3
3,2002,161100,17,17,0,0
4,2002,161100,13,13,0,0
5,2002,161100,27,27,0,0
6,2002,161100,16,16,0,0
7,2002,161100,17,17,0,0
8,2002,161100,21,19,2,3
9,2002,161100,21,20,1,0
10,2002,161100,25,23,2,2
11,2002,161100,20,19,1,2
12,2002,161100,16,16,0,0
1,2003,161100,15,15,0,0
2,2003,161100,22,22,0,1
3,2003,161100,9,9,0,0
4,2003,161100,23,21,2,0
5,2003,161100,21,20,1,0
6,2003,161100,17,17,0,2
7,2003,161100,15,15,0,2
8,2003,161100,24,24,0,0
9,2003,161100,10,10,0,0
10,2003,161100,20,20,0,0
11,2003,161100,18,18,0,0
12,2003,161100,18,16,2,0
1,2004,161100,11,10,1,0
2,2004,161100,9,8,1,0
3,2004,161100,20,19,1,0
4,2004,161100,17,17,0,0
5,2004,161100,19,18,1,0
6,2004,161100,14,14,0,1
7,2004,161100,16,16,0,0
8,2004,161100,16,15,1,1
9,2004,161100,17,17,0,0
10,2004,161100,10,9,1,1
11,2004,161100,15,15,0,1
12,2004,161100,12,12,0,0
1,2005,161100,11,10,1,0
2,2005,161100,9,9,0,3
3,2005,161100,11,11,0,4
4,2005,161100,10,10,0,6
5,2005,161100,12,12,0,0
6,2005,161100,12,12,0,0
7,2005,161100,13,13,0,0
8,2005,161100,18,18,0,1
9,2005,161100,17,17,0,1
10,2005,161100,10,10,0,0
11,2005,161100,13,13,0,1
12,2005,161100,13,12,1,2
1,2006,161100,19,19,0,2
2,2006,161100,7,7,0,1
3,2006,161100,11,9,2,1
4,2006,161100,9,9,0,0
5,2006,161100,8,8,0,0
6,2006,161100,11,10,1,1
7,2006,161100,12,12,0,0
8,2006,161100,14,14,0,0
9,2006,161100,17,17,0,0
10,2006,161100,14,14,0,0
11,2006,161100,7,7,0,0
12,2006,161100,12,12,0,0
1,2007,161100,11,10,1,2
2,2007,161100,6,6,0,0
3,2007,161100,9,9,0,0
4,2007,161100,10,10,0,0
5,2007,161100,8,8,0,0
6,2007,161100,11,11,0,0
7,2007,161100,6,5,1,1
8,2007,161100,14,14,0,1
9,2007,161100,10,10,0,2
10,2007,161100,10,10,0,1
11,2007,161100,5,5,0,0
12,2007,161100,11,11,0,1
1,2008,161100,14,13,1,0
2,2008,161100,5,5,0,2
3,2008,161100,10,9,1,2
4,2008,161100,14,14,0,0
5,2008,161100,14,13,1,0
6,2008,161100,16,16,0,3
7,2008,161100,20,20,0,0
8,2008,161100,20,20,0,1
9,2008,161100,13,13,0,0
10,2008,161100,10,10,0,0
11,2008,161100,17,14,3,0
12,2008,161100,21,21,0,1
1,2009,161100,10,10,0,0
2,2009,161100,9,9,0,0
3,2009,161100,10,10,0,0
4,2009,161100,9,9,0,1
5,2009,161100,14,13,1,0
6,2009,161100,11,10,1,0
7,2009,161100,6,6,0,1
8,2009,161100,9,9,0,0
9,2009,161100,8,8,0,1
10,2009,161100,13,13,0,0
11,2009,161100,10,10,0,1
12,2009,161100,9,9,0,0
1,2010,161100,8,8,0,0
2,2010,161100,3,2,1,0
3,2010,161100,9,9,0,0
4,2010,161100,8,8,0,0
5,2010,161100,11,11,0,2
6,2010,161100,12,12,0,1
7,2010,161100,11,10,1,0
8,2010,161100,9,7,2,1
9,2010,161100,9,9,0,2
10,2010,161100,9,9,0,0
11,2010,161100,7,7,0,1
12,2010,161100,7,7,0,2
1,2011,161100,11,11,0,1
2,2011,161100,3,3,0,0
1,1999,050500,8,8,0,0
2,1999,050500,5,5,0,1
3,1999,050500,8,7,1,0
4,1999,050500,6,6,0,2
5,1999,050500,13,12,1,1
6,1999,050500,11,11,0,0
7,1999,050500,29,29,0,0
8,1999,050500,14,13,1,1
9,1999,050500,17,17,0,2
10,1999,050500,20,20,0,3
11,1999,050500,19,18,1,3
12,1999,050500,9,9,0,1
1,2000,050500,10,10,0,1
2,2000,050500,10,10,0,3
3,2000,050500,7,7,0,0
4,2000,050500,8,7,1,1
5,2000,050500,8,8,0,1
6,2000,050500,9,9,0,1
7,2000,050500,12,12,0,0
8,2000,050500,15,14,1,0
9,2000,050500,13,13,0,1
10,2000,050500,10,10,0,0
11,2000,050500,9,9,0,1
12,2000,050500,6,6,0,0
1,2001,050500,12,11,1,0
2,2001,050500,5,4,1,1
3,2001,050500,6,6,0,3
4,2001,050500,11,11,0,3
5,2001,050500,10,10,0,3
6,2001,050500,13,13,0,1
7,2001,050500,13,13,0,0
8,2001,050500,11,10,1,0
9,2001,050500,16,16,0,1
10,2001,050500,11,11,0,0
11,2001,050500,11,11,0,2
12,2001,050500,14,13,1,0
1,2002,050500,9,8,1,2
2,2002,050500,6,6,0,1
3,2002,050500,5,4,1,4
4,2002,050500,21,21,0,3
5,2002,050500,6,6,0,1
6,2002,050500,14,14,0,0
7,2002,050500,6,6,0,0
8,2002,050500,16,16,0,0
9,2002,050500,24,23,1,0
10,2002,050500,16,16,0,2
11,2002,050500,15,14,1,0
12,2002,050500,11,11,0,0
1,2003,050500,24,24,0,3
2,2003,050500,10,10,0,0
3,2003,050500,18,17,1,1
4,2003,050500,11,11,0,2
5,2003,050500,9,9,0,1
6,2003,050500,14,12,2,0
7,2003,050500,14,14,0,0
8,2003,050500,11,10,1,0
9,2003,050500,18,18,0,0
10,2003,050500,15,15,0,1
11,2003,050500,10,10,0,0
12,2003,050500,13,13,0,0
1,2004,050500,7,7,0,0
2,2004,050500,9,9,0,2
3,2004,050500,7,7,0,0
4,2004,050500,6,6,0,1
5,2004,050500,10,10,0,2
6,2004,050500,14,13,1,0
7,2004,050500,12,11,1,0
8,2004,050500,6,6,0,0
9,2004,050500,15,14,1,0
10,2004,050500,7,7,0,0
11,2004,050500,10,10,0,1
12,2004,050500,11,11,0,0
1,2005,050500,8,8,0,0
2,2005,050500,14,14,0,1
3,2005,050500,7,6,1,0
4,2005,050500,8,8,0,0
5,2005,050500,14,13,1,0
6,2005,050500,7,7,0,0
7,2005,050500,16,16,0,0
8,2005,050500,11,11,0,0
9,2005,050500,13,13,0,0
10,2005,050500,15,14,1,0
11,2005,050500,6,6,0,1
12,2005,050500,9,9,0,0
1,2006,050500,9,9,0,1
2,2006,050500,6,6,0,1
3,2006,050500,3,3,0,0
4,2006,050500,6,6,0,0
5,2006,050500,7,7,0,0
6,2006,050500,7,7,0,0
7,2006,050500,11,11,0,0
8,2006,050500,13,13,0,2
9,2006,050500,16,16,0,2
10,2006,050500,13,13,0,2
11,2006,050500,7,7,0,0
12,2006,050500,5,5,0,0
1,2007,050500,11,11,0,0
2,2007,050500,3,3,0,1
3,2007,050500,10,9,1,0
4,2007,050500,6,6,0,1
5,2007,050500,9,9,0,3
6,2007,050500,10,10,0,0
7,2007,050500,13,13,0,0
8,2007,050500,15,15,0,1
9,2007,050500,11,10,1,0
10,2007,050500,15,15,0,0
11,2007,050500,7,7,0,1
12,2007,050500,9,9,0,2
1,2008,050500,9,9,0,0
2,2008,050500,8,8,0,2
3,2008,050500,7,6,1,0
4,2008,050500,12,11,1,0
5,2008,050500,10,10,0,0
6,2008,050500,7,7,0,0
7,2008,050500,11,10,1,1
8,2008,050500,12,10,2,1
9,2008,050500,14,13,1,0
10,2008,050500,7,7,0,0
11,2008,050500,12,11,1,0
12,2008,050500,12,12,0,0
1,2009,050500,7,7,0,1
2,2009,050500,10,9,1,0
3,2009,050500,15,15,0,0
4,2009,050500,4,4,0,0
5,2009,050500,11,11,0,0
6,2009,050500,13,13,0,1
7,2009,050500,13,13,0,0
8,2009,050500,8,7,1,0
9,2009,050500,13,13,0,0
10,2009,050500,11,11,0,0
11,2009,050500,12,11,1,0
12,2009,050500,11,10,1,0
1,2010,050500,6,6,0,0
2,2010,050500,1,1,0,0
3,2010,050500,7,7,0,0
4,2010,050500,8,8,0,3
5,2010,050500,5,5,0,1
6,2010,050500,9,9,0,2
7,2010,050500,12,12,0,0
8,2010,050500,10,10,0,0
9,2010,050500,4,4,0,0
10,2010,050500,12,8,4,0
11,2010,050500,7,7,0,0
12,2010,050500,9,9,0,0
1,2011,050500,6,6,0,0
2,2011,050500,3,3,0,0
1,1999,831700,27,25,2,3
2,1999,831700,39,39,0,1
3,1999,831700,22,19,3,0
4,1999,831700,23,22,1,4
5,1999,831700,28,27,1,1
6,1999,831700,30,28,2,2
7,1999,831700,41,37,4,1
8,1999,831700,29,28,1,7
9,1999,831700,26,25,1,1
10,1999,831700,42,39,3,1
11,1999,831700,38,36,2,4
12,1999,831700,29,28,1,2
1,2000,831700,41,40,1,1
2,2000,831700,32,32,0,2
3,2000,831700,43,42,1,4
4,2000,831700,31,31,0,0
5,2000,831700,39,36,3,5
6,2000,831700,33,32,1,0
7,2000,831700,38,36,2,3
8,2000,831700,33,28,5,2
9,2000,831700,45,44,1,1
10,2000,831700,41,39,2,0
11,2000,831700,36,35,1,2
12,2000,831700,24,23,1,2
1,2001,831700,36,35,1,5
2,2001,831700,26,26,0,1
3,2001,831700,29,28,1,4
4,2001,831700,20,16,4,2
5,2001,831700,30,30,0,1
6,2001,831700,20,18,2,1
7,2001,831700,23,20,3,1
8,2001,831700,19,18,1,1
9,2001,831700,27,27,0,3
10,2001,831700,31,27,4,4
11,2001,831700,22,22,0,4
12,2001,831700,12,11,1,0
1,2002,831700,24,24,0,1
2,2002,831700,11,11,0,3
3,2002,831700,22,22,0,0
4,2002,831700,29,28,1,1
5,2002,831700,15,13,2,2
6,2002,831700,27,26,1,0
7,2002,831700,21,19,2,2
8,2002,831700,19,17,2,2
9,2002,831700,20,19,1,2
10,2002,831700,26,25,1,2
11,2002,831700,24,23,1,2
12,2002,831700,17,17,0,2
1,2003,831700,33,32,1,8
2,2003,831700,14,13,1,6
3,2003,831700,26,26,0,1
4,2003,831700,31,30,1,4
5,2003,831700,29,28,1,1
6,2003,831700,26,25,1,4
7,2003,831700,32,31,1,0
8,2003,831700,27,27,0,0
9,2003,831700,31,29,2,2
10,2003,831700,42,40,2,1
11,2003,831700,21,20,1,2
12,2003,831700,34,34,0,1
1,2004,831700,26,26,0,4
2,2004,831700,19,18,1,0
3,2004,831700,36,36,0,3
4,2004,831700,40,39,1,7
5,2004,831700,37,37,0,6
6,2004,831700,36,36,0,1
7,2004,831700,43,40,3,2
8,2004,831700,23,23,0,1
9,2004,831700,25,24,1,2
10,2004,831700,33,32,1,7
11,2004,831700,32,31,1,4
12,2004,831700,19,19,0,6
1,2005,831700,24,22,2,2
2,2005,831700,26,26,0,5
3,2005,831700,21,20,1,5
4,2005,831700,23,23,0,4
5,2005,831700,23,22,1,4
6,2005,831700,17,13,4,6
7,2005,831700,28,27,1,1
8,2005,831700,22,22,0,6
9,2005,831700,26,25,1,3
10,2005,831700,29,29,0,1
11,2005,831700,32,30,2,0
12,2005,831700,22,22,0,2
1,2006,831700,24,23,1,0
2,2006,831700,13,12,1,3
3,2006,831700,29,28,1,3
4,2006,831700,17,17,0,4
5,2006,831700,22,22,0,1
6,2006,831700,17,16,1,0
7,2006,831700,19,19,0,2
8,2006,831700,27,27,0,5
9,2006,831700,29,28,1,3
10,2006,831700,22,21,1,4
11,2006,831700,17,15,2,1
12,2006,831700,28,28,0,0
1,2007,831700,13,13,0,1
2,2007,831700,15,14,1,1
3,2007,831700,23,23,0,3
4,2007,831700,17,17,0,1
5,2007,831700,21,20,1,2
6,2007,831700,25,24,1,0
7,2007,831700,13,13,0,4
8,2007,831700,12,10,2,0
9,2007,831700,19,17,2,3
10,2007,831700,25,24,1,2
11,2007,831700,16,16,0,1
12,2007,831700,20,17,3,1
1,2008,831700,22,21,1,1
2,2008,831700,14,13,1,3
3,2008,831700,25,24,1,3
4,2008,831700,30,29,1,6
5,2008,831700,35,34,1,2
6,2008,831700,27,26,1,1
7,2008,831700,33,32,1,1
8,2008,831700,28,26,2,3
9,2008,831700,16,16,0,1
10,2008,831700,17,17,0,1
11,2008,831700,35,33,2,4
12,2008,831700,27,26,1,1
1,2009,831700,16,16,0,3
2,2009,831700,21,21,0,2
3,2009,831700,32,31,1,4
4,2009,831700,24,22,2,7
5,2009,831700,38,35,3,2
6,2009,831700,21,21,0,3
7,2009,831700,24,23,1,6
8,2009,831700,23,23,0,5
9,2009,831700,20,20,0,0
10,2009,831700,20,20,0,1
11,2009,831700,19,19,0,6
12,2009,831700,19,18,1,0
1,2010,831700,24,24,0,2
2,2010,831700,12,12,0,0
3,2010,831700,24,23,1,3
4,2010,831700,12,12,0,2
5,2010,831700,18,17,1,3
6,2010,831700,23,23,0,3
7,2010,831700,21,18,3,1
8,2010,831700,19,17,2,4
9,2010,831700,17,17,0,1
10,2010,831700,24,24,0,2
11,2010,831700,13,13,0,2
12,2010,831700,14,14,0,3
1,2011,831700,19,17,2,1
2,2011,831700,14,12,2,0
1,1999,050600,3,3,0,0
2,1999,050600,8,5,3,0
3,1999,050600,7,6,1,1
4,1999,050600,7,6,1,0
5,1999,050600,7,6,1,1
6,1999,050600,4,4,0,0
7,1999,050600,5,5,0,0
8,1999,050600,9,9,0,0
9,1999,050600,5,4,1,1
10,1999,050600,8,7,1,0
11,1999,050600,8,5,3,2
12,1999,050600,5,5,0,0
1,2000,050600,9,9,0,0
2,2000,050600,7,7,0,0
3,2000,050600,8,7,1,4
4,2000,050600,7,7,0,3
5,2000,050600,8,8,0,0
6,2000,050600,8,8,0,1
7,2000,050600,9,9,0,1
8,2000,050600,8,7,1,0
9,2000,050600,8,7,1,1
10,2000,050600,7,7,0,0
11,2000,050600,6,6,0,0
12,2000,050600,10,10,0,0
1,2001,050600,6,6,0,0
2,2001,050600,2,2,0,0
3,2001,050600,6,6,0,1
4,2001,050600,13,11,2,1
5,2001,050600,11,11,0,1
6,2001,050600,4,4,0,0
7,2001,050600,14,12,2,0
8,2001,050600,4,4,0,0
9,2001,050600,11,11,0,5
10,2001,050600,6,6,0,0
11,2001,050600,7,6,1,0
12,2001,050600,6,6,0,2
1,2002,050600,2,1,1,0
2,2002,050600,6,5,1,0
3,2002,050600,8,8,0,0
4,2002,050600,10,9,1,0
5,2002,050600,13,12,1,0
6,2002,050600,7,6,1,0
7,2002,050600,12,12,0,0
8,2002,050600,8,7,1,0
9,2002,050600,8,8,0,0
10,2002,050600,17,17,0,0
11,2002,050600,5,5,0,0
12,2002,050600,6,6,0,0
1,2003,050600,15,15,0,0
2,2003,050600,12,12,0,1
3,2003,050600,6,6,0,0
4,2003,050600,10,10,0,0
5,2003,050600,10,9,1,0
6,2003,050600,5,5,0,0
7,2003,050600,10,10,0,0
8,2003,050600,12,11,1,0
9,2003,050600,7,7,0,0
10,2003,050600,8,8,0,0
11,2003,050600,15,15,0,0
12,2003,050600,9,8,1,0
1,2004,050600,5,5,0,2
2,2004,050600,8,7,1,1
3,2004,050600,3,3,0,0
4,2004,050600,6,6,0,0
5,2004,050600,11,11,0,0
6,2004,050600,6,6,0,0
7,2004,050600,5,5,0,1
8,2004,050600,14,13,1,0
9,2004,050600,8,8,0,2
10,2004,050600,6,6,0,0
11,2004,050600,12,12,0,0
12,2004,050600,5,5,0,0
1,2005,050600,4,4,0,0
2,2005,050600,7,6,1,0
3,2005,050600,5,5,0,1
4,2005,050600,6,6,0,0
5,2005,050600,9,9,0,0
6,2005,050600,6,6,0,0
7,2005,050600,7,7,0,0
8,2005,050600,8,8,0,0
9,2005,050600,13,13,0,0
10,2005,050600,5,5,0,0
11,2005,050600,7,7,0,0
12,2005,050600,7,7,0,0
1,2006,050600,15,15,0,0
2,2006,050600,8,8,0,0
3,2006,050600,10,9,1,0
4,2006,050600,6,6,0,0
5,2006,050600,2,2,0,1
6,2006,050600,13,11,2,0
7,2006,050600,15,15,0,0
8,2006,050600,9,8,1,0
9,2006,050600,12,11,1,1
10,2006,050600,6,6,0,0
11,2006,050600,9,9,0,0
12,2006,050600,4,4,0,0
1,2007,050600,6,6,0,0
2,2007,050600,5,5,0,0
3,2007,050600,7,7,0,0
4,2007,050600,10,10,0,0
5,2007,050600,8,8,0,0
6,2007,050600,5,5,0,0
7,2007,050600,9,9,0,0
8,2007,050600,8,8,0,1
9,2007,050600,19,19,0,0
10,2007,050600,11,11,0,0
11,2007,050600,8,8,0,0
12,2007,050600,4,4,0,0
1,2008,050600,9,9,0,0
2,2008,050600,5,5,0,0
3,2008,050600,8,8,0,0
4,2008,050600,14,14,0,0
5,2008,050600,7,7,0,0
6,2008,050600,4,4,0,0
7,2008,050600,14,13,1,0
8,2008,050600,4,4,0,0
9,2008,050600,13,13,0,0
10,2008,050600,11,10,1,0
11,2008,050600,9,9,0,0
12,2008,050600,8,8,0,0
1,2009,050600,9,9,0,0
2,2009,050600,7,7,0,0
3,2009,050600,12,12,0,0
4,2009,050600,4,4,0,0
5,2009,050600,12,11,1,1
6,2009,050600,9,9,0,0
7,2009,050600,13,13,0,1
8,2009,050600,6,6,0,0
9,2009,050600,10,10,0,0
10,2009,050600,13,13,0,0
11,2009,050600,9,9,0,0
12,2009,050600,8,8,0,0
1,2010,050600,11,11,0,1
2,2010,050600,2,2,0,1
3,2010,050600,6,6,0,0
4,2010,050600,10,10,0,1
5,2010,050600,5,5,0,0
6,2010,050600,7,7,0,0
7,2010,050600,13,13,0,0
8,2010,050600,9,9,0,0
9,2010,050600,6,6,0,0
10,2010,050600,15,15,0,1
11,2010,050600,15,15,0,2
12,2010,050600,9,9,0,0
1,2011,050600,5,4,1,0
2,2011,050600,7,7,0,0
1,1999,060900,7,7,0,0
2,1999,060900,5,5,0,3
3,1999,060900,8,8,0,1
4,1999,060900,12,11,1,0
5,1999,060900,5,4,1,1
6,1999,060900,20,20,0,2
7,1999,060900,21,19,2,0
8,1999,060900,12,12,0,0
9,1999,060900,13,13,0,0
10,1999,060900,10,9,1,1
11,1999,060900,8,8,0,1
12,1999,060900,7,6,1,0
1,2000,060900,11,10,1,4
2,2000,060900,6,5,1,2
3,2000,060900,11,11,0,0
4,2000,060900,16,14,2,0
5,2000,060900,15,15,0,1
6,2000,060900,13,10,3,1
7,2000,060900,12,12,0,0
8,2000,060900,11,11,0,2
9,2000,060900,13,13,0,0
10,2000,060900,5,5,0,0
11,2000,060900,16,14,2,1
12,2000,060900,13,12,1,0
1,2001,060900,3,3,0,0
2,2001,060900,7,5,2,0
3,2001,060900,7,7,0,0
4,2001,060900,14,14,0,0
5,2001,060900,9,8,1,1
6,2001,060900,9,9,0,1
7,2001,060900,11,11,0,0
8,2001,060900,16,14,2,0
9,2001,060900,9,9,0,0
10,2001,060900,13,12,1,1
11,2001,060900,9,9,0,1
12,2001,060900,6,5,1,0
1,2002,060900,1,1,0,2
2,2002,060900,11,11,0,1
3,2002,060900,7,5,2,0
4,2002,060900,13,12,1,0
5,2002,060900,8,8,0,0
6,2002,060900,10,9,1,0
7,2002,060900,11,11,0,0
8,2002,060900,13,13,0,0
9,2002,060900,10,8,2,0
10,2002,060900,6,6,0,0
11,2002,060900,6,5,1,0
12,2002,060900,3,3,0,0
1,2003,060900,6,6,0,1
2,2003,060900,6,6,0,0
3,2003,060900,2,1,1,0
4,2003,060900,16,16,0,0
5,2003,060900,9,9,0,4
6,2003,060900,16,16,0,1
7,2003,060900,15,14,1,0
8,2003,060900,8,7,1,0
9,2003,060900,10,8,2,0
10,2003,060900,10,8,2,0
11,2003,060900,9,8,1,0
12,2003,060900,8,8,0,1
1,2004,060900,8,8,0,3
2,2004,060900,9,8,1,0
3,2004,060900,9,9,0,0
4,2004,060900,5,5,0,0
5,2004,060900,9,9,0,4
6,2004,060900,9,9,0,0
7,2004,060900,13,13,0,0
8,2004,060900,19,19,0,4
9,2004,060900,10,10,0,0
10,2004,060900,15,12,3,1
11,2004,060900,2,2,0,0
12,2004,060900,7,7,0,0
1,2005,060900,8,8,0,0
2,2005,060900,9,9,0,0
3,2005,060900,6,6,0,4
4,2005,060900,7,7,0,0
5,2005,060900,10,10,0,0
6,2005,060900,6,6,0,2
7,2005,060900,11,10,1,0
8,2005,060900,11,10,1,3
9,2005,060900,12,12,0,1
10,2005,060900,2,2,0,1
11,2005,060900,9,9,0,2
12,2005,060900,7,5,2,0
1,2006,060900,10,10,0,1
2,2006,060900,6,6,0,0
3,2006,060900,11,10,1,1
4,2006,060900,8,8,0,0
5,2006,060900,14,14,0,1
6,2006,060900,7,7,0,1
7,2006,060900,7,7,0,0
8,2006,060900,11,11,0,0
9,2006,060900,13,13,0,0
10,2006,060900,14,12,2,1
11,2006,060900,10,10,0,0
12,2006,060900,5,5,0,1
1,2007,060900,8,8,0,1
2,2007,060900,3,3,0,1
3,2007,060900,6,6,0,1
4,2007,060900,8,8,0,0
5,2007,060900,9,9,0,0
6,2007,060900,12,12,0,0
7,2007,060900,11,11,0,1
8,2007,060900,9,8,1,2
9,2007,060900,5,5,0,0
10,2007,060900,9,9,0,0
11,2007,060900,10,10,0,0
12,2007,060900,7,7,0,0
1,2008,060900,14,14,0,0
2,2008,060900,10,9,1,0
3,2008,060900,12,12,0,1
4,2008,060900,7,7,0,0
5,2008,060900,6,5,1,0
6,2008,060900,9,9,0,1
7,2008,060900,14,14,0,1
8,2008,060900,4,3,1,0
9,2008,060900,7,6,1,0
10,2008,060900,8,8,0,1
11,2008,060900,8,8,0,0
12,2008,060900,12,12,0,0
1,2009,060900,5,5,0,0
2,2009,060900,4,4,0,0
3,2009,060900,6,6,0,0
4,2009,060900,7,7,0,0
5,2009,060900,5,5,0,0
6,2009,060900,8,8,0,1
7,2009,060900,7,7,0,0
8,2009,060900,16,15,1,0
9,2009,060900,13,13,0,0
10,2009,060900,3,3,0,0
11,2009,060900,3,3,0,0
12,2009,060900,6,5,1,0
1,2010,060900,9,8,1,0
2,2010,060900,7,6,1,0
3,2010,060900,6,6,0,0
4,2010,060900,9,8,1,0
5,2010,060900,7,7,0,0
6,2010,060900,6,6,0,0
7,2010,060900,3,3,0,0
8,2010,060900,14,14,0,0
9,2010,060900,11,11,0,0
10,2010,060900,8,8,0,0
11,2010,060900,9,7,2,0
12,2010,060900,5,5,0,0
1,2011,060900,6,6,0,0
2,2011,060900,3,3,0,0
1,1999,060300,7,7,0,0
2,1999,060300,8,7,1,1
3,1999,060300,6,5,1,0
4,1999,060300,4,4,0,0
5,1999,060300,10,9,1,0
6,1999,060300,9,9,0,0
7,1999,060300,12,12,0,0
8,1999,060300,15,13,2,1
9,1999,060300,10,8,2,0
10,1999,060300,8,8,0,1
11,1999,060300,9,9,0,0
12,1999,060300,6,6,0,1
1,2000,060300,11,11,0,1
2,2000,060300,9,9,0,1
3,2000,060300,8,8,0,1
4,2000,060300,9,8,1,1
5,2000,060300,9,9,0,1
6,2000,060300,7,7,0,1
7,2000,060300,12,9,3,0
8,2000,060300,13,11,2,1
9,2000,060300,12,12,0,0
10,2000,060300,11,10,1,3
11,2000,060300,10,10,0,0
12,2000,060300,3,3,0,2
1,2001,060300,6,6,0,1
2,2001,060300,6,6,0,1
3,2001,060300,11,11,0,0
4,2001,060300,9,9,0,0
5,2001,060300,11,8,3,0
6,2001,060300,10,9,1,5
7,2001,060300,15,15,0,0
8,2001,060300,6,6,0,1
9,2001,060300,13,13,0,1
10,2001,060300,8,8,0,1
11,2001,060300,9,9,0,1
12,2001,060300,10,10,0,0
1,2002,060300,14,10,4,0
2,2002,060300,9,8,1,0
3,2002,060300,9,8,1,0
4,2002,060300,9,9,0,2
5,2002,060300,3,3,0,2
6,2002,060300,14,13,1,2
7,2002,060300,18,17,1,0
8,2002,060300,17,15,2,1
9,2002,060300,11,11,0,0
10,2002,060300,10,10,0,0
11,2002,060300,19,19,0,0
12,2002,060300,7,7,0,0
1,2003,060300,10,10,0,2
2,2003,060300,5,5,0,0
3,2003,060300,7,7,0,0
4,2003,060300,16,16,0,0
5,2003,060300,10,10,0,0
6,2003,060300,14,11,3,0
7,2003,060300,6,6,0,0
8,2003,060300,7,7,0,0
9,2003,060300,8,8,0,1
10,2003,060300,15,14,1,0
11,2003,060300,11,11,0,0
12,2003,060300,7,7,0,1
1,2004,060300,9,8,1,0
2,2004,060300,9,5,4,0
3,2004,060300,7,7,0,0
4,2004,060300,9,9,0,0
5,2004,060300,8,8,0,0
6,2004,060300,3,2,1,0
7,2004,060300,13,13,0,0
8,2004,060300,12,12,0,0
9,2004,060300,10,10,0,0
10,2004,060300,8,8,0,0
11,2004,060300,15,14,1,0
12,2004,060300,8,8,0,2
1,2005,060300,3,2,1,0
2,2005,060300,8,7,1,0
3,2005,060300,11,11,0,0
4,2005,060300,11,11,0,0
5,2005,060300,14,13,1,0
6,2005,060300,10,9,1,0
7,2005,060300,7,7,0,0
8,2005,060300,6,6,0,0
9,2005,060300,8,8,0,1
10,2005,060300,10,10,0,0
11,2005,060300,10,10,0,0
12,2005,060300,8,8,0,0
1,2006,060300,15,15,0,0
2,2006,060300,3,3,0,0
3,2006,060300,8,7,1,0
4,2006,060300,8,8,0,0
5,2006,060300,11,11,0,0
6,2006,060300,4,4,0,0
7,2006,060300,10,10,0,1
8,2006,060300,12,12,0,1
9,2006,060300,9,8,1,2
10,2006,060300,9,9,0,0
11,2006,060300,7,7,0,0
12,2006,060300,7,7,0,2
1,2007,060300,9,9,0,1
2,2007,060300,6,5,1,0
3,2007,060300,11,11,0,0
4,2007,060300,6,6,0,0
5,2007,060300,8,8,0,0
6,2007,060300,8,8,0,0
7,2007,060300,8,8,0,2
8,2007,060300,6,6,0,1
9,2007,060300,8,8,0,0
10,2007,060300,8,8,0,2
11,2007,060300,9,9,0,2
12,2007,060300,3,3,0,1
1,2008,060300,8,8,0,0
2,2008,060300,5,5,0,0
3,2008,060300,7,7,0,2
4,2008,060300,7,7,0,0
5,2008,060300,15,14,1,0
6,2008,060300,4,4,0,0
7,2008,060300,15,15,0,0
8,2008,060300,11,11,0,0
9,2008,060300,10,10,0,0
10,2008,060300,12,11,1,0
11,2008,060300,11,10,1,0
12,2008,060300,2,2,0,0
1,2009,060300,4,4,0,0
2,2009,060300,10,10,0,1
3,2009,060300,14,14,0,0
4,2009,060300,8,8,0,0
5,2009,060300,9,9,0,0
6,2009,060300,9,9,0,0
7,2009,060300,15,15,0,0
8,2009,060300,10,9,1,0
9,2009,060300,11,11,0,0
10,2009,060300,10,10,0,0
11,2009,060300,9,9,0,0
12,2009,060300,11,11,0,0
1,2010,060300,2,2,0,0
2,2010,060300,3,3,0,0
3,2010,060300,5,4,1,1
4,2010,060300,9,8,1,0
5,2010,060300,7,7,0,0
6,2010,060300,13,12,1,0
7,2010,060300,6,5,1,0
8,2010,060300,13,13,0,3
9,2010,060300,11,11,0,0
10,2010,060300,13,13,0,1
11,2010,060300,8,7,1,0
12,2010,060300,16,16,0,0
1,2011,060300,8,8,0,0
2,2011,060300,4,3,1,0
1,1999,060400,5,5,0,0
2,1999,060400,4,4,0,0
3,1999,060400,13,13,0,0
4,1999,060400,6,6,0,0
5,1999,060400,16,14,2,0
6,1999,060400,12,11,1,0
7,1999,060400,17,16,1,0
8,1999,060400,20,20,0,0
9,1999,060400,21,21,0,0
10,1999,060400,13,13,0,0
11,1999,060400,4,4,0,2
12,1999,060400,6,6,0,0
1,2000,060400,10,9,1,0
2,2000,060400,7,6,1,0
3,2000,060400,13,13,0,1
4,2000,060400,16,14,2,0
5,2000,060400,8,7,1,0
6,2000,060400,12,11,1,0
7,2000,060400,11,10,1,0
8,2000,060400,21,20,1,0
9,2000,060400,19,19,0,0
10,2000,060400,7,7,0,0
11,2000,060400,8,8,0,0
12,2000,060400,11,11,0,0
1,2001,060400,7,7,0,0
2,2001,060400,11,11,0,0
3,2001,060400,14,14,0,0
4,2001,060400,9,9,0,0
5,2001,060400,15,14,1,0
6,2001,060400,9,8,1,1
7,2001,060400,28,28,0,0
8,2001,060400,10,10,0,0
9,2001,060400,14,13,1,0
10,2001,060400,8,8,0,0
11,2001,060400,10,10,0,0
12,2001,060400,6,6,0,0
1,2002,060400,13,12,1,0
2,2002,060400,11,11,0,0
3,2002,060400,14,14,0,0
4,2002,060400,11,11,0,0
5,2002,060400,20,20,0,0
6,2002,060400,16,15,1,0
7,2002,060400,13,12,1,0
8,2002,060400,24,24,0,0
9,2002,060400,17,16,1,0
10,2002,060400,14,14,0,0
11,2002,060400,18,18,0,0
12,2002,060400,14,14,0,1
1,2003,060400,12,12,0,2
2,2003,060400,15,14,1,0
3,2003,060400,8,8,0,0
4,2003,060400,13,13,0,0
5,2003,060400,9,9,0,0
6,2003,060400,12,12,0,0
7,2003,060400,20,20,0,0
8,2003,060400,10,9,1,0
9,2003,060400,15,15,0,0
10,2003,060400,25,24,1,0
11,2003,060400,16,14,2,1
12,2003,060400,10,10,0,0
1,2004,060400,10,10,0,0
2,2004,060400,6,6,0,0
3,2004,060400,15,14,1,0
4,2004,060400,17,17,0,1
5,2004,060400,15,15,0,0
6,2004,060400,9,9,0,0
7,2004,060400,16,16,0,0
8,2004,060400,5,5,0,0
9,2004,060400,11,11,0,1
10,2004,060400,5,5,0,0
11,2004,060400,8,8,0,0
12,2004,060400,7,7,0,0
1,2005,060400,5,5,0,0
2,2005,060400,16,15,1,0
3,2005,060400,11,10,1,0
4,2005,060400,11,11,0,0
5,2005,060400,12,12,0,1
6,2005,060400,10,10,0,0
7,2005,060400,12,12,0,0
8,2005,060400,11,11,0,0
9,2005,060400,11,11,0,0
10,2005,060400,10,10,0,0
11,2005,060400,9,8,1,0
12,2005,060400,9,9,0,0
1,2006,060400,8,8,0,0
2,2006,060400,3,3,0,0
3,2006,060400,5,5,0,0
4,2006,060400,7,7,0,0
5,2006,060400,9,9,0,0
6,2006,060400,6,6,0,0
7,2006,060400,15,15,0,1
8,2006,060400,15,15,0,0
9,2006,060400,7,7,0,0
10,2006,060400,8,8,0,1
11,2006,060400,12,12,0,0
12,2006,060400,9,9,0,0
1,2007,060400,11,11,0,1
2,2007,060400,3,3,0,0
3,2007,060400,6,4,2,0
4,2007,060400,8,8,0,0
5,2007,060400,10,10,0,1
6,2007,060400,12,12,0,0
7,2007,060400,11,11,0,0
8,2007,060400,6,5,1,1
9,2007,060400,12,12,0,3
10,2007,060400,21,21,0,0
11,2007,060400,11,11,0,0
12,2007,060400,10,10,0,0
1,2008,060400,8,8,0,0
2,2008,060400,17,17,0,0
3,2008,060400,13,13,0,0
4,2008,060400,13,13,0,0
5,2008,060400,4,4,0,0
6,2008,060400,6,6,0,0
7,2008,060400,8,8,0,0
8,2008,060400,10,10,0,0
9,2008,060400,6,6,0,0
10,2008,060400,23,22,1,0
11,2008,060400,17,16,1,0
12,2008,060400,9,9,0,0
1,2009,060400,10,10,0,2
2,2009,060400,8,8,0,0
3,2009,060400,8,8,0,0
4,2009,060400,8,8,0,0
5,2009,060400,14,14,0,0
6,2009,060400,4,4,0,0
7,2009,060400,9,9,0,0
8,2009,060400,8,8,0,0
9,2009,060400,10,10,0,0
10,2009,060400,11,11,0,0
11,2009,060400,11,11,0,0
12,2009,060400,5,5,0,0
1,2010,060400,3,3,0,0
2,2010,060400,13,13,0,0
3,2010,060400,5,5,0,0
4,2010,060400,7,7,0,0
5,2010,060400,6,6,0,0
6,2010,060400,6,6,0,0
7,2010,060400,17,17,0,0
8,2010,060400,16,16,0,0
9,2010,060400,17,17,0,1
10,2010,060400,7,7,0,0
11,2010,060400,7,7,0,0
12,2010,060400,10,10,0,0
1,2011,060400,7,7,0,0
2,2011,060400,13,13,0,0
1,1999,160900,11,9,2,0
2,1999,160900,10,10,0,3
3,1999,160900,15,15,0,5
4,1999,160900,19,19,0,0
5,1999,160900,21,20,1,1
6,1999,160900,26,26,0,6
7,1999,160900,15,15,0,2
8,1999,160900,16,13,3,1
9,1999,160900,20,13,7,1
10,1999,160900,13,12,1,1
11,1999,160900,13,13,0,1
12,1999,160900,14,14,0,5
1,2000,160900,9,9,0,1
2,2000,160900,16,15,1,5
3,2000,160900,20,17,3,9
4,2000,160900,24,24,0,2
5,2000,160900,18,17,1,1
6,2000,160900,13,12,1,3
7,2000,160900,15,14,1,4
8,2000,160900,8,8,0,6
9,2000,160900,14,12,2,1
10,2000,160900,16,12,4,1
11,2000,160900,18,17,1,4
12,2000,160900,11,10,1,1
1,2001,160900,10,9,1,2
2,2001,160900,8,6,2,6
3,2001,160900,8,6,2,4
4,2001,160900,19,18,1,0
5,2001,160900,17,16,1,4
6,2001,160900,19,16,3,2
7,2001,160900,17,14,3,1
8,2001,160900,12,12,0,0
9,2001,160900,21,21,0,1
10,2001,160900,14,12,2,5
11,2001,160900,13,12,1,0
12,2001,160900,17,16,1,1
1,2002,160900,15,14,1,4
2,2002,160900,14,12,2,3
3,2002,160900,20,19,1,3
4,2002,160900,14,14,0,3
5,2002,160900,20,19,1,6
6,2002,160900,33,29,4,2
7,2002,160900,23,21,2,0
8,2002,160900,22,22,0,2
9,2002,160900,20,18,2,2
10,2002,160900,23,22,1,0
11,2002,160900,12,11,1,0
12,2002,160900,15,12,3,3
1,2003,160900,10,9,1,12
2,2003,160900,9,9,0,2
3,2003,160900,13,13,0,5
4,2003,160900,9,9,0,2
5,2003,160900,16,16,0,1
6,2003,160900,20,18,2,1
7,2003,160900,16,15,1,4
8,2003,160900,17,17,0,4
9,2003,160900,13,13,0,5
10,2003,160900,18,16,2,4
11,2003,160900,20,18,2,3
12,2003,160900,12,12,0,7
1,2004,160900,12,12,0,5
2,2004,160900,11,9,2,11
3,2004,160900,6,6,0,5
4,2004,160900,10,9,1,5
5,2004,160900,11,10,1,1
6,2004,160900,7,7,0,9
7,2004,160900,21,21,0,2
8,2004,160900,15,12,3,6
9,2004,160900,13,13,0,2
10,2004,160900,22,20,2,2
11,2004,160900,13,13,0,1
12,2004,160900,14,12,2,2
1,2005,160900,10,10,0,6
2,2005,160900,20,19,1,3
3,2005,160900,15,15,0,2
4,2005,160900,16,16,0,6
5,2005,160900,10,8,2,0
6,2005,160900,15,14,1,4
7,2005,160900,17,16,1,3
8,2005,160900,18,17,1,3
9,2005,160900,16,16,0,6
10,2005,160900,10,10,0,2
11,2005,160900,7,7,0,3
12,2005,160900,10,10,0,3
1,2006,160900,10,9,1,3
2,2006,160900,13,12,1,7
3,2006,160900,14,14,0,1
4,2006,160900,4,4,0,1
5,2006,160900,16,13,3,3
6,2006,160900,15,14,1,0
7,2006,160900,10,10,0,2
8,2006,160900,7,6,1,2
9,2006,160900,12,12,0,5
10,2006,160900,9,7,2,0
11,2006,160900,10,10,0,3
12,2006,160900,15,14,1,2
1,2007,160900,12,12,0,4
2,2007,160900,9,9,0,3
3,2007,160900,9,8,1,3
4,2007,160900,6,4,2,3
5,2007,160900,10,9,1,3
6,2007,160900,17,13,4,0
7,2007,160900,17,17,0,1
8,2007,160900,11,11,0,3
9,2007,160900,7,6,1,1
10,2007,160900,13,13,0,3
11,2007,160900,11,11,0,2
12,2007,160900,13,12,1,2
1,2008,160900,4,3,1,0
2,2008,160900,7,7,0,2
3,2008,160900,9,9,0,4
4,2008,160900,9,8,1,2
5,2008,160900,5,4,1,2
6,2008,160900,16,13,3,2
7,2008,160900,21,21,0,0
8,2008,160900,13,12,1,0
9,2008,160900,15,14,1,1
10,2008,160900,15,15,0,0
11,2008,160900,7,6,1,0
12,2008,160900,17,16,1,4
1,2009,160900,9,6,3,2
2,2009,160900,7,7,0,0
3,2009,160900,12,11,1,1
4,2009,160900,18,18,0,4
5,2009,160900,15,15,0,4
6,2009,160900,9,9,0,3
7,2009,160900,15,15,0,0
8,2009,160900,21,19,2,4
9,2009,160900,20,20,0,0
10,2009,160900,20,18,2,2
11,2009,160900,6,5,1,2
12,2009,160900,11,11,0,0
1,2010,160900,12,10,2,2
2,2010,160900,7,7,0,1
3,2010,160900,10,8,2,0
4,2010,160900,12,11,1,2
5,2010,160900,14,13,1,0
6,2010,160900,17,17,0,2
7,2010,160900,21,21,0,2
8,2010,160900,14,13,1,0
9,2010,160900,10,9,1,1
10,2010,160900,12,12,0,2
11,2010,160900,7,7,0,0
12,2010,160900,8,8,0,1
1,2011,160900,14,14,0,0
2,2011,160900,8,7,1,0
1,1999,061200,2,2,0,0
2,1999,061200,10,10,0,0
3,1999,061200,9,9,0,0
4,1999,061200,4,4,0,1
5,1999,061200,11,11,0,0
6,1999,061200,10,10,0,1
7,1999,061200,14,14,0,0
8,1999,061200,12,12,0,0
9,1999,061200,8,8,0,2
10,1999,061200,3,2,1,0
11,1999,061200,6,6,0,0
12,1999,061200,4,4,0,0
1,2000,061200,6,6,0,1
2,2000,061200,3,3,0,0
3,2000,061200,3,3,0,0
4,2000,061200,4,4,0,0
5,2000,061200,12,12,0,0
6,2000,061200,7,6,1,0
7,2000,061200,8,8,0,1
8,2000,061200,10,10,0,1
9,2000,061200,14,14,0,1
10,2000,061200,13,13,0,0
11,2000,061200,8,8,0,0
12,2000,061200,8,7,1,0
1,2001,061200,7,7,0,0
2,2001,061200,5,5,0,1
3,2001,061200,6,5,1,0
4,2001,061200,4,4,0,2
5,2001,061200,8,8,0,1
6,2001,061200,7,7,0,0
7,2001,061200,9,9,0,0
8,2001,061200,13,13,0,0
9,2001,061200,5,5,0,0
10,2001,061200,5,5,0,0
11,2001,061200,11,10,1,0
12,2001,061200,6,6,0,1
1,2002,061200,5,5,0,0
2,2002,061200,8,8,0,0
3,2002,061200,5,5,0,0
4,2002,061200,11,11,0,0
5,2002,061200,11,11,0,2
6,2002,061200,3,3,0,0
7,2002,061200,9,8,1,0
8,2002,061200,20,20,0,1
9,2002,061200,7,7,0,0
10,2002,061200,4,4,0,0
11,2002,061200,8,8,0,0
12,2002,061200,5,5,0,0
1,2003,061200,3,3,0,0
2,2003,061200,4,4,0,0
3,2003,061200,14,14,0,0
4,2003,061200,8,8,0,0
5,2003,061200,10,10,0,0
6,2003,061200,8,8,0,0
7,2003,061200,7,7,0,2
8,2003,061200,10,10,0,0
9,2003,061200,17,16,1,0
10,2003,061200,7,7,0,1
11,2003,061200,8,8,0,1
12,2003,061200,4,4,0,0
1,2004,061200,7,5,2,1
2,2004,061200,5,5,0,0
3,2004,061200,3,3,0,0
4,2004,061200,6,5,1,0
5,2004,061200,4,4,0,0
6,2004,061200,4,4,0,0
7,2004,061200,2,2,0,0
8,2004,061200,10,8,2,1
9,2004,061200,8,8,0,1
10,2004,061200,10,9,1,0
11,2004,061200,9,9,0,1
12,2004,061200,4,4,0,2
1,2005,061200,9,8,1,0
2,2005,061200,5,5,0,0
3,2005,061200,4,4,0,0
4,2005,061200,5,4,1,0
5,2005,061200,7,7,0,2
6,2005,061200,7,7,0,0
7,2005,061200,8,8,0,0
8,2005,061200,11,11,0,0
9,2005,061200,8,8,0,1
10,2005,061200,7,7,0,0
11,2005,061200,10,10,0,0
12,2005,061200,3,3,0,0
1,2006,061200,5,5,0,0
2,2006,061200,4,4,0,0
3,2006,061200,5,5,0,0
4,2006,061200,12,12,0,0
5,2006,061200,7,7,0,0
6,2006,061200,2,2,0,1
7,2006,061200,9,9,0,0
8,2006,061200,9,9,0,1
9,2006,061200,5,4,1,0
10,2006,061200,3,3,0,0
11,2006,061200,10,10,0,0
12,2006,061200,3,3,0,0
1,2007,061200,3,3,0,0
2,2007,061200,3,3,0,0
3,2007,061200,7,6,1,0
4,2007,061200,8,8,0,0
5,2007,061200,6,6,0,0
6,2007,061200,4,4,0,0
7,2007,061200,4,3,1,0
8,2007,061200,6,6,0,0
9,2007,061200,16,16,0,0
10,2007,061200,17,17,0,0
11,2007,061200,13,13,0,0
12,2007,061200,4,4,0,0
1,2008,061200,4,4,0,0
2,2008,061200,6,6,0,0
3,2008,061200,7,7,0,2
4,2008,061200,3,3,0,0
5,2008,061200,8,8,0,0
6,2008,061200,9,9,0,0
7,2008,061200,6,6,0,0
8,2008,061200,4,4,0,0
9,2008,061200,10,10,0,0
10,2008,061200,4,4,0,1
11,2008,061200,7,7,0,1
12,2008,061200,4,4,0,0
1,2009,061200,5,5,0,0
2,2009,061200,5,5,0,0
3,2009,061200,14,14,0,3
4,2009,061200,5,5,0,0
5,2009,061200,7,7,0,0
6,2009,061200,6,6,0,1
7,2009,061200,16,16,0,0
8,2009,061200,11,11,0,0
9,2009,061200,10,10,0,1
10,2009,061200,5,4,1,0
11,2009,061200,2,2,0,1
12,2009,061200,4,4,0,0
1,2010,061200,13,12,1,0
2,2010,061200,4,4,0,0
3,2010,061200,8,8,0,1
4,2010,061200,6,6,0,0
5,2010,061200,15,14,1,0
6,2010,061200,12,12,0,0
7,2010,061200,5,5,0,0
8,2010,061200,10,10,0,0
9,2010,061200,5,4,1,0
10,2010,061200,7,6,1,0
11,2010,061200,7,7,0,0
12,2010,061200,4,4,0,0
1,2011,061200,6,6,0,0
2,2011,061200,1,1,0,0
1,1999,061100,5,5,0,0
2,1999,061100,6,6,0,0
3,1999,061100,10,10,0,0
4,1999,061100,10,10,0,0
5,1999,061100,12,10,2,1
6,1999,061100,25,23,2,0
7,1999,061100,15,13,2,1
8,1999,061100,27,27,0,0
9,1999,061100,21,20,1,2
10,1999,061100,5,4,1,0
11,1999,061100,6,5,1,0
12,1999,061100,8,7,1,0
1,2000,061100,4,4,0,0
2,2000,061100,8,6,2,0
3,2000,061100,9,7,2,0
4,2000,061100,10,9,1,0
5,2000,061100,13,11,2,0
6,2000,061100,12,11,1,0
7,2000,061100,17,16,1,0
8,2000,061100,19,17,2,1
9,2000,061100,11,11,0,4
10,2000,061100,9,9,0,0
11,2000,061100,12,12,0,0
12,2000,061100,10,10,0,0
1,2001,061100,8,6,2,0
2,2001,061100,5,5,0,0
3,2001,061100,8,8,0,1
4,2001,061100,9,9,0,0
5,2001,061100,19,16,3,1
6,2001,061100,18,17,1,0
7,2001,061100,13,12,1,2
8,2001,061100,9,9,0,0
9,2001,061100,7,7,0,0
10,2001,061100,6,5,1,1
11,2001,061100,6,6,0,0
12,2001,061100,4,4,0,0
1,2002,061100,9,9,0,0
2,2002,061100,2,2,0,0
3,2002,061100,2,2,0,1
4,2002,061100,8,8,0,0
5,2002,061100,6,6,0,1
6,2002,061100,14,14,0,1
7,2002,061100,8,8,0,3
8,2002,061100,13,12,1,1
9,2002,061100,13,13,0,0
10,2002,061100,5,4,1,1
11,2002,061100,4,4,0,0
12,2002,061100,10,10,0,1
1,2003,061100,6,6,0,0
2,2003,061100,3,3,0,1
3,2003,061100,8,8,0,1
4,2003,061100,12,12,0,0
5,2003,061100,5,4,1,1
6,2003,061100,13,12,1,0
7,2003,061100,13,13,0,1
8,2003,061100,14,14,0,1
9,2003,061100,16,16,0,1
10,2003,061100,23,22,1,0
11,2003,061100,5,5,0,1
12,2003,061100,3,2,1,0
1,2004,061100,7,5,2,2
2,2004,061100,2,2,0,0
3,2004,061100,6,6,0,0
4,2004,061100,4,4,0,3
5,2004,061100,5,5,0,3
6,2004,061100,21,20,1,0
7,2004,061100,12,12,0,4
8,2004,061100,11,11,0,4
9,2004,061100,15,14,1,2
10,2004,061100,12,12,0,0
11,2004,061100,4,4,0,0
12,2004,061100,3,2,1,1
1,2005,061100,8,8,0,1
2,2005,061100,2,2,0,0
3,2005,061100,2,2,0,0
4,2005,061100,11,9,2,1
5,2005,061100,17,15,2,1
6,2005,061100,9,7,2,0
7,2005,061100,12,12,0,1
8,2005,061100,17,17,0,0
9,2005,061100,6,5,1,7
10,2005,061100,5,5,0,0
11,2005,061100,4,4,0,0
12,2005,061100,7,6,1,1
1,2006,061100,7,6,1,0
2,2006,061100,5,4,1,0
3,2006,061100,8,8,0,0
4,2006,061100,12,12,0,1
5,2006,061100,15,14,1,2
6,2006,061100,10,8,2,2
7,2006,061100,17,16,1,0
8,2006,061100,9,7,2,0
9,2006,061100,6,6,0,2
10,2006,061100,6,6,0,0
11,2006,061100,9,9,0,0
12,2006,061100,9,9,0,0
1,2007,061100,3,3,0,0
2,2007,061100,2,2,0,0
3,2007,061100,5,5,0,1
4,2007,061100,4,3,1,0
5,2007,061100,11,11,0,1
6,2007,061100,11,9,2,4
7,2007,061100,10,9,1,0
8,2007,061100,11,11,0,0
9,2007,061100,15,15,0,2
10,2007,061100,12,10,2,4
11,2007,061100,2,2,0,0
12,2007,061100,4,4,0,0
1,2008,061100,3,2,1,1
2,2008,061100,5,5,0,0
3,2008,061100,6,6,0,1
4,2008,061100,14,13,1,3
5,2008,061100,14,13,1,1
6,2008,061100,16,16,0,2
7,2008,061100,17,17,0,2
8,2008,061100,15,15,0,0
9,2008,061100,14,14,0,3
10,2008,061100,9,8,1,1
11,2008,061100,5,5,0,0
12,2008,061100,5,5,0,0
1,2009,061100,6,6,0,0
2,2009,061100,11,9,2,1
3,2009,061100,10,9,1,0
4,2009,061100,7,7,0,1
5,2009,061100,14,13,1,0
6,2009,061100,8,8,0,2
7,2009,061100,19,18,1,1
8,2009,061100,11,10,1,1
9,2009,061100,16,16,0,0
10,2009,061100,8,8,0,2
11,2009,061100,5,5,0,4
12,2009,061100,5,5,0,0
1,2010,061100,4,4,0,1
2,2010,061100,6,6,0,1
3,2010,061100,9,8,1,0
4,2010,061100,16,15,1,1
5,2010,061100,17,17,0,1
6,2010,061100,11,10,1,1
7,2010,061100,15,15,0,1
8,2010,061100,24,24,0,1
9,2010,061100,22,19,3,1
10,2010,061100,7,6,1,0
11,2010,061100,9,6,3,0
12,2010,061100,7,6,1,0
1,2011,061100,7,7,0,2
2,2011,061100,2,2,0,0
1,1999,061000,10,10,0,0
2,1999,061000,8,7,1,1
3,1999,061000,7,6,1,2
4,1999,061000,12,11,1,1
5,1999,061000,17,17,0,3
6,1999,061000,18,14,4,2
7,1999,061000,20,19,1,4
8,1999,061000,15,15,0,6
9,1999,061000,15,15,0,0
10,1999,061000,10,10,0,4
11,1999,061000,5,5,0,1
12,1999,061000,7,7,0,0
1,2000,061000,12,11,1,0
2,2000,061000,6,6,0,0
3,2000,061000,12,9,3,1
4,2000,061000,15,14,1,3
5,2000,061000,18,17,1,6
6,2000,061000,10,9,1,1
7,2000,061000,20,18,2,1
8,2000,061000,8,7,1,2
9,2000,061000,10,10,0,4
10,2000,061000,15,13,2,0
11,2000,061000,11,11,0,0
12,2000,061000,3,3,0,1
1,2001,061000,8,8,0,3
2,2001,061000,7,7,0,1
3,2001,061000,6,5,1,1
4,2001,061000,7,6,1,4
5,2001,061000,13,10,3,2
6,2001,061000,7,7,0,4
7,2001,061000,6,6,0,1
8,2001,061000,14,14,0,3
9,2001,061000,16,14,2,2
10,2001,061000,7,7,0,0
11,2001,061000,9,9,0,2
12,2001,061000,3,3,0,0
1,2002,061000,8,7,1,0
2,2002,061000,2,2,0,1
3,2002,061000,9,9,0,0
4,2002,061000,5,4,1,2
5,2002,061000,5,4,1,1
6,2002,061000,14,14,0,1
7,2002,061000,9,9,0,4
8,2002,061000,10,10,0,3
9,2002,061000,12,12,0,1
10,2002,061000,4,1,3,0
11,2002,061000,8,8,0,0
12,2002,061000,9,8,1,1
1,2003,061000,3,3,0,1
2,2003,061000,7,7,0,0
3,2003,061000,4,4,0,0
4,2003,061000,10,10,0,1
5,2003,061000,10,10,0,2
6,2003,061000,10,9,1,2
7,2003,061000,10,6,4,2
8,2003,061000,15,15,0,2
9,2003,061000,6,6,0,1
10,2003,061000,9,8,1,3
11,2003,061000,6,6,0,1
12,2003,061000,4,4,0,0
1,2004,061000,2,2,0,0
2,2004,061000,9,8,1,0
3,2004,061000,5,4,1,1
4,2004,061000,11,11,0,3
5,2004,061000,12,12,0,2
6,2004,061000,18,16,2,3
7,2004,061000,9,9,0,3
8,2004,061000,18,17,1,1
9,2004,061000,11,11,0,1
10,2004,061000,9,8,1,1
11,2004,061000,8,7,1,0
12,2004,061000,3,2,1,0
1,2005,061000,8,8,0,1
2,2005,061000,6,6,0,1
3,2005,061000,6,6,0,2
4,2005,061000,2,1,1,3
5,2005,061000,9,8,1,1
6,2005,061000,12,11,1,1
7,2005,061000,16,16,0,4
8,2005,061000,18,16,2,3
9,2005,061000,13,12,1,0
10,2005,061000,11,11,0,0
11,2005,061000,8,7,1,0
12,2005,061000,8,7,1,1
1,2006,061000,3,3,0,0
2,2006,061000,12,12,0,0
3,2006,061000,6,6,0,0
4,2006,061000,11,11,0,0
5,2006,061000,13,13,0,2
6,2006,061000,9,9,0,2
7,2006,061000,14,14,0,3
8,2006,061000,8,8,0,3
9,2006,061000,13,10,3,3
10,2006,061000,10,10,0,2
11,2006,061000,12,12,0,2
12,2006,061000,12,12,0,0
1,2007,061000,13,13,0,1
2,2007,061000,7,7,0,2
3,2007,061000,9,8,1,1
4,2007,061000,10,10,0,1
5,2007,061000,9,9,0,1
6,2007,061000,13,12,1,2
7,2007,061000,11,10,1,4
8,2007,061000,9,9,0,1
9,2007,061000,12,11,1,4
10,2007,061000,6,6,0,0
11,2007,061000,8,8,0,0
12,2007,061000,14,14,0,0
1,2008,061000,10,8,2,1
2,2008,061000,5,5,0,1
3,2008,061000,9,9,0,1
4,2008,061000,11,10,1,1
5,2008,061000,11,10,1,2
6,2008,061000,16,15,1,1
7,2008,061000,16,16,0,3
8,2008,061000,19,19,0,0
9,2008,061000,20,20,0,1
10,2008,061000,16,16,0,0
11,2008,061000,10,10,0,1
12,2008,061000,20,20,0,0
1,2009,061000,17,16,1,1
2,2009,061000,16,15,1,0
3,2009,061000,18,18,0,0
4,2009,061000,10,9,1,0
5,2009,061000,14,13,1,0
6,2009,061000,11,9,2,3
7,2009,061000,21,21,0,2
8,2009,061000,30,30,0,1
9,2009,061000,18,17,1,0
10,2009,061000,10,10,0,0
11,2009,061000,7,6,1,0
12,2009,061000,13,10,3,0
1,2010,061000,13,11,2,3
2,2010,061000,8,8,0,1
3,2010,061000,10,9,1,0
4,2010,061000,10,10,0,0
5,2010,061000,14,13,1,0
6,2010,061000,20,18,2,2
7,2010,061000,23,22,1,2
8,2010,061000,18,17,1,0
9,2010,061000,23,22,1,0
10,2010,061000,9,9,0,1
11,2010,061000,15,14,1,0
12,2010,061000,10,10,0,0
1,2011,061000,7,7,0,0
2,2011,061000,6,6,0,0
1,1999,161000,10,9,1,0
2,1999,161000,13,11,2,0
3,1999,161000,5,4,1,0
4,1999,161000,9,8,1,1
5,1999,161000,13,13,0,0
6,1999,161000,10,10,0,0
7,1999,161000,10,9,1,2
8,1999,161000,13,12,1,0
9,1999,161000,12,12,0,0
10,1999,161000,10,10,0,0
11,1999,161000,12,12,0,4
12,1999,161000,11,9,2,4
1,2000,161000,8,7,1,2
2,2000,161000,6,6,0,5
3,2000,161000,8,8,0,1
4,2000,161000,10,10,0,0
5,2000,161000,8,8,0,1
6,2000,161000,7,5,2,0
7,2000,161000,12,12,0,1
8,2000,161000,6,5,1,1
9,2000,161000,10,10,0,0
10,2000,161000,8,7,1,0
11,2000,161000,7,7,0,1
12,2000,161000,7,6,1,0
1,2001,161000,7,6,1,0
2,2001,161000,4,4,0,0
3,2001,161000,6,6,0,3
4,2001,161000,8,7,1,0
5,2001,161000,8,8,0,4
6,2001,161000,8,8,0,2
7,2001,161000,9,9,0,0
8,2001,161000,17,17,0,0
9,2001,161000,8,8,0,2
10,2001,161000,8,7,1,0
11,2001,161000,19,18,1,1
12,2001,161000,10,10,0,3
1,2002,161000,7,7,0,0
2,2002,161000,7,7,0,0
3,2002,161000,9,8,1,0
4,2002,161000,10,8,2,1
5,2002,161000,7,6,1,1
6,2002,161000,18,17,1,2
7,2002,161000,11,10,1,0
8,2002,161000,12,12,0,0
9,2002,161000,12,11,1,0
10,2002,161000,8,8,0,0
11,2002,161000,5,4,1,2
12,2002,161000,9,8,1,1
1,2003,161000,12,11,1,3
2,2003,161000,10,10,0,2
3,2003,161000,9,9,0,3
4,2003,161000,9,8,1,1
5,2003,161000,8,8,0,0
6,2003,161000,5,5,0,0
7,2003,161000,10,10,0,0
8,2003,161000,7,7,0,0
9,2003,161000,6,5,1,0
10,2003,161000,8,7,1,0
11,2003,161000,10,10,0,1
12,2003,161000,10,10,0,1
1,2004,161000,8,8,0,1
2,2004,161000,7,7,0,0
3,2004,161000,12,12,0,0
4,2004,161000,5,5,0,2
5,2004,161000,11,11,0,1
6,2004,161000,5,5,0,2
7,2004,161000,3,3,0,0
8,2004,161000,3,3,0,2
9,2004,161000,8,7,1,0
10,2004,161000,8,8,0,0
11,2004,161000,6,6,0,0
12,2004,161000,6,6,0,1
1,2005,161000,3,2,1,0
2,2005,161000,9,8,1,4
3,2005,161000,9,9,0,0
4,2005,161000,10,10,0,3
5,2005,161000,8,8,0,4
6,2005,161000,10,8,2,1
7,2005,161000,4,4,0,0
8,2005,161000,13,13,0,1
9,2005,161000,6,6,0,0
10,2005,161000,6,5,1,1
11,2005,161000,5,5,0,1
12,2005,161000,11,10,1,2
1,2006,161000,3,3,0,0
2,2006,161000,6,6,0,1
3,2006,161000,3,3,0,3
4,2006,161000,3,3,0,1
5,2006,161000,7,6,1,0
6,2006,161000,9,9,0,1
7,2006,161000,13,12,1,1
8,2006,161000,5,5,0,0
9,2006,161000,11,11,0,0
10,2006,161000,4,4,0,0
11,2006,161000,7,7,0,0
12,2006,161000,11,11,0,0
1,2007,161000,3,2,1,0
2,2007,161000,4,4,0,0
3,2007,161000,9,9,0,3
4,2007,161000,10,9,1,0
5,2007,161000,5,4,1,1
6,2007,161000,7,7,0,0
7,2007,161000,7,7,0,0
8,2007,161000,4,4,0,1
9,2007,161000,5,5,0,2
10,2007,161000,7,7,0,1
11,2007,161000,9,9,0,0
12,2007,161000,3,3,0,0
1,2008,161000,9,9,0,0
2,2008,161000,5,5,0,1
3,2008,161000,4,4,0,0
4,2008,161000,5,4,1,1
5,2008,161000,4,4,0,1
6,2008,161000,10,9,1,0
7,2008,161000,6,6,0,0
8,2008,161000,8,7,1,0
9,2008,161000,6,6,0,0
10,2008,161000,8,8,0,0
11,2008,161000,4,4,0,0
12,2008,161000,5,4,1,0
1,2009,161000,3,3,0,0
2,2009,161000,3,3,0,0
3,2009,161000,10,9,1,3
4,2009,161000,8,8,0,0
5,2009,161000,10,9,1,0
6,2009,161000,10,8,2,0
7,2009,161000,7,6,1,0
8,2009,161000,6,6,0,0
9,2009,161000,12,12,0,1
10,2009,161000,8,8,0,0
11,2009,161000,14,13,1,3
12,2009,161000,2,2,0,0
1,2010,161000,7,6,1,0
2,2010,161000,5,5,0,0
3,2010,161000,8,8,0,0
4,2010,161000,7,7,0,0
5,2010,161000,9,9,0,1
6,2010,161000,10,10,0,1
7,2010,161000,4,4,0,2
8,2010,161000,11,11,0,0
9,2010,161000,13,13,0,1
10,2010,161000,9,9,0,0
11,2010,161000,4,4,0,2
12,2010,161000,7,7,0,0
1,2011,161000,9,9,0,0
2,2011,161000,2,2,0,0
1,1999,060500,0,0,0,0
2,1999,060500,0,0,0,0
3,1999,060500,2,2,0,0
4,1999,060500,3,3,0,0
5,1999,060500,3,3,0,0
6,1999,060500,0,0,0,0
7,1999,060500,7,6,1,0
8,1999,060500,4,4,0,0
9,1999,060500,3,3,0,0
10,1999,060500,2,2,0,0
11,1999,060500,2,2,0,0
12,1999,060500,2,2,0,0
1,2000,060500,1,1,0,0
2,2000,060500,0,0,0,0
3,2000,060500,2,1,1,0
4,2000,060500,1,1,0,0
5,2000,060500,2,2,0,0
6,2000,060500,3,3,0,0
7,2000,060500,1,0,1,0
8,2000,060500,4,4,0,1
9,2000,060500,4,4,0,0
10,2000,060500,2,2,0,0
11,2000,060500,1,1,0,0
12,2000,060500,0,0,0,0
1,2001,060500,1,1,0,0
2,2001,060500,0,0,0,0
3,2001,060500,1,1,0,0
4,2001,060500,0,0,0,0
5,2001,060500,2,2,0,0
6,2001,060500,2,2,0,0
7,2001,060500,3,3,0,0
8,2001,060500,2,1,1,0
9,2001,060500,1,0,1,0
10,2001,060500,3,2,1,0
11,2001,060500,1,1,0,0
12,2001,060500,0,0,0,0
1,2002,060500,2,2,0,0
2,2002,060500,3,3,0,0
3,2002,060500,0,0,0,0
4,2002,060500,2,2,0,0
5,2002,060500,1,1,0,0
6,2002,060500,2,2,0,0
7,2002,060500,3,3,0,0
8,2002,060500,5,5,0,1
9,2002,060500,0,0,0,0
10,2002,060500,0,0,0,0
11,2002,060500,1,1,0,0
12,2002,060500,0,0,0,0
1,2003,060500,2,2,0,0
2,2003,060500,0,0,0,0
3,2003,060500,0,0,0,0
4,2003,060500,5,5,0,0
5,2003,060500,1,1,0,3
6,2003,060500,1,0,1,0
7,2003,060500,0,0,0,0
8,2003,060500,4,4,0,1
9,2003,060500,1,1,0,0
10,2003,060500,2,2,0,0
11,2003,060500,3,2,1,0
12,2003,060500,1,1,0,0
1,2004,060500,1,1,0,0
2,2004,060500,0,0,0,0
3,2004,060500,2,2,0,0
4,2004,060500,2,2,0,0
5,2004,060500,0,0,0,0
6,2004,060500,1,1,0,0
7,2004,060500,2,2,0,0
8,2004,060500,2,2,0,0
9,2004,060500,2,2,0,0
10,2004,060500,4,4,0,0
11,2004,060500,1,1,0,0
12,2004,060500,0,0,0,0
1,2005,060500,4,4,0,0
2,2005,060500,3,3,0,0
3,2005,060500,1,1,0,0
4,2005,060500,0,0,0,0
5,2005,060500,1,1,0,0
6,2005,060500,1,1,0,0
7,2005,060500,2,2,0,0
8,2005,060500,2,2,0,0
9,2005,060500,3,2,1,0
10,2005,060500,0,0,0,0
11,2005,060500,2,2,0,0
12,2005,060500,0,0,0,0
1,2006,060500,5,5,0,0
2,2006,060500,4,4,0,0
3,2006,060500,0,0,0,0
4,2006,060500,2,1,1,1
5,2006,060500,2,2,0,0
6,2006,060500,3,3,0,0
7,2006,060500,3,3,0,0
8,2006,060500,2,2,0,0
9,2006,060500,2,2,0,0
10,2006,060500,1,1,0,0
11,2006,060500,1,1,0,0
12,2006,060500,3,3,0,0
1,2007,060500,2,2,0,0
2,2007,060500,1,1,0,0
3,2007,060500,1,1,0,0
4,2007,060500,1,1,0,0
5,2007,060500,2,1,1,0
6,2007,060500,3,3,0,1
7,2007,060500,1,1,0,0
8,2007,060500,1,1,0,0
9,2007,060500,4,4,0,0
10,2007,060500,1,1,0,0
11,2007,060500,5,5,0,0
12,2007,060500,1,1,0,0
1,2008,060500,3,3,0,0
2,2008,060500,2,2,0,1
3,2008,060500,4,4,0,0
4,2008,060500,1,1,0,0
5,2008,060500,0,0,0,0
6,2008,060500,2,2,0,0
7,2008,060500,0,0,0,0
8,2008,060500,3,3,0,3
9,2008,060500,0,0,0,0
10,2008,060500,4,4,0,0
11,2008,060500,0,0,0,0
12,2008,060500,0,0,0,0
1,2009,060500,1,1,0,0
2,2009,060500,1,1,0,0
3,2009,060500,2,2,0,0
4,2009,060500,0,0,0,0
5,2009,060500,3,2,1,0
6,2009,060500,1,1,0,0
7,2009,060500,0,0,0,2
8,2009,060500,3,2,1,0
9,2009,060500,3,3,0,0
10,2009,060500,7,7,0,0
11,2009,060500,0,0,0,0
12,2009,060500,2,2,0,0
1,2010,060500,0,0,0,0
2,2010,060500,1,1,0,0
3,2010,060500,1,1,0,0
4,2010,060500,1,1,0,0
5,2010,060500,2,2,0,1
6,2010,060500,3,3,0,0
7,2010,060500,2,2,0,0
8,2010,060500,1,1,0,0
9,2010,060500,2,2,0,0
10,2010,060500,2,1,1,0
11,2010,060500,2,2,0,0
12,2010,060500,1,1,0,0
1,2011,060500,1,1,0,0
2,2011,060500,1,1,0,0
1,1999,832100,12,9,3,3
2,1999,832100,8,7,1,1
3,1999,832100,12,9,3,1
4,1999,832100,20,19,1,2
5,1999,832100,23,21,2,3
6,1999,832100,19,17,2,4
7,1999,832100,26,24,2,5
8,1999,832100,12,12,0,4
9,1999,832100,11,9,2,3
10,1999,832100,21,20,1,5
11,1999,832100,17,16,1,3
12,1999,832100,14,10,4,0
1,2000,832100,19,19,0,1
2,2000,832100,13,12,1,4
3,2000,832100,8,8,0,2
4,2000,832100,14,12,2,3
5,2000,832100,16,14,2,3
6,2000,832100,21,20,1,2
7,2000,832100,18,15,3,3
8,2000,832100,9,9,0,6
9,2000,832100,21,21,0,6
10,2000,832100,17,16,1,4
11,2000,832100,13,12,1,2
12,2000,832100,12,12,0,4
1,2001,832100,16,14,2,2
2,2001,832100,2,2,0,5
3,2001,832100,12,10,2,0
4,2001,832100,13,13,0,0
5,2001,832100,20,19,1,3
6,2001,832100,23,19,4,5
7,2001,832100,15,14,1,4
8,2001,832100,11,9,2,6
9,2001,832100,14,14,0,8
10,2001,832100,6,6,0,7
11,2001,832100,13,13,0,3
12,2001,832100,15,15,0,4
1,2002,832100,8,7,1,4
2,2002,832100,9,9,0,5
3,2002,832100,15,14,1,2
4,2002,832100,11,11,0,2
5,2002,832100,14,10,4,5
6,2002,832100,20,17,3,3
7,2002,832100,14,11,3,6
8,2002,832100,16,16,0,7
9,2002,832100,20,19,1,2
10,2002,832100,13,12,1,0
11,2002,832100,14,12,2,1
12,2002,832100,8,8,0,1
1,2003,832100,14,10,4,2
2,2003,832100,16,15,1,1
3,2003,832100,16,16,0,0
4,2003,832100,15,14,1,4
5,2003,832100,13,12,1,2
6,2003,832100,19,19,0,3
7,2003,832100,25,22,3,2
8,2003,832100,21,21,0,4
9,2003,832100,20,20,0,3
10,2003,832100,11,9,2,0
11,2003,832100,15,14,1,2
12,2003,832100,15,15,0,1
1,2004,832100,7,7,0,2
2,2004,832100,12,10,2,0
3,2004,832100,11,11,0,9
4,2004,832100,16,15,1,2
5,2004,832100,18,16,2,11
6,2004,832100,22,22,0,3
7,2004,832100,25,22,3,2
8,2004,832100,26,22,4,1
9,2004,832100,16,16,0,4
10,2004,832100,17,16,1,1
11,2004,832100,12,12,0,4
12,2004,832100,4,3,1,4
1,2005,832100,7,7,0,9
2,2005,832100,12,10,2,1
3,2005,832100,12,12,0,1
4,2005,832100,15,13,2,3
5,2005,832100,11,11,0,6
6,2005,832100,8,8,0,2
7,2005,832100,17,14,3,4
8,2005,832100,18,16,2,13
9,2005,832100,12,10,2,8
10,2005,832100,24,24,0,4
11,2005,832100,8,5,3,3
12,2005,832100,13,12,1,0
1,2006,832100,23,19,4,0
2,2006,832100,9,7,2,1
3,2006,832100,8,7,1,4
4,2006,832100,15,15,0,2
5,2006,832100,17,17,0,4
6,2006,832100,12,11,1,2
7,2006,832100,13,13,0,1
8,2006,832100,23,20,3,6
9,2006,832100,14,11,3,2
10,2006,832100,9,8,1,1
11,2006,832100,17,14,3,1
12,2006,832100,16,15,1,2
1,2007,832100,15,15,0,0
2,2007,832100,5,4,1,1
3,2007,832100,11,8,3,2
4,2007,832100,11,9,2,4
5,2007,832100,22,21,1,4
6,2007,832100,14,14,0,3
7,2007,832100,20,16,4,4
8,2007,832100,14,9,5,0
9,2007,832100,14,13,1,0
10,2007,832100,8,8,0,6
11,2007,832100,13,13,0,0
12,2007,832100,6,6,0,2
1,2008,832100,12,12,0,0
2,2008,832100,10,8,2,1
3,2008,832100,12,9,3,1
4,2008,832100,8,8,0,1
5,2008,832100,9,7,2,2
6,2008,832100,18,18,0,1
7,2008,832100,17,17,0,2
8,2008,832100,14,13,1,0
9,2008,832100,23,23,0,2
10,2008,832100,19,19,0,1
11,2008,832100,16,16,0,2
12,2008,832100,22,22,0,2
1,2009,832100,12,11,1,0
2,2009,832100,9,9,0,3
3,2009,832100,7,6,1,0
4,2009,832100,10,10,0,0
5,2009,832100,10,10,0,2
6,2009,832100,10,8,2,1
7,2009,832100,23,22,1,1
8,2009,832100,11,10,1,5
9,2009,832100,9,9,0,1
10,2009,832100,15,14,1,1
11,2009,832100,6,6,0,2
12,2009,832100,8,7,1,0
1,2010,832100,14,13,1,2
2,2010,832100,4,4,0,1
3,2010,832100,8,8,0,1
4,2010,832100,10,10,0,0
5,2010,832100,15,14,1,3
6,2010,832100,8,7,1,3
7,2010,832100,10,10,0,2
8,2010,832100,16,13,3,2
9,2010,832100,5,4,1,3
10,2010,832100,17,15,2,1
11,2010,832100,15,15,0,0
12,2010,832100,9,8,1,1
1,2011,832100,17,15,2,0
2,2011,832100,3,3,0,2
1,1999,060800,15,15,0,0
2,1999,060800,9,9,0,0
3,1999,060800,10,10,0,0
4,1999,060800,7,7,0,0
5,1999,060800,12,12,0,3
6,1999,060800,10,10,0,2
7,1999,060800,10,10,0,6
8,1999,060800,8,8,0,3
9,1999,060800,11,11,0,1
10,1999,060800,8,7,1,1
11,1999,060800,1,1,0,1
12,1999,060800,8,8,0,2
1,2000,060800,4,4,0,2
2,2000,060800,6,6,0,4
3,2000,060800,7,5,2,2
4,2000,060800,4,4,0,2
5,2000,060800,5,3,2,7
6,2000,060800,7,7,0,1
7,2000,060800,16,16,0,2
8,2000,060800,20,20,0,11
9,2000,060800,11,11,0,0
10,2000,060800,12,12,0,4
11,2000,060800,14,13,1,1
12,2000,060800,7,7,0,1
1,2001,060800,6,6,0,0
2,2001,060800,9,9,0,0
3,2001,060800,2,2,0,1
4,2001,060800,9,9,0,7
5,2001,060800,12,11,1,1
6,2001,060800,8,6,2,0
7,2001,060800,6,5,1,2
8,2001,060800,9,9,0,2
9,2001,060800,9,9,0,0
10,2001,060800,13,13,0,2
11,2001,060800,9,7,2,0
12,2001,060800,3,3,0,1
1,2002,060800,8,5,3,3
2,2002,060800,5,5,0,0
3,2002,060800,7,7,0,0
4,2002,060800,6,6,0,1
5,2002,060800,9,9,0,2
6,2002,060800,7,6,1,1
7,2002,060800,11,11,0,0
8,2002,060800,9,9,0,2
9,2002,060800,3,3,0,4
10,2002,060800,5,4,1,1
11,2002,060800,7,7,0,2
12,2002,060800,7,7,0,1
1,2003,060800,7,7,0,3
2,2003,060800,3,3,0,4
3,2003,060800,6,6,0,2
4,2003,060800,8,8,0,0
5,2003,060800,12,11,1,4
6,2003,060800,17,17,0,2
7,2003,060800,6,6,0,0
8,2003,060800,14,14,0,1
9,2003,060800,7,7,0,4
10,2003,060800,9,9,0,1
11,2003,060800,11,10,1,1
12,2003,060800,4,4,0,3
1,2004,060800,9,9,0,0
2,2004,060800,3,3,0,1
3,2004,060800,1,1,0,1
4,2004,060800,6,6,0,0
5,2004,060800,9,9,0,5
6,2004,060800,8,8,0,2
7,2004,060800,7,7,0,1
8,2004,060800,11,10,1,1
9,2004,060800,6,6,0,0
10,2004,060800,10,10,0,0
11,2004,060800,4,4,0,0
12,2004,060800,5,4,1,0
1,2005,060800,4,3,1,1
2,2005,060800,1,1,0,0
3,2005,060800,6,6,0,8
4,2005,060800,8,8,0,3
5,2005,060800,7,6,1,4
6,2005,060800,6,5,1,5
7,2005,060800,11,11,0,6
8,2005,060800,8,8,0,1
9,2005,060800,8,8,0,4
10,2005,060800,11,11,0,4
11,2005,060800,9,7,2,3
12,2005,060800,1,1,0,2
1,2006,060800,2,2,0,2
2,2006,060800,2,2,0,5
3,2006,060800,8,8,0,2
4,2006,060800,20,20,0,8
5,2006,060800,2,1,1,7
6,2006,060800,12,11,1,9
7,2006,060800,11,11,0,2
8,2006,060800,6,6,0,1
9,2006,060800,5,5,0,2
10,2006,060800,8,8,0,2
11,2006,060800,4,4,0,0
12,2006,060800,1,1,0,0
1,2007,060800,13,13,0,2
2,2007,060800,2,2,0,0
3,2007,060800,4,4,0,5
4,2007,060800,3,3,0,6
5,2007,060800,5,5,0,6
6,2007,060800,5,5,0,2
7,2007,060800,5,5,0,3
8,2007,060800,18,18,0,2
9,2007,060800,3,3,0,5
10,2007,060800,2,2,0,1
11,2007,060800,3,3,0,1
12,2007,060800,2,2,0,0
1,2008,060800,1,1,0,3
2,2008,060800,4,4,0,1
3,2008,060800,5,5,0,0
4,2008,060800,7,7,0,2
5,2008,060800,7,7,0,1
6,2008,060800,6,6,0,2
7,2008,060800,11,10,1,2
8,2008,060800,13,10,3,1
9,2008,060800,5,5,0,3
10,2008,060800,9,9,0,0
11,2008,060800,5,5,0,0
12,2008,060800,4,4,0,0
1,2009,060800,5,5,0,0
2,2009,060800,3,2,1,4
3,2009,060800,5,5,0,4
4,2009,060800,5,5,0,1
5,2009,060800,5,4,1,4
6,2009,060800,12,12,0,5
7,2009,060800,10,9,1,5
8,2009,060800,4,4,0,2
9,2009,060800,8,8,0,2
10,2009,060800,2,2,0,3
11,2009,060800,2,2,0,1
12,2009,060800,3,3,0,1
1,2010,060800,1,1,0,1
2,2010,060800,3,3,0,0
3,2010,060800,10,10,0,4
4,2010,060800,7,7,0,3
5,2010,060800,4,3,1,3
6,2010,060800,3,3,0,1
7,2010,060800,4,2,2,1
8,2010,060800,3,3,0,3
9,2010,060800,12,12,0,0
10,2010,060800,6,5,1,5
11,2010,060800,4,4,0,0
12,2010,060800,0,0,0,0
1,2011,060800,3,3,0,0
2,2011,060800,1,1,0,0
1,1999,170100,1,1,0,0
2,1999,170100,1,1,0,0
3,1999,170100,0,0,0,0
4,1999,170100,0,0,0,0
5,1999,170100,2,2,0,0
6,1999,170100,1,1,0,0
7,1999,170100,2,1,1,0
8,1999,170100,5,4,1,0
9,1999,170100,0,0,0,0
10,1999,170100,2,2,0,0
11,1999,170100,1,1,0,0
12,1999,170100,1,1,0,0
1,2000,170100,1,1,0,0
2,2000,170100,1,1,0,0
3,2000,170100,2,1,1,0
4,2000,170100,3,3,0,0
5,2000,170100,2,2,0,0
6,2000,170100,4,3,1,0
7,2000,170100,2,2,0,0
8,2000,170100,1,1,0,1
9,2000,170100,2,2,0,0
10,2000,170100,0,0,0,0
11,2000,170100,2,2,0,0
12,2000,170100,0,0,0,1
1,2001,170100,2,2,0,0
2,2001,170100,0,0,0,0
3,2001,170100,2,1,1,0
4,2001,170100,1,1,0,0
5,2001,170100,2,2,0,0
6,2001,170100,2,2,0,0
7,2001,170100,2,1,1,0
8,2001,170100,4,2,2,0
9,2001,170100,1,1,0,0
10,2001,170100,2,2,0,0
11,2001,170100,3,3,0,0
12,2001,170100,0,0,0,0
1,2002,170100,1,1,0,0
2,2002,170100,2,1,1,0
3,2002,170100,2,2,0,0
4,2002,170100,0,0,0,0
5,2002,170100,3,2,1,0
6,2002,170100,2,2,0,0
7,2002,170100,1,1,0,0
8,2002,170100,1,1,0,0
9,2002,170100,2,2,0,0
10,2002,170100,0,0,0,0
11,2002,170100,2,2,0,0
12,2002,170100,2,2,0,0
1,2003,170100,0,0,0,0
2,2003,170100,1,1,0,0
3,2003,170100,4,4,0,0
4,2003,170100,2,2,0,1
5,2003,170100,1,1,0,0
6,2003,170100,1,1,0,1
7,2003,170100,2,2,0,0
8,2003,170100,2,2,0,0
9,2003,170100,1,1,0,0
10,2003,170100,1,1,0,0
11,2003,170100,1,1,0,0
12,2003,170100,1,0,1,1
1,2004,170100,1,1,0,0
2,2004,170100,2,2,0,0
3,2004,170100,0,0,0,0
4,2004,170100,0,0,0,0
5,2004,170100,0,0,0,0
6,2004,170100,3,3,0,0
7,2004,170100,1,1,0,0
8,2004,170100,0,0,0,0
9,2004,170100,2,2,0,1
10,2004,170100,0,0,0,2
11,2004,170100,1,1,0,0
12,2004,170100,0,0,0,0
1,2005,170100,2,2,0,1
2,2005,170100,1,1,0,0
3,2005,170100,5,5,0,0
4,2005,170100,0,0,0,0
5,2005,170100,2,2,0,0
6,2005,170100,1,1,0,0
7,2005,170100,0,0,0,0
8,2005,170100,2,2,0,0
9,2005,170100,3,3,0,0
10,2005,170100,0,0,0,0
11,2005,170100,0,0,0,0
12,2005,170100,0,0,0,0
1,2006,170100,0,0,0,0
2,2006,170100,3,3,0,0
3,2006,170100,1,1,0,0
4,2006,170100,1,1,0,1
5,2006,170100,0,0,0,0
6,2006,170100,1,1,0,0
7,2006,170100,0,0,0,2
8,2006,170100,1,1,0,0
9,2006,170100,2,2,0,0
10,2006,170100,0,0,0,0
11,2006,170100,3,3,0,0
12,2006,170100,1,1,0,0
1,2007,170100,0,0,0,0
2,2007,170100,1,1,0,0
3,2007,170100,1,1,0,0
4,2007,170100,3,3,0,1
5,2007,170100,2,2,0,0
6,2007,170100,0,0,0,1
7,2007,170100,0,0,0,0
8,2007,170100,3,3,0,1
9,2007,170100,1,1,0,0
10,2007,170100,3,3,0,0
11,2007,170100,0,0,0,0
12,2007,170100,0,0,0,0
1,2008,170100,1,1,0,0
2,2008,170100,2,2,0,0
3,2008,170100,0,0,0,0
4,2008,170100,1,1,0,0
5,2008,170100,0,0,0,0
6,2008,170100,0,0,0,0
7,2008,170100,0,0,0,0
8,2008,170100,1,1,0,0
9,2008,170100,1,1,0,0
10,2008,170100,3,3,0,0
11,2008,170100,3,3,0,0
12,2008,170100,1,1,0,0
1,2009,170100,1,1,0,0
2,2009,170100,0,0,0,0
3,2009,170100,2,1,1,0
4,2009,170100,2,2,0,0
5,2009,170100,1,1,0,0
6,2009,170100,2,2,0,0
7,2009,170100,1,1,0,0
8,2009,170100,0,0,0,0
9,2009,170100,1,1,0,0
10,2009,170100,2,2,0,0
11,2009,170100,2,1,1,0
12,2009,170100,0,0,0,0
1,2010,170100,0,0,0,0
2,2010,170100,1,1,0,0
3,2010,170100,2,1,1,0
4,2010,170100,4,4,0,0
5,2010,170100,1,1,0,0
6,2010,170100,1,1,0,0
7,2010,170100,1,1,0,0
8,2010,170100,3,2,1,1
9,2010,170100,1,1,0,0
10,2010,170100,2,2,0,0
11,2010,170100,3,3,0,0
12,2010,170100,1,1,0,0
1,2011,170100,1,1,0,0
2,2011,170100,0,0,0,0
1,1999,150502,6,4,2,0
2,1999,150502,8,7,1,0
3,1999,150502,11,10,1,0
4,1999,150502,8,8,0,0
5,1999,150502,8,8,0,0
6,1999,150502,10,9,1,1
7,1999,150502,15,14,1,2
8,1999,150502,11,10,1,2
9,1999,150502,10,9,1,0
10,1999,150502,5,5,0,0
11,1999,150502,5,5,0,2
12,1999,150502,3,3,0,0
1,2000,150502,5,5,0,1
2,2000,150502,5,5,0,1
3,2000,150502,8,8,0,0
4,2000,150502,11,11,0,1
5,2000,150502,10,10,0,0
6,2000,150502,14,14,0,0
7,2000,150502,9,9,0,0
8,2000,150502,8,8,0,3
9,2000,150502,7,6,1,0
10,2000,150502,6,6,0,1
11,2000,150502,6,5,1,0
12,2000,150502,7,7,0,0
1,2001,150502,6,6,0,0
2,2001,150502,9,8,1,1
3,2001,150502,7,6,1,1
4,2001,150502,4,4,0,0
5,2001,150502,9,7,2,0
6,2001,150502,9,8,1,0
7,2001,150502,10,10,0,0
8,2001,150502,11,11,0,0
9,2001,150502,9,8,1,0
10,2001,150502,6,6,0,0
11,2001,150502,13,13,0,0
12,2001,150502,7,7,0,0
1,2002,150502,7,6,1,0
2,2002,150502,8,8,0,0
3,2002,150502,8,8,0,1
4,2002,150502,8,7,1,3
5,2002,150502,5,5,0,0
6,2002,150502,8,7,1,0
7,2002,150502,17,17,0,2
8,2002,150502,5,4,1,0
9,2002,150502,15,14,1,0
10,2002,150502,15,15,0,0
11,2002,150502,17,17,0,1
12,2002,150502,7,7,0,3
1,2003,150502,4,4,0,0
2,2003,150502,8,6,2,2
3,2003,150502,6,6,0,1
4,2003,150502,9,8,1,2
5,2003,150502,4,3,1,0
6,2003,150502,9,8,1,0
7,2003,150502,8,8,0,2
8,2003,150502,10,10,0,0
9,2003,150502,8,8,0,0
10,2003,150502,7,6,1,0
11,2003,150502,11,11,0,0
12,2003,150502,8,6,2,0
1,2004,150502,5,5,0,0
2,2004,150502,3,3,0,0
3,2004,150502,10,9,1,2
4,2004,150502,4,4,0,0
5,2004,150502,6,6,0,1
6,2004,150502,11,8,3,0
7,2004,150502,6,6,0,0
8,2004,150502,6,6,0,0
9,2004,150502,12,12,0,1
10,2004,150502,5,5,0,1
11,2004,150502,4,4,0,1
12,2004,150502,3,3,0,0
1,2005,150502,3,3,0,1
2,2005,150502,12,11,1,0
3,2005,150502,9,8,1,1
4,2005,150502,6,6,0,0
5,2005,150502,12,10,2,2
6,2005,150502,4,3,1,2
7,2005,150502,2,2,0,2
8,2005,150502,7,6,1,1
9,2005,150502,10,9,1,0
10,2005,150502,7,5,2,0
11,2005,150502,9,8,1,4
12,2005,150502,7,7,0,3
1,2006,150502,8,7,1,1
2,2006,150502,4,4,0,3
3,2006,150502,6,5,1,0
4,2006,150502,10,10,0,0
5,2006,150502,5,4,1,0
6,2006,150502,5,4,1,1
7,2006,150502,4,4,0,1
8,2006,150502,5,5,0,0
9,2006,150502,10,9,1,0
10,2006,150502,5,5,0,2
11,2006,150502,11,10,1,1
12,2006,150502,6,5,1,1
1,2007,150502,8,7,1,2
2,2007,150502,5,5,0,0
3,2007,150502,5,5,0,1
4,2007,150502,7,7,0,0
5,2007,150502,8,7,1,1
6,2007,150502,8,8,0,2
7,2007,150502,6,5,1,0
8,2007,150502,9,9,0,3
9,2007,150502,4,4,0,0
10,2007,150502,5,5,0,1
11,2007,150502,6,6,0,0
12,2007,150502,5,5,0,3
1,2008,150502,3,3,0,3
2,2008,150502,6,6,0,0
3,2008,150502,8,7,1,0
4,2008,150502,5,5,0,0
5,2008,150502,4,4,0,3
6,2008,150502,8,7,1,0
7,2008,150502,10,10,0,0
8,2008,150502,11,11,0,0
9,2008,150502,8,8,0,0
10,2008,150502,12,12,0,0
11,2008,150502,7,7,0,0
12,2008,150502,5,5,0,0
1,2009,150502,3,3,0,0
2,2009,150502,4,3,1,1
3,2009,150502,6,5,1,1
4,2009,150502,4,4,0,0
5,2009,150502,7,6,1,2
6,2009,150502,8,8,0,1
7,2009,150502,10,9,1,2
8,2009,150502,3,2,1,0
9,2009,150502,6,5,1,2
10,2009,150502,9,8,1,0
11,2009,150502,9,8,1,0
12,2009,150502,8,7,1,3
1,2010,150502,7,7,0,0
2,2010,150502,3,3,0,0
3,2010,150502,5,5,0,1
4,2010,150502,6,6,0,0
5,2010,150502,2,1,1,0
6,2010,150502,8,7,1,2
7,2010,150502,9,9,0,0
8,2010,150502,3,3,0,0
9,2010,150502,10,8,2,0
10,2010,150502,10,10,0,1
11,2010,150502,5,5,0,2
12,2010,150502,9,8,1,0
1,2011,150502,8,8,0,0
2,2011,150502,0,0,0,2
1,1999,160400,26,23,3,1
2,1999,160400,24,21,3,8
3,1999,160400,26,24,2,5
4,1999,160400,32,24,8,9
5,1999,160400,34,31,3,5
6,1999,160400,31,26,5,1
7,1999,160400,33,29,4,4
8,1999,160400,40,32,8,3
9,1999,160400,23,19,4,4
10,1999,160400,29,24,5,4
11,1999,160400,19,16,3,2
12,1999,160400,27,25,2,1
1,2000,160400,26,24,2,4
2,2000,160400,16,14,2,3
3,2000,160400,24,20,4,6
4,2000,160400,20,16,4,3
5,2000,160400,26,21,5,2
6,2000,160400,27,25,2,4
7,2000,160400,16,15,1,6
8,2000,160400,25,22,3,4
9,2000,160400,23,20,3,2
10,2000,160400,31,29,2,1
11,2000,160400,17,14,3,2
12,2000,160400,19,18,1,1
1,2001,160400,16,16,0,2
2,2001,160400,16,13,3,1
3,2001,160400,16,16,0,6
4,2001,160400,17,12,5,6
5,2001,160400,15,13,2,5
6,2001,160400,13,10,3,5
7,2001,160400,17,16,1,2
8,2001,160400,23,22,1,2
9,2001,160400,25,25,0,1
10,2001,160400,20,18,2,3
11,2001,160400,12,11,1,0
12,2001,160400,20,19,1,1
1,2002,160400,16,14,2,3
2,2002,160400,15,13,2,2
3,2002,160400,13,12,1,3
4,2002,160400,14,12,2,3
5,2002,160400,20,19,1,4
6,2002,160400,14,14,0,4
7,2002,160400,22,20,2,4
8,2002,160400,33,31,2,2
9,2002,160400,30,28,2,2
10,2002,160400,32,31,1,0
11,2002,160400,30,28,2,4
12,2002,160400,25,24,1,2
1,2003,160400,25,25,0,4
2,2003,160400,19,18,1,3
3,2003,160400,15,15,0,7
4,2003,160400,15,14,1,9
5,2003,160400,21,20,1,2
6,2003,160400,29,29,0,4
7,2003,160400,21,20,1,5
8,2003,160400,20,16,4,1
9,2003,160400,19,19,0,2
10,2003,160400,10,9,1,2
11,2003,160400,24,23,1,3
12,2003,160400,13,11,2,3
1,2004,160400,22,21,1,0
2,2004,160400,18,15,3,1
3,2004,160400,19,19,0,3
4,2004,160400,12,11,1,1
5,2004,160400,16,15,1,2
6,2004,160400,25,22,3,1
7,2004,160400,28,25,3,1
8,2004,160400,32,30,2,1
9,2004,160400,19,18,1,3
10,2004,160400,19,17,2,2
11,2004,160400,22,21,1,0
12,2004,160400,13,10,3,2
1,2005,160400,19,18,1,0
2,2005,160400,14,14,0,1
3,2005,160400,20,14,6,4
4,2005,160400,19,17,2,4
5,2005,160400,16,16,0,5
6,2005,160400,20,18,2,6
7,2005,160400,19,18,1,3
8,2005,160400,13,13,0,10
9,2005,160400,25,22,3,3
10,2005,160400,20,18,2,3
11,2005,160400,20,18,2,1
12,2005,160400,18,18,0,1
1,2006,160400,23,21,2,3
2,2006,160400,14,14,0,2
3,2006,160400,10,8,2,4
4,2006,160400,17,14,3,2
5,2006,160400,21,21,0,0
6,2006,160400,15,14,1,6
7,2006,160400,24,23,1,2
8,2006,160400,18,17,1,0
9,2006,160400,24,23,1,3
10,2006,160400,22,21,1,1
11,2006,160400,22,21,1,1
12,2006,160400,23,21,2,2
1,2007,160400,18,17,1,1
2,2007,160400,9,8,1,4
3,2007,160400,14,13,1,1
4,2007,160400,14,13,1,4
5,2007,160400,24,24,0,5
6,2007,160400,24,21,3,6
7,2007,160400,28,23,5,1
8,2007,160400,34,30,4,7
9,2007,160400,22,22,0,5
10,2007,160400,32,30,2,2
11,2007,160400,28,25,3,3
12,2007,160400,20,19,1,3
1,2008,160400,23,20,3,6
2,2008,160400,14,10,4,6
3,2008,160400,27,21,6,3
4,2008,160400,13,12,1,0
5,2008,160400,16,15,1,2
6,2008,160400,24,24,0,4
7,2008,160400,29,28,1,1
8,2008,160400,28,27,1,8
9,2008,160400,15,14,1,5
10,2008,160400,18,15,3,2
11,2008,160400,7,6,1,7
12,2008,160400,21,20,1,1
1,2009,160400,22,21,1,6
2,2009,160400,13,12,1,4
3,2009,160400,24,24,0,2
4,2009,160400,20,19,1,1
5,2009,160400,24,22,2,1
6,2009,160400,15,15,0,4
7,2009,160400,16,14,2,3
8,2009,160400,23,21,2,1
9,2009,160400,22,20,2,4
10,2009,160400,23,23,0,2
11,2009,160400,22,21,1,2
12,2009,160400,12,10,2,0
1,2010,160400,16,13,3,7
2,2010,160400,11,9,2,3
3,2010,160400,18,14,4,3
4,2010,160400,21,21,0,3
5,2010,160400,14,14,0,2
6,2010,160400,16,15,1,3
7,2010,160400,18,18,0,5
8,2010,160400,23,22,1,5
9,2010,160400,21,19,2,7
10,2010,160400,9,8,1,3
11,2010,160400,17,14,3,1
12,2010,160400,24,22,2,2
1,2011,160400,20,18,2,5
2,2011,160400,16,16,0,3
1,1999,160502,11,11,0,1
2,1999,160502,21,21,0,3
3,1999,160502,15,12,3,3
4,1999,160502,28,25,3,3
5,1999,160502,19,15,4,4
6,1999,160502,29,25,4,3
7,1999,160502,17,14,3,3
8,1999,160502,24,22,2,2
9,1999,160502,13,12,1,2
10,1999,160502,17,17,0,3
11,1999,160502,18,16,2,0
12,1999,160502,25,22,3,2
1,2000,160502,18,16,2,5
2,2000,160502,15,14,1,2
3,2000,160502,12,12,0,4
4,2000,160502,13,13,0,3
5,2000,160502,15,13,2,3
6,2000,160502,21,16,5,2
7,2000,160502,16,13,3,5
8,2000,160502,22,21,1,1
9,2000,160502,23,20,3,5
10,2000,160502,18,15,3,1
11,2000,160502,26,23,3,1
12,2000,160502,14,13,1,3
1,2001,160502,22,21,1,3
2,2001,160502,13,12,1,1
3,2001,160502,19,17,2,1
4,2001,160502,13,12,1,3
5,2001,160502,20,18,2,5
6,2001,160502,16,15,1,0
7,2001,160502,11,11,0,2
8,2001,160502,13,9,4,0
9,2001,160502,17,13,4,2
10,2001,160502,13,13,0,0
11,2001,160502,16,14,2,2
12,2001,160502,16,15,1,0
1,2002,160502,19,18,1,0
2,2002,160502,10,9,1,2
3,2002,160502,11,10,1,3
4,2002,160502,10,6,4,2
5,2002,160502,14,13,1,2
6,2002,160502,12,12,0,0
7,2002,160502,23,19,4,0
8,2002,160502,15,12,3,3
9,2002,160502,15,13,2,0
10,2002,160502,23,20,3,4
11,2002,160502,14,13,1,1
12,2002,160502,13,13,0,1
1,2003,160502,8,7,1,2
2,2003,160502,12,12,0,5
3,2003,160502,14,12,2,5
4,2003,160502,12,12,0,0
5,2003,160502,19,17,2,3
6,2003,160502,20,18,2,1
7,2003,160502,23,18,5,3
8,2003,160502,20,20,0,1
9,2003,160502,14,12,2,1
10,2003,160502,22,20,2,2
11,2003,160502,9,8,1,3
12,2003,160502,12,12,0,3
1,2004,160502,15,13,2,4
2,2004,160502,18,17,1,2
3,2004,160502,22,22,0,0
4,2004,160502,9,6,3,0
5,2004,160502,15,13,2,3
6,2004,160502,8,6,2,0
7,2004,160502,14,11,3,1
8,2004,160502,17,16,1,2
9,2004,160502,17,14,3,2
10,2004,160502,17,15,2,7
11,2004,160502,18,18,0,3
12,2004,160502,14,11,3,2
1,2005,160502,8,8,0,2
2,2005,160502,21,18,3,2
3,2005,160502,15,14,1,5
4,2005,160502,18,18,0,10
5,2005,160502,12,12,0,5
6,2005,160502,10,9,1,5
7,2005,160502,18,13,5,2
8,2005,160502,14,14,0,3
9,2005,160502,17,17,0,3
10,2005,160502,13,13,0,5
11,2005,160502,6,5,1,0
12,2005,160502,2,1,1,0
1,2006,160502,15,15,0,2
2,2006,160502,7,7,0,0
3,2006,160502,6,6,0,1
4,2006,160502,17,16,1,1
5,2006,160502,14,13,1,2
6,2006,160502,12,11,1,1
7,2006,160502,21,19,2,2
8,2006,160502,14,13,1,2
9,2006,160502,8,8,0,2
10,2006,160502,9,7,2,2
11,2006,160502,11,10,1,2
12,2006,160502,10,9,1,1
1,2007,160502,11,9,2,2
2,2007,160502,8,6,2,1
3,2007,160502,6,6,0,1
4,2007,160502,5,3,2,1
5,2007,160502,7,7,0,1
6,2007,160502,10,8,2,0
7,2007,160502,10,9,1,6
8,2007,160502,11,10,1,1
9,2007,160502,14,14,0,0
10,2007,160502,11,11,0,0
11,2007,160502,21,18,3,0
12,2007,160502,11,10,1,1
1,2008,160502,12,12,0,1
2,2008,160502,11,10,1,0
3,2008,160502,11,10,1,1
4,2008,160502,13,13,0,0
5,2008,160502,8,8,0,0
6,2008,160502,12,11,1,3
7,2008,160502,17,17,0,2
8,2008,160502,12,11,1,1
9,2008,160502,13,11,2,1
10,2008,160502,17,16,1,4
11,2008,160502,17,15,2,1
12,2008,160502,7,7,0,1
1,2009,160502,5,5,0,2
2,2009,160502,9,9,0,4
3,2009,160502,17,15,2,2
4,2009,160502,24,24,0,4
5,2009,160502,18,17,1,1
6,2009,160502,16,11,5,3
7,2009,160502,15,14,1,0
8,2009,160502,14,12,2,1
9,2009,160502,15,15,0,4
10,2009,160502,14,13,1,2
11,2009,160502,20,18,2,1
12,2009,160502,10,10,0,2
1,2010,160502,14,13,1,5
2,2010,160502,13,11,2,2
3,2010,160502,11,9,2,3
4,2010,160502,10,7,3,2
5,2010,160502,9,8,1,3
6,2010,160502,15,14,1,3
7,2010,160502,12,11,1,4
8,2010,160502,19,16,3,2
9,2010,160502,11,10,1,2
10,2010,160502,15,14,1,5
11,2010,160502,6,6,0,5
12,2010,160502,9,9,0,0
1,2011,160502,9,9,0,2
2,2011,160502,5,5,0,4
1,1999,160602,26,24,2,4
2,1999,160602,12,11,1,0
3,1999,160602,12,12,0,1
4,1999,160602,14,14,0,6
5,1999,160602,17,15,2,3
6,1999,160602,16,13,3,2
7,1999,160602,13,12,1,2
8,1999,160602,19,17,2,1
9,1999,160602,14,14,0,2
10,1999,160602,10,10,0,1
11,1999,160602,19,18,1,2
12,1999,160602,10,9,1,3
1,2000,160602,15,13,2,5
2,2000,160602,8,8,0,1
3,2000,160602,17,16,1,3
4,2000,160602,12,10,2,4
5,2000,160602,5,5,0,3
6,2000,160602,11,11,0,0
7,2000,160602,12,10,2,0
8,2000,160602,18,18,0,0
9,2000,160602,11,10,1,3
10,2000,160602,12,10,2,3
11,2000,160602,8,6,2,2
12,2000,160602,11,11,0,0
1,2001,160602,13,11,2,1
2,2001,160602,11,9,2,2
3,2001,160602,11,11,0,4
4,2001,160602,12,9,3,4
5,2001,160602,14,13,1,5
6,2001,160602,9,7,2,1
7,2001,160602,16,13,3,2
8,2001,160602,12,11,1,2
9,2001,160602,13,11,2,0
10,2001,160602,15,14,1,2
11,2001,160602,9,8,1,1
12,2001,160602,16,16,0,1
1,2002,160602,9,8,1,2
2,2002,160602,12,12,0,0
3,2002,160602,14,14,0,0
4,2002,160602,12,11,1,1
5,2002,160602,6,6,0,0
6,2002,160602,10,8,2,0
7,2002,160602,20,18,2,1
8,2002,160602,12,10,2,2
9,2002,160602,10,10,0,1
10,2002,160602,15,14,1,1
11,2002,160602,9,9,0,1
12,2002,160602,14,12,2,0
1,2003,160602,12,12,0,0
2,2003,160602,9,9,0,1
3,2003,160602,9,7,2,0
4,2003,160602,6,6,0,2
5,2003,160602,3,3,0,0
6,2003,160602,10,9,1,2
7,2003,160602,9,9,0,0
8,2003,160602,16,14,2,1
9,2003,160602,5,4,1,1
10,2003,160602,10,9,1,2
11,2003,160602,10,10,0,1
12,2003,160602,11,10,1,1
1,2004,160602,13,13,0,6
2,2004,160602,10,9,1,3
3,2004,160602,4,3,1,1
4,2004,160602,5,5,0,0
5,2004,160602,10,10,0,2
6,2004,160602,14,14,0,0
7,2004,160602,16,14,2,2
8,2004,160602,10,10,0,0
9,2004,160602,14,14,0,2
10,2004,160602,7,6,1,2
11,2004,160602,14,13,1,2
12,2004,160602,21,21,0,0
1,2005,160602,6,6,0,3
2,2005,160602,7,7,0,1
3,2005,160602,16,14,2,2
4,2005,160602,12,11,1,2
5,2005,160602,6,6,0,0
6,2005,160602,8,7,1,0
7,2005,160602,9,9,0,2
8,2005,160602,11,10,1,2
9,2005,160602,8,5,3,1
10,2005,160602,10,10,0,0
11,2005,160602,6,5,1,2
12,2005,160602,10,10,0,0
1,2006,160602,10,10,0,3
2,2006,160602,10,9,1,2
3,2006,160602,7,7,0,2
4,2006,160602,11,10,1,0
5,2006,160602,16,14,2,0
6,2006,160602,11,10,1,3
7,2006,160602,12,12,0,1
8,2006,160602,6,6,0,0
9,2006,160602,14,14,0,0
10,2006,160602,6,6,0,0
11,2006,160602,9,8,1,1
12,2006,160602,11,11,0,0
1,2007,160602,4,4,0,1
2,2007,160602,3,3,0,0
3,2007,160602,4,4,0,2
4,2007,160602,4,4,0,0
5,2007,160602,12,9,3,0
6,2007,160602,10,8,2,0
7,2007,160602,15,13,2,3
8,2007,160602,10,10,0,3
9,2007,160602,9,9,0,1
10,2007,160602,4,2,2,1
11,2007,160602,6,6,0,0
12,2007,160602,12,11,1,2
1,2008,160602,9,9,0,3
2,2008,160602,10,9,1,0
3,2008,160602,12,11,1,0
4,2008,160602,21,20,1,0
5,2008,160602,10,10,0,0
6,2008,160602,14,11,3,0
7,2008,160602,17,16,1,1
8,2008,160602,6,5,1,1
9,2008,160602,10,9,1,0
10,2008,160602,10,10,0,0
11,2008,160602,3,3,0,0
12,2008,160602,9,8,1,2
1,2009,160602,9,8,1,2
2,2009,160602,6,5,1,0
3,2009,160602,12,12,0,0
4,2009,160602,11,11,0,0
5,2009,160602,9,9,0,2
6,2009,160602,10,8,2,0
7,2009,160602,6,6,0,2
8,2009,160602,8,7,1,1
9,2009,160602,13,13,0,1
10,2009,160602,6,5,1,0
11,2009,160602,10,10,0,0
12,2009,160602,10,9,1,1
1,2010,160602,9,9,0,0
2,2010,160602,4,4,0,1
3,2010,160602,12,12,0,2
4,2010,160602,13,12,1,1
5,2010,160602,15,13,2,1
6,2010,160602,11,9,2,1
7,2010,160602,22,22,0,1
8,2010,160602,13,9,4,1
9,2010,160602,13,13,0,1
10,2010,160602,5,5,0,2
11,2010,160602,8,8,0,0
12,2010,160602,4,4,0,3
1,2011,160602,11,10,1,1
2,2011,160602,3,3,0,0
1,1999,150200,20,19,1,2
2,1999,150200,19,16,3,4
3,1999,150200,26,24,2,3
4,1999,150200,24,22,2,0
5,1999,150200,27,26,1,3
6,1999,150200,34,33,1,2
7,1999,150200,23,23,0,1
8,1999,150200,21,21,0,8
9,1999,150200,29,26,3,1
10,1999,150200,20,17,3,2
11,1999,150200,17,15,2,6
12,1999,150200,28,25,3,2
1,2000,150200,17,16,1,4
2,2000,150200,18,18,0,4
3,2000,150200,21,19,2,1
4,2000,150200,12,10,2,1
5,2000,150200,25,21,4,1
6,2000,150200,37,33,4,3
7,2000,150200,22,20,2,6
8,2000,150200,15,14,1,6
9,2000,150200,32,29,3,2
10,2000,150200,15,14,1,4
11,2000,150200,21,19,2,3
12,2000,150200,21,20,1,0
1,2001,150200,35,29,6,4
2,2001,150200,22,22,0,0
3,2001,150200,16,13,3,1
4,2001,150200,8,8,0,6
5,2001,150200,17,16,1,3
6,2001,150200,17,15,2,2
7,2001,150200,19,17,2,0
8,2001,150200,26,22,4,3
9,2001,150200,21,19,2,2
10,2001,150200,23,22,1,4
11,2001,150200,13,13,0,2
12,2001,150200,20,17,3,3
1,2002,150200,20,19,1,3
2,2002,150200,25,24,1,2
3,2002,150200,16,14,2,5
4,2002,150200,25,24,1,7
5,2002,150200,16,14,2,3
6,2002,150200,30,28,2,0
7,2002,150200,24,24,0,1
8,2002,150200,22,19,3,2
9,2002,150200,24,23,1,2
10,2002,150200,28,25,3,0
11,2002,150200,24,22,2,1
12,2002,150200,14,13,1,0
1,2003,150200,14,14,0,4
2,2003,150200,27,26,1,0
3,2003,150200,19,18,1,3
4,2003,150200,11,10,1,6
5,2003,150200,16,15,1,5
6,2003,150200,22,22,0,15
7,2003,150200,16,15,1,4
8,2003,150200,17,16,1,6
9,2003,150200,13,10,3,1
10,2003,150200,22,21,1,4
11,2003,150200,20,17,3,7
12,2003,150200,27,26,1,8
1,2004,150200,11,9,2,8
2,2004,150200,17,16,1,1
3,2004,150200,17,15,2,6
4,2004,150200,13,10,3,7
5,2004,150200,17,14,3,3
6,2004,150200,21,20,1,0
7,2004,150200,23,21,2,3
8,2004,150200,21,19,2,5
9,2004,150200,18,16,2,6
10,2004,150200,21,18,3,3
11,2004,150200,15,14,1,3
12,2004,150200,15,15,0,2
1,2005,150200,11,9,2,3
2,2005,150200,11,11,0,6
3,2005,150200,20,19,1,2
4,2005,150200,19,16,3,3
5,2005,150200,15,15,0,7
6,2005,150200,29,28,1,4
7,2005,150200,15,14,1,0
8,2005,150200,20,17,3,6
9,2005,150200,17,16,1,3
10,2005,150200,27,26,1,1
11,2005,150200,13,12,1,3
12,2005,150200,17,16,1,0
1,2006,150200,15,15,0,3
2,2006,150200,17,16,1,2
3,2006,150200,11,11,0,0
4,2006,150200,12,11,1,3
5,2006,150200,15,14,1,3
6,2006,150200,15,14,1,4
7,2006,150200,16,15,1,2
8,2006,150200,27,27,0,3
9,2006,150200,17,17,0,2
10,2006,150200,23,23,0,4
11,2006,150200,23,22,1,0
12,2006,150200,20,19,1,3
1,2007,150200,16,14,2,1
2,2007,150200,9,9,0,1
3,2007,150200,13,11,2,5
4,2007,150200,15,13,2,2
5,2007,150200,14,14,0,1
6,2007,150200,17,16,1,3
7,2007,150200,30,27,3,1
8,2007,150200,13,9,4,5
9,2007,150200,24,23,1,1
10,2007,150200,16,16,0,3
11,2007,150200,12,9,3,4
12,2007,150200,16,15,1,2
1,2008,150200,16,15,1,5
2,2008,150200,9,9,0,5
3,2008,150200,13,12,1,3
4,2008,150200,14,13,1,1
5,2008,150200,9,8,1,3
6,2008,150200,24,22,2,1
7,2008,150200,17,17,0,0
8,2008,150200,15,15,0,2
9,2008,150200,27,24,3,1
10,2008,150200,16,16,0,4
11,2008,150200,19,16,3,4
12,2008,150200,17,16,1,3
1,2009,150200,17,16,1,3
2,2009,150200,16,16,0,4
3,2009,150200,15,15,0,1
4,2009,150200,16,15,1,2
5,2009,150200,13,12,1,3
6,2009,150200,16,14,2,2
7,2009,150200,31,29,2,1
8,2009,150200,20,20,0,2
9,2009,150200,20,19,1,0
10,2009,150200,11,10,1,7
11,2009,150200,12,12,0,4
12,2009,150200,16,15,1,4
1,2010,150200,16,15,1,2
2,2010,150200,25,24,1,4
3,2010,150200,9,7,2,0
4,2010,150200,17,16,1,6
5,2010,150200,14,12,2,3
6,2010,150200,19,18,1,3
7,2010,150200,15,15,0,2
8,2010,150200,24,22,2,3
9,2010,150200,25,22,3,3
10,2010,150200,14,14,0,4
11,2010,150200,21,17,4,2
12,2010,150200,9,9,0,1
1,2011,150200,12,12,0,2
2,2011,150200,6,6,0,3
1,1999,150300,26,24,2,4
2,1999,150300,14,14,0,7
3,1999,150300,32,32,0,10
4,1999,150300,35,34,1,9
5,1999,150300,36,33,3,8
6,1999,150300,27,26,1,15
7,1999,150300,41,37,4,10
8,1999,150300,36,33,3,16
9,1999,150300,28,26,2,62
10,1999,150300,18,17,1,7
11,1999,150300,18,16,2,12
12,1999,150300,25,24,1,6
1,2000,150300,14,12,2,7
2,2000,150300,25,21,4,8
3,2000,150300,24,23,1,4
4,2000,150300,20,18,2,2
5,2000,150300,19,18,1,1
6,2000,150300,32,31,1,2
7,2000,150300,30,30,0,6
8,2000,150300,31,28,3,7
9,2000,150300,34,34,0,7
10,2000,150300,27,22,5,5
11,2000,150300,31,29,2,14
12,2000,150300,18,16,2,15
1,2001,150300,17,14,3,9
2,2001,150300,18,18,0,2
3,2001,150300,17,16,1,3
4,2001,150300,25,23,2,8
5,2001,150300,16,12,4,13
6,2001,150300,33,32,1,14
7,2001,150300,25,24,1,14
8,2001,150300,45,42,3,4
9,2001,150300,25,24,1,6
10,2001,150300,27,26,1,5
11,2001,150300,27,24,3,7
12,2001,150300,17,16,1,3
1,2002,150300,25,24,1,4
2,2002,150300,7,7,0,4
3,2002,150300,26,24,2,6
4,2002,150300,21,20,1,2
5,2002,150300,24,23,1,6
6,2002,150300,30,28,2,2
7,2002,150300,37,33,4,6
8,2002,150300,32,32,0,6
9,2002,150300,16,14,2,6
10,2002,150300,28,27,1,3
11,2002,150300,31,29,2,11
12,2002,150300,16,15,1,4
1,2003,150300,16,15,1,5
2,2003,150300,18,17,1,9
3,2003,150300,20,17,3,9
4,2003,150300,11,10,1,5
5,2003,150300,23,22,1,13
6,2003,150300,30,29,1,5
7,2003,150300,28,28,0,3
8,2003,150300,29,28,1,4
9,2003,150300,26,26,0,11
10,2003,150300,32,28,4,7
11,2003,150300,19,18,1,10
12,2003,150300,12,11,1,9
1,2004,150300,14,14,0,2
2,2004,150300,18,17,1,1
3,2004,150300,14,14,0,3
4,2004,150300,15,15,0,3
5,2004,150300,19,18,1,1
6,2004,150300,35,33,2,3
7,2004,150300,26,25,1,2
8,2004,150300,24,23,1,6
9,2004,150300,22,21,1,5
10,2004,150300,23,22,1,6
11,2004,150300,20,19,1,4
12,2004,150300,19,19,0,5
1,2005,150300,12,12,0,2
2,2005,150300,18,18,0,3
3,2005,150300,11,10,1,4
4,2005,150300,23,21,2,4
5,2005,150300,21,18,3,9
6,2005,150300,23,22,1,4
7,2005,150300,31,31,0,8
8,2005,150300,21,20,1,5
9,2005,150300,30,29,1,6
10,2005,150300,19,18,1,3
11,2005,150300,21,19,2,6
12,2005,150300,18,16,2,3
1,2006,150300,16,15,1,4
2,2006,150300,13,13,0,2
3,2006,150300,16,15,1,3
4,2006,150300,16,16,0,8
5,2006,150300,16,16,0,5
6,2006,150300,24,23,1,4
7,2006,150300,29,28,1,2
8,2006,150300,31,31,0,7
9,2006,150300,19,18,1,7
10,2006,150300,10,10,0,2
11,2006,150300,14,13,1,2
12,2006,150300,13,12,1,5
1,2007,150300,24,23,1,10
2,2007,150300,9,9,0,1
3,2007,150300,13,11,2,6
4,2007,150300,14,12,2,6
5,2007,150300,19,17,2,5
6,2007,150300,22,21,1,2
7,2007,150300,28,26,2,3
8,2007,150300,18,17,1,5
9,2007,150300,18,18,0,5
10,2007,150300,18,17,1,1
11,2007,150300,22,21,1,3
12,2007,150300,19,18,1,3
1,2008,150300,15,14,1,4
2,2008,150300,11,11,0,2
3,2008,150300,21,21,0,3
4,2008,150300,25,22,3,4
5,2008,150300,28,25,3,1
6,2008,150300,20,20,0,5
7,2008,150300,25,22,3,5
8,2008,150300,24,24,0,5
9,2008,150300,17,16,1,7
10,2008,150300,25,23,2,3
11,2008,150300,20,20,0,7
12,2008,150300,18,18,0,0
1,2009,150300,11,10,1,1
2,2009,150300,16,15,1,4
3,2009,150300,25,22,3,4
4,2009,150300,12,10,2,6
5,2009,150300,15,14,1,6
6,2009,150300,22,19,3,1
7,2009,150300,37,35,2,4
8,2009,150300,23,23,0,3
9,2009,150300,19,18,1,3
10,2009,150300,22,21,1,8
11,2009,150300,22,22,0,4
12,2009,150300,16,16,0,3
1,2010,150300,13,10,3,1
2,2010,150300,11,11,0,3
3,2010,150300,12,10,2,2
4,2010,150300,26,26,0,4
5,2010,150300,15,13,2,4
6,2010,150300,27,25,2,2
7,2010,150300,26,24,2,3
8,2010,150300,12,12,0,4
9,2010,150300,19,18,1,2
10,2010,150300,20,17,3,7
11,2010,150300,15,14,1,2
12,2010,150300,12,12,0,1
1,2011,150300,14,13,1,4
2,2011,150300,8,8,0,3
1,1999,050300,4,4,0,0
2,1999,050300,7,7,0,1
3,1999,050300,6,6,0,0
4,1999,050300,7,7,0,0
5,1999,050300,12,12,0,1
6,1999,050300,10,10,0,0
7,1999,050300,6,6,0,1
8,1999,050300,12,12,0,0
9,1999,050300,13,13,0,0
10,1999,050300,11,9,2,1
11,1999,050300,7,5,2,0
12,1999,050300,8,7,1,1
1,2000,050300,9,7,2,0
2,2000,050300,11,10,1,1
3,2000,050300,4,2,2,2
4,2000,050300,7,7,0,3
5,2000,050300,9,9,0,0
6,2000,050300,6,6,0,1
7,2000,050300,15,15,0,0
8,2000,050300,12,10,2,1
9,2000,050300,13,11,2,1
10,2000,050300,11,10,1,0
11,2000,050300,6,6,0,2
12,2000,050300,7,6,1,0
1,2001,050300,3,3,0,0
2,2001,050300,10,10,0,1
3,2001,050300,3,2,1,0
4,2001,050300,8,7,1,3
5,2001,050300,8,8,0,0
6,2001,050300,11,9,2,0
7,2001,050300,9,9,0,0
8,2001,050300,13,11,2,1
9,2001,050300,8,7,1,2
10,2001,050300,7,7,0,0
11,2001,050300,13,13,0,0
12,2001,050300,4,4,0,0
1,2002,050300,12,11,1,0
2,2002,050300,9,9,0,2
3,2002,050300,10,10,0,0
4,2002,050300,9,9,0,0
5,2002,050300,4,3,1,0
6,2002,050300,7,7,0,0
7,2002,050300,11,10,1,3
8,2002,050300,4,4,0,1
9,2002,050300,9,8,1,0
10,2002,050300,9,8,1,0
11,2002,050300,3,3,0,0
12,2002,050300,8,5,3,0
1,2003,050300,8,8,0,1
2,2003,050300,6,5,1,2
3,2003,050300,9,8,1,2
4,2003,050300,8,8,0,0
5,2003,050300,3,3,0,1
6,2003,050300,10,10,0,0
7,2003,050300,5,5,0,0
8,2003,050300,6,6,0,1
9,2003,050300,5,5,0,2
10,2003,050300,6,4,2,1
11,2003,050300,7,7,0,0
12,2003,050300,12,10,2,1
1,2004,050300,3,2,1,0
2,2004,050300,4,4,0,0
3,2004,050300,8,7,1,0
4,2004,050300,5,5,0,4
5,2004,050300,7,7,0,0
6,2004,050300,13,11,2,1
7,2004,050300,7,7,0,1
8,2004,050300,9,9,0,1
9,2004,050300,7,7,0,1
10,2004,050300,9,9,0,6
11,2004,050300,6,6,0,0
12,2004,050300,6,6,0,0
1,2005,050300,6,6,0,1
2,2005,050300,5,5,0,1
3,2005,050300,9,9,0,1
4,2005,050300,7,7,0,0
5,2005,050300,3,3,0,1
6,2005,050300,7,7,0,0
7,2005,050300,11,11,0,0
8,2005,050300,6,5,1,2
9,2005,050300,9,9,0,0
10,2005,050300,3,3,0,0
11,2005,050300,10,10,0,0
12,2005,050300,8,7,1,0
1,2006,050300,6,6,0,1
2,2006,050300,4,4,0,0
3,2006,050300,10,10,0,2
4,2006,050300,10,10,0,1
5,2006,050300,7,7,0,2
6,2006,050300,7,7,0,0
7,2006,050300,4,3,1,1
8,2006,050300,13,11,2,1
9,2006,050300,10,9,1,1
10,2006,050300,6,5,1,1
11,2006,050300,7,7,0,1
12,2006,050300,6,6,0,5
1,2007,050300,7,7,0,1
2,2007,050300,2,2,0,0
3,2007,050300,4,4,0,0
4,2007,050300,6,6,0,0
5,2007,050300,9,8,1,1
6,2007,050300,6,6,0,0
7,2007,050300,6,6,0,1
8,2007,050300,8,8,0,1
9,2007,050300,10,10,0,1
10,2007,050300,9,9,0,2
11,2007,050300,11,10,1,1
12,2007,050300,5,4,1,2
1,2008,050300,8,7,1,0
2,2008,050300,0,0,0,1
3,2008,050300,5,5,0,0
4,2008,050300,4,4,0,1
5,2008,050300,7,7,0,0
6,2008,050300,6,6,0,0
7,2008,050300,6,6,0,1
8,2008,050300,11,10,1,2
9,2008,050300,9,9,0,0
10,2008,050300,13,13,0,0
11,2008,050300,6,5,1,0
12,2008,050300,4,4,0,0
1,2009,050300,5,4,1,0
2,2009,050300,4,4,0,0
3,2009,050300,6,5,1,0
4,2009,050300,4,4,0,0
5,2009,050300,6,6,0,0
6,2009,050300,2,2,0,0
7,2009,050300,10,9,1,3
8,2009,050300,18,18,0,2
9,2009,050300,6,6,0,0
10,2009,050300,9,9,0,1
11,2009,050300,3,3,0,3
12,2009,050300,5,5,0,0
1,2010,050300,2,2,0,1
2,2010,050300,7,7,0,3
3,2010,050300,3,3,0,3
4,2010,050300,9,9,0,3
5,2010,050300,2,2,0,2
6,2010,050300,4,4,0,2
7,2010,050300,6,5,1,2
8,2010,050300,5,5,0,0
9,2010,050300,7,7,0,0
10,2010,050300,5,5,0,1
11,2010,050300,3,3,0,0
12,2010,050300,4,4,0,1
1,2011,050300,4,4,0,0
2,2011,050300,5,5,0,0
1,1999,050200,16,15,1,0
2,1999,050200,17,17,0,1
3,1999,050200,18,16,2,0
4,1999,050200,18,17,1,1
5,1999,050200,15,15,0,0
6,1999,050200,20,15,5,3
7,1999,050200,18,17,1,1
8,1999,050200,30,29,1,4
9,1999,050200,19,18,1,1
10,1999,050200,24,20,4,2
11,1999,050200,19,18,1,2
12,1999,050200,15,12,3,3
1,2000,050200,12,12,0,1
2,2000,050200,4,4,0,1
3,2000,050200,9,9,0,1
4,2000,050200,16,14,2,1
5,2000,050200,15,14,1,3
6,2000,050200,16,15,1,2
7,2000,050200,16,14,2,4
8,2000,050200,19,18,1,1
9,2000,050200,18,17,1,1
10,2000,050200,11,10,1,4
11,2000,050200,16,16,0,0
12,2000,050200,7,7,0,0
1,2001,050200,18,17,1,0
2,2001,050200,13,10,3,0
3,2001,050200,15,15,0,0
4,2001,050200,10,9,1,1
5,2001,050200,11,11,0,0
6,2001,050200,19,16,3,1
7,2001,050200,13,13,0,0
8,2001,050200,15,12,3,1
9,2001,050200,20,17,3,0
10,2001,050200,18,17,1,2
11,2001,050200,20,20,0,2
12,2001,050200,21,21,0,1
1,2002,050200,11,10,1,1
2,2002,050200,21,21,0,1
3,2002,050200,13,13,0,1
4,2002,050200,10,9,1,2
5,2002,050200,18,18,0,0
6,2002,050200,16,15,1,0
7,2002,050200,17,17,0,1
8,2002,050200,19,19,0,0
9,2002,050200,18,17,1,0
10,2002,050200,14,13,1,1
11,2002,050200,14,12,2,0
12,2002,050200,19,15,4,0
1,2003,050200,14,14,0,1
2,2003,050200,13,12,1,1
3,2003,050200,12,10,2,2
4,2003,050200,12,12,0,3
5,2003,050200,12,12,0,0
6,2003,050200,16,16,0,1
7,2003,050200,17,14,3,0
8,2003,050200,21,20,1,2
9,2003,050200,19,18,1,0
10,2003,050200,11,11,0,0
11,2003,050200,16,16,0,0
12,2003,050200,16,16,0,0
1,2004,050200,9,8,1,0
2,2004,050200,6,6,0,0
3,2004,050200,13,13,0,0
4,2004,050200,17,16,1,0
5,2004,050200,12,12,0,1
6,2004,050200,10,10,0,0
7,2004,050200,27,26,1,2
8,2004,050200,16,16,0,0
9,2004,050200,15,15,0,0
10,2004,050200,29,29,0,1
11,2004,050200,22,22,0,0
12,2004,050200,21,21,0,2
1,2005,050200,13,11,2,0
2,2005,050200,13,12,1,1
3,2005,050200,17,15,2,1
4,2005,050200,14,13,1,0
5,2005,050200,17,17,0,1
6,2005,050200,19,18,1,0
7,2005,050200,9,8,1,2
8,2005,050200,16,15,1,0
9,2005,050200,15,15,0,0
10,2005,050200,23,22,1,0
11,2005,050200,25,24,1,2
12,2005,050200,18,17,1,2
1,2006,050200,12,11,1,2
2,2006,050200,11,11,0,2
3,2006,050200,14,13,1,0
4,2006,050200,16,16,0,0
5,2006,050200,14,12,2,1
6,2006,050200,9,9,0,0
7,2006,050200,24,21,3,2
8,2006,050200,17,17,0,1
9,2006,050200,11,11,0,1
10,2006,050200,15,15,0,0
11,2006,050200,13,12,1,0
12,2006,050200,10,10,0,0
1,2007,050200,11,11,0,1
2,2007,050200,4,4,0,0
3,2007,050200,9,9,0,0
4,2007,050200,13,13,0,0
5,2007,050200,18,17,1,1
6,2007,050200,14,13,1,0
7,2007,050200,14,14,0,2
8,2007,050200,12,12,0,0
9,2007,050200,15,15,0,0
10,2007,050200,15,14,1,4
11,2007,050200,10,9,1,2
12,2007,050200,7,7,0,1
1,2008,050200,12,11,1,0
2,2008,050200,13,13,0,1
3,2008,050200,7,6,1,0
4,2008,050200,8,8,0,1
5,2008,050200,8,8,0,0
6,2008,050200,13,12,1,1
7,2008,050200,14,14,0,0
8,2008,050200,19,19,0,0
9,2008,050200,25,24,1,0
10,2008,050200,23,23,0,1
11,2008,050200,14,14,0,1
12,2008,050200,18,18,0,0
1,2009,050200,7,6,1,0
2,2009,050200,12,12,0,0
3,2009,050200,10,10,0,1
4,2009,050200,13,13,0,1
5,2009,050200,21,20,1,1
6,2009,050200,9,9,0,0
7,2009,050200,15,14,1,0
8,2009,050200,24,24,0,0
9,2009,050200,28,28,0,2
10,2009,050200,17,16,1,0
11,2009,050200,6,6,0,0
12,2009,050200,13,13,0,1
1,2010,050200,12,12,0,1
2,2010,050200,15,13,2,0
3,2010,050200,7,7,0,0
4,2010,050200,11,10,1,0
5,2010,050200,12,12,0,0
6,2010,050200,16,16,0,0
7,2010,050200,13,13,0,0
8,2010,050200,16,16,0,0
9,2010,050200,20,19,1,0
10,2010,050200,14,11,3,2
11,2010,050200,15,15,0,0
12,2010,050200,8,8,0,0
1,2011,050200,8,7,1,1
2,2011,050200,5,3,2,1
1,1999,050100,9,9,0,0
2,1999,050100,5,5,0,0
3,1999,050100,4,3,1,1
4,1999,050100,5,5,0,0
5,1999,050100,7,6,1,2
6,1999,050100,17,17,0,0
7,1999,050100,9,9,0,0
8,1999,050100,14,13,1,0
9,1999,050100,12,12,0,0
10,1999,050100,8,8,0,2
11,1999,050100,7,6,1,0
12,1999,050100,12,12,0,1
1,2000,050100,7,7,0,2
2,2000,050100,8,8,0,0
3,2000,050100,10,10,0,0
4,2000,050100,3,2,1,0
5,2000,050100,5,5,0,1
6,2000,050100,4,3,1,1
7,2000,050100,8,6,2,0
8,2000,050100,9,8,1,0
9,2000,050100,10,9,1,0
10,2000,050100,8,7,1,0
11,2000,050100,6,4,2,0
12,2000,050100,11,11,0,0
1,2001,050100,10,10,0,0
2,2001,050100,5,4,1,1
3,2001,050100,9,9,0,0
4,2001,050100,7,6,1,1
5,2001,050100,7,6,1,0
6,2001,050100,10,9,1,2
7,2001,050100,9,9,0,0
8,2001,050100,5,5,0,0
9,2001,050100,7,6,1,1
10,2001,050100,10,10,0,0
11,2001,050100,6,6,0,0
12,2001,050100,15,15,0,0
1,2002,050100,9,8,1,2
2,2002,050100,5,5,0,5
3,2002,050100,10,9,1,0
4,2002,050100,13,13,0,1
5,2002,050100,7,7,0,0
6,2002,050100,4,4,0,0
7,2002,050100,12,12,0,0
8,2002,050100,5,5,0,2
9,2002,050100,8,8,0,0
10,2002,050100,8,7,1,0
11,2002,050100,7,7,0,3
12,2002,050100,9,9,0,1
1,2003,050100,12,12,0,2
2,2003,050100,6,4,2,0
3,2003,050100,8,7,1,0
4,2003,050100,14,14,0,2
5,2003,050100,11,11,0,2
6,2003,050100,9,9,0,3
7,2003,050100,16,15,1,0
8,2003,050100,9,9,0,0
9,2003,050100,15,13,2,1
10,2003,050100,16,15,1,1
11,2003,050100,14,14,0,0
12,2003,050100,11,11,0,0
1,2004,050100,10,10,0,1
2,2004,050100,6,6,0,1
3,2004,050100,7,7,0,0
4,2004,050100,8,8,0,0
5,2004,050100,8,8,0,0
6,2004,050100,6,6,0,2
7,2004,050100,19,19,0,0
8,2004,050100,11,10,1,1
9,2004,050100,8,7,1,1
10,2004,050100,10,10,0,0
11,2004,050100,12,12,0,0
12,2004,050100,5,5,0,0
1,2005,050100,3,3,0,1
2,2005,050100,4,4,0,1
3,2005,050100,5,5,0,6
4,2005,050100,9,9,0,1
5,2005,050100,12,12,0,0
6,2005,050100,4,3,1,0
7,2005,050100,5,5,0,2
8,2005,050100,6,6,0,0
9,2005,050100,9,9,0,1
10,2005,050100,5,5,0,0
11,2005,050100,8,8,0,0
12,2005,050100,4,4,0,0
1,2006,050100,13,13,0,0
2,2006,050100,15,14,1,1
3,2006,050100,14,13,1,0
4,2006,050100,11,11,0,1
5,2006,050100,10,10,0,0
6,2006,050100,14,14,0,2
7,2006,050100,12,11,1,1
8,2006,050100,7,7,0,1
9,2006,050100,8,8,0,0
10,2006,050100,7,7,0,0
11,2006,050100,3,3,0,1
12,2006,050100,5,5,0,1
1,2007,050100,8,7,1,0
2,2007,050100,4,4,0,0
3,2007,050100,3,2,1,1
4,2007,050100,7,6,1,0
5,2007,050100,9,9,0,1
6,2007,050100,9,8,1,0
7,2007,050100,14,12,2,1
8,2007,050100,10,10,0,0
9,2007,050100,12,12,0,1
10,2007,050100,6,5,1,0
11,2007,050100,4,3,1,0
12,2007,050100,3,3,0,0
1,2008,050100,6,6,0,0
2,2008,050100,6,6,0,0
3,2008,050100,4,4,0,0
4,2008,050100,2,2,0,0
5,2008,050100,7,7,0,0
6,2008,050100,2,2,0,0
7,2008,050100,10,10,0,0
8,2008,050100,10,10,0,0
9,2008,050100,9,9,0,0
10,2008,050100,12,12,0,1
11,2008,050100,11,11,0,0
12,2008,050100,11,11,0,0
1,2009,050100,5,5,0,0
2,2009,050100,6,6,0,0
3,2009,050100,8,8,0,0
4,2009,050100,7,7,0,1
5,2009,050100,18,15,3,1
6,2009,050100,5,5,0,0
7,2009,050100,11,11,0,0
8,2009,050100,11,11,0,0
9,2009,050100,14,14,0,0
10,2009,050100,11,10,1,0
11,2009,050100,7,7,0,0
12,2009,050100,8,8,0,1
1,2010,050100,8,8,0,0
2,2010,050100,5,5,0,1
3,2010,050100,8,8,0,1
4,2010,050100,7,6,1,2
5,2010,050100,11,11,0,2
6,2010,050100,11,11,0,0
7,2010,050100,10,10,0,0
8,2010,050100,9,9,0,0
9,2010,050100,12,11,1,1
10,2010,050100,4,4,0,0
11,2010,050100,6,6,0,0
12,2010,050100,5,5,0,0
1,2011,050100,6,6,0,0
2,2011,050100,4,4,0,0
1,1999,060200,8,8,0,1
2,1999,060200,8,8,0,0
3,1999,060200,9,7,2,2
4,1999,060200,10,8,2,1
5,1999,060200,8,7,1,0
6,1999,060200,9,8,1,0
7,1999,060200,10,9,1,0
8,1999,060200,17,17,0,0
9,1999,060200,16,16,0,2
10,1999,060200,9,9,0,0
11,1999,060200,8,5,3,2
12,1999,060200,13,13,0,0
1,2000,060200,8,8,0,2
2,2000,060200,8,8,0,0
3,2000,060200,5,4,1,0
4,2000,060200,4,4,0,2
5,2000,060200,8,8,0,1
6,2000,060200,12,10,2,1
7,2000,060200,16,14,2,1
8,2000,060200,12,11,1,0
9,2000,060200,10,10,0,5
10,2000,060200,9,7,2,1
11,2000,060200,7,7,0,1
12,2000,060200,6,5,1,0
1,2001,060200,6,6,0,2
2,2001,060200,7,5,2,0
3,2001,060200,14,12,2,1
4,2001,060200,7,7,0,4
5,2001,060200,13,11,2,3
6,2001,060200,12,12,0,0
7,2001,060200,17,15,2,0
8,2001,060200,6,6,0,0
9,2001,060200,17,16,1,3
10,2001,060200,16,15,1,4
11,2001,060200,10,9,1,0
12,2001,060200,8,6,2,3
1,2002,060200,8,8,0,2
2,2002,060200,14,14,0,2
3,2002,060200,17,17,0,1
4,2002,060200,11,11,0,1
5,2002,060200,9,9,0,1
6,2002,060200,13,13,0,0
7,2002,060200,15,15,0,1
8,2002,060200,12,11,1,1
9,2002,060200,7,7,0,0
10,2002,060200,11,10,1,1
11,2002,060200,10,10,0,0
12,2002,060200,5,5,0,0
1,2003,060200,12,11,1,1
2,2003,060200,10,10,0,1
3,2003,060200,17,17,0,0
4,2003,060200,11,10,1,2
5,2003,060200,8,7,1,0
6,2003,060200,10,10,0,0
7,2003,060200,12,12,0,0
8,2003,060200,14,14,0,0
9,2003,060200,15,15,0,0
10,2003,060200,13,12,1,0
11,2003,060200,14,14,0,0
12,2003,060200,5,5,0,2
1,2004,060200,10,8,2,3
2,2004,060200,8,8,0,0
3,2004,060200,8,6,2,0
4,2004,060200,14,14,0,0
5,2004,060200,8,7,1,1
6,2004,060200,8,8,0,0
7,2004,060200,13,12,1,0
8,2004,060200,9,9,0,2
9,2004,060200,16,15,1,1
10,2004,060200,13,13,0,0
11,2004,060200,6,6,0,0
12,2004,060200,11,10,1,2
1,2005,060200,6,6,0,0
2,2005,060200,11,10,1,2
3,2005,060200,12,11,1,1
4,2005,060200,13,12,1,1
5,2005,060200,16,16,0,0
6,2005,060200,7,7,0,0
7,2005,060200,7,7,0,0
8,2005,060200,9,8,1,1
9,2005,060200,13,13,0,1
10,2005,060200,11,10,1,1
11,2005,060200,6,6,0,1
12,2005,060200,9,9,0,1
1,2006,060200,8,8,0,0
2,2006,060200,6,6,0,1
3,2006,060200,12,12,0,2
4,2006,060200,5,5,0,1
5,2006,060200,8,8,0,0
6,2006,060200,8,7,1,0
7,2006,060200,6,6,0,0
8,2006,060200,7,7,0,1
9,2006,060200,6,3,3,0
10,2006,060200,9,9,0,2
11,2006,060200,8,8,0,0
12,2006,060200,8,7,1,0
1,2007,060200,10,10,0,0
2,2007,060200,8,8,0,1
3,2007,060200,11,11,0,0
4,2007,060200,5,4,1,1
5,2007,060200,6,6,0,0
6,2007,060200,5,5,0,0
7,2007,060200,6,6,0,0
8,2007,060200,9,9,0,2
9,2007,060200,8,8,0,0
10,2007,060200,13,12,1,0
11,2007,060200,11,11,0,1
12,2007,060200,7,6,1,1
1,2008,060200,5,5,0,0
2,2008,060200,7,7,0,0
3,2008,060200,10,10,0,0
4,2008,060200,8,7,1,1
5,2008,060200,9,8,1,1
6,2008,060200,10,10,0,0
7,2008,060200,8,8,0,0
8,2008,060200,10,10,0,0
9,2008,060200,19,17,2,0
10,2008,060200,14,14,0,1
11,2008,060200,6,6,0,1
12,2008,060200,12,12,0,0
1,2009,060200,6,5,1,1
2,2009,060200,7,7,0,0
3,2009,060200,6,6,0,0
4,2009,060200,10,10,0,2
5,2009,060200,4,4,0,1
6,2009,060200,5,4,1,0
7,2009,060200,7,7,0,0
8,2009,060200,7,7,0,0
9,2009,060200,7,7,0,1
10,2009,060200,8,8,0,2
11,2009,060200,7,7,0,2
12,2009,060200,3,3,0,2
1,2010,060200,6,4,2,1
2,2010,060200,5,3,2,1
3,2010,060200,10,9,1,5
4,2010,060200,9,9,0,4
5,2010,060200,5,5,0,1
6,2010,060200,7,6,1,0
7,2010,060200,8,8,0,0
8,2010,060200,20,19,1,1
9,2010,060200,9,8,1,2
10,2010,060200,12,12,0,5
11,2010,060200,7,7,0,3
12,2010,060200,19,19,0,1
1,2011,060200,12,11,1,2
2,2011,060200,6,6,0,3
1,1999,060100,10,10,0,0
2,1999,060100,6,4,2,0
3,1999,060100,3,3,0,0
4,1999,060100,6,6,0,0
5,1999,060100,8,8,0,0
6,1999,060100,12,11,1,0
7,1999,060100,12,12,0,0
8,1999,060100,18,18,0,0
9,1999,060100,11,11,0,1
10,1999,060100,13,13,0,0
11,1999,060100,10,10,0,1
12,1999,060100,13,12,1,0
1,2000,060100,9,9,0,0
2,2000,060100,5,5,0,1
3,2000,060100,15,15,0,2
4,2000,060100,8,8,0,0
5,2000,060100,7,7,0,0
6,2000,060100,14,14,0,1
7,2000,060100,13,12,1,2
8,2000,060100,11,9,2,0
9,2000,060100,6,5,1,0
10,2000,060100,9,9,0,1
11,2000,060100,3,2,1,0
12,2000,060100,3,3,0,1
1,2001,060100,8,7,1,1
2,2001,060100,6,6,0,1
3,2001,060100,6,6,0,0
4,2001,060100,12,11,1,0
5,2001,060100,9,9,0,0
6,2001,060100,4,4,0,0
7,2001,060100,10,9,1,1
8,2001,060100,6,6,0,0
9,2001,060100,9,9,0,0
10,2001,060100,4,4,0,2
11,2001,060100,7,7,0,0
12,2001,060100,2,2,0,0
1,2002,060100,7,7,0,1
2,2002,060100,3,2,1,0
3,2002,060100,3,3,0,0
4,2002,060100,20,20,0,1
5,2002,060100,12,12,0,0
6,2002,060100,4,4,0,0
7,2002,060100,11,11,0,0
8,2002,060100,10,9,1,0
9,2002,060100,8,8,0,0
10,2002,060100,4,4,0,0
11,2002,060100,8,8,0,0
12,2002,060100,7,6,1,0
1,2003,060100,6,6,0,2
2,2003,060100,6,6,0,1
3,2003,060100,2,2,0,0
4,2003,060100,6,5,1,0
5,2003,060100,4,4,0,0
6,2003,060100,5,5,0,2
7,2003,060100,8,8,0,0
8,2003,060100,12,11,1,1
9,2003,060100,4,4,0,0
10,2003,060100,9,9,0,1
11,2003,060100,3,2,1,0
12,2003,060100,9,9,0,0
1,2004,060100,8,8,0,0
2,2004,060100,4,4,0,2
3,2004,060100,6,5,1,1
4,2004,060100,13,13,0,0
5,2004,060100,8,7,1,0
6,2004,060100,5,4,1,2
7,2004,060100,8,8,0,0
8,2004,060100,11,11,0,0
9,2004,060100,7,7,0,0
10,2004,060100,5,3,2,0
11,2004,060100,7,7,0,0
12,2004,060100,7,7,0,0
1,2005,060100,3,2,1,0
2,2005,060100,5,5,0,0
3,2005,060100,1,1,0,0
4,2005,060100,6,6,0,1
5,2005,060100,15,15,0,0
6,2005,060100,11,9,2,0
7,2005,060100,7,7,0,0
8,2005,060100,7,7,0,2
9,2005,060100,9,9,0,0
10,2005,060100,6,5,1,0
11,2005,060100,7,7,0,0
12,2005,060100,2,2,0,1
1,2006,060100,6,5,1,0
2,2006,060100,4,4,0,0
3,2006,060100,7,5,2,0
4,2006,060100,11,11,0,2
5,2006,060100,4,4,0,1
6,2006,060100,6,6,0,0
7,2006,060100,10,10,0,0
8,2006,060100,11,10,1,0
9,2006,060100,10,10,0,1
10,2006,060100,12,12,0,0
11,2006,060100,4,4,0,0
12,2006,060100,5,5,0,0
1,2007,060100,3,3,0,1
2,2007,060100,3,2,1,0
3,2007,060100,4,4,0,0
4,2007,060100,4,4,0,1
5,2007,060100,4,4,0,0
6,2007,060100,4,4,0,1
7,2007,060100,4,4,0,0
8,2007,060100,6,5,1,0
9,2007,060100,6,5,1,0
10,2007,060100,8,8,0,0
11,2007,060100,4,4,0,1
12,2007,060100,6,6,0,0
1,2008,060100,5,5,0,0
2,2008,060100,0,0,0,0
3,2008,060100,6,6,0,0
4,2008,060100,4,2,2,1
5,2008,060100,13,12,1,0
6,2008,060100,9,8,1,0
7,2008,060100,11,11,0,0
8,2008,060100,10,9,1,0
9,2008,060100,12,12,0,0
10,2008,060100,14,14,0,0
11,2008,060100,4,4,0,0
12,2008,060100,6,6,0,0
1,2009,060100,10,10,0,0
2,2009,060100,6,6,0,1
3,2009,060100,7,7,0,0
4,2009,060100,1,1,0,0
5,2009,060100,6,6,0,0
6,2009,060100,10,10,0,0
7,2009,060100,10,10,0,1
8,2009,060100,8,8,0,0
9,2009,060100,7,7,0,0
10,2009,060100,5,5,0,2
11,2009,060100,7,7,0,0
12,2009,060100,6,6,0,0
1,2010,060100,7,7,0,0
2,2010,060100,0,0,0,0
3,2010,060100,0,0,0,1
4,2010,060100,7,7,0,0
5,2010,060100,5,5,0,1
6,2010,060100,5,5,0,0
7,2010,060100,3,3,0,0
8,2010,060100,20,20,0,0
9,2010,060100,11,11,0,1
10,2010,060100,7,6,1,0
11,2010,060100,3,3,0,1
12,2010,060100,4,4,0,0
1,2011,060100,9,9,0,0
2,2011,060100,3,3,0,0
1,1999,830700,64,57,7,42
2,1999,830700,57,47,10,39
3,1999,830700,54,45,9,22
4,1999,830700,50,47,3,26
5,1999,830700,80,71,9,18
6,1999,830700,72,59,13,16
7,1999,830700,78,68,10,23
8,1999,830700,66,55,11,25
9,1999,830700,61,53,8,18
10,1999,830700,63,52,11,18
11,1999,830700,53,43,10,33
12,1999,830700,58,52,6,21
1,2000,830700,44,39,5,20
2,2000,830700,39,34,5,44
3,2000,830700,53,46,7,22
4,2000,830700,56,46,10,29
5,2000,830700,49,42,7,14
6,2000,830700,49,41,8,38
7,2000,830700,64,56,8,25
8,2000,830700,53,46,7,26
9,2000,830700,42,32,10,19
10,2000,830700,47,37,10,26
11,2000,830700,52,42,10,22
12,2000,830700,41,30,11,22
1,2001,830700,58,48,10,30
2,2001,830700,46,42,4,19
3,2001,830700,50,42,8,23
4,2001,830700,54,47,7,24
5,2001,830700,38,35,3,25
6,2001,830700,44,35,9,39
7,2001,830700,68,58,10,29
8,2001,830700,64,52,12,16
9,2001,830700,63,54,9,16
10,2001,830700,69,64,5,18
11,2001,830700,50,45,5,21
12,2001,830700,32,29,3,29
1,2002,830700,39,35,4,33
2,2002,830700,33,30,3,38
3,2002,830700,45,36,9,41
4,2002,830700,59,55,4,33
5,2002,830700,52,41,11,26
6,2002,830700,44,37,7,37
7,2002,830700,60,48,12,26
8,2002,830700,59,53,6,16
9,2002,830700,59,50,9,16
10,2002,830700,55,42,13,31
11,2002,830700,52,46,6,31
12,2002,830700,45,36,9,23
1,2003,830700,39,37,2,26
2,2003,830700,32,27,5,23
3,2003,830700,42,34,8,26
4,2003,830700,31,22,9,52
5,2003,830700,41,34,7,44
6,2003,830700,40,33,7,48
7,2003,830700,36,34,2,34
8,2003,830700,44,37,7,28
9,2003,830700,40,37,3,27
10,2003,830700,53,43,10,21
11,2003,830700,37,31,6,32
12,2003,830700,25,22,3,57
1,2004,830700,29,27,2,31
2,2004,830700,33,31,2,26
3,2004,830700,39,35,4,34
4,2004,830700,35,30,5,33
5,2004,830700,60,56,4,19
6,2004,830700,41,32,9,31
7,2004,830700,37,36,1,24
8,2004,830700,48,45,3,19
9,2004,830700,49,43,6,4
10,2004,830700,60,58,2,15
11,2004,830700,45,38,7,13
12,2004,830700,42,35,7,18
1,2005,830700,45,41,4,15
2,2005,830700,26,21,5,33
3,2005,830700,33,30,3,20
4,2005,830700,65,61,4,31
5,2005,830700,56,53,3,25
6,2005,830700,24,22,2,26
7,2005,830700,53,47,6,24
8,2005,830700,56,47,9,39
9,2005,830700,50,48,2,29
10,2005,830700,64,52,12,36
11,2005,830700,42,39,3,20
12,2005,830700,35,31,4,23
1,2006,830700,28,22,6,17
2,2006,830700,30,26,4,21
3,2006,830700,43,40,3,32
4,2006,830700,25,21,4,28
5,2006,830700,48,41,7,32
6,2006,830700,36,33,3,30
7,2006,830700,43,33,10,25
8,2006,830700,58,53,5,25
9,2006,830700,54,50,4,38
10,2006,830700,35,33,2,29
11,2006,830700,35,34,1,30
12,2006,830700,34,32,2,28
1,2007,830700,41,36,5,35
2,2007,830700,29,25,4,25
3,2007,830700,34,29,5,12
4,2007,830700,39,36,3,24
5,2007,830700,41,35,6,16
6,2007,830700,36,32,4,18
7,2007,830700,39,36,3,26
8,2007,830700,32,29,3,26
9,2007,830700,41,35,6,26
10,2007,830700,37,34,3,26
11,2007,830700,30,28,2,27
12,2007,830700,43,37,6,23
1,2008,830700,38,32,6,14
2,2008,830700,28,25,3,15
3,2008,830700,39,36,3,22
4,2008,830700,40,34,6,15
5,2008,830700,41,35,6,20
6,2008,830700,43,39,4,19
7,2008,830700,48,44,4,12
8,2008,830700,36,31,5,16
9,2008,830700,46,39,7,14
10,2008,830700,43,39,4,27
11,2008,830700,34,31,3,34
12,2008,830700,34,29,5,13
1,2009,830700,37,37,0,17
2,2009,830700,23,22,1,23
3,2009,830700,37,32,5,19
4,2009,830700,27,21,6,30
5,2009,830700,35,33,2,21
6,2009,830700,33,28,5,22
7,2009,830700,49,39,10,22
8,2009,830700,50,47,3,25
9,2009,830700,38,32,6,30
10,2009,830700,32,28,4,20
11,2009,830700,22,20,2,20
12,2009,830700,31,30,1,30
1,2010,830700,43,41,2,26
2,2010,830700,27,24,3,29
3,2010,830700,45,38,7,29
4,2010,830700,29,28,1,19
5,2010,830700,48,43,5,13
6,2010,830700,33,30,3,16
7,2010,830700,42,38,4,16
8,2010,830700,45,42,3,12
9,2010,830700,49,39,10,19
10,2010,830700,37,31,6,19
11,2010,830700,39,37,2,17
12,2010,830700,37,36,1,15
1,2011,830700,36,33,3,27
2,2011,830700,17,15,2,17
1,1999,160300,8,6,2,0
2,1999,160300,7,7,0,0
3,1999,160300,10,7,3,0
4,1999,160300,8,8,0,1
5,1999,160300,12,9,3,1
6,1999,160300,17,11,6,1
7,1999,160300,11,8,3,2
8,1999,160300,18,18,0,5
9,1999,160300,14,12,2,0
10,1999,160300,10,9,1,0
11,1999,160300,10,9,1,0
12,1999,160300,13,12,1,0
1,2000,160300,6,5,1,0
2,2000,160300,8,8,0,2
3,2000,160300,8,8,0,0
4,2000,160300,7,6,1,2
5,2000,160300,23,23,0,2
6,2000,160300,8,8,0,2
7,2000,160300,7,6,1,0
8,2000,160300,8,7,1,4
9,2000,160300,11,9,2,7
10,2000,160300,12,12,0,2
11,2000,160300,6,6,0,1
12,2000,160300,8,8,0,0
1,2001,160300,4,4,0,0
2,2001,160300,10,10,0,1
3,2001,160300,6,5,1,0
4,2001,160300,13,13,0,1
5,2001,160300,17,16,1,1
6,2001,160300,9,8,1,2
7,2001,160300,9,8,1,0
8,2001,160300,9,9,0,1
9,2001,160300,13,13,0,1
10,2001,160300,13,13,0,0
11,2001,160300,9,9,0,2
12,2001,160300,9,7,2,0
1,2002,160300,7,7,0,1
2,2002,160300,12,11,1,0
3,2002,160300,7,7,0,1
4,2002,160300,10,9,1,0
5,2002,160300,12,11,1,0
6,2002,160300,16,16,0,2
7,2002,160300,17,17,0,1
8,2002,160300,14,13,1,1
9,2002,160300,14,14,0,1
10,2002,160300,11,10,1,1
11,2002,160300,13,13,0,0
12,2002,160300,10,9,1,3
1,2003,160300,15,13,2,6
2,2003,160300,5,4,1,2
3,2003,160300,16,15,1,6
4,2003,160300,7,6,1,0
5,2003,160300,16,14,2,1
6,2003,160300,11,8,3,1
7,2003,160300,11,10,1,0
8,2003,160300,10,10,0,1
9,2003,160300,7,6,1,2
10,2003,160300,11,10,1,1
11,2003,160300,7,6,1,0
12,2003,160300,10,10,0,0
1,2004,160300,2,2,0,2
2,2004,160300,9,9,0,1
3,2004,160300,10,9,1,0
4,2004,160300,7,7,0,2
5,2004,160300,8,7,1,3
6,2004,160300,6,6,0,2
7,2004,160300,13,12,1,3
8,2004,160300,5,5,0,1
9,2004,160300,4,4,0,2
10,2004,160300,3,2,1,4
11,2004,160300,6,6,0,0
12,2004,160300,6,6,0,2
1,2005,160300,10,10,0,1
2,2005,160300,10,9,1,4
3,2005,160300,5,5,0,1
4,2005,160300,5,5,0,1
5,2005,160300,10,10,0,1
6,2005,160300,9,9,0,3
7,2005,160300,4,4,0,1
8,2005,160300,8,6,2,3
9,2005,160300,8,8,0,2
10,2005,160300,6,6,0,0
11,2005,160300,8,8,0,0
12,2005,160300,3,3,0,0
1,2006,160300,14,14,0,2
2,2006,160300,6,6,0,4
3,2006,160300,9,7,2,1
4,2006,160300,13,12,1,0
5,2006,160300,12,12,0,0
6,2006,160300,12,12,0,4
7,2006,160300,16,15,1,1
8,2006,160300,10,10,0,0
9,2006,160300,9,8,1,1
10,2006,160300,11,11,0,0
11,2006,160300,5,5,0,0
12,2006,160300,3,3,0,1
1,2007,160300,3,3,0,0
2,2007,160300,2,2,0,1
3,2007,160300,8,8,0,0
4,2007,160300,5,5,0,3
5,2007,160300,9,8,1,0
6,2007,160300,7,7,0,4
7,2007,160300,6,6,0,1
8,2007,160300,7,7,0,2
9,2007,160300,11,10,1,3
10,2007,160300,11,10,1,0
11,2007,160300,13,12,1,1
12,2007,160300,8,8,0,0
1,2008,160300,8,7,1,0
2,2008,160300,7,7,0,1
3,2008,160300,11,11,0,3
4,2008,160300,4,4,0,0
5,2008,160300,9,8,1,0
6,2008,160300,7,6,1,0
7,2008,160300,10,9,1,4
8,2008,160300,14,13,1,4
9,2008,160300,8,7,1,2
10,2008,160300,9,7,2,0
11,2008,160300,8,7,1,1
12,2008,160300,6,5,1,0
1,2009,160300,7,6,1,1
2,2009,160300,6,5,1,2
3,2009,160300,16,14,2,2
4,2009,160300,10,8,2,0
5,2009,160300,7,6,1,0
6,2009,160300,8,8,0,0
7,2009,160300,11,11,0,1
8,2009,160300,15,13,2,0
9,2009,160300,12,12,0,0
10,2009,160300,9,9,0,1
11,2009,160300,6,5,1,0
12,2009,160300,8,8,0,1
1,2010,160300,11,11,0,1
2,2010,160300,4,4,0,0
3,2010,160300,6,6,0,0
4,2010,160300,8,6,2,1
5,2010,160300,13,12,1,1
6,2010,160300,12,10,2,0
7,2010,160300,12,11,1,0
8,2010,160300,6,6,0,3
9,2010,160300,11,11,0,1
10,2010,160300,6,6,0,2
11,2010,160300,3,3,0,0
12,2010,160300,9,9,0,0
1,2011,160300,7,7,0,0
2,2011,160300,1,1,0,1
1,1999,032100,29,25,4,1
2,1999,032100,32,31,1,6
3,1999,032100,23,22,1,4
4,1999,032100,43,43,0,9
5,1999,032100,45,40,5,4
6,1999,032100,30,27,3,7
7,1999,032100,53,48,5,2
8,1999,032100,38,35,3,4
9,1999,032100,26,25,1,3
10,1999,032100,34,31,3,4
11,1999,032100,26,24,2,2
12,1999,032100,25,24,1,5
1,2000,032100,30,27,3,6
2,2000,032100,17,14,3,3
3,2000,032100,25,24,1,0
4,2000,032100,18,18,0,2
5,2000,032100,32,29,3,4
6,2000,032100,19,15,4,4
7,2000,032100,31,27,4,4
8,2000,032100,46,44,2,2
9,2000,032100,20,20,0,2
10,2000,032100,27,25,2,2
11,2000,032100,25,24,1,5
12,2000,032100,15,14,1,5
1,2001,032100,21,19,2,2
2,2001,032100,15,13,2,6
3,2001,032100,26,25,1,3
4,2001,032100,25,23,2,5
5,2001,032100,21,19,2,2
6,2001,032100,27,24,3,3
7,2001,032100,19,18,1,4
8,2001,032100,33,31,2,3
9,2001,032100,32,28,4,6
10,2001,032100,32,30,2,6
11,2001,032100,27,25,2,2
12,2001,032100,17,16,1,2
1,2002,032100,26,26,0,5
2,2002,032100,26,23,3,3
3,2002,032100,41,39,2,7
4,2002,032100,32,32,0,8
5,2002,032100,31,27,4,3
6,2002,032100,32,31,1,3
7,2002,032100,43,41,2,1
8,2002,032100,39,39,0,7
9,2002,032100,40,38,2,6
10,2002,032100,28,27,1,0
11,2002,032100,27,25,2,4
12,2002,032100,27,27,0,0
1,2003,032100,24,22,2,0
2,2003,032100,17,15,2,2
3,2003,032100,15,13,2,3
4,2003,032100,28,27,1,2
5,2003,032100,29,28,1,2
6,2003,032100,35,33,2,2
7,2003,032100,39,38,1,6
8,2003,032100,58,58,0,2
9,2003,032100,25,25,0,4
10,2003,032100,27,25,2,1
11,2003,032100,23,22,1,0
12,2003,032100,36,34,2,0
1,2004,032100,29,28,1,1
2,2004,032100,21,21,0,0
3,2004,032100,25,23,2,1
4,2004,032100,28,28,0,1
5,2004,032100,38,32,6,4
6,2004,032100,40,38,2,1
7,2004,032100,56,54,2,2
8,2004,032100,44,43,1,5
9,2004,032100,48,47,1,1
10,2004,032100,17,16,1,1
11,2004,032100,19,19,0,3
12,2004,032100,36,35,1,2
1,2005,032100,22,21,1,7
2,2005,032100,17,16,1,3
3,2005,032100,35,32,3,3
4,2005,032100,28,26,2,2
5,2005,032100,25,24,1,4
6,2005,032100,29,27,2,6
7,2005,032100,41,39,2,1
8,2005,032100,43,43,0,3
9,2005,032100,38,37,1,3
10,2005,032100,30,28,2,3
11,2005,032100,39,38,1,6
12,2005,032100,27,27,0,2
1,2006,032100,21,18,3,4
2,2006,032100,25,23,2,1
3,2006,032100,31,28,3,2
4,2006,032100,30,30,0,1
5,2006,032100,29,26,3,5
6,2006,032100,28,24,4,5
7,2006,032100,35,35,0,2
8,2006,032100,40,37,3,4
9,2006,032100,28,28,0,4
10,2006,032100,26,24,2,6
11,2006,032100,24,23,1,7
12,2006,032100,24,24,0,9
1,2007,032100,18,17,1,2
2,2007,032100,20,19,1,5
3,2007,032100,18,17,1,4
4,2007,032100,15,13,2,1
5,2007,032100,32,30,2,5
6,2007,032100,29,27,2,4
7,2007,032100,31,27,4,5
8,2007,032100,32,28,4,4
9,2007,032100,19,19,0,2
10,2007,032100,28,28,0,1
11,2007,032100,23,23,0,3
12,2007,032100,28,28,0,0
1,2008,032100,24,24,0,3
2,2008,032100,22,21,1,0
3,2008,032100,26,24,2,3
4,2008,032100,24,24,0,3
5,2008,032100,26,25,1,3
6,2008,032100,31,29,2,0
7,2008,032100,26,25,1,0
8,2008,032100,36,34,2,2
9,2008,032100,29,27,2,1
10,2008,032100,26,22,4,2
11,2008,032100,22,21,1,2
12,2008,032100,44,44,0,1
1,2009,032100,29,27,2,3
2,2009,032100,25,23,2,1
3,2009,032100,26,24,2,0
4,2009,032100,23,22,1,1
5,2009,032100,27,27,0,2
6,2009,032100,30,28,2,0
7,2009,032100,25,23,2,2
8,2009,032100,28,27,1,1
9,2009,032100,15,15,0,1
10,2009,032100,30,27,3,0
11,2009,032100,15,15,0,0
12,2009,032100,13,13,0,0
1,2010,032100,21,19,2,4
2,2010,032100,16,15,1,3
3,2010,032100,18,18,0,1
4,2010,032100,20,19,1,1
5,2010,032100,35,34,1,1
6,2010,032100,21,19,2,1
7,2010,032100,31,28,3,3
8,2010,032100,22,22,0,3
9,2010,032100,18,18,0,1
10,2010,032100,26,26,0,1
11,2010,032100,20,19,1,2
12,2010,032100,17,17,0,0
1,2011,032100,20,20,0,3
2,2011,032100,6,5,1,0
1,1999,150402,7,6,1,2
2,1999,150402,8,8,0,0
3,1999,150402,11,11,0,0
4,1999,150402,5,4,1,0
5,1999,150402,12,10,2,0
6,1999,150402,5,5,0,0
7,1999,150402,16,15,1,3
8,1999,150402,15,13,2,1
9,1999,150402,9,8,1,0
10,1999,150402,4,3,1,2
11,1999,150402,9,8,1,1
12,1999,150402,4,4,0,0
1,2000,150402,5,5,0,0
2,2000,150402,10,9,1,0
3,2000,150402,11,11,0,1
4,2000,150402,4,4,0,0
5,2000,150402,13,13,0,3
6,2000,150402,11,11,0,0
7,2000,150402,10,9,1,0
8,2000,150402,9,8,1,0
9,2000,150402,9,8,1,0
10,2000,150402,14,13,1,1
11,2000,150402,8,8,0,1
12,2000,150402,8,8,0,0
1,2001,150402,7,7,0,0
2,2001,150402,4,4,0,0
3,2001,150402,8,7,1,2
4,2001,150402,12,11,1,0
5,2001,150402,14,13,1,2
6,2001,150402,17,17,0,0
7,2001,150402,7,7,0,3
8,2001,150402,17,15,2,1
9,2001,150402,8,7,1,0
10,2001,150402,10,9,1,0
11,2001,150402,10,10,0,1
12,2001,150402,7,7,0,0
1,2002,150402,7,7,0,6
2,2002,150402,9,8,1,2
3,2002,150402,10,9,1,0
4,2002,150402,5,4,1,0
5,2002,150402,5,5,0,0
6,2002,150402,6,6,0,3
7,2002,150402,7,7,0,0
8,2002,150402,8,8,0,1
9,2002,150402,11,10,1,1
10,2002,150402,13,13,0,2
11,2002,150402,9,8,1,2
12,2002,150402,17,15,2,1
1,2003,150402,6,6,0,0
2,2003,150402,7,7,0,2
3,2003,150402,12,12,0,1
4,2003,150402,6,6,0,1
5,2003,150402,8,8,0,0
6,2003,150402,11,11,0,1
7,2003,150402,13,13,0,2
8,2003,150402,14,13,1,1
9,2003,150402,12,12,0,0
10,2003,150402,11,11,0,1
11,2003,150402,7,6,1,3
12,2003,150402,3,3,0,1
1,2004,150402,7,7,0,0
2,2004,150402,6,6,0,2
3,2004,150402,7,7,0,1
4,2004,150402,8,8,0,0
5,2004,150402,2,2,0,0
6,2004,150402,5,5,0,2
7,2004,150402,4,4,0,1
8,2004,150402,8,7,1,0
9,2004,150402,9,8,1,0
10,2004,150402,6,5,1,0
11,2004,150402,9,9,0,1
12,2004,150402,9,6,3,2
1,2005,150402,5,4,1,0
2,2005,150402,5,4,1,1
3,2005,150402,8,8,0,0
4,2005,150402,5,5,0,5
5,2005,150402,8,8,0,2
6,2005,150402,8,7,1,0
7,2005,150402,15,15,0,0
8,2005,150402,5,4,1,0
9,2005,150402,5,5,0,2
10,2005,150402,3,3,0,1
11,2005,150402,9,9,0,2
12,2005,150402,5,5,0,2
1,2006,150402,6,6,0,0
2,2006,150402,4,4,0,1
3,2006,150402,9,8,1,2
4,2006,150402,12,12,0,0
5,2006,150402,2,2,0,0
6,2006,150402,7,6,1,0
7,2006,150402,6,6,0,0
8,2006,150402,8,6,2,0
9,2006,150402,6,6,0,4
10,2006,150402,7,7,0,0
11,2006,150402,2,1,1,2
12,2006,150402,11,11,0,2
1,2007,150402,6,6,0,6
2,2007,150402,4,3,1,1
3,2007,150402,7,7,0,1
4,2007,150402,6,6,0,5
5,2007,150402,9,8,1,0
6,2007,150402,9,9,0,0
7,2007,150402,9,8,1,2
8,2007,150402,3,3,0,0
9,2007,150402,6,5,1,1
10,2007,150402,10,10,0,1
11,2007,150402,9,9,0,1
12,2007,150402,5,5,0,0
1,2008,150402,3,3,0,0
2,2008,150402,5,5,0,0
3,2008,150402,7,6,1,1
4,2008,150402,6,6,0,0
5,2008,150402,6,6,0,0
6,2008,150402,8,7,1,0
7,2008,150402,7,7,0,0
8,2008,150402,4,4,0,0
9,2008,150402,8,8,0,1
10,2008,150402,11,11,0,2
11,2008,150402,13,12,1,0
12,2008,150402,5,5,0,0
1,2009,150402,5,5,0,0
2,2009,150402,2,2,0,2
3,2009,150402,2,2,0,2
4,2009,150402,13,13,0,1
5,2009,150402,7,6,1,1
6,2009,150402,6,6,0,0
7,2009,150402,9,9,0,0
8,2009,150402,6,5,1,2
9,2009,150402,6,6,0,0
10,2009,150402,4,4,0,0
11,2009,150402,10,10,0,1
12,2009,150402,4,4,0,0
1,2010,150402,7,7,0,1
2,2010,150402,8,8,0,1
3,2010,150402,4,4,0,0
4,2010,150402,6,6,0,0
5,2010,150402,6,6,0,1
6,2010,150402,3,3,0,2
7,2010,150402,5,4,1,1
8,2010,150402,4,4,0,3
9,2010,150402,2,2,0,0
10,2010,150402,4,3,1,2
11,2010,150402,8,8,0,0
12,2010,150402,9,8,1,0
1,2011,150402,6,4,2,0
2,2011,150402,4,4,0,1
1,1999,031400,16,16,0,1
2,1999,031400,15,14,1,4
3,1999,031400,15,14,1,1
4,1999,031400,22,20,2,3
5,1999,031400,17,17,0,13
6,1999,031400,20,19,1,2
7,1999,031400,31,30,1,6
8,1999,031400,27,26,1,2
9,1999,031400,17,17,0,1
10,1999,031400,26,24,2,5
11,1999,031400,15,14,1,3
12,1999,031400,15,15,0,2
1,2000,031400,14,14,0,5
2,2000,031400,10,10,0,2
3,2000,031400,23,23,0,4
4,2000,031400,18,17,1,2
5,2000,031400,18,15,3,3
6,2000,031400,21,20,1,1
7,2000,031400,15,13,2,4
8,2000,031400,36,35,1,4
9,2000,031400,21,18,3,6
10,2000,031400,29,28,1,1
11,2000,031400,28,27,1,1
12,2000,031400,20,16,4,0
1,2001,031400,12,12,0,0
2,2001,031400,13,11,2,2
3,2001,031400,19,17,2,0
4,2001,031400,11,11,0,0
5,2001,031400,12,12,0,1
6,2001,031400,26,24,2,1
7,2001,031400,27,26,1,0
8,2001,031400,19,18,1,4
9,2001,031400,27,26,1,1
10,2001,031400,33,33,0,1
11,2001,031400,27,27,0,2
12,2001,031400,12,12,0,0
1,2002,031400,14,14,0,0
2,2002,031400,18,16,2,0
3,2002,031400,9,9,0,0
4,2002,031400,15,15,0,0
5,2002,031400,22,20,2,3
6,2002,031400,13,12,1,1
7,2002,031400,24,23,1,5
8,2002,031400,48,46,2,1
9,2002,031400,26,26,0,2
10,2002,031400,22,21,1,2
11,2002,031400,15,14,1,0
12,2002,031400,10,10,0,1
1,2003,031400,9,9,0,1
2,2003,031400,9,9,0,2
3,2003,031400,5,4,1,0
4,2003,031400,18,16,2,0
5,2003,031400,17,16,1,2
6,2003,031400,20,19,1,0
7,2003,031400,18,12,6,2
8,2003,031400,18,16,2,0
9,2003,031400,19,15,4,2
10,2003,031400,13,12,1,5
11,2003,031400,21,21,0,4
12,2003,031400,10,10,0,2
1,2004,031400,13,13,0,1
2,2004,031400,9,9,0,0
3,2004,031400,19,18,1,0
4,2004,031400,9,8,1,1
5,2004,031400,9,9,0,2
6,2004,031400,25,24,1,3
7,2004,031400,24,23,1,8
8,2004,031400,15,13,2,5
9,2004,031400,11,10,1,4
10,2004,031400,19,19,0,1
11,2004,031400,15,15,0,0
12,2004,031400,19,19,0,2
1,2005,031400,11,10,1,2
2,2005,031400,12,12,0,1
3,2005,031400,16,15,1,2
4,2005,031400,15,14,1,4
5,2005,031400,21,21,0,7
6,2005,031400,13,13,0,5
7,2005,031400,9,7,2,3
8,2005,031400,27,27,0,8
9,2005,031400,14,12,2,3
10,2005,031400,11,11,0,0
11,2005,031400,9,8,1,1
12,2005,031400,4,4,0,1
1,2006,031400,6,5,1,2
2,2006,031400,14,12,2,1
3,2006,031400,17,17,0,0
4,2006,031400,14,13,1,4
5,2006,031400,13,12,1,1
6,2006,031400,17,17,0,1
7,2006,031400,16,16,0,0
8,2006,031400,16,14,2,2
9,2006,031400,17,17,0,14
10,2006,031400,12,12,0,1
11,2006,031400,21,21,0,2
12,2006,031400,12,11,1,0
1,2007,031400,23,23,0,2
2,2007,031400,6,6,0,2
3,2007,031400,13,12,1,5
4,2007,031400,7,7,0,2
5,2007,031400,15,15,0,2
6,2007,031400,9,9,0,7
7,2007,031400,18,17,1,4
8,2007,031400,14,14,0,5
9,2007,031400,9,9,0,2
10,2007,031400,9,9,0,3
11,2007,031400,13,13,0,1
12,2007,031400,4,4,0,1
1,2008,031400,13,13,0,0
2,2008,031400,9,9,0,0
3,2008,031400,2,2,0,0
4,2008,031400,11,10,1,1
5,2008,031400,14,14,0,2
6,2008,031400,15,15,0,1
7,2008,031400,20,19,1,4
8,2008,031400,23,23,0,2
9,2008,031400,27,26,1,3
10,2008,031400,31,30,1,4
11,2008,031400,11,11,0,0
12,2008,031400,17,17,0,0
1,2009,031400,15,13,2,1
2,2009,031400,11,11,0,0
3,2009,031400,12,11,1,1
4,2009,031400,13,13,0,0
5,2009,031400,8,8,0,4
6,2009,031400,2,2,0,1
7,2009,031400,16,16,0,1
8,2009,031400,19,19,0,1
9,2009,031400,19,19,0,5
10,2009,031400,7,7,0,0
11,2009,031400,5,5,0,0
12,2009,031400,1,1,0,5
1,2010,031400,14,13,1,4
2,2010,031400,7,7,0,0
3,2010,031400,10,9,1,1
4,2010,031400,12,11,1,2
5,2010,031400,9,9,0,2
6,2010,031400,10,10,0,0
7,2010,031400,8,7,1,5
8,2010,031400,21,21,0,1
9,2010,031400,11,11,0,1
10,2010,031400,16,15,1,1
11,2010,031400,11,10,1,2
12,2010,031400,7,7,0,1
1,2011,031400,8,8,0,2
2,2011,031400,2,2,0,0
1,1999,160200,21,19,2,2
2,1999,160200,12,12,0,0
3,1999,160200,12,12,0,6
4,1999,160200,13,12,1,1
5,1999,160200,22,21,1,1
6,1999,160200,15,14,1,3
7,1999,160200,19,18,1,0
8,1999,160200,20,18,2,2
9,1999,160200,14,12,2,0
10,1999,160200,9,7,2,1
11,1999,160200,12,11,1,1
12,1999,160200,9,8,1,0
1,2000,160200,9,8,1,0
2,2000,160200,7,7,0,1
3,2000,160200,16,15,1,1
4,2000,160200,9,8,1,3
5,2000,160200,12,11,1,3
6,2000,160200,11,10,1,2
7,2000,160200,12,11,1,0
8,2000,160200,12,12,0,0
9,2000,160200,13,12,1,0
10,2000,160200,22,22,0,0
11,2000,160200,15,14,1,0
12,2000,160200,14,11,3,2
1,2001,160200,11,11,0,4
2,2001,160200,3,3,0,1
3,2001,160200,8,8,0,3
4,2001,160200,11,10,1,2
5,2001,160200,14,12,2,0
6,2001,160200,6,6,0,0
7,2001,160200,14,13,1,1
8,2001,160200,16,14,2,0
9,2001,160200,14,13,1,0
10,2001,160200,19,18,1,0
11,2001,160200,11,9,2,0
12,2001,160200,13,13,0,0
1,2002,160200,15,15,0,0
2,2002,160200,14,13,1,2
3,2002,160200,13,13,0,0
4,2002,160200,7,7,0,1
5,2002,160200,12,11,1,3
6,2002,160200,17,16,1,2
7,2002,160200,14,13,1,1
8,2002,160200,9,9,0,0
9,2002,160200,14,13,1,0
10,2002,160200,9,8,1,1
11,2002,160200,10,9,1,0
12,2002,160200,14,14,0,0
1,2003,160200,18,17,1,2
2,2003,160200,17,17,0,0
3,2003,160200,13,12,1,1
4,2003,160200,8,7,1,1
5,2003,160200,8,6,2,3
6,2003,160200,15,15,0,3
7,2003,160200,16,16,0,1
8,2003,160200,11,11,0,2
9,2003,160200,16,14,2,1
10,2003,160200,12,11,1,5
11,2003,160200,9,8,1,1
12,2003,160200,4,3,1,1
1,2004,160200,9,9,0,1
2,2004,160200,8,8,0,0
3,2004,160200,14,14,0,1
4,2004,160200,10,10,0,1
5,2004,160200,7,6,1,4
6,2004,160200,12,12,0,2
7,2004,160200,11,9,2,2
8,2004,160200,20,20,0,3
9,2004,160200,15,15,0,3
10,2004,160200,11,10,1,0
11,2004,160200,11,11,0,0
12,2004,160200,14,14,0,1
1,2005,160200,9,8,1,2
2,2005,160200,5,5,0,1
3,2005,160200,13,13,0,3
4,2005,160200,5,4,1,2
5,2005,160200,6,6,0,1
6,2005,160200,7,7,0,2
7,2005,160200,10,10,0,3
8,2005,160200,18,16,2,2
9,2005,160200,13,12,1,0
10,2005,160200,13,12,1,0
11,2005,160200,10,9,1,0
12,2005,160200,12,11,1,0
1,2006,160200,8,8,0,0
2,2006,160200,14,13,1,0
3,2006,160200,7,6,1,0
4,2006,160200,10,10,0,0
5,2006,160200,8,8,0,0
6,2006,160200,11,9,2,0
7,2006,160200,14,14,0,0
8,2006,160200,12,11,1,0
9,2006,160200,11,10,1,0
10,2006,160200,16,15,1,0
11,2006,160200,9,9,0,2
12,2006,160200,12,12,0,3
1,2007,160200,14,14,0,1
2,2007,160200,7,7,0,0
3,2007,160200,13,12,1,2
4,2007,160200,12,12,0,0
5,2007,160200,5,5,0,1
6,2007,160200,9,9,0,1
7,2007,160200,6,5,1,0
8,2007,160200,10,8,2,1
9,2007,160200,7,7,0,1
10,2007,160200,20,20,0,2
11,2007,160200,14,14,0,0
12,2007,160200,11,10,1,2
1,2008,160200,22,20,2,2
2,2008,160200,13,13,0,2
3,2008,160200,13,12,1,0
4,2008,160200,6,6,0,0
5,2008,160200,15,14,1,0
6,2008,160200,13,13,0,0
7,2008,160200,16,15,1,0
8,2008,160200,8,8,0,4
9,2008,160200,10,9,1,1
10,2008,160200,16,16,0,0
11,2008,160200,9,9,0,0
12,2008,160200,11,8,3,0
1,2009,160200,9,9,0,0
2,2009,160200,4,4,0,1
3,2009,160200,17,15,2,1
4,2009,160200,12,12,0,0
5,2009,160200,16,16,0,0
6,2009,160200,14,13,1,2
7,2009,160200,14,13,1,1
8,2009,160200,5,4,1,1
9,2009,160200,7,7,0,1
10,2009,160200,14,13,1,2
11,2009,160200,12,11,1,4
12,2009,160200,4,4,0,0
1,2010,160200,19,19,0,3
2,2010,160200,5,4,1,0
3,2010,160200,10,10,0,1
4,2010,160200,10,10,0,4
5,2010,160200,8,8,0,1
6,2010,160200,17,17,0,0
7,2010,160200,14,14,0,2
8,2010,160200,17,17,0,0
9,2010,160200,14,14,0,0
10,2010,160200,16,16,0,0
11,2010,160200,12,11,1,1
12,2010,160200,9,9,0,0
1,2011,160200,2,2,0,1
2,2011,160200,7,7,0,2
1,1999,160501,9,8,1,3
2,1999,160501,17,16,1,0
3,1999,160501,19,11,8,3
4,1999,160501,18,16,2,7
5,1999,160501,23,17,6,8
6,1999,160501,11,9,2,3
7,1999,160501,21,17,4,5
8,1999,160501,24,20,4,5
9,1999,160501,14,11,3,9
10,1999,160501,15,14,1,7
11,1999,160501,17,14,3,4
12,1999,160501,17,15,2,2
1,2000,160501,14,12,2,3
2,2000,160501,15,13,2,2
3,2000,160501,15,15,0,10
4,2000,160501,8,5,3,4
5,2000,160501,19,16,3,7
6,2000,160501,22,17,5,5
7,2000,160501,16,14,2,2
8,2000,160501,13,11,2,6
9,2000,160501,14,13,1,9
10,2000,160501,20,18,2,6
11,2000,160501,16,12,4,3
12,2000,160501,15,12,3,4
1,2001,160501,14,12,2,3
2,2001,160501,13,13,0,5
3,2001,160501,18,14,4,6
4,2001,160501,12,7,5,4
5,2001,160501,15,13,2,7
6,2001,160501,12,10,2,1
7,2001,160501,22,13,9,8
8,2001,160501,18,16,2,1
9,2001,160501,11,9,2,3
10,2001,160501,15,13,2,2
11,2001,160501,17,13,4,1
12,2001,160501,17,13,4,3
1,2002,160501,12,10,2,4
2,2002,160501,9,8,1,6
3,2002,160501,18,15,3,8
4,2002,160501,12,10,2,3
5,2002,160501,16,12,4,2
6,2002,160501,21,17,4,10
7,2002,160501,22,20,2,3
8,2002,160501,14,10,4,4
9,2002,160501,12,10,2,4
10,2002,160501,27,21,6,4
11,2002,160501,17,16,1,2
12,2002,160501,12,10,2,3
1,2003,160501,17,15,2,2
2,2003,160501,8,7,1,2
3,2003,160501,16,15,1,5
4,2003,160501,15,13,2,2
5,2003,160501,11,9,2,4
6,2003,160501,8,8,0,5
7,2003,160501,15,12,3,7
8,2003,160501,22,20,2,1
9,2003,160501,13,11,2,2
10,2003,160501,11,10,1,9
11,2003,160501,15,13,2,5
12,2003,160501,15,14,1,1
1,2004,160501,14,13,1,3
2,2004,160501,11,11,0,6
3,2004,160501,13,12,1,0
4,2004,160501,13,12,1,3
5,2004,160501,8,8,0,2
6,2004,160501,19,15,4,4
7,2004,160501,15,14,1,4
8,2004,160501,14,11,3,4
9,2004,160501,14,12,2,1
10,2004,160501,9,9,0,2
11,2004,160501,9,8,1,4
12,2004,160501,23,19,4,4
1,2005,160501,7,7,0,2
2,2005,160501,5,4,1,3
3,2005,160501,17,14,3,1
4,2005,160501,12,12,0,10
5,2005,160501,7,7,0,5
6,2005,160501,10,9,1,0
7,2005,160501,6,6,0,1
8,2005,160501,14,12,2,1
9,2005,160501,13,13,0,1
10,2005,160501,17,17,0,0
11,2005,160501,11,9,2,1
12,2005,160501,11,10,1,1
1,2006,160501,20,20,0,1
2,2006,160501,12,12,0,2
3,2006,160501,6,5,1,1
4,2006,160501,9,9,0,4
5,2006,160501,12,12,0,2
6,2006,160501,17,17,0,5
7,2006,160501,20,19,1,0
8,2006,160501,16,13,3,0
9,2006,160501,9,7,2,6
10,2006,160501,11,8,3,1
11,2006,160501,12,10,2,0
12,2006,160501,15,12,3,2
1,2007,160501,14,13,1,1
2,2007,160501,5,5,0,1
3,2007,160501,11,8,3,2
4,2007,160501,15,13,2,0
5,2007,160501,13,11,2,0
6,2007,160501,20,14,6,0
7,2007,160501,19,16,3,3
8,2007,160501,15,14,1,3
9,2007,160501,11,7,4,4
10,2007,160501,18,18,0,3
11,2007,160501,10,7,3,2
12,2007,160501,15,15,0,1
1,2008,160501,16,12,4,0
2,2008,160501,12,9,3,1
3,2008,160501,18,16,2,1
4,2008,160501,8,8,0,1
5,2008,160501,15,13,2,4
6,2008,160501,13,12,1,1
7,2008,160501,22,21,1,3
8,2008,160501,11,10,1,3
9,2008,160501,16,14,2,2
10,2008,160501,12,12,0,2
11,2008,160501,14,13,1,7
12,2008,160501,12,12,0,4
1,2009,160501,8,7,1,1
2,2009,160501,10,10,0,3
3,2009,160501,6,5,1,2
4,2009,160501,19,14,5,5
5,2009,160501,7,6,1,5
6,2009,160501,10,8,2,4
7,2009,160501,11,11,0,0
8,2009,160501,15,15,0,8
9,2009,160501,20,20,0,3
10,2009,160501,18,18,0,0
11,2009,160501,7,6,1,2
12,2009,160501,10,9,1,3
1,2010,160501,10,9,1,5
2,2010,160501,10,10,0,4
3,2010,160501,13,13,0,3
4,2010,160501,10,9,1,3
5,2010,160501,8,8,0,4
6,2010,160501,16,15,1,2
7,2010,160501,7,6,1,2
8,2010,160501,32,28,4,4
9,2010,160501,14,13,1,9
10,2010,160501,9,9,0,3
11,2010,160501,13,12,1,5
12,2010,160501,12,12,0,1
1,2011,160501,11,11,0,3
2,2011,160501,6,6,0,0
1,1999,160601,16,16,0,1
2,1999,160601,18,17,1,5
3,1999,160601,16,16,0,4
4,1999,160601,16,15,1,3
5,1999,160601,15,11,4,2
6,1999,160601,14,14,0,5
7,1999,160601,13,10,3,3
8,1999,160601,12,10,2,5
9,1999,160601,12,12,0,2
10,1999,160601,7,6,1,4
11,1999,160601,12,11,1,7
12,1999,160601,7,6,1,7
1,2000,160601,15,15,0,11
2,2000,160601,11,10,1,2
3,2000,160601,18,16,2,2
4,2000,160601,21,18,3,1
5,2000,160601,8,6,2,12
6,2000,160601,12,12,0,4
7,2000,160601,26,21,5,6
8,2000,160601,12,10,2,2
9,2000,160601,17,12,5,9
10,2000,160601,13,11,2,10
11,2000,160601,8,6,2,3
12,2000,160601,14,13,1,4
1,2001,160601,8,6,2,3
2,2001,160601,9,8,1,6
3,2001,160601,14,9,5,0
4,2001,160601,12,10,2,1
5,2001,160601,9,9,0,4
6,2001,160601,13,11,2,15
7,2001,160601,7,6,1,4
8,2001,160601,11,8,3,3
9,2001,160601,17,15,2,3
10,2001,160601,15,14,1,4
11,2001,160601,13,12,1,3
12,2001,160601,11,10,1,3
1,2002,160601,12,12,0,6
2,2002,160601,11,10,1,2
3,2002,160601,8,8,0,2
4,2002,160601,13,11,2,3
5,2002,160601,11,9,2,3
6,2002,160601,14,13,1,1
7,2002,160601,21,19,2,3
8,2002,160601,7,6,1,1
9,2002,160601,15,12,3,2
10,2002,160601,15,12,3,2
11,2002,160601,20,18,2,5
12,2002,160601,14,14,0,2
1,2003,160601,14,14,0,2
2,2003,160601,6,5,1,4
3,2003,160601,8,7,1,2
4,2003,160601,13,13,0,2
5,2003,160601,15,12,3,1
6,2003,160601,7,7,0,5
7,2003,160601,16,14,2,4
8,2003,160601,13,11,2,4
9,2003,160601,7,7,0,1
10,2003,160601,16,15,1,5
11,2003,160601,14,14,0,2
12,2003,160601,12,12,0,2
1,2004,160601,11,10,1,2
2,2004,160601,10,9,1,3
3,2004,160601,10,8,2,0
4,2004,160601,9,7,2,1
5,2004,160601,10,9,1,4
6,2004,160601,7,7,0,1
7,2004,160601,15,14,1,6
8,2004,160601,12,11,1,0
9,2004,160601,11,11,0,0
10,2004,160601,9,7,2,1
11,2004,160601,20,18,2,4
12,2004,160601,16,16,0,0
1,2005,160601,10,10,0,4
2,2005,160601,6,6,0,1
3,2005,160601,14,13,1,3
4,2005,160601,10,9,1,3
5,2005,160601,11,11,0,3
6,2005,160601,16,15,1,4
7,2005,160601,10,10,0,3
8,2005,160601,14,12,2,1
9,2005,160601,17,16,1,1
10,2005,160601,12,11,1,0
11,2005,160601,11,11,0,5
12,2005,160601,9,8,1,3
1,2006,160601,18,16,2,6
2,2006,160601,14,12,2,2
3,2006,160601,14,14,0,3
4,2006,160601,13,10,3,0
5,2006,160601,14,14,0,2
6,2006,160601,11,10,1,2
7,2006,160601,13,12,1,0
8,2006,160601,7,7,0,1
9,2006,160601,9,7,2,1
10,2006,160601,13,9,4,3
11,2006,160601,8,8,0,3
12,2006,160601,8,7,1,1
1,2007,160601,9,9,0,4
2,2007,160601,3,2,1,7
3,2007,160601,4,3,1,3
4,2007,160601,6,6,0,0
5,2007,160601,7,7,0,0
6,2007,160601,11,10,1,1
7,2007,160601,19,18,1,2
8,2007,160601,12,10,2,1
9,2007,160601,9,8,1,1
10,2007,160601,14,12,2,1
11,2007,160601,14,13,1,1
12,2007,160601,13,13,0,2
1,2008,160601,13,12,1,2
2,2008,160601,7,7,0,2
3,2008,160601,15,14,1,1
4,2008,160601,9,8,1,1
5,2008,160601,8,8,0,2
6,2008,160601,10,7,3,1
7,2008,160601,16,14,2,1
8,2008,160601,15,13,2,1
9,2008,160601,13,12,1,0
10,2008,160601,17,17,0,3
11,2008,160601,12,12,0,3
12,2008,160601,5,4,1,3
1,2009,160601,8,8,0,0
2,2009,160601,9,7,2,5
3,2009,160601,4,3,1,1
4,2009,160601,10,10,0,1
5,2009,160601,10,10,0,2
6,2009,160601,11,10,1,1
7,2009,160601,13,11,2,2
8,2009,160601,16,16,0,3
9,2009,160601,18,18,0,3
10,2009,160601,17,17,0,3
11,2009,160601,6,6,0,0
12,2009,160601,13,13,0,0
1,2010,160601,5,5,0,2
2,2010,160601,4,3,1,1
3,2010,160601,15,13,2,0
4,2010,160601,13,13,0,1
5,2010,160601,7,6,1,2
6,2010,160601,13,11,2,2
7,2010,160601,15,15,0,3
8,2010,160601,15,12,3,0
9,2010,160601,12,11,1,2
10,2010,160601,14,14,0,2
11,2010,160601,12,11,1,1
12,2010,160601,5,5,0,1
1,2011,160601,7,7,0,3
2,2011,160601,6,5,1,2
1,1999,980000,2,2,0,0
2,1999,980000,0,0,0,0
3,1999,980000,1,1,0,0
4,1999,980000,2,2,0,0
5,1999,980000,1,1,0,0
6,1999,980000,1,1,0,0
7,1999,980000,1,1,0,0
8,1999,980000,1,1,0,0
9,1999,980000,0,0,0,0
10,1999,980000,3,3,0,0
11,1999,980000,12,11,1,0
12,1999,980000,19,19,0,0
1,2000,980000,21,21,0,0
2,2000,980000,57,55,2,1
3,2000,980000,60,60,0,2
4,2000,980000,63,62,1,0
5,2000,980000,79,79,0,1
6,2000,980000,92,92,0,0
7,2000,980000,98,98,0,0
8,2000,980000,86,85,1,0
9,2000,980000,80,80,0,0
10,2000,980000,80,79,1,0
11,2000,980000,74,72,2,1
12,2000,980000,84,84,0,0
1,2001,980000,69,69,0,1
2,2001,980000,63,63,0,0
3,2001,980000,86,86,0,0
4,2001,980000,75,75,0,0
5,2001,980000,80,78,2,0
6,2001,980000,94,91,3,0
7,2001,980000,105,103,2,0
8,2001,980000,109,108,1,0
9,2001,980000,64,64,0,0
10,2001,980000,63,63,0,1
11,2001,980000,53,53,0,1
12,2001,980000,47,47,0,1
1,2002,980000,54,54,0,0
2,2002,980000,57,55,2,0
3,2002,980000,56,56,0,1
4,2002,980000,68,67,1,2
5,2002,980000,50,50,0,5
6,2002,980000,54,54,0,4
7,2002,980000,57,54,3,5
8,2002,980000,65,64,1,7
9,2002,980000,57,56,1,5
10,2002,980000,41,39,2,1
11,2002,980000,46,45,1,3
12,2002,980000,48,48,0,8
1,2003,980000,43,43,0,6
2,2003,980000,30,29,1,2
3,2003,980000,40,40,0,1
4,2003,980000,43,42,1,4
5,2003,980000,31,30,1,6
6,2003,980000,47,47,0,3
7,2003,980000,42,41,1,1
8,2003,980000,43,43,0,4
9,2003,980000,34,31,3,1
10,2003,980000,49,48,1,4
11,2003,980000,42,40,2,5
12,2003,980000,61,58,3,2
1,2004,980000,41,41,0,1
2,2004,980000,52,52,0,0
3,2004,980000,38,37,1,2
4,2004,980000,38,38,0,2
5,2004,980000,52,50,2,1
6,2004,980000,39,38,1,7
7,2004,980000,57,56,1,1
8,2004,980000,42,42,0,3
9,2004,980000,52,51,1,3
10,2004,980000,43,43,0,3
11,2004,980000,42,41,1,2
12,2004,980000,43,43,0,3
1,2005,980000,42,41,1,3
2,2005,980000,48,48,0,2
3,2005,980000,38,37,1,0
4,2005,980000,39,39,0,0
5,2005,980000,49,47,2,2
6,2005,980000,41,41,0,1
7,2005,980000,42,42,0,1
8,2005,980000,53,52,1,0
9,2005,980000,43,42,1,2
10,2005,980000,56,56,0,3
11,2005,980000,38,38,0,1
12,2005,980000,42,42,0,0
1,2006,980000,55,54,1,2
2,2006,980000,47,46,1,0
3,2006,980000,45,45,0,3
4,2006,980000,35,35,0,2
5,2006,980000,52,52,0,5
6,2006,980000,51,51,0,0
7,2006,980000,50,49,1,2
8,2006,980000,58,58,0,1
9,2006,980000,49,47,2,2
10,2006,980000,68,68,0,3
11,2006,980000,54,53,1,1
12,2006,980000,60,59,1,3
1,2007,980000,56,55,1,1
2,2007,980000,30,30,0,0
3,2007,980000,46,44,2,2
4,2007,980000,46,45,1,3
5,2007,980000,55,55,0,0
6,2007,980000,52,52,0,0
7,2007,980000,43,43,0,0
8,2007,980000,37,37,0,2
9,2007,980000,36,35,1,1
10,2007,980000,40,40,0,2
11,2007,980000,39,39,0,0
12,2007,980000,56,55,1,1
1,2008,980000,57,56,1,0
2,2008,980000,35,35,0,1
3,2008,980000,49,49,0,1
4,2008,980000,42,41,1,1
5,2008,980000,42,42,0,0
6,2008,980000,45,45,0,2
7,2008,980000,43,43,0,0
8,2008,980000,48,47,1,2
9,2008,980000,42,42,0,2
10,2008,980000,43,43,0,2
11,2008,980000,28,28,0,1
12,2008,980000,33,33,0,2
1,2009,980000,26,26,0,4
2,2009,980000,40,40,0,1
3,2009,980000,36,36,0,1
4,2009,980000,28,28,0,1
5,2009,980000,26,26,0,1
6,2009,980000,38,38,0,1
7,2009,980000,35,35,0,2
8,2009,980000,33,33,0,0
9,2009,980000,34,34,0,0
10,2009,980000,39,38,1,1
11,2009,980000,38,38,0,1
12,2009,980000,39,39,0,2
1,2010,980000,11,11,0,0
2,2010,980000,6,6,0,0
3,2010,980000,11,11,0,0
4,2010,980000,11,11,0,0
5,2010,980000,3,3,0,0
6,2010,980000,10,10,0,0
7,2010,980000,14,14,0,0
8,2010,980000,8,8,0,0
9,2010,980000,11,11,0,1
10,2010,980000,7,7,0,0
11,2010,980000,6,5,1,0
12,2010,980000,5,5,0,0
1,2011,980000,5,5,0,0
2,2011,980000,3,3,0,1
1,1999,140602,20,13,7,5
2,1999,140602,21,17,4,3
3,1999,140602,23,19,4,7
4,1999,140602,21,18,3,7
5,1999,140602,23,20,3,13
6,1999,140602,20,17,3,4
7,1999,140602,30,23,7,6
8,1999,140602,26,22,4,3
9,1999,140602,19,15,4,10
10,1999,140602,19,16,3,10
11,1999,140602,16,13,3,8
12,1999,140602,19,16,3,5
1,2000,140602,20,19,1,8
2,2000,140602,28,26,2,5
3,2000,140602,20,16,4,6
4,2000,140602,22,19,3,3
5,2000,140602,24,20,4,5
6,2000,140602,23,19,4,4
7,2000,140602,19,13,6,4
8,2000,140602,24,17,7,9
9,2000,140602,15,13,2,9
10,2000,140602,22,18,4,1
11,2000,140602,24,18,6,2
12,2000,140602,11,9,2,5
1,2001,140602,15,13,2,2
2,2001,140602,17,14,3,3
3,2001,140602,17,17,0,4
4,2001,140602,10,8,2,4
5,2001,140602,19,14,5,5
6,2001,140602,24,18,6,4
7,2001,140602,22,18,4,6
8,2001,140602,18,16,2,1
9,2001,140602,26,24,2,2
10,2001,140602,23,20,3,6
11,2001,140602,12,10,2,6
12,2001,140602,14,13,1,6
1,2002,140602,16,13,3,3
2,2002,140602,15,13,2,6
3,2002,140602,16,13,3,1
4,2002,140602,5,5,0,3
5,2002,140602,14,9,5,1
6,2002,140602,9,6,3,4
7,2002,140602,28,26,2,5
8,2002,140602,35,30,5,8
9,2002,140602,22,21,1,5
10,2002,140602,28,24,4,3
11,2002,140602,31,27,4,1
12,2002,140602,22,19,3,0
1,2003,140602,16,13,3,2
2,2003,140602,14,13,1,2
3,2003,140602,14,14,0,7
4,2003,140602,22,22,0,8
5,2003,140602,17,13,4,8
6,2003,140602,9,5,4,5
7,2003,140602,41,36,5,3
8,2003,140602,16,12,4,6
9,2003,140602,22,18,4,5
10,2003,140602,16,15,1,5
11,2003,140602,20,15,5,1
12,2003,140602,17,16,1,4
1,2004,140602,16,14,2,3
2,2004,140602,14,12,2,3
3,2004,140602,8,8,0,4
4,2004,140602,13,10,3,5
5,2004,140602,20,19,1,2
6,2004,140602,17,15,2,3
7,2004,140602,16,13,3,6
8,2004,140602,29,29,0,6
9,2004,140602,14,11,3,2
10,2004,140602,18,14,4,9
11,2004,140602,18,15,3,0
12,2004,140602,13,12,1,7
1,2005,140602,22,18,4,6
2,2005,140602,14,13,1,8
3,2005,140602,15,14,1,12
4,2005,140602,23,20,3,5
5,2005,140602,21,18,3,8
6,2005,140602,16,12,4,1
7,2005,140602,14,13,1,8
8,2005,140602,27,25,2,6
9,2005,140602,26,23,3,10
10,2005,140602,19,15,4,8
11,2005,140602,32,31,1,10
12,2005,140602,11,11,0,6
1,2006,140602,23,22,1,7
2,2006,140602,18,17,1,1
3,2006,140602,14,13,1,2
4,2006,140602,16,13,3,3
5,2006,140602,15,13,2,4
6,2006,140602,17,16,1,8
7,2006,140602,25,22,3,4
8,2006,140602,25,21,4,4
9,2006,140602,19,19,0,8
10,2006,140602,16,15,1,7
11,2006,140602,12,10,2,2
12,2006,140602,14,12,2,3
1,2007,140602,20,16,4,2
2,2007,140602,10,9,1,3
3,2007,140602,18,15,3,6
4,2007,140602,15,14,1,9
5,2007,140602,18,16,2,5
6,2007,140602,15,11,4,6
7,2007,140602,25,21,4,2
8,2007,140602,21,18,3,3
9,2007,140602,20,18,2,8
10,2007,140602,19,13,6,5
11,2007,140602,10,8,2,1
12,2007,140602,14,13,1,1
1,2008,140602,11,11,0,0
2,2008,140602,14,11,3,5
3,2008,140602,15,12,3,3
4,2008,140602,11,10,1,9
5,2008,140602,18,12,6,5
6,2008,140602,11,8,3,2
7,2008,140602,25,22,3,3
8,2008,140602,13,12,1,5
9,2008,140602,16,13,3,5
10,2008,140602,16,13,3,3
11,2008,140602,15,15,0,1
12,2008,140602,11,11,0,3
1,2009,140602,11,8,3,0
2,2009,140602,13,11,2,6
3,2009,140602,14,9,5,1
4,2009,140602,7,4,3,5
5,2009,140602,10,8,2,4
6,2009,140602,15,14,1,3
7,2009,140602,11,8,3,1
8,2009,140602,12,11,1,2
9,2009,140602,10,8,2,7
10,2009,140602,11,9,2,1
11,2009,140602,18,15,3,3
12,2009,140602,16,14,2,2
1,2010,140602,13,10,3,2
2,2010,140602,11,10,1,5
3,2010,140602,16,13,3,3
4,2010,140602,14,13,1,7
5,2010,140602,10,10,0,8
6,2010,140602,18,13,5,7
7,2010,140602,19,16,3,4
8,2010,140602,12,10,2,5
9,2010,140602,8,8,0,3
10,2010,140602,16,13,3,9
11,2010,140602,12,12,0,7
12,2010,140602,11,11,0,2
1,2011,140602,7,6,1,6
2,2011,140602,11,11,0,0
1,1999,140702,22,19,3,5
2,1999,140702,18,16,2,15
3,1999,140702,8,5,3,8
4,1999,140702,8,8,0,11
5,1999,140702,22,17,5,3
6,1999,140702,18,12,6,9
7,1999,140702,20,17,3,8
8,1999,140702,32,24,8,10
9,1999,140702,27,19,8,18
10,1999,140702,22,18,4,12
11,1999,140702,16,11,5,8
12,1999,140702,27,24,3,8
1,2000,140702,27,21,6,6
2,2000,140702,17,15,2,15
3,2000,140702,14,12,2,4
4,2000,140702,12,9,3,4
5,2000,140702,19,17,2,8
6,2000,140702,18,14,4,6
7,2000,140702,10,7,3,7
8,2000,140702,20,17,3,10
9,2000,140702,17,12,5,12
10,2000,140702,18,17,1,16
11,2000,140702,22,20,2,8
12,2000,140702,16,13,3,5
1,2001,140702,21,19,2,10
2,2001,140702,11,9,2,4
3,2001,140702,18,17,1,2
4,2001,140702,15,15,0,6
5,2001,140702,19,16,3,9
6,2001,140702,7,6,1,3
7,2001,140702,23,18,5,2
8,2001,140702,20,17,3,3
9,2001,140702,22,20,2,4
10,2001,140702,18,14,4,9
11,2001,140702,11,10,1,2
12,2001,140702,14,11,3,3
1,2002,140702,15,13,2,8
2,2002,140702,16,13,3,6
3,2002,140702,10,10,0,3
4,2002,140702,24,22,2,8
5,2002,140702,21,21,0,4
6,2002,140702,22,15,7,2
7,2002,140702,18,15,3,3
8,2002,140702,22,18,4,3
9,2002,140702,24,22,2,6
10,2002,140702,16,14,2,3
11,2002,140702,28,23,5,6
12,2002,140702,16,14,2,6
1,2003,140702,23,20,3,7
2,2003,140702,21,19,2,7
3,2003,140702,17,16,1,4
4,2003,140702,22,21,1,0
5,2003,140702,16,15,1,6
6,2003,140702,11,9,2,4
7,2003,140702,15,12,3,4
8,2003,140702,24,21,3,2
9,2003,140702,25,19,6,1
10,2003,140702,17,13,4,9
11,2003,140702,16,16,0,1
12,2003,140702,19,17,2,4
1,2004,140702,13,11,2,4
2,2004,140702,13,11,2,3
3,2004,140702,11,9,2,7
4,2004,140702,10,9,1,5
5,2004,140702,16,16,0,5
6,2004,140702,14,13,1,10
7,2004,140702,10,9,1,2
8,2004,140702,14,10,4,2
9,2004,140702,23,19,4,4
10,2004,140702,15,14,1,3
11,2004,140702,10,10,0,2
12,2004,140702,14,13,1,5
1,2005,140702,20,20,0,5
2,2005,140702,19,19,0,5
3,2005,140702,15,15,0,7
4,2005,140702,21,19,2,7
5,2005,140702,14,11,3,8
6,2005,140702,14,9,5,3
7,2005,140702,13,11,2,6
8,2005,140702,20,16,4,9
9,2005,140702,15,15,0,11
10,2005,140702,20,19,1,6
11,2005,140702,19,18,1,6
12,2005,140702,17,15,2,4
1,2006,140702,14,13,1,6
2,2006,140702,8,8,0,14
3,2006,140702,10,10,0,4
4,2006,140702,14,12,2,2
5,2006,140702,15,13,2,4
6,2006,140702,14,11,3,7
7,2006,140702,21,20,1,1
8,2006,140702,17,17,0,5
9,2006,140702,15,14,1,7
10,2006,140702,24,18,6,5
11,2006,140702,22,21,1,5
12,2006,140702,14,14,0,3
1,2007,140702,15,13,2,2
2,2007,140702,12,12,0,9
3,2007,140702,13,12,1,8
4,2007,140702,10,9,1,0
5,2007,140702,17,13,4,9
6,2007,140702,17,16,1,3
7,2007,140702,11,9,2,2
8,2007,140702,17,14,3,4
9,2007,140702,13,11,2,8
10,2007,140702,15,15,0,7
11,2007,140702,8,8,0,7
12,2007,140702,21,18,3,9
1,2008,140702,14,12,2,8
2,2008,140702,8,8,0,2
3,2008,140702,10,9,1,3
4,2008,140702,21,19,2,6
5,2008,140702,18,15,3,4
6,2008,140702,15,14,1,1
7,2008,140702,14,11,3,9
8,2008,140702,17,14,3,2
9,2008,140702,21,14,7,3
10,2008,140702,10,9,1,0
11,2008,140702,17,14,3,6
12,2008,140702,17,13,4,5
1,2009,140702,18,16,2,3
2,2009,140702,18,13,5,3
3,2009,140702,15,10,5,10
4,2009,140702,14,14,0,1
5,2009,140702,7,6,1,3
6,2009,140702,17,16,1,3
7,2009,140702,15,15,0,3
8,2009,140702,14,10,4,8
9,2009,140702,15,10,5,3
10,2009,140702,19,15,4,9
11,2009,140702,17,15,2,3
12,2009,140702,13,12,1,3
1,2010,140702,12,10,2,5
2,2010,140702,11,10,1,5
3,2010,140702,21,17,4,4
4,2010,140702,13,12,1,5
5,2010,140702,16,16,0,4
6,2010,140702,13,12,1,4
7,2010,140702,10,9,1,4
8,2010,140702,17,9,8,3
9,2010,140702,15,12,3,3
10,2010,140702,22,19,3,5
11,2010,140702,22,21,1,10
12,2010,140702,21,18,3,9
1,2011,140702,11,8,3,6
2,2011,140702,9,8,1,1
1,1999,160100,6,6,0,0
2,1999,160100,5,5,0,0
3,1999,160100,6,6,0,4
4,1999,160100,6,6,0,0
5,1999,160100,3,3,0,0
6,1999,160100,6,6,0,0
7,1999,160100,7,7,0,0
8,1999,160100,11,9,2,1
9,1999,160100,12,11,1,2
10,1999,160100,9,7,2,1
11,1999,160100,10,8,2,1
12,1999,160100,6,6,0,0
1,2000,160100,6,5,1,0
2,2000,160100,4,3,1,1
3,2000,160100,8,8,0,0
4,2000,160100,14,12,2,0
5,2000,160100,5,5,0,0
6,2000,160100,16,15,1,0
7,2000,160100,4,4,0,1
8,2000,160100,14,11,3,0
9,2000,160100,7,6,1,0
10,2000,160100,5,3,2,0
11,2000,160100,14,14,0,1
12,2000,160100,3,2,1,0
1,2001,160100,6,5,1,1
2,2001,160100,7,6,1,0
3,2001,160100,9,8,1,0
4,2001,160100,7,7,0,0
5,2001,160100,9,8,1,0
6,2001,160100,5,5,0,0
7,2001,160100,2,2,0,1
8,2001,160100,11,11,0,0
9,2001,160100,5,5,0,0
10,2001,160100,10,10,0,0
11,2001,160100,4,4,0,0
12,2001,160100,4,4,0,1
1,2002,160100,9,8,1,0
2,2002,160100,9,8,1,0
3,2002,160100,4,4,0,1
4,2002,160100,6,6,0,3
5,2002,160100,12,10,2,0
6,2002,160100,10,9,1,0
7,2002,160100,5,5,0,1
8,2002,160100,7,6,1,0
9,2002,160100,2,2,0,2
10,2002,160100,8,8,0,2
11,2002,160100,9,8,1,0
12,2002,160100,13,13,0,0
1,2003,160100,10,8,2,0
2,2003,160100,10,10,0,0
3,2003,160100,1,1,0,0
4,2003,160100,9,8,1,2
5,2003,160100,7,7,0,0
6,2003,160100,12,11,1,0
7,2003,160100,10,9,1,2
8,2003,160100,8,7,1,0
9,2003,160100,8,7,1,2
10,2003,160100,7,7,0,0
11,2003,160100,8,8,0,0
12,2003,160100,3,3,0,2
1,2004,160100,10,9,1,1
2,2004,160100,2,2,0,0
3,2004,160100,4,3,1,0
4,2004,160100,3,3,0,0
5,2004,160100,5,5,0,1
6,2004,160100,8,8,0,0
7,2004,160100,7,6,1,0
8,2004,160100,7,7,0,0
9,2004,160100,9,8,1,1
10,2004,160100,6,6,0,1
11,2004,160100,5,4,1,0
12,2004,160100,6,4,2,0
1,2005,160100,5,5,0,0
2,2005,160100,8,8,0,0
3,2005,160100,3,3,0,0
4,2005,160100,7,7,0,1
5,2005,160100,7,7,0,1
6,2005,160100,8,7,1,0
7,2005,160100,8,7,1,2
8,2005,160100,9,9,0,0
9,2005,160100,6,6,0,0
10,2005,160100,5,5,0,0
11,2005,160100,5,4,1,0
12,2005,160100,8,8,0,0
1,2006,160100,6,5,1,0
2,2006,160100,1,1,0,2
3,2006,160100,4,4,0,0
4,2006,160100,7,7,0,0
5,2006,160100,3,3,0,1
6,2006,160100,6,6,0,0
7,2006,160100,7,7,0,0
8,2006,160100,12,11,1,1
9,2006,160100,6,5,1,1
10,2006,160100,4,4,0,0
11,2006,160100,7,7,0,0
12,2006,160100,7,7,0,1
1,2007,160100,4,3,1,0
2,2007,160100,4,4,0,0
3,2007,160100,2,2,0,0
4,2007,160100,5,5,0,1
5,2007,160100,3,2,1,1
6,2007,160100,14,13,1,0
7,2007,160100,6,6,0,1
8,2007,160100,4,4,0,0
9,2007,160100,3,3,0,2
10,2007,160100,7,6,1,0
11,2007,160100,9,7,2,0
12,2007,160100,4,4,0,1
1,2008,160100,2,2,0,0
2,2008,160100,2,2,0,1
3,2008,160100,9,9,0,0
4,2008,160100,6,5,1,2
5,2008,160100,3,3,0,3
6,2008,160100,7,5,2,1
7,2008,160100,7,7,0,0
8,2008,160100,5,3,2,0
9,2008,160100,9,8,1,0
10,2008,160100,4,4,0,0
11,2008,160100,7,7,0,1
12,2008,160100,3,3,0,0
1,2009,160100,10,10,0,0
2,2009,160100,7,7,0,0
3,2009,160100,6,6,0,1
4,2009,160100,8,7,1,1
5,2009,160100,6,6,0,3
6,2009,160100,6,6,0,0
7,2009,160100,15,13,2,0
8,2009,160100,6,6,0,0
9,2009,160100,4,4,0,0
10,2009,160100,5,5,0,0
11,2009,160100,5,3,2,1
12,2009,160100,8,8,0,2
1,2010,160100,4,4,0,2
2,2010,160100,5,5,0,0
3,2010,160100,5,4,1,0
4,2010,160100,3,3,0,0
5,2010,160100,3,2,1,1
6,2010,160100,11,11,0,0
7,2010,160100,13,13,0,0
8,2010,160100,9,7,2,0
9,2010,160100,9,9,0,0
10,2010,160100,8,8,0,1
11,2010,160100,8,8,0,0
12,2010,160100,12,11,1,0
1,2011,160100,7,7,0,0
2,2011,160100,5,5,0,1
1,1999,140800,8,7,1,1
2,1999,140800,7,7,0,0
3,1999,140800,11,8,3,3
4,1999,140800,17,14,3,3
5,1999,140800,19,16,3,1
6,1999,140800,21,18,3,2
7,1999,140800,18,16,2,4
8,1999,140800,17,17,0,5
9,1999,140800,14,14,0,4
10,1999,140800,9,9,0,1
11,1999,140800,9,7,2,5
12,1999,140800,12,11,1,1
1,2000,140800,11,10,1,1
2,2000,140800,4,4,0,4
3,2000,140800,8,8,0,0
4,2000,140800,12,11,1,3
5,2000,140800,9,8,1,3
6,2000,140800,15,13,2,0
7,2000,140800,17,16,1,1
8,2000,140800,19,17,2,1
9,2000,140800,12,8,4,3
10,2000,140800,12,10,2,2
11,2000,140800,8,5,3,3
12,2000,140800,5,4,1,2
1,2001,140800,11,10,1,2
2,2001,140800,9,8,1,0
3,2001,140800,14,12,2,3
4,2001,140800,14,13,1,3
5,2001,140800,13,13,0,3
6,2001,140800,17,14,3,1
7,2001,140800,9,8,1,2
8,2001,140800,11,9,2,1
9,2001,140800,13,12,1,6
10,2001,140800,7,7,0,1
11,2001,140800,13,11,2,1
12,2001,140800,4,3,1,0
1,2002,140800,11,11,0,0
2,2002,140800,9,9,0,3
3,2002,140800,4,2,2,1
4,2002,140800,7,7,0,0
5,2002,140800,10,9,1,2
6,2002,140800,25,25,0,1
7,2002,140800,12,11,1,0
8,2002,140800,9,8,1,1
9,2002,140800,12,11,1,2
10,2002,140800,12,11,1,2
11,2002,140800,11,11,0,0
12,2002,140800,17,17,0,1
1,2003,140800,15,14,1,1
2,2003,140800,8,8,0,0
3,2003,140800,6,6,0,2
4,2003,140800,14,14,0,1
5,2003,140800,16,13,3,2
6,2003,140800,10,8,2,0
7,2003,140800,20,18,2,2
8,2003,140800,13,12,1,0
9,2003,140800,17,17,0,2
10,2003,140800,12,12,0,2
11,2003,140800,5,4,1,3
12,2003,140800,10,9,1,1
1,2004,140800,9,8,1,0
2,2004,140800,8,6,2,2
3,2004,140800,17,12,5,1
4,2004,140800,9,8,1,0
5,2004,140800,13,12,1,3
6,2004,140800,12,12,0,0
7,2004,140800,15,14,1,0
8,2004,140800,17,16,1,0
9,2004,140800,15,14,1,0
10,2004,140800,11,11,0,5
11,2004,140800,14,12,2,4
12,2004,140800,12,12,0,2
1,2005,140800,5,4,1,1
2,2005,140800,6,6,0,0
3,2005,140800,9,9,0,2
4,2005,140800,11,11,0,2
5,2005,140800,11,10,1,1
6,2005,140800,14,14,0,0
7,2005,140800,9,8,1,0
8,2005,140800,7,6,1,1
9,2005,140800,12,11,1,0
10,2005,140800,9,8,1,2
11,2005,140800,6,6,0,4
12,2005,140800,4,4,0,0
1,2006,140800,7,7,0,2
2,2006,140800,18,18,0,2
3,2006,140800,10,10,0,1
4,2006,140800,10,9,1,3
5,2006,140800,14,11,3,1
6,2006,140800,6,5,1,0
7,2006,140800,13,13,0,1
8,2006,140800,8,8,0,1
9,2006,140800,10,9,1,1
10,2006,140800,11,11,0,3
11,2006,140800,8,5,3,1
12,2006,140800,4,3,1,3
1,2007,140800,8,8,0,6
2,2007,140800,7,6,1,4
3,2007,140800,5,3,2,2
4,2007,140800,7,7,0,2
5,2007,140800,9,8,1,1
6,2007,140800,11,11,0,1
7,2007,140800,9,7,2,3
8,2007,140800,5,5,0,1
9,2007,140800,10,9,1,5
10,2007,140800,11,11,0,3
11,2007,140800,6,6,0,3
12,2007,140800,7,7,0,1
1,2008,140800,13,13,0,0
2,2008,140800,5,4,1,2
3,2008,140800,9,9,0,2
4,2008,140800,6,6,0,1
5,2008,140800,5,5,0,2
6,2008,140800,5,3,2,1
7,2008,140800,10,10,0,0
8,2008,140800,15,15,0,3
9,2008,140800,11,10,1,0
10,2008,140800,8,8,0,1
11,2008,140800,13,13,0,2
12,2008,140800,9,9,0,0
1,2009,140800,8,7,1,2
2,2009,140800,10,10,0,0
3,2009,140800,10,10,0,2
4,2009,140800,9,9,0,2
5,2009,140800,9,9,0,0
6,2009,140800,10,10,0,0
7,2009,140800,8,7,1,2
8,2009,140800,12,11,1,4
9,2009,140800,14,12,2,2
10,2009,140800,14,14,0,2
11,2009,140800,10,10,0,2
12,2009,140800,18,18,0,2
1,2010,140800,7,7,0,2
2,2010,140800,9,9,0,0
3,2010,140800,9,9,0,0
4,2010,140800,11,11,0,1
5,2010,140800,9,8,1,2
6,2010,140800,18,17,1,3
7,2010,140800,17,15,2,4
8,2010,140800,7,7,0,1
9,2010,140800,14,14,0,2
10,2010,140800,13,13,0,3
11,2010,140800,10,10,0,0
12,2010,140800,8,8,0,1
1,2011,140800,10,9,1,2
2,2011,140800,2,2,0,1
1,1999,040800,5,4,1,0
2,1999,040800,8,8,0,1
3,1999,040800,6,6,0,2
4,1999,040800,13,13,0,2
5,1999,040800,10,9,1,0
6,1999,040800,8,7,1,4
7,1999,040800,7,6,1,2
8,1999,040800,20,18,2,0
9,1999,040800,9,9,0,1
10,1999,040800,15,15,0,1
11,1999,040800,12,12,0,1
12,1999,040800,4,4,0,4
1,2000,040800,7,7,0,0
2,2000,040800,4,4,0,0
3,2000,040800,4,3,1,2
4,2000,040800,8,8,0,3
5,2000,040800,6,5,1,0
6,2000,040800,14,9,5,1
7,2000,040800,13,11,2,3
8,2000,040800,11,11,0,1
9,2000,040800,8,5,3,0
10,2000,040800,15,15,0,1
11,2000,040800,8,7,1,0
12,2000,040800,5,5,0,0
1,2001,040800,2,2,0,4
2,2001,040800,13,11,2,4
3,2001,040800,6,5,1,0
4,2001,040800,11,6,5,4
5,2001,040800,13,13,0,3
6,2001,040800,10,10,0,0
7,2001,040800,7,6,1,0
8,2001,040800,7,5,2,1
9,2001,040800,7,7,0,1
10,2001,040800,7,7,0,0
11,2001,040800,11,10,1,0
12,2001,040800,6,6,0,1
1,2002,040800,4,4,0,3
2,2002,040800,7,7,0,1
3,2002,040800,5,5,0,0
4,2002,040800,5,4,1,1
5,2002,040800,12,10,2,0
6,2002,040800,6,6,0,1
7,2002,040800,5,5,0,1
8,2002,040800,13,13,0,3
9,2002,040800,15,15,0,1
10,2002,040800,9,7,2,0
11,2002,040800,4,4,0,3
12,2002,040800,15,15,0,1
1,2003,040800,8,8,0,2
2,2003,040800,9,9,0,1
3,2003,040800,16,16,0,1
4,2003,040800,10,7,3,0
5,2003,040800,10,10,0,0
6,2003,040800,10,7,3,1
7,2003,040800,10,10,0,0
8,2003,040800,10,10,0,2
9,2003,040800,11,11,0,3
10,2003,040800,6,5,1,2
11,2003,040800,7,6,1,1
12,2003,040800,3,3,0,3
1,2004,040800,15,13,2,0
2,2004,040800,7,6,1,7
3,2004,040800,5,5,0,7
4,2004,040800,6,6,0,1
5,2004,040800,16,16,0,0
6,2004,040800,11,11,0,1
7,2004,040800,8,8,0,2
8,2004,040800,8,8,0,3
9,2004,040800,10,10,0,1
10,2004,040800,9,9,0,1
11,2004,040800,6,6,0,0
12,2004,040800,8,8,0,2
1,2005,040800,7,7,0,0
2,2005,040800,3,2,1,1
3,2005,040800,10,10,0,0
4,2005,040800,10,9,1,3
5,2005,040800,7,6,1,4
6,2005,040800,10,10,0,3
7,2005,040800,16,15,1,3
8,2005,040800,9,8,1,3
9,2005,040800,4,4,0,3
10,2005,040800,6,6,0,0
11,2005,040800,5,5,0,0
12,2005,040800,6,6,0,2
1,2006,040800,8,8,0,2
2,2006,040800,9,9,0,2
3,2006,040800,4,4,0,1
4,2006,040800,10,8,2,2
5,2006,040800,5,5,0,1
6,2006,040800,8,8,0,0
7,2006,040800,12,12,0,0
8,2006,040800,10,10,0,3
9,2006,040800,11,10,1,1
10,2006,040800,10,8,2,2
11,2006,040800,4,4,0,0
12,2006,040800,7,7,0,3
1,2007,040800,4,3,1,4
2,2007,040800,5,5,0,1
3,2007,040800,2,2,0,5
4,2007,040800,3,3,0,2
5,2007,040800,4,3,1,1
6,2007,040800,7,6,1,2
7,2007,040800,10,8,2,3
8,2007,040800,4,4,0,2
9,2007,040800,3,3,0,5
10,2007,040800,7,6,1,1
11,2007,040800,7,7,0,2
12,2007,040800,12,12,0,1
1,2008,040800,7,7,0,2
2,2008,040800,4,4,0,2
3,2008,040800,7,6,1,3
4,2008,040800,7,6,1,1
5,2008,040800,3,3,0,2
6,2008,040800,9,9,0,1
7,2008,040800,10,9,1,3
8,2008,040800,4,3,1,2
9,2008,040800,17,15,2,0
10,2008,040800,6,4,2,0
11,2008,040800,11,9,2,1
12,2008,040800,9,8,1,0
1,2009,040800,7,5,2,0
2,2009,040800,6,5,1,2
3,2009,040800,9,9,0,2
4,2009,040800,1,1,0,1
5,2009,040800,3,3,0,1
6,2009,040800,9,7,2,1
7,2009,040800,5,5,0,0
8,2009,040800,3,2,1,3
9,2009,040800,3,2,1,1
10,2009,040800,11,10,1,1
11,2009,040800,6,6,0,1
12,2009,040800,4,4,0,3
1,2010,040800,11,11,0,3
2,2010,040800,7,7,0,0
3,2010,040800,3,2,1,2
4,2010,040800,6,6,0,2
5,2010,040800,5,5,0,1
6,2010,040800,7,7,0,0
7,2010,040800,8,8,0,1
8,2010,040800,7,7,0,0
9,2010,040800,8,7,1,0
10,2010,040800,15,15,0,1
11,2010,040800,2,2,0,0
12,2010,040800,5,5,0,2
1,2011,040800,4,3,1,2
2,2011,040800,1,1,0,1
1,1999,040900,9,9,0,0
2,1999,040900,9,8,1,0
3,1999,040900,6,5,1,0
4,1999,040900,10,10,0,2
5,1999,040900,11,10,1,1
6,1999,040900,11,11,0,0
7,1999,040900,7,6,1,1
8,1999,040900,8,8,0,2
9,1999,040900,11,11,0,0
10,1999,040900,2,2,0,1
11,1999,040900,9,9,0,0
12,1999,040900,7,7,0,0
1,2000,040900,7,7,0,2
2,2000,040900,10,10,0,1
3,2000,040900,6,5,1,2
4,2000,040900,10,9,1,0
5,2000,040900,4,4,0,1
6,2000,040900,8,6,2,0
7,2000,040900,14,12,2,2
8,2000,040900,12,11,1,0
9,2000,040900,6,6,0,0
10,2000,040900,4,4,0,0
11,2000,040900,6,5,1,0
12,2000,040900,3,3,0,0
1,2001,040900,3,2,1,1
2,2001,040900,9,6,3,0
3,2001,040900,9,9,0,2
4,2001,040900,2,2,0,1
5,2001,040900,4,4,0,0
6,2001,040900,7,7,0,1
7,2001,040900,6,5,1,1
8,2001,040900,8,8,0,2
9,2001,040900,8,7,1,0
10,2001,040900,5,5,0,0
11,2001,040900,8,8,0,1
12,2001,040900,4,4,0,0
1,2002,040900,8,8,0,1
2,2002,040900,7,7,0,0
3,2002,040900,8,8,0,0
4,2002,040900,3,2,1,0
5,2002,040900,6,5,1,0
6,2002,040900,5,4,1,0
7,2002,040900,7,6,1,0
8,2002,040900,12,11,1,2
9,2002,040900,9,9,0,0
10,2002,040900,14,14,0,0
11,2002,040900,12,12,0,0
12,2002,040900,19,19,0,0
1,2003,040900,9,9,0,0
2,2003,040900,7,7,0,1
3,2003,040900,1,1,0,3
4,2003,040900,8,7,1,1
5,2003,040900,9,9,0,0
6,2003,040900,9,8,1,1
7,2003,040900,8,7,1,3
8,2003,040900,4,4,0,1
9,2003,040900,8,8,0,1
10,2003,040900,5,5,0,0
11,2003,040900,9,9,0,0
12,2003,040900,1,1,0,1
1,2004,040900,10,10,0,0
2,2004,040900,4,4,0,1
3,2004,040900,6,6,0,0
4,2004,040900,6,6,0,0
5,2004,040900,14,14,0,0
6,2004,040900,6,6,0,0
7,2004,040900,9,9,0,0
8,2004,040900,8,7,1,0
9,2004,040900,7,6,1,0
10,2004,040900,10,9,1,0
11,2004,040900,9,9,0,1
12,2004,040900,3,3,0,1
1,2005,040900,6,6,0,1
2,2005,040900,5,5,0,1
3,2005,040900,5,5,0,2
4,2005,040900,5,5,0,1
5,2005,040900,6,6,0,2
6,2005,040900,5,5,0,1
7,2005,040900,5,5,0,0
8,2005,040900,7,6,1,0
9,2005,040900,8,8,0,3
10,2005,040900,7,6,1,0
11,2005,040900,2,1,1,0
12,2005,040900,6,6,0,0
1,2006,040900,4,4,0,0
2,2006,040900,5,4,1,0
3,2006,040900,8,8,0,0
4,2006,040900,6,4,2,2
5,2006,040900,8,7,1,1
6,2006,040900,5,5,0,1
7,2006,040900,6,6,0,0
8,2006,040900,6,6,0,0
9,2006,040900,4,3,1,0
10,2006,040900,11,10,1,1
11,2006,040900,4,4,0,2
12,2006,040900,7,7,0,0
1,2007,040900,6,6,0,1
2,2007,040900,3,3,0,2
3,2007,040900,4,4,0,0
4,2007,040900,4,4,0,0
5,2007,040900,5,5,0,0
6,2007,040900,9,9,0,3
7,2007,040900,16,16,0,3
8,2007,040900,5,4,1,1
9,2007,040900,9,8,1,2
10,2007,040900,8,7,1,0
11,2007,040900,8,8,0,1
12,2007,040900,3,3,0,0
1,2008,040900,6,6,0,1
2,2008,040900,4,4,0,0
3,2008,040900,2,2,0,2
4,2008,040900,5,5,0,0
5,2008,040900,8,8,0,0
6,2008,040900,5,5,0,0
7,2008,040900,13,12,1,3
8,2008,040900,5,5,0,2
9,2008,040900,11,11,0,0
10,2008,040900,9,9,0,1
11,2008,040900,4,4,0,0
12,2008,040900,7,6,1,0
1,2009,040900,3,3,0,0
2,2009,040900,5,4,1,1
3,2009,040900,8,8,0,1
4,2009,040900,5,5,0,0
5,2009,040900,4,3,1,1
6,2009,040900,8,7,1,1
7,2009,040900,6,6,0,2
8,2009,040900,10,10,0,0
9,2009,040900,5,5,0,0
10,2009,040900,7,7,0,0
11,2009,040900,7,6,1,1
12,2009,040900,5,5,0,0
1,2010,040900,3,3,0,0
2,2010,040900,6,5,1,0
3,2010,040900,3,3,0,0
4,2010,040900,4,4,0,0
5,2010,040900,11,11,0,0
6,2010,040900,9,9,0,0
7,2010,040900,9,9,0,0
8,2010,040900,11,11,0,0
9,2010,040900,5,5,0,0
10,2010,040900,3,3,0,0
11,2010,040900,4,4,0,0
12,2010,040900,1,1,0,0
1,2011,040900,2,2,0,0
2,2011,040900,0,0,0,1
1,1999,140500,13,11,2,0
2,1999,140500,7,7,0,0
3,1999,140500,15,13,2,0
4,1999,140500,9,9,0,2
5,1999,140500,13,11,2,2
6,1999,140500,17,14,3,0
7,1999,140500,19,18,1,0
8,1999,140500,10,9,1,1
9,1999,140500,10,10,0,1
10,1999,140500,7,7,0,0
11,1999,140500,7,7,0,0
12,1999,140500,12,12,0,1
1,2000,140500,8,8,0,2
2,2000,140500,10,9,1,1
3,2000,140500,16,16,0,2
4,2000,140500,15,15,0,0
5,2000,140500,8,7,1,1
6,2000,140500,7,7,0,0
7,2000,140500,11,11,0,0
8,2000,140500,8,7,1,2
9,2000,140500,16,12,4,0
10,2000,140500,8,7,1,0
11,2000,140500,14,12,2,0
12,2000,140500,7,7,0,0
1,2001,140500,6,4,2,0
2,2001,140500,10,8,2,2
3,2001,140500,10,9,1,1
4,2001,140500,13,12,1,0
5,2001,140500,12,11,1,0
6,2001,140500,8,6,2,2
7,2001,140500,8,8,0,1
8,2001,140500,13,12,1,1
9,2001,140500,13,11,2,2
10,2001,140500,15,15,0,1
11,2001,140500,7,7,0,0
12,2001,140500,12,11,1,1
1,2002,140500,13,12,1,2
2,2002,140500,12,12,0,1
3,2002,140500,9,9,0,0
4,2002,140500,9,9,0,0
5,2002,140500,7,4,3,1
6,2002,140500,9,8,1,0
7,2002,140500,13,12,1,0
8,2002,140500,10,9,1,0
9,2002,140500,13,13,0,1
10,2002,140500,8,6,2,0
11,2002,140500,7,6,1,3
12,2002,140500,6,5,1,0
1,2003,140500,13,11,2,4
2,2003,140500,6,5,1,2
3,2003,140500,11,11,0,1
4,2003,140500,8,7,1,1
5,2003,140500,9,8,1,0
6,2003,140500,14,14,0,4
7,2003,140500,9,9,0,0
8,2003,140500,22,22,0,0
9,2003,140500,11,10,1,0
10,2003,140500,8,7,1,0
11,2003,140500,8,6,2,0
12,2003,140500,7,6,1,2
1,2004,140500,4,4,0,1
2,2004,140500,10,10,0,0
3,2004,140500,7,7,0,2
4,2004,140500,10,10,0,1
5,2004,140500,9,9,0,0
6,2004,140500,14,13,1,0
7,2004,140500,12,11,1,0
8,2004,140500,6,6,0,2
9,2004,140500,7,6,1,0
10,2004,140500,7,7,0,1
11,2004,140500,6,5,1,1
12,2004,140500,10,9,1,0
1,2005,140500,7,7,0,0
2,2005,140500,5,5,0,0
3,2005,140500,7,7,0,1
4,2005,140500,9,9,0,1
5,2005,140500,3,3,0,0
6,2005,140500,4,3,1,2
7,2005,140500,7,7,0,0
8,2005,140500,4,4,0,1
9,2005,140500,6,5,1,1
10,2005,140500,4,4,0,0
11,2005,140500,2,2,0,0
12,2005,140500,8,7,1,5
1,2006,140500,11,11,0,0
2,2006,140500,8,8,0,0
3,2006,140500,10,9,1,0
4,2006,140500,7,7,0,1
5,2006,140500,13,11,2,2
6,2006,140500,9,9,0,3
7,2006,140500,8,8,0,0
8,2006,140500,14,12,2,0
9,2006,140500,9,8,1,0
10,2006,140500,8,8,0,1
11,2006,140500,9,7,2,0
12,2006,140500,8,7,1,0
1,2007,140500,6,5,1,1
2,2007,140500,7,7,0,0
3,2007,140500,12,10,2,0
4,2007,140500,8,8,0,0
5,2007,140500,8,8,0,1
6,2007,140500,9,6,3,0
7,2007,140500,11,11,0,0
8,2007,140500,7,7,0,0
9,2007,140500,4,4,0,0
10,2007,140500,9,9,0,0
11,2007,140500,8,8,0,0
12,2007,140500,8,7,1,0
1,2008,140500,4,3,1,0
2,2008,140500,10,10,0,1
3,2008,140500,18,18,0,0
4,2008,140500,8,7,1,0
5,2008,140500,11,9,2,2
6,2008,140500,13,12,1,0
7,2008,140500,23,19,4,0
8,2008,140500,12,12,0,4
9,2008,140500,12,12,0,0
10,2008,140500,19,17,2,0
11,2008,140500,11,10,1,0
12,2008,140500,5,5,0,0
1,2009,140500,12,12,0,1
2,2009,140500,8,7,1,1
3,2009,140500,12,11,1,2
4,2009,140500,5,5,0,0
5,2009,140500,6,4,2,0
6,2009,140500,10,9,1,3
7,2009,140500,15,15,0,0
8,2009,140500,8,7,1,2
9,2009,140500,12,11,1,0
10,2009,140500,17,16,1,2
11,2009,140500,2,2,0,0
12,2009,140500,6,5,1,0
1,2010,140500,12,12,0,1
2,2010,140500,4,4,0,1
3,2010,140500,5,4,1,0
4,2010,140500,8,8,0,0
5,2010,140500,5,5,0,0
6,2010,140500,8,7,1,0
7,2010,140500,10,9,1,0
8,2010,140500,13,13,0,0
9,2010,140500,9,8,1,0
10,2010,140500,10,10,0,0
11,2010,140500,5,3,2,0
12,2010,140500,11,11,0,0
1,2011,140500,2,2,0,0
2,2011,140500,2,2,0,1
1,1999,830800,8,8,0,0
2,1999,830800,8,8,0,0
3,1999,830800,13,13,0,1
4,1999,830800,8,8,0,0
5,1999,830800,19,18,1,1
6,1999,830800,13,12,1,0
7,1999,830800,17,17,0,2
8,1999,830800,16,15,1,0
9,1999,830800,14,13,1,1
10,1999,830800,17,16,1,0
11,1999,830800,8,7,1,1
12,1999,830800,8,8,0,0
1,2000,830800,8,7,1,1
2,2000,830800,6,5,1,0
3,2000,830800,10,8,2,2
4,2000,830800,10,10,0,0
5,2000,830800,6,6,0,0
6,2000,830800,14,13,1,0
7,2000,830800,15,14,1,0
8,2000,830800,12,10,2,1
9,2000,830800,5,5,0,2
10,2000,830800,9,7,2,0
11,2000,830800,8,7,1,0
12,2000,830800,7,7,0,1
1,2001,830800,8,8,0,0
2,2001,830800,10,9,1,0
3,2001,830800,5,5,0,1
4,2001,830800,4,2,2,1
5,2001,830800,6,6,0,2
6,2001,830800,1,1,0,0
7,2001,830800,8,4,4,0
8,2001,830800,10,10,0,0
9,2001,830800,4,4,0,1
10,2001,830800,10,10,0,0
11,2001,830800,18,18,0,0
12,2001,830800,13,13,0,0
1,2002,830800,9,9,0,1
2,2002,830800,13,13,0,0
3,2002,830800,11,11,0,0
4,2002,830800,6,6,0,0
5,2002,830800,11,9,2,0
6,2002,830800,16,16,0,0
7,2002,830800,32,32,0,0
8,2002,830800,16,16,0,0
9,2002,830800,9,8,1,1
10,2002,830800,7,6,1,0
11,2002,830800,15,15,0,0
12,2002,830800,10,10,0,0
1,2003,830800,5,5,0,0
2,2003,830800,11,11,0,1
3,2003,830800,7,7,0,0
4,2003,830800,11,11,0,0
5,2003,830800,8,6,2,1
6,2003,830800,17,17,0,1
7,2003,830800,10,10,0,0
8,2003,830800,9,9,0,0
9,2003,830800,7,7,0,0
10,2003,830800,13,12,1,1
11,2003,830800,14,14,0,0
12,2003,830800,8,8,0,0
1,2004,830800,9,9,0,0
2,2004,830800,8,8,0,0
3,2004,830800,8,8,0,0
4,2004,830800,5,5,0,0
5,2004,830800,12,12,0,0
6,2004,830800,11,11,0,0
7,2004,830800,11,11,0,0
8,2004,830800,14,14,0,0
9,2004,830800,8,8,0,0
10,2004,830800,7,7,0,0
11,2004,830800,13,12,1,0
12,2004,830800,10,10,0,0
1,2005,830800,6,6,0,0
2,2005,830800,5,5,0,0
3,2005,830800,4,4,0,0
4,2005,830800,3,3,0,1
5,2005,830800,5,4,1,0
6,2005,830800,9,9,0,0
7,2005,830800,14,14,0,0
8,2005,830800,9,9,0,1
9,2005,830800,14,14,0,0
10,2005,830800,16,16,0,0
11,2005,830800,8,8,0,1
12,2005,830800,6,6,0,1
1,2006,830800,13,13,0,0
2,2006,830800,7,7,0,0
3,2006,830800,7,7,0,1
4,2006,830800,6,5,1,0
5,2006,830800,12,9,3,0
6,2006,830800,10,9,1,0
7,2006,830800,10,9,1,0
8,2006,830800,16,16,0,0
9,2006,830800,21,20,1,1
10,2006,830800,10,7,3,2
11,2006,830800,8,8,0,0
12,2006,830800,5,5,0,0
1,2007,830800,5,4,1,0
2,2007,830800,5,5,0,1
3,2007,830800,4,4,0,1
4,2007,830800,6,5,1,0
5,2007,830800,8,8,0,0
6,2007,830800,6,6,0,0
7,2007,830800,7,6,1,0
8,2007,830800,9,9,0,0
9,2007,830800,10,10,0,1
10,2007,830800,3,3,0,0
11,2007,830800,2,2,0,1
12,2007,830800,3,3,0,0
1,2008,830800,4,3,1,0
2,2008,830800,15,15,0,1
3,2008,830800,9,9,0,1
4,2008,830800,3,3,0,0
5,2008,830800,3,3,0,0
6,2008,830800,12,12,0,0
7,2008,830800,9,8,1,0
8,2008,830800,12,9,3,1
9,2008,830800,10,10,0,1
10,2008,830800,13,12,1,1
11,2008,830800,7,7,0,0
12,2008,830800,7,7,0,0
1,2009,830800,5,5,0,0
2,2009,830800,6,6,0,1
3,2009,830800,12,12,0,0
4,2009,830800,9,9,0,1
5,2009,830800,11,9,2,0
6,2009,830800,6,6,0,0
7,2009,830800,16,16,0,0
8,2009,830800,19,19,0,0
9,2009,830800,8,8,0,0
10,2009,830800,12,12,0,1
11,2009,830800,7,7,0,2
12,2009,830800,7,7,0,2
1,2010,830800,3,3,0,0
2,2010,830800,5,5,0,1
3,2010,830800,11,9,2,2
4,2010,830800,8,8,0,1
5,2010,830800,11,11,0,1
6,2010,830800,8,8,0,0
7,2010,830800,15,15,0,0
8,2010,830800,12,11,1,0
9,2010,830800,14,14,0,0
10,2010,830800,10,10,0,0
11,2010,830800,8,7,1,0
12,2010,830800,3,3,0,0
1,2011,830800,9,9,0,0
2,2011,830800,8,8,0,0
1,1999,031900,8,8,0,0
2,1999,031900,17,16,1,0
3,1999,031900,12,12,0,0
4,1999,031900,21,21,0,0
5,1999,031900,13,12,1,3
6,1999,031900,19,17,2,1
7,1999,031900,16,16,0,1
8,1999,031900,21,18,3,1
9,1999,031900,12,11,1,0
10,1999,031900,13,12,1,0
11,1999,031900,16,14,2,1
12,1999,031900,10,10,0,0
1,2000,031900,8,8,0,1
2,2000,031900,8,8,0,4
3,2000,031900,8,7,1,1
4,2000,031900,7,6,1,0
5,2000,031900,11,11,0,1
6,2000,031900,9,9,0,1
7,2000,031900,12,10,2,1
8,2000,031900,12,11,1,0
9,2000,031900,9,9,0,2
10,2000,031900,12,12,0,1
11,2000,031900,7,6,1,0
12,2000,031900,6,6,0,2
1,2001,031900,12,8,4,1
2,2001,031900,4,2,2,0
3,2001,031900,10,8,2,2
4,2001,031900,8,8,0,1
5,2001,031900,6,5,1,2
6,2001,031900,8,8,0,1
7,2001,031900,10,8,2,0
8,2001,031900,11,10,1,0
9,2001,031900,8,7,1,0
10,2001,031900,14,14,0,0
11,2001,031900,7,5,2,0
12,2001,031900,8,7,1,0
1,2002,031900,7,7,0,2
2,2002,031900,9,9,0,1
3,2002,031900,5,5,0,2
4,2002,031900,9,8,1,0
5,2002,031900,10,7,3,1
6,2002,031900,13,13,0,1
7,2002,031900,11,11,0,1
8,2002,031900,17,14,3,0
9,2002,031900,14,12,2,1
10,2002,031900,10,9,1,1
11,2002,031900,11,9,2,0
12,2002,031900,21,21,0,2
1,2003,031900,5,4,1,0
2,2003,031900,10,8,2,0
3,2003,031900,12,12,0,0
4,2003,031900,13,13,0,0
5,2003,031900,15,14,1,1
6,2003,031900,10,9,1,2
7,2003,031900,11,10,1,4
8,2003,031900,13,13,0,0
9,2003,031900,18,18,0,0
10,2003,031900,12,12,0,1
11,2003,031900,12,12,0,0
12,2003,031900,11,11,0,0
1,2004,031900,11,11,0,4
2,2004,031900,3,2,1,0
3,2004,031900,8,7,1,0
4,2004,031900,5,4,1,0
5,2004,031900,17,15,2,0
6,2004,031900,8,8,0,1
7,2004,031900,17,17,0,0
8,2004,031900,14,13,1,0
9,2004,031900,14,13,1,1
10,2004,031900,13,13,0,0
11,2004,031900,12,12,0,0
12,2004,031900,8,8,0,0
1,2005,031900,9,9,0,0
2,2005,031900,5,4,1,2
3,2005,031900,8,8,0,1
4,2005,031900,7,7,0,1
5,2005,031900,7,7,0,0
6,2005,031900,15,14,1,1
7,2005,031900,9,9,0,1
8,2005,031900,10,10,0,2
9,2005,031900,11,10,1,2
10,2005,031900,12,11,1,3
11,2005,031900,11,11,0,0
12,2005,031900,11,11,0,0
1,2006,031900,14,13,1,0
2,2006,031900,8,8,0,1
3,2006,031900,9,9,0,0
4,2006,031900,15,15,0,1
5,2006,031900,11,9,2,0
6,2006,031900,8,7,1,1
7,2006,031900,13,13,0,2
8,2006,031900,10,10,0,2
9,2006,031900,15,15,0,0
10,2006,031900,14,14,0,2
11,2006,031900,9,9,0,2
12,2006,031900,10,10,0,0
1,2007,031900,8,8,0,0
2,2007,031900,6,6,0,7
3,2007,031900,5,5,0,0
4,2007,031900,12,11,1,0
5,2007,031900,7,7,0,3
6,2007,031900,5,5,0,1
7,2007,031900,13,12,1,2
8,2007,031900,12,12,0,0
9,2007,031900,6,5,1,0
10,2007,031900,13,13,0,0
11,2007,031900,12,12,0,1
12,2007,031900,4,4,0,1
1,2008,031900,6,6,0,0
2,2008,031900,5,5,0,1
3,2008,031900,8,8,0,0
4,2008,031900,16,15,1,2
5,2008,031900,8,7,1,0
6,2008,031900,7,7,0,0
7,2008,031900,23,21,2,0
8,2008,031900,15,15,0,1
9,2008,031900,12,11,1,0
10,2008,031900,8,8,0,0
11,2008,031900,12,12,0,0
12,2008,031900,8,7,1,0
1,2009,031900,12,11,1,1
2,2009,031900,10,10,0,1
3,2009,031900,7,7,0,1
4,2009,031900,12,12,0,1
5,2009,031900,8,8,0,1
6,2009,031900,8,7,1,1
7,2009,031900,12,11,1,1
8,2009,031900,9,9,0,0
9,2009,031900,14,13,1,0
10,2009,031900,10,10,0,0
11,2009,031900,7,7,0,0
12,2009,031900,8,8,0,0
1,2010,031900,10,9,1,0
2,2010,031900,7,7,0,1
3,2010,031900,10,9,1,0
4,2010,031900,8,7,1,1
5,2010,031900,9,9,0,1
6,2010,031900,8,8,0,0
7,2010,031900,16,16,0,1
8,2010,031900,16,14,2,0
9,2010,031900,8,8,0,2
10,2010,031900,10,10,0,0
11,2010,031900,8,8,0,1
12,2010,031900,3,3,0,0
1,2011,031900,5,4,1,0
2,2011,031900,8,8,0,0
1,1999,150501,4,4,0,0
2,1999,150501,4,3,1,0
3,1999,150501,6,5,1,0
4,1999,150501,3,2,1,0
5,1999,150501,6,6,0,0
6,1999,150501,3,3,0,0
7,1999,150501,8,7,1,0
8,1999,150501,6,6,0,0
9,1999,150501,3,3,0,0
10,1999,150501,1,1,0,0
11,1999,150501,4,4,0,0
12,1999,150501,2,2,0,0
1,2000,150501,7,7,0,0
2,2000,150501,5,5,0,0
3,2000,150501,6,6,0,0
4,2000,150501,8,8,0,0
5,2000,150501,12,12,0,2
6,2000,150501,10,9,1,2
7,2000,150501,8,8,0,1
8,2000,150501,7,7,0,2
9,2000,150501,4,4,0,0
10,2000,150501,14,13,1,1
11,2000,150501,7,7,0,0
12,2000,150501,5,5,0,0
1,2001,150501,7,7,0,0
2,2001,150501,0,0,0,0
3,2001,150501,4,4,0,1
4,2001,150501,2,2,0,0
5,2001,150501,7,7,0,0
6,2001,150501,9,7,2,0
7,2001,150501,6,6,0,0
8,2001,150501,11,11,0,0
9,2001,150501,8,8,0,0
10,2001,150501,7,6,1,0
11,2001,150501,4,4,0,0
12,2001,150501,2,2,0,0
1,2002,150501,5,5,0,0
2,2002,150501,3,3,0,2
3,2002,150501,0,0,0,0
4,2002,150501,10,10,0,1
5,2002,150501,5,5,0,4
6,2002,150501,4,4,0,1
7,2002,150501,2,2,0,0
8,2002,150501,5,5,0,2
9,2002,150501,4,4,0,2
10,2002,150501,10,10,0,0
11,2002,150501,4,4,0,0
12,2002,150501,11,11,0,0
1,2003,150501,7,6,1,0
2,2003,150501,2,2,0,1
3,2003,150501,5,5,0,0
4,2003,150501,3,3,0,1
5,2003,150501,7,6,1,0
6,2003,150501,10,9,1,0
7,2003,150501,9,9,0,0
8,2003,150501,5,5,0,1
9,2003,150501,5,5,0,3
10,2003,150501,5,5,0,0
11,2003,150501,3,3,0,2
12,2003,150501,8,8,0,0
1,2004,150501,8,8,0,0
2,2004,150501,6,5,1,0
3,2004,150501,5,5,0,0
4,2004,150501,3,3,0,0
5,2004,150501,3,3,0,0
6,2004,150501,7,5,2,0
7,2004,150501,7,7,0,0
8,2004,150501,6,4,2,0
9,2004,150501,8,7,1,0
10,2004,150501,4,4,0,1
11,2004,150501,6,5,1,0
12,2004,150501,2,2,0,0
1,2005,150501,1,1,0,0
2,2005,150501,0,0,0,0
3,2005,150501,5,3,2,0
4,2005,150501,4,4,0,2
5,2005,150501,5,3,2,0
6,2005,150501,8,7,1,0
7,2005,150501,6,5,1,1
8,2005,150501,2,2,0,0
9,2005,150501,2,2,0,2
10,2005,150501,3,2,1,0
11,2005,150501,3,3,0,1
12,2005,150501,6,6,0,0
1,2006,150501,1,1,0,0
2,2006,150501,5,4,1,0
3,2006,150501,3,3,0,0
4,2006,150501,5,5,0,0
5,2006,150501,4,4,0,0
6,2006,150501,4,4,0,4
7,2006,150501,7,7,0,0
8,2006,150501,5,5,0,1
9,2006,150501,2,2,0,0
10,2006,150501,4,4,0,1
11,2006,150501,3,3,0,0
12,2006,150501,2,2,0,1
1,2007,150501,4,4,0,0
2,2007,150501,3,3,0,1
3,2007,150501,6,5,1,0
4,2007,150501,3,3,0,1
5,2007,150501,5,4,1,0
6,2007,150501,7,7,0,1
7,2007,150501,3,3,0,0
8,2007,150501,4,4,0,1
9,2007,150501,6,5,1,1
10,2007,150501,3,2,1,2
11,2007,150501,2,1,1,0
12,2007,150501,10,9,1,0
1,2008,150501,1,1,0,1
2,2008,150501,6,5,1,0
3,2008,150501,7,6,1,1
4,2008,150501,7,6,1,0
5,2008,150501,4,4,0,0
6,2008,150501,1,1,0,0
7,2008,150501,6,5,1,1
8,2008,150501,16,15,1,0
9,2008,150501,7,7,0,1
10,2008,150501,5,4,1,2
11,2008,150501,8,7,1,1
12,2008,150501,3,3,0,0
1,2009,150501,5,4,1,1
2,2009,150501,4,4,0,2
3,2009,150501,5,5,0,0
4,2009,150501,3,3,0,1
5,2009,150501,7,7,0,2
6,2009,150501,5,4,1,2
7,2009,150501,10,10,0,0
8,2009,150501,7,7,0,0
9,2009,150501,8,6,2,1
10,2009,150501,6,4,2,0
11,2009,150501,4,4,0,3
12,2009,150501,3,2,1,2
1,2010,150501,1,1,0,0
2,2010,150501,1,1,0,1
3,2010,150501,4,4,0,0
4,2010,150501,2,2,0,2
5,2010,150501,6,6,0,1
6,2010,150501,3,2,1,0
7,2010,150501,2,1,1,1
8,2010,150501,4,3,1,1
9,2010,150501,3,2,1,1
10,2010,150501,8,6,2,0
11,2010,150501,2,2,0,0
12,2010,150501,7,6,1,2
1,2011,150501,2,1,1,0
2,2011,150501,4,4,0,1
1,1999,031700,30,28,2,7
2,1999,031700,33,25,8,10
3,1999,031700,28,24,4,14
4,1999,031700,24,20,4,15
5,1999,031700,38,30,8,11
6,1999,031700,44,38,6,17
7,1999,031700,41,31,10,22
8,1999,031700,37,29,8,14
9,1999,031700,25,20,5,10
10,1999,031700,28,21,7,7
11,1999,031700,26,22,4,11
12,1999,031700,32,27,5,17
1,2000,031700,28,21,7,5
2,2000,031700,15,11,4,12
3,2000,031700,29,27,2,8
4,2000,031700,28,26,2,6
5,2000,031700,19,17,2,13
6,2000,031700,27,22,5,2
7,2000,031700,29,25,4,15
8,2000,031700,27,22,5,14
9,2000,031700,23,15,8,7
10,2000,031700,25,21,4,14
11,2000,031700,23,21,2,13
12,2000,031700,12,10,2,8
1,2001,031700,25,23,2,9
2,2001,031700,13,11,2,11
3,2001,031700,26,22,4,8
4,2001,031700,16,14,2,9
5,2001,031700,25,24,1,10
6,2001,031700,22,19,3,10
7,2001,031700,34,27,7,11
8,2001,031700,26,21,5,17
9,2001,031700,27,22,5,31
10,2001,031700,30,25,5,11
11,2001,031700,21,20,1,5
12,2001,031700,22,20,2,7
1,2002,031700,17,13,4,16
2,2002,031700,19,13,6,4
3,2002,031700,15,13,2,8
4,2002,031700,19,16,3,11
5,2002,031700,28,22,6,4
6,2002,031700,21,19,2,14
7,2002,031700,31,29,2,5
8,2002,031700,24,23,1,8
9,2002,031700,21,19,2,14
10,2002,031700,26,22,4,19
11,2002,031700,20,15,5,9
12,2002,031700,18,15,3,9
1,2003,031700,14,12,2,6
2,2003,031700,11,10,1,7
3,2003,031700,20,19,1,16
4,2003,031700,18,14,4,13
5,2003,031700,19,13,6,16
6,2003,031700,22,20,2,13
7,2003,031700,27,22,5,8
8,2003,031700,30,26,4,14
9,2003,031700,28,22,6,9
10,2003,031700,36,32,4,11
11,2003,031700,23,19,4,15
12,2003,031700,30,26,4,8
1,2004,031700,25,23,2,1
2,2004,031700,16,14,2,10
3,2004,031700,15,14,1,11
4,2004,031700,19,16,3,10
5,2004,031700,29,27,2,16
6,2004,031700,19,15,4,15
7,2004,031700,19,16,3,14
8,2004,031700,38,33,5,17
9,2004,031700,54,50,4,18
10,2004,031700,25,23,2,13
11,2004,031700,25,22,3,15
12,2004,031700,15,14,1,8
1,2005,031700,12,10,2,7
2,2005,031700,11,11,0,20
3,2005,031700,20,17,3,11
4,2005,031700,22,18,4,6
5,2005,031700,14,12,2,16
6,2005,031700,19,15,4,8
7,2005,031700,36,26,10,11
8,2005,031700,34,32,2,14
9,2005,031700,25,18,7,15
10,2005,031700,21,19,2,14
11,2005,031700,23,16,7,13
12,2005,031700,17,15,2,11
1,2006,031700,24,23,1,14
2,2006,031700,11,10,1,5
3,2006,031700,23,22,1,9
4,2006,031700,12,11,1,15
5,2006,031700,25,20,5,5
6,2006,031700,18,15,3,10
7,2006,031700,25,18,7,5
8,2006,031700,22,19,3,14
9,2006,031700,20,19,1,4
10,2006,031700,17,16,1,12
11,2006,031700,19,16,3,9
12,2006,031700,19,16,3,6
1,2007,031700,16,15,1,5
2,2007,031700,12,12,0,6
3,2007,031700,25,20,5,11
4,2007,031700,17,15,2,3
5,2007,031700,16,13,3,9
6,2007,031700,18,18,0,10
7,2007,031700,22,20,2,11
8,2007,031700,15,13,2,6
9,2007,031700,15,15,0,9
10,2007,031700,12,9,3,13
11,2007,031700,16,15,1,8
12,2007,031700,17,15,2,8
1,2008,031700,15,13,2,8
2,2008,031700,11,10,1,11
3,2008,031700,9,8,1,5
4,2008,031700,12,9,3,13
5,2008,031700,21,20,1,18
6,2008,031700,18,12,6,3
7,2008,031700,24,21,3,14
8,2008,031700,30,28,2,7
9,2008,031700,28,26,2,4
10,2008,031700,18,16,2,8
11,2008,031700,17,17,0,5
12,2008,031700,18,17,1,5
1,2009,031700,15,12,3,3
2,2009,031700,22,19,3,4
3,2009,031700,16,14,2,6
4,2009,031700,6,6,0,7
5,2009,031700,12,12,0,8
6,2009,031700,17,16,1,13
7,2009,031700,26,24,2,10
8,2009,031700,19,15,4,12
9,2009,031700,24,23,1,7
10,2009,031700,11,10,1,8
11,2009,031700,14,13,1,5
12,2009,031700,18,16,2,7
1,2010,031700,11,10,1,11
2,2010,031700,10,8,2,7
3,2010,031700,9,8,1,15
4,2010,031700,14,10,4,4
5,2010,031700,13,11,2,6
6,2010,031700,16,14,2,5
7,2010,031700,20,17,3,6
8,2010,031700,20,18,2,10
9,2010,031700,21,19,2,13
10,2010,031700,26,22,4,4
11,2010,031700,18,17,1,6
12,2010,031700,16,16,0,3
1,2011,031700,17,13,4,5
2,2011,031700,9,6,3,3
1,1999,031502,16,14,2,8
2,1999,031502,10,7,3,16
3,1999,031502,11,10,1,14
4,1999,031502,14,11,3,11
5,1999,031502,27,21,6,7
6,1999,031502,21,18,3,11
7,1999,031502,29,23,6,13
8,1999,031502,29,21,8,17
9,1999,031502,23,19,4,11
10,1999,031502,24,19,5,6
11,1999,031502,12,12,0,19
12,1999,031502,18,14,4,14
1,2000,031502,12,11,1,13
2,2000,031502,12,11,1,16
3,2000,031502,10,8,2,5
4,2000,031502,16,12,4,11
5,2000,031502,11,9,2,13
6,2000,031502,20,17,3,11
7,2000,031502,14,11,3,22
8,2000,031502,20,17,3,20
9,2000,031502,24,18,6,12
10,2000,031502,20,17,3,14
11,2000,031502,15,12,3,15
12,2000,031502,23,21,2,5
1,2001,031502,18,16,2,5
2,2001,031502,16,15,1,8
3,2001,031502,13,9,4,12
4,2001,031502,13,8,5,12
5,2001,031502,18,11,7,4
6,2001,031502,19,16,3,17
7,2001,031502,23,20,3,9
8,2001,031502,25,24,1,21
9,2001,031502,15,14,1,15
10,2001,031502,24,20,4,9
11,2001,031502,20,15,5,10
12,2001,031502,18,14,4,29
1,2002,031502,10,10,0,18
2,2002,031502,12,9,3,15
3,2002,031502,16,13,3,14
4,2002,031502,9,9,0,13
5,2002,031502,16,13,3,11
6,2002,031502,9,7,2,4
7,2002,031502,22,14,8,10
8,2002,031502,9,6,3,7
9,2002,031502,19,17,2,16
10,2002,031502,17,12,5,8
11,2002,031502,14,12,2,5
12,2002,031502,8,5,3,3
1,2003,031502,6,5,1,3
2,2003,031502,12,12,0,5
3,2003,031502,15,14,1,1
4,2003,031502,8,7,1,4
5,2003,031502,4,3,1,7
6,2003,031502,8,7,1,6
7,2003,031502,17,15,2,5
8,2003,031502,24,21,3,2
9,2003,031502,15,15,0,8
10,2003,031502,8,8,0,4
11,2003,031502,7,5,2,5
12,2003,031502,6,4,2,6
1,2004,031502,5,4,1,4
2,2004,031502,15,13,2,1
3,2004,031502,8,8,0,0
4,2004,031502,11,9,2,6
5,2004,031502,12,11,1,3
6,2004,031502,12,9,3,3
7,2004,031502,6,6,0,4
8,2004,031502,10,10,0,1
9,2004,031502,13,11,2,3
10,2004,031502,15,14,1,2
11,2004,031502,14,12,2,5
12,2004,031502,8,8,0,4
1,2005,031502,13,11,2,0
2,2005,031502,8,6,2,7
3,2005,031502,8,7,1,2
4,2005,031502,9,9,0,12
5,2005,031502,12,12,0,2
6,2005,031502,11,9,2,4
7,2005,031502,10,9,1,3
8,2005,031502,10,8,2,9
9,2005,031502,13,12,1,5
10,2005,031502,26,24,2,5
11,2005,031502,18,16,2,5
12,2005,031502,11,11,0,2
1,2006,031502,12,10,2,8
2,2006,031502,10,7,3,3
3,2006,031502,10,8,2,3
4,2006,031502,2,2,0,5
5,2006,031502,13,11,2,3
6,2006,031502,8,7,1,4
7,2006,031502,13,11,2,12
8,2006,031502,6,6,0,7
9,2006,031502,3,2,1,3
10,2006,031502,10,10,0,11
11,2006,031502,6,5,1,10
12,2006,031502,10,9,1,4
1,2007,031502,10,8,2,7
2,2007,031502,1,1,0,3
3,2007,031502,10,9,1,5
4,2007,031502,8,7,1,3
5,2007,031502,10,9,1,9
6,2007,031502,11,10,1,7
7,2007,031502,13,13,0,6
8,2007,031502,7,2,5,9
9,2007,031502,7,5,2,5
10,2007,031502,6,5,1,8
11,2007,031502,6,6,0,7
12,2007,031502,10,9,1,3
1,2008,031502,5,4,1,2
2,2008,031502,11,11,0,3
3,2008,031502,6,5,1,7
4,2008,031502,7,6,1,10
5,2008,031502,3,3,0,6
6,2008,031502,14,13,1,6
7,2008,031502,10,7,3,3
8,2008,031502,10,8,2,3
9,2008,031502,7,2,5,0
10,2008,031502,9,6,3,6
11,2008,031502,7,5,2,3
12,2008,031502,9,8,1,1
1,2009,031502,6,6,0,1
2,2009,031502,7,7,0,4
3,2009,031502,5,4,1,1
4,2009,031502,8,7,1,2
5,2009,031502,5,5,0,6
6,2009,031502,9,7,2,1
7,2009,031502,8,8,0,3
8,2009,031502,13,11,2,8
9,2009,031502,9,8,1,4
10,2009,031502,6,6,0,3
11,2009,031502,9,7,2,6
12,2009,031502,7,7,0,4
1,2010,031502,4,3,1,4
2,2010,031502,3,2,1,6
3,2010,031502,5,5,0,3
4,2010,031502,7,6,1,4
5,2010,031502,7,6,1,4
6,2010,031502,8,6,2,3
7,2010,031502,8,5,3,11
8,2010,031502,15,13,2,6
9,2010,031502,3,3,0,2
10,2010,031502,8,6,2,2
11,2010,031502,6,4,2,1
12,2010,031502,4,4,0,1
1,2011,031502,4,2,2,4
2,2011,031502,3,2,1,2
1,1999,150401,8,8,0,1
2,1999,150401,7,7,0,0
3,1999,150401,14,13,1,1
4,1999,150401,3,3,0,0
5,1999,150401,7,6,1,1
6,1999,150401,8,7,1,0
7,1999,150401,3,3,0,0
8,1999,150401,10,10,0,1
9,1999,150401,8,7,1,0
10,1999,150401,4,4,0,0
11,1999,150401,3,2,1,0
12,1999,150401,5,5,0,0
1,2000,150401,8,7,1,0
2,2000,150401,1,1,0,0
3,2000,150401,6,6,0,0
4,2000,150401,5,5,0,0
5,2000,150401,9,9,0,0
6,2000,150401,8,7,1,1
7,2000,150401,11,9,2,1
8,2000,150401,7,6,1,0
9,2000,150401,7,7,0,0
10,2000,150401,9,9,0,0
11,2000,150401,3,3,0,0
12,2000,150401,2,2,0,0
1,2001,150401,6,6,0,0
2,2001,150401,5,5,0,0
3,2001,150401,2,2,0,0
4,2001,150401,6,6,0,0
5,2001,150401,2,1,1,0
6,2001,150401,5,5,0,0
7,2001,150401,6,6,0,0
8,2001,150401,14,14,0,0
9,2001,150401,8,8,0,0
10,2001,150401,7,7,0,0
11,2001,150401,7,6,1,0
12,2001,150401,5,5,0,0
1,2002,150401,5,5,0,0
2,2002,150401,2,1,1,5
3,2002,150401,6,5,1,3
4,2002,150401,5,5,0,1
5,2002,150401,9,9,0,0
6,2002,150401,6,5,1,1
7,2002,150401,7,7,0,6
8,2002,150401,9,9,0,1
9,2002,150401,3,3,0,0
10,2002,150401,12,12,0,0
11,2002,150401,7,7,0,2
12,2002,150401,7,7,0,0
1,2003,150401,4,4,0,2
2,2003,150401,4,4,0,0
3,2003,150401,6,6,0,0
4,2003,150401,3,3,0,0
5,2003,150401,5,5,0,2
6,2003,150401,7,7,0,0
7,2003,150401,5,5,0,1
8,2003,150401,3,3,0,2
9,2003,150401,10,10,0,0
10,2003,150401,8,7,1,0
11,2003,150401,4,4,0,0
12,2003,150401,8,7,1,0
1,2004,150401,3,3,0,0
2,2004,150401,7,6,1,1
3,2004,150401,7,7,0,0
4,2004,150401,6,5,1,0
5,2004,150401,5,5,0,2
6,2004,150401,8,8,0,1
7,2004,150401,10,9,1,0
8,2004,150401,5,5,0,1
9,2004,150401,7,7,0,0
10,2004,150401,9,9,0,0
11,2004,150401,8,8,0,0
12,2004,150401,5,4,1,0
1,2005,150401,10,10,0,1
2,2005,150401,2,2,0,0
3,2005,150401,2,2,0,0
4,2005,150401,9,8,1,1
5,2005,150401,4,4,0,0
6,2005,150401,1,1,0,0
7,2005,150401,5,5,0,2
8,2005,150401,5,4,1,0
9,2005,150401,3,3,0,2
10,2005,150401,6,6,0,0
11,2005,150401,2,2,0,2
12,2005,150401,6,6,0,0
1,2006,150401,6,5,1,1
2,2006,150401,7,7,0,2
3,2006,150401,7,6,1,0
4,2006,150401,8,7,1,1
5,2006,150401,5,5,0,2
6,2006,150401,3,3,0,1
7,2006,150401,6,6,0,2
8,2006,150401,9,8,1,1
9,2006,150401,3,2,1,1
10,2006,150401,8,7,1,0
11,2006,150401,2,2,0,0
12,2006,150401,9,9,0,0
1,2007,150401,2,2,0,1
2,2007,150401,3,3,0,0
3,2007,150401,6,5,1,1
4,2007,150401,1,1,0,1
5,2007,150401,4,4,0,1
6,2007,150401,6,6,0,0
7,2007,150401,6,6,0,0
8,2007,150401,8,8,0,0
9,2007,150401,5,5,0,0
10,2007,150401,4,2,2,0
11,2007,150401,11,10,1,0
12,2007,150401,8,8,0,0
1,2008,150401,4,4,0,0
2,2008,150401,5,5,0,0
3,2008,150401,2,2,0,1
4,2008,150401,5,5,0,1
5,2008,150401,4,4,0,2
6,2008,150401,1,1,0,1
7,2008,150401,5,5,0,0
8,2008,150401,3,1,2,0
9,2008,150401,10,10,0,2
10,2008,150401,12,12,0,0
11,2008,150401,7,7,0,1
12,2008,150401,6,6,0,0
1,2009,150401,5,5,0,0
2,2009,150401,5,5,0,1
3,2009,150401,5,5,0,1
4,2009,150401,11,9,2,1
5,2009,150401,4,4,0,0
6,2009,150401,13,12,1,1
7,2009,150401,13,12,1,1
8,2009,150401,5,5,0,0
9,2009,150401,5,5,0,3
10,2009,150401,9,8,1,0
11,2009,150401,5,4,1,1
12,2009,150401,10,10,0,0
1,2010,150401,4,4,0,1
2,2010,150401,2,2,0,1
3,2010,150401,4,3,1,1
4,2010,150401,5,5,0,0
5,2010,150401,7,7,0,0
6,2010,150401,4,4,0,0
7,2010,150401,7,6,1,0
8,2010,150401,3,3,0,0
9,2010,150401,4,4,0,0
10,2010,150401,3,3,0,0
11,2010,150401,5,5,0,0
12,2010,150401,4,3,1,0
1,2011,150401,4,4,0,1
2,2011,150401,8,7,1,0
1,1999,140601,14,14,0,0
2,1999,140601,21,21,0,1
3,1999,140601,16,13,3,1
4,1999,140601,23,23,0,0
5,1999,140601,20,19,1,0
6,1999,140601,17,16,1,1
7,1999,140601,20,18,2,0
8,1999,140601,21,19,2,0
9,1999,140601,17,13,4,0
10,1999,140601,14,14,0,1
11,1999,140601,13,11,2,3
12,1999,140601,27,27,0,1
1,2000,140601,13,11,2,4
2,2000,140601,18,16,2,0
3,2000,140601,18,18,0,3
4,2000,140601,18,17,1,1
5,2000,140601,20,18,2,2
6,2000,140601,17,15,2,3
7,2000,140601,20,17,3,1
8,2000,140601,27,24,3,4
9,2000,140601,14,14,0,1
10,2000,140601,15,15,0,5
11,2000,140601,17,14,3,2
12,2000,140601,9,9,0,0
1,2001,140601,12,11,1,1
2,2001,140601,4,4,0,0
3,2001,140601,14,14,0,1
4,2001,140601,16,13,3,4
5,2001,140601,14,13,1,0
6,2001,140601,19,17,2,4
7,2001,140601,15,14,1,1
8,2001,140601,28,26,2,3
9,2001,140601,16,14,2,1
10,2001,140601,20,20,0,2
11,2001,140601,19,14,5,0
12,2001,140601,14,12,2,2
1,2002,140601,14,13,1,1
2,2002,140601,9,8,1,0
3,2002,140601,19,19,0,1
4,2002,140601,14,14,0,3
5,2002,140601,18,18,0,3
6,2002,140601,19,18,1,2
7,2002,140601,16,14,2,0
8,2002,140601,18,18,0,1
9,2002,140601,17,14,3,2
10,2002,140601,10,10,0,1
11,2002,140601,13,12,1,1
12,2002,140601,26,25,1,1
1,2003,140601,12,11,1,2
2,2003,140601,11,10,1,1
3,2003,140601,16,15,1,1
4,2003,140601,11,11,0,0
5,2003,140601,23,20,3,1
6,2003,140601,17,17,0,0
7,2003,140601,12,12,0,1
8,2003,140601,22,22,0,2
9,2003,140601,18,18,0,5
10,2003,140601,21,21,0,3
11,2003,140601,15,15,0,2
12,2003,140601,11,10,1,0
1,2004,140601,13,12,1,2
2,2004,140601,17,17,0,0
3,2004,140601,9,8,1,0
4,2004,140601,6,6,0,4
5,2004,140601,5,5,0,1
6,2004,140601,13,13,0,5
7,2004,140601,10,10,0,0
8,2004,140601,7,7,0,1
9,2004,140601,5,4,1,5
10,2004,140601,8,6,2,3
11,2004,140601,7,7,0,1
12,2004,140601,4,4,0,1
1,2005,140601,2,2,0,0
2,2005,140601,6,5,1,0
3,2005,140601,10,10,0,0
4,2005,140601,16,16,0,4
5,2005,140601,9,9,0,1
6,2005,140601,5,5,0,1
7,2005,140601,4,3,1,1
8,2005,140601,4,4,0,0
9,2005,140601,10,10,0,2
10,2005,140601,10,10,0,0
11,2005,140601,5,4,1,2
12,2005,140601,9,7,2,0
1,2006,140601,13,13,0,0
2,2006,140601,12,10,2,2
3,2006,140601,5,5,0,1
4,2006,140601,9,9,0,0
5,2006,140601,10,10,0,1
6,2006,140601,8,8,0,0
7,2006,140601,13,13,0,2
8,2006,140601,7,6,1,6
9,2006,140601,18,17,1,1
10,2006,140601,9,9,0,0
11,2006,140601,7,6,1,1
12,2006,140601,9,8,1,1
1,2007,140601,4,4,0,0
2,2007,140601,3,3,0,2
3,2007,140601,9,9,0,1
4,2007,140601,10,10,0,5
5,2007,140601,7,6,1,1
6,2007,140601,6,5,1,5
7,2007,140601,17,16,1,1
8,2007,140601,15,13,2,7
9,2007,140601,19,16,3,3
10,2007,140601,13,12,1,1
11,2007,140601,4,4,0,1
12,2007,140601,6,5,1,0
1,2008,140601,8,8,0,0
2,2008,140601,5,5,0,1
3,2008,140601,6,6,0,0
4,2008,140601,17,15,2,1
5,2008,140601,12,10,2,3
6,2008,140601,8,8,0,0
7,2008,140601,17,16,1,1
8,2008,140601,13,12,1,0
9,2008,140601,7,6,1,2
10,2008,140601,4,1,3,2
11,2008,140601,8,7,1,4
12,2008,140601,10,10,0,3
1,2009,140601,6,6,0,4
2,2009,140601,7,6,1,2
3,2009,140601,8,8,0,4
4,2009,140601,9,9,0,1
5,2009,140601,9,9,0,0
6,2009,140601,3,3,0,1
7,2009,140601,7,6,1,3
8,2009,140601,10,8,2,1
9,2009,140601,7,6,1,5
10,2009,140601,6,5,1,3
11,2009,140601,10,10,0,2
12,2009,140601,8,7,1,4
1,2010,140601,15,14,1,1
2,2010,140601,5,5,0,0
3,2010,140601,11,9,2,4
4,2010,140601,9,8,1,4
5,2010,140601,13,9,4,6
6,2010,140601,10,10,0,0
7,2010,140601,10,7,3,1
8,2010,140601,11,8,3,3
9,2010,140601,11,11,0,4
10,2010,140601,8,6,2,3
11,2010,140601,8,8,0,2
12,2010,140601,8,8,0,0
1,2011,140601,9,9,0,3
2,2011,140601,6,6,0,0
1,1999,040700,8,6,2,3
2,1999,040700,16,14,2,4
3,1999,040700,12,11,1,0
4,1999,040700,9,7,2,0
5,1999,040700,11,11,0,2
6,1999,040700,25,23,2,1
7,1999,040700,14,14,0,2
8,1999,040700,17,15,2,1
9,1999,040700,23,23,0,1
10,1999,040700,9,7,2,0
11,1999,040700,15,15,0,1
12,1999,040700,8,7,1,1
1,2000,040700,17,17,0,2
2,2000,040700,10,9,1,0
3,2000,040700,13,12,1,4
4,2000,040700,9,9,0,0
5,2000,040700,24,22,2,0
6,2000,040700,18,16,2,2
7,2000,040700,18,17,1,1
8,2000,040700,10,9,1,2
9,2000,040700,18,17,1,0
10,2000,040700,12,12,0,0
11,2000,040700,9,7,2,1
12,2000,040700,11,10,1,1
1,2001,040700,10,10,0,1
2,2001,040700,13,13,0,2
3,2001,040700,18,17,1,2
4,2001,040700,14,13,1,0
5,2001,040700,11,7,4,1
6,2001,040700,11,10,1,1
7,2001,040700,24,23,1,3
8,2001,040700,12,11,1,3
9,2001,040700,19,19,0,4
10,2001,040700,10,9,1,0
11,2001,040700,13,12,1,0
12,2001,040700,5,5,0,1
1,2002,040700,8,8,0,1
2,2002,040700,9,9,0,0
3,2002,040700,12,12,0,2
4,2002,040700,15,14,1,1
5,2002,040700,11,10,1,0
6,2002,040700,14,13,1,1
7,2002,040700,13,13,0,1
8,2002,040700,12,9,3,5
9,2002,040700,11,11,0,3
10,2002,040700,9,7,2,0
11,2002,040700,9,8,1,1
12,2002,040700,16,16,0,2
1,2003,040700,25,24,1,2
2,2003,040700,11,8,3,0
3,2003,040700,13,13,0,0
4,2003,040700,13,12,1,0
5,2003,040700,8,8,0,2
6,2003,040700,13,12,1,1
7,2003,040700,14,12,2,0
8,2003,040700,8,8,0,0
9,2003,040700,12,10,2,1
10,2003,040700,11,11,0,0
11,2003,040700,12,11,1,0
12,2003,040700,11,11,0,1
1,2004,040700,17,16,1,0
2,2004,040700,9,7,2,3
3,2004,040700,7,7,0,0
4,2004,040700,12,12,0,0
5,2004,040700,15,15,0,0
6,2004,040700,22,20,2,2
7,2004,040700,22,21,1,0
8,2004,040700,15,13,2,0
9,2004,040700,18,18,0,2
10,2004,040700,13,11,2,4
11,2004,040700,12,10,2,0
12,2004,040700,21,21,0,1
1,2005,040700,14,14,0,1
2,2005,040700,7,6,1,1
3,2005,040700,18,17,1,1
4,2005,040700,11,11,0,0
5,2005,040700,10,9,1,0
6,2005,040700,14,13,1,1
7,2005,040700,8,8,0,1
8,2005,040700,18,18,0,1
9,2005,040700,14,14,0,0
10,2005,040700,4,4,0,0
11,2005,040700,8,7,1,2
12,2005,040700,11,11,0,1
1,2006,040700,12,12,0,2
2,2006,040700,12,11,1,0
3,2006,040700,14,14,0,3
4,2006,040700,12,10,2,0
5,2006,040700,10,10,0,2
6,2006,040700,12,12,0,0
7,2006,040700,16,16,0,1
8,2006,040700,13,12,1,0
9,2006,040700,11,11,0,1
10,2006,040700,12,10,2,1
11,2006,040700,10,10,0,2
12,2006,040700,11,10,1,0
1,2007,040700,10,10,0,1
2,2007,040700,5,5,0,0
3,2007,040700,10,10,0,0
4,2007,040700,6,6,0,1
5,2007,040700,5,5,0,0
6,2007,040700,12,9,3,0
7,2007,040700,13,13,0,4
8,2007,040700,13,13,0,4
9,2007,040700,10,10,0,4
10,2007,040700,8,8,0,0
11,2007,040700,10,10,0,2
12,2007,040700,11,11,0,4
1,2008,040700,8,8,0,0
2,2008,040700,8,7,1,3
3,2008,040700,7,7,0,2
4,2008,040700,8,8,0,1
5,2008,040700,7,7,0,1
6,2008,040700,6,6,0,0
7,2008,040700,14,14,0,0
8,2008,040700,11,11,0,1
9,2008,040700,13,10,3,1
10,2008,040700,10,10,0,1
11,2008,040700,8,8,0,0
12,2008,040700,9,9,0,1
1,2009,040700,10,10,0,0
2,2009,040700,3,3,0,1
3,2009,040700,18,17,1,1
4,2009,040700,13,13,0,0
5,2009,040700,8,8,0,1
6,2009,040700,11,11,0,1
7,2009,040700,9,9,0,0
8,2009,040700,11,10,1,1
9,2009,040700,6,6,0,1
10,2009,040700,7,7,0,3
11,2009,040700,8,8,0,0
12,2009,040700,9,9,0,2
1,2010,040700,7,7,0,3
2,2010,040700,9,8,1,0
3,2010,040700,9,9,0,3
4,2010,040700,11,11,0,1
5,2010,040700,7,7,0,1
6,2010,040700,18,16,2,2
7,2010,040700,15,14,1,0
8,2010,040700,23,23,0,1
9,2010,040700,19,18,1,0
10,2010,040700,15,14,1,0
11,2010,040700,5,5,0,0
12,2010,040700,6,5,1,0
1,2011,040700,11,11,0,3
2,2011,040700,4,4,0,1
1,1999,040600,4,4,0,0
2,1999,040600,5,5,0,1
3,1999,040600,4,4,0,2
4,1999,040600,10,9,1,0
5,1999,040600,5,5,0,0
6,1999,040600,11,11,0,0
7,1999,040600,4,2,2,1
8,1999,040600,11,11,0,0
9,1999,040600,8,8,0,0
10,1999,040600,10,10,0,0
11,1999,040600,11,11,0,0
12,1999,040600,8,7,1,1
1,2000,040600,8,8,0,0
2,2000,040600,5,5,0,0
3,2000,040600,7,7,0,1
4,2000,040600,7,6,1,1
5,2000,040600,5,5,0,0
6,2000,040600,12,10,2,0
7,2000,040600,6,5,1,1
8,2000,040600,9,9,0,1
9,2000,040600,7,6,1,0
10,2000,040600,16,16,0,0
11,2000,040600,13,11,2,1
12,2000,040600,8,8,0,0
1,2001,040600,7,7,0,2
2,2001,040600,3,3,0,0
3,2001,040600,8,8,0,0
4,2001,040600,8,7,1,0
5,2001,040600,2,2,0,0
6,2001,040600,5,5,0,1
7,2001,040600,14,13,1,0
8,2001,040600,8,8,0,0
9,2001,040600,5,5,0,1
10,2001,040600,6,6,0,2
11,2001,040600,4,4,0,0
12,2001,040600,5,5,0,0
1,2002,040600,8,7,1,0
2,2002,040600,5,5,0,0
3,2002,040600,7,6,1,0
4,2002,040600,6,6,0,0
5,2002,040600,2,2,0,0
6,2002,040600,5,4,1,0
7,2002,040600,11,11,0,0
8,2002,040600,9,9,0,0
9,2002,040600,7,7,0,0
10,2002,040600,11,11,0,0
11,2002,040600,3,3,0,0
12,2002,040600,10,10,0,0
1,2003,040600,9,9,0,1
2,2003,040600,6,6,0,0
3,2003,040600,6,6,0,1
4,2003,040600,5,5,0,0
5,2003,040600,6,6,0,0
6,2003,040600,2,2,0,0
7,2003,040600,8,8,0,2
8,2003,040600,6,6,0,1
9,2003,040600,8,8,0,0
10,2003,040600,7,7,0,0
11,2003,040600,9,8,1,0
12,2003,040600,13,13,0,0
1,2004,040600,4,4,0,0
2,2004,040600,1,1,0,2
3,2004,040600,9,8,1,0
4,2004,040600,7,6,1,0
5,2004,040600,6,6,0,0
6,2004,040600,8,7,1,0
7,2004,040600,8,8,0,0
8,2004,040600,10,10,0,0
9,2004,040600,4,4,0,0
10,2004,040600,5,5,0,0
11,2004,040600,11,11,0,0
12,2004,040600,12,12,0,0
1,2005,040600,7,7,0,0
2,2005,040600,6,6,0,2
3,2005,040600,5,5,0,0
4,2005,040600,3,3,0,1
5,2005,040600,8,8,0,0
6,2005,040600,6,6,0,0
7,2005,040600,7,7,0,0
8,2005,040600,9,8,1,2
9,2005,040600,5,5,0,0
10,2005,040600,6,6,0,0
11,2005,040600,10,10,0,0
12,2005,040600,9,7,2,0
1,2006,040600,4,4,0,0
2,2006,040600,10,8,2,0
3,2006,040600,8,8,0,1
4,2006,040600,7,6,1,1
5,2006,040600,9,9,0,0
6,2006,040600,6,6,0,0
7,2006,040600,8,8,0,0
8,2006,040600,13,13,0,0
9,2006,040600,5,5,0,0
10,2006,040600,4,4,0,1
11,2006,040600,5,5,0,0
12,2006,040600,8,8,0,0
1,2007,040600,6,6,0,0
2,2007,040600,6,6,0,0
3,2007,040600,7,7,0,1
4,2007,040600,6,6,0,0
5,2007,040600,8,7,1,0
6,2007,040600,8,8,0,0
7,2007,040600,7,7,0,0
8,2007,040600,5,4,1,0
9,2007,040600,4,4,0,0
10,2007,040600,6,4,2,0
11,2007,040600,5,5,0,0
12,2007,040600,3,3,0,0
1,2008,040600,5,5,0,0
2,2008,040600,0,0,0,0
3,2008,040600,2,2,0,0
4,2008,040600,3,3,0,1
5,2008,040600,3,2,1,0
6,2008,040600,13,13,0,0
7,2008,040600,8,7,1,0
8,2008,040600,10,10,0,0
9,2008,040600,3,3,0,0
10,2008,040600,3,3,0,0
11,2008,040600,4,4,0,0
12,2008,040600,6,6,0,0
1,2009,040600,8,8,0,0
2,2009,040600,5,4,1,0
3,2009,040600,3,3,0,0
4,2009,040600,10,10,0,0
5,2009,040600,10,10,0,0
6,2009,040600,6,6,0,0
7,2009,040600,8,8,0,0
8,2009,040600,9,9,0,0
9,2009,040600,11,11,0,0
10,2009,040600,6,6,0,0
11,2009,040600,7,7,0,0
12,2009,040600,4,4,0,0
1,2010,040600,7,7,0,1
2,2010,040600,7,6,1,0
3,2010,040600,4,4,0,0
4,2010,040600,1,1,0,1
5,2010,040600,5,5,0,0
6,2010,040600,11,11,0,0
7,2010,040600,9,9,0,1
8,2010,040600,4,3,1,0
9,2010,040600,8,8,0,0
10,2010,040600,13,13,0,0
11,2010,040600,2,2,0,0
12,2010,040600,3,2,1,0
1,2011,040600,3,3,0,0
2,2011,040600,4,4,0,0
1,1999,031800,12,10,2,0
2,1999,031800,8,8,0,0
3,1999,031800,7,6,1,0
4,1999,031800,9,9,0,5
5,1999,031800,18,17,1,0
6,1999,031800,20,18,2,0
7,1999,031800,13,11,2,1
8,1999,031800,17,15,2,1
9,1999,031800,13,12,1,0
10,1999,031800,8,8,0,0
11,1999,031800,6,6,0,2
12,1999,031800,10,9,1,0
1,2000,031800,5,5,0,0
2,2000,031800,11,11,0,0
3,2000,031800,4,2,2,1
4,2000,031800,10,8,2,2
5,2000,031800,8,6,2,0
6,2000,031800,9,8,1,0
7,2000,031800,16,15,1,0
8,2000,031800,20,19,1,0
9,2000,031800,13,13,0,1
10,2000,031800,21,18,3,0
11,2000,031800,15,14,1,0
12,2000,031800,8,6,2,1
1,2001,031800,8,8,0,1
2,2001,031800,7,7,0,1
3,2001,031800,10,8,2,0
4,2001,031800,14,13,1,1
5,2001,031800,13,13,0,0
6,2001,031800,17,15,2,2
7,2001,031800,4,3,1,0
8,2001,031800,13,12,1,2
9,2001,031800,14,12,2,0
10,2001,031800,10,9,1,2
11,2001,031800,18,16,2,1
12,2001,031800,8,8,0,0
1,2002,031800,11,7,4,1
2,2002,031800,8,8,0,0
3,2002,031800,13,12,1,0
4,2002,031800,7,7,0,0
5,2002,031800,7,7,0,0
6,2002,031800,14,13,1,1
7,2002,031800,10,8,2,1
8,2002,031800,18,18,0,1
9,2002,031800,18,17,1,1
10,2002,031800,10,10,0,0
11,2002,031800,11,10,1,1
12,2002,031800,14,14,0,1
1,2003,031800,8,7,1,4
2,2003,031800,4,4,0,0
3,2003,031800,6,6,0,0
4,2003,031800,10,9,1,4
5,2003,031800,11,10,1,1
6,2003,031800,6,5,1,1
7,2003,031800,10,9,1,1
8,2003,031800,13,12,1,1
9,2003,031800,13,13,0,1
10,2003,031800,11,11,0,0
11,2003,031800,10,10,0,0
12,2003,031800,17,17,0,0
1,2004,031800,17,16,1,2
2,2004,031800,6,6,0,0
3,2004,031800,5,4,1,2
4,2004,031800,9,8,1,1
5,2004,031800,10,10,0,0
6,2004,031800,5,5,0,0
7,2004,031800,6,5,1,1
8,2004,031800,10,9,1,0
9,2004,031800,18,17,1,1
10,2004,031800,14,13,1,0
11,2004,031800,9,8,1,1
12,2004,031800,11,10,1,0
1,2005,031800,14,12,2,2
2,2005,031800,6,6,0,1
3,2005,031800,5,5,0,1
4,2005,031800,10,9,1,1
5,2005,031800,9,8,1,0
6,2005,031800,8,6,2,0
7,2005,031800,11,10,1,1
8,2005,031800,8,8,0,0
9,2005,031800,7,7,0,0
10,2005,031800,6,6,0,1
11,2005,031800,6,5,1,1
12,2005,031800,5,5,0,1
1,2006,031800,8,8,0,0
2,2006,031800,5,5,0,0
3,2006,031800,9,9,0,0
4,2006,031800,5,5,0,1
5,2006,031800,9,8,1,0
6,2006,031800,4,4,0,0
7,2006,031800,7,7,0,0
8,2006,031800,8,7,1,0
9,2006,031800,6,6,0,1
10,2006,031800,4,3,1,1
11,2006,031800,4,4,0,0
12,2006,031800,6,6,0,0
1,2007,031800,8,8,0,0
2,2007,031800,3,3,0,3
3,2007,031800,0,0,0,1
4,2007,031800,10,10,0,0
5,2007,031800,6,4,2,0
6,2007,031800,5,5,0,0
7,2007,031800,12,10,2,0
8,2007,031800,5,5,0,1
9,2007,031800,6,6,0,2
10,2007,031800,8,6,2,0
11,2007,031800,5,5,0,0
12,2007,031800,6,5,1,0
1,2008,031800,8,7,1,0
2,2008,031800,3,3,0,0
3,2008,031800,4,4,0,0
4,2008,031800,6,5,1,1
5,2008,031800,2,2,0,0
6,2008,031800,4,4,0,0
7,2008,031800,9,8,1,0
8,2008,031800,8,6,2,2
9,2008,031800,9,9,0,2
10,2008,031800,9,9,0,0
11,2008,031800,4,4,0,1
12,2008,031800,13,13,0,0
1,2009,031800,9,9,0,0
2,2009,031800,4,4,0,0
3,2009,031800,6,6,0,0
4,2009,031800,7,7,0,0
5,2009,031800,1,1,0,0
6,2009,031800,6,6,0,0
7,2009,031800,4,4,0,0
8,2009,031800,10,8,2,0
9,2009,031800,9,9,0,1
10,2009,031800,3,1,2,0
11,2009,031800,12,11,1,0
12,2009,031800,5,5,0,0
1,2010,031800,4,3,1,0
2,2010,031800,8,8,0,3
3,2010,031800,5,5,0,1
4,2010,031800,5,5,0,0
5,2010,031800,7,7,0,0
6,2010,031800,5,5,0,2
7,2010,031800,5,4,1,2
8,2010,031800,10,10,0,1
9,2010,031800,12,12,0,0
10,2010,031800,12,11,1,0
11,2010,031800,5,5,0,1
12,2010,031800,8,8,0,0
1,2011,031800,7,6,1,0
2,2011,031800,2,2,0,0
1,1999,140701,4,4,0,1
2,1999,140701,7,7,0,0
3,1999,140701,6,5,1,2
4,1999,140701,7,6,1,2
5,1999,140701,5,3,2,5
6,1999,140701,6,3,3,0
7,1999,140701,8,7,1,6
8,1999,140701,7,6,1,2
9,1999,140701,4,2,2,3
10,1999,140701,6,6,0,1
11,1999,140701,6,5,1,3
12,1999,140701,5,4,1,4
1,2000,140701,11,11,0,0
2,2000,140701,6,5,1,3
3,2000,140701,6,4,2,0
4,2000,140701,8,6,2,3
5,2000,140701,6,6,0,2
6,2000,140701,5,3,2,2
7,2000,140701,6,4,2,1
8,2000,140701,7,7,0,1
9,2000,140701,11,8,3,4
10,2000,140701,3,1,2,5
11,2000,140701,4,2,2,2
12,2000,140701,6,5,1,0
1,2001,140701,5,5,0,1
2,2001,140701,3,2,1,2
3,2001,140701,1,1,0,0
4,2001,140701,10,9,1,0
5,2001,140701,3,2,1,0
6,2001,140701,4,3,1,0
7,2001,140701,8,7,1,2
8,2001,140701,7,7,0,1
9,2001,140701,6,6,0,2
10,2001,140701,3,3,0,0
11,2001,140701,3,3,0,0
12,2001,140701,6,4,2,0
1,2002,140701,4,4,0,0
2,2002,140701,6,5,1,0
3,2002,140701,6,6,0,0
4,2002,140701,3,3,0,1
5,2002,140701,5,4,1,0
6,2002,140701,7,7,0,1
7,2002,140701,4,4,0,0
8,2002,140701,4,3,1,0
9,2002,140701,8,5,3,0
10,2002,140701,11,10,1,0
11,2002,140701,4,4,0,1
12,2002,140701,3,3,0,2
1,2003,140701,6,4,2,0
2,2003,140701,7,7,0,2
3,2003,140701,1,1,0,1
4,2003,140701,3,3,0,0
5,2003,140701,5,3,2,2
6,2003,140701,3,2,1,1
7,2003,140701,5,4,1,0
8,2003,140701,5,5,0,2
9,2003,140701,5,5,0,4
10,2003,140701,11,9,2,0
11,2003,140701,9,8,1,0
12,2003,140701,4,3,1,4
1,2004,140701,5,5,0,0
2,2004,140701,1,1,0,1
3,2004,140701,4,3,1,0
4,2004,140701,1,1,0,0
5,2004,140701,1,1,0,0
6,2004,140701,4,4,0,2
7,2004,140701,3,2,1,1
8,2004,140701,5,5,0,0
9,2004,140701,4,4,0,1
10,2004,140701,2,2,0,1
11,2004,140701,3,3,0,1
12,2004,140701,5,3,2,0
1,2005,140701,2,2,0,1
2,2005,140701,4,4,0,1
3,2005,140701,3,3,0,0
4,2005,140701,2,2,0,4
5,2005,140701,4,4,0,0
6,2005,140701,3,2,1,1
7,2005,140701,7,5,2,2
8,2005,140701,2,2,0,0
9,2005,140701,4,4,0,2
10,2005,140701,2,1,1,2
11,2005,140701,2,2,0,0
12,2005,140701,4,4,0,0
1,2006,140701,3,3,0,0
2,2006,140701,4,3,1,0
3,2006,140701,5,4,1,0
4,2006,140701,1,0,1,0
5,2006,140701,1,1,0,2
6,2006,140701,8,6,2,3
7,2006,140701,2,2,0,1
8,2006,140701,2,2,0,0
9,2006,140701,5,3,2,0
10,2006,140701,1,1,0,0
11,2006,140701,3,2,1,1
12,2006,140701,3,3,0,0
1,2007,140701,6,5,1,3
2,2007,140701,4,4,0,0
3,2007,140701,4,3,1,2
4,2007,140701,5,3,2,0
5,2007,140701,4,3,1,0
6,2007,140701,2,2,0,0
7,2007,140701,7,7,0,0
8,2007,140701,3,2,1,0
9,2007,140701,4,4,0,0
10,2007,140701,5,5,0,0
11,2007,140701,4,3,1,0
12,2007,140701,2,2,0,4
1,2008,140701,1,1,0,0
2,2008,140701,3,3,0,0
3,2008,140701,6,5,1,0
4,2008,140701,5,4,1,1
5,2008,140701,6,6,0,0
6,2008,140701,1,1,0,0
7,2008,140701,7,5,2,0
8,2008,140701,1,1,0,2
9,2008,140701,8,6,2,0
10,2008,140701,6,4,2,0
11,2008,140701,4,4,0,1
12,2008,140701,1,1,0,2
1,2009,140701,3,3,0,2
2,2009,140701,7,6,1,0
3,2009,140701,8,7,1,4
4,2009,140701,1,1,0,3
5,2009,140701,3,2,1,0
6,2009,140701,0,0,0,0
7,2009,140701,4,3,1,0
8,2009,140701,3,3,0,0
9,2009,140701,1,1,0,0
10,2009,140701,4,4,0,0
11,2009,140701,0,0,0,0
12,2009,140701,3,3,0,1
1,2010,140701,4,3,1,0
2,2010,140701,1,1,0,0
3,2010,140701,2,2,0,1
4,2010,140701,5,4,1,0
5,2010,140701,1,1,0,0
6,2010,140701,7,6,1,1
7,2010,140701,7,7,0,1
8,2010,140701,3,2,1,0
9,2010,140701,5,5,0,2
10,2010,140701,7,7,0,2
11,2010,140701,2,1,1,1
12,2010,140701,1,1,0,1
1,2011,140701,5,5,0,1
2,2011,140701,0,0,0,0
1,1999,031501,12,11,1,6
2,1999,031501,7,7,0,4
3,1999,031501,10,7,3,7
4,1999,031501,9,8,1,0
5,1999,031501,10,8,2,3
6,1999,031501,5,5,0,4
7,1999,031501,6,6,0,5
8,1999,031501,10,10,0,6
9,1999,031501,10,9,1,2
10,1999,031501,19,16,3,2
11,1999,031501,14,11,3,4
12,1999,031501,15,13,2,1
1,2000,031501,15,13,2,6
2,2000,031501,5,5,0,5
3,2000,031501,8,7,1,1
4,2000,031501,14,11,3,3
5,2000,031501,11,6,5,5
6,2000,031501,9,7,2,3
7,2000,031501,28,26,2,3
8,2000,031501,9,9,0,4
9,2000,031501,20,18,2,2
10,2000,031501,22,17,5,6
11,2000,031501,9,7,2,1
12,2000,031501,8,7,1,1
1,2001,031501,4,2,2,5
2,2001,031501,10,7,3,3
3,2001,031501,9,8,1,3
4,2001,031501,14,13,1,2
5,2001,031501,5,4,1,1
6,2001,031501,8,8,0,3
7,2001,031501,6,6,0,4
8,2001,031501,9,6,3,8
9,2001,031501,8,8,0,1
10,2001,031501,14,14,0,5
11,2001,031501,13,13,0,2
12,2001,031501,10,9,1,1
1,2002,031501,11,10,1,5
2,2002,031501,7,5,2,0
3,2002,031501,7,7,0,6
4,2002,031501,7,7,0,5
5,2002,031501,7,6,1,3
6,2002,031501,4,4,0,10
7,2002,031501,14,12,2,6
8,2002,031501,10,9,1,2
9,2002,031501,14,10,4,0
10,2002,031501,4,4,0,2
11,2002,031501,7,6,1,2
12,2002,031501,6,4,2,1
1,2003,031501,11,9,2,2
2,2003,031501,3,3,0,5
3,2003,031501,5,4,1,1
4,2003,031501,8,7,1,3
5,2003,031501,8,8,0,1
6,2003,031501,7,7,0,5
7,2003,031501,4,4,0,2
8,2003,031501,13,11,2,1
9,2003,031501,7,7,0,1
10,2003,031501,11,10,1,4
11,2003,031501,6,4,2,0
12,2003,031501,8,7,1,1
1,2004,031501,6,5,1,4
2,2004,031501,7,7,0,1
3,2004,031501,6,5,1,0
4,2004,031501,0,0,0,1
5,2004,031501,8,7,1,0
6,2004,031501,11,10,1,1
7,2004,031501,10,8,2,2
8,2004,031501,8,7,1,1
9,2004,031501,12,9,3,2
10,2004,031501,14,13,1,1
11,2004,031501,12,10,2,1
12,2004,031501,8,8,0,0
1,2005,031501,2,2,0,3
2,2005,031501,8,7,1,0
3,2005,031501,5,4,1,1
4,2005,031501,3,2,1,3
5,2005,031501,11,11,0,4
6,2005,031501,10,8,2,2
7,2005,031501,15,13,2,12
8,2005,031501,2,2,0,3
9,2005,031501,7,5,2,11
10,2005,031501,5,3,2,4
11,2005,031501,6,6,0,6
12,2005,031501,8,7,1,1
1,2006,031501,3,3,0,7
2,2006,031501,4,3,1,5
3,2006,031501,3,2,1,5
4,2006,031501,1,1,0,3
5,2006,031501,8,7,1,1
6,2006,031501,4,3,1,7
7,2006,031501,7,6,1,4
8,2006,031501,6,5,1,8
9,2006,031501,8,7,1,19
10,2006,031501,2,2,0,9
11,2006,031501,6,6,0,7
12,2006,031501,3,2,1,9
1,2007,031501,14,14,0,9
2,2007,031501,6,6,0,7
3,2007,031501,4,2,2,2
4,2007,031501,7,7,0,7
5,2007,031501,6,6,0,4
6,2007,031501,6,6,0,13
7,2007,031501,6,6,0,7
8,2007,031501,4,4,0,7
9,2007,031501,5,5,0,8
10,2007,031501,9,9,0,6
11,2007,031501,8,7,1,6
12,2007,031501,5,5,0,2
1,2008,031501,6,6,0,4
2,2008,031501,5,5,0,2
3,2008,031501,6,6,0,3
4,2008,031501,8,7,1,2
5,2008,031501,2,2,0,3
6,2008,031501,4,3,1,4
7,2008,031501,7,7,0,4
8,2008,031501,9,6,3,8
9,2008,031501,6,5,1,2
10,2008,031501,4,3,1,3
11,2008,031501,5,5,0,12
12,2008,031501,3,3,0,4
1,2009,031501,4,4,0,2
2,2009,031501,3,3,0,1
3,2009,031501,10,10,0,1
4,2009,031501,1,1,0,4
5,2009,031501,5,4,1,6
6,2009,031501,8,8,0,9
7,2009,031501,8,7,1,2
8,2009,031501,6,6,0,1
9,2009,031501,8,8,0,2
10,2009,031501,9,8,1,1
11,2009,031501,11,11,0,5
12,2009,031501,4,4,0,1
1,2010,031501,5,5,0,4
2,2010,031501,2,2,0,2
3,2010,031501,7,5,2,3
4,2010,031501,8,6,2,3
5,2010,031501,2,2,0,2
6,2010,031501,5,4,1,1
7,2010,031501,4,3,1,4
8,2010,031501,4,4,0,2
9,2010,031501,7,7,0,4
10,2010,031501,2,1,1,1
11,2010,031501,7,7,0,4
12,2010,031501,7,7,0,1
1,2011,031501,1,1,0,6
2,2011,031501,2,2,0,1
1,1999,120400,5,4,1,1
2,1999,120400,5,5,0,0
3,1999,120400,8,8,0,0
4,1999,120400,9,8,1,0
5,1999,120400,8,7,1,1
6,1999,120400,11,10,1,1
7,1999,120400,7,7,0,0
8,1999,120400,8,6,2,2
9,1999,120400,8,8,0,0
10,1999,120400,9,7,2,0
11,1999,120400,3,3,0,0
12,1999,120400,2,2,0,0
1,2000,120400,4,4,0,1
2,2000,120400,4,4,0,0
3,2000,120400,6,6,0,1
4,2000,120400,10,10,0,0
5,2000,120400,7,7,0,0
6,2000,120400,13,13,0,2
7,2000,120400,4,4,0,2
8,2000,120400,5,5,0,1
9,2000,120400,8,8,0,1
10,2000,120400,4,4,0,0
11,2000,120400,7,6,1,0
12,2000,120400,13,12,1,0
1,2001,120400,4,4,0,2
2,2001,120400,5,3,2,1
3,2001,120400,9,8,1,1
4,2001,120400,9,8,1,0
5,2001,120400,4,2,2,0
6,2001,120400,11,11,0,1
7,2001,120400,7,7,0,0
8,2001,120400,6,4,2,1
9,2001,120400,9,8,1,0
10,2001,120400,5,4,1,2
11,2001,120400,7,6,1,5
12,2001,120400,12,12,0,0
1,2002,120400,3,3,0,2
2,2002,120400,8,8,0,0
3,2002,120400,6,6,0,0
4,2002,120400,10,9,1,0
5,2002,120400,4,4,0,0
6,2002,120400,4,4,0,1
7,2002,120400,12,11,1,0
8,2002,120400,14,14,0,0
9,2002,120400,6,4,2,0
10,2002,120400,5,5,0,1
11,2002,120400,6,6,0,0
12,2002,120400,10,9,1,0
1,2003,120400,8,8,0,0
2,2003,120400,6,6,0,0
3,2003,120400,6,6,0,0
4,2003,120400,5,5,0,0
5,2003,120400,9,9,0,2
6,2003,120400,4,4,0,0
7,2003,120400,15,15,0,1
8,2003,120400,7,7,0,2
9,2003,120400,11,11,0,2
10,2003,120400,5,5,0,0
11,2003,120400,4,4,0,1
12,2003,120400,6,6,0,0
1,2004,120400,5,5,0,0
2,2004,120400,7,7,0,0
3,2004,120400,2,2,0,0
4,2004,120400,4,4,0,2
5,2004,120400,16,16,0,0
6,2004,120400,7,7,0,1
7,2004,120400,5,3,2,1
8,2004,120400,8,7,1,0
9,2004,120400,6,6,0,2
10,2004,120400,8,7,1,0
11,2004,120400,9,9,0,0
12,2004,120400,8,7,1,1
1,2005,120400,9,9,0,0
2,2005,120400,11,11,0,2
3,2005,120400,7,6,1,0
4,2005,120400,9,9,0,1
5,2005,120400,8,8,0,1
6,2005,120400,13,11,2,0
7,2005,120400,6,6,0,0
8,2005,120400,20,18,2,3
9,2005,120400,7,6,1,0
10,2005,120400,5,5,0,0
11,2005,120400,7,7,0,0
12,2005,120400,8,8,0,0
1,2006,120400,6,6,0,0
2,2006,120400,7,6,1,0
3,2006,120400,2,2,0,2
4,2006,120400,9,9,0,0
5,2006,120400,5,4,1,0
6,2006,120400,3,3,0,2
7,2006,120400,3,2,1,0
8,2006,120400,9,9,0,0
9,2006,120400,9,9,0,1
10,2006,120400,3,3,0,1
11,2006,120400,10,10,0,2
12,2006,120400,4,4,0,0
1,2007,120400,7,7,0,0
2,2007,120400,7,7,0,0
3,2007,120400,4,2,2,0
4,2007,120400,5,4,1,3
5,2007,120400,10,10,0,6
6,2007,120400,8,8,0,1
7,2007,120400,3,3,0,0
8,2007,120400,9,8,1,1
9,2007,120400,6,6,0,1
10,2007,120400,5,5,0,0
11,2007,120400,5,4,1,0
12,2007,120400,5,5,0,0
1,2008,120400,6,6,0,0
2,2008,120400,4,4,0,0
3,2008,120400,4,4,0,0
4,2008,120400,7,7,0,0
5,2008,120400,10,10,0,0
6,2008,120400,8,7,1,0
7,2008,120400,6,6,0,2
8,2008,120400,13,11,2,0
9,2008,120400,8,8,0,0
10,2008,120400,11,11,0,0
11,2008,120400,9,9,0,0
12,2008,120400,4,4,0,0
1,2009,120400,10,10,0,0
2,2009,120400,3,3,0,1
3,2009,120400,6,6,0,0
4,2009,120400,3,3,0,0
5,2009,120400,6,6,0,0
6,2009,120400,6,4,2,1
7,2009,120400,8,8,0,0
8,2009,120400,9,7,2,1
9,2009,120400,7,6,1,0
10,2009,120400,4,4,0,0
11,2009,120400,10,9,1,0
12,2009,120400,5,5,0,0
1,2010,120400,3,3,0,0
2,2010,120400,5,2,3,0
3,2010,120400,7,7,0,3
4,2010,120400,5,5,0,1
5,2010,120400,1,1,0,0
6,2010,120400,7,7,0,1
7,2010,120400,7,6,1,0
8,2010,120400,10,10,0,2
9,2010,120400,8,7,1,0
10,2010,120400,5,5,0,0
11,2010,120400,8,5,3,0
12,2010,120400,9,9,0,0
1,2011,120400,6,6,0,0
2,2011,120400,2,2,0,0
1,1999,140400,12,12,0,1
2,1999,140400,14,13,1,0
3,1999,140400,23,23,0,0
4,1999,140400,24,24,0,1
5,1999,140400,24,24,0,0
6,1999,140400,26,25,1,0
7,1999,140400,30,30,0,0
8,1999,140400,21,20,1,0
9,1999,140400,20,19,1,0
10,1999,140400,16,14,2,0
11,1999,140400,12,11,1,1
12,1999,140400,10,9,1,0
1,2000,140400,18,17,1,0
2,2000,140400,12,11,1,0
3,2000,140400,20,18,2,0
4,2000,140400,13,13,0,1
5,2000,140400,15,15,0,1
6,2000,140400,22,21,1,0
7,2000,140400,23,22,1,0
8,2000,140400,16,15,1,1
9,2000,140400,10,9,1,0
10,2000,140400,17,16,1,0
11,2000,140400,7,7,0,0
12,2000,140400,17,16,1,0
1,2001,140400,12,11,1,0
2,2001,140400,13,13,0,1
3,2001,140400,15,14,1,0
4,2001,140400,14,14,0,0
5,2001,140400,17,16,1,0
6,2001,140400,13,13,0,0
7,2001,140400,21,19,2,1
8,2001,140400,22,22,0,0
9,2001,140400,12,11,1,0
10,2001,140400,11,11,0,1
11,2001,140400,7,6,1,2
12,2001,140400,16,16,0,0
1,2002,140400,9,9,0,0
2,2002,140400,16,16,0,0
3,2002,140400,13,13,0,0
4,2002,140400,9,9,0,0
5,2002,140400,15,15,0,1
6,2002,140400,12,12,0,0
7,2002,140400,10,10,0,0
8,2002,140400,13,12,1,2
9,2002,140400,10,9,1,1
10,2002,140400,16,15,1,0
11,2002,140400,7,7,0,1
12,2002,140400,5,5,0,2
1,2003,140400,10,10,0,1
2,2003,140400,12,12,0,0
3,2003,140400,13,13,0,1
4,2003,140400,15,14,1,0
5,2003,140400,13,12,1,1
6,2003,140400,15,15,0,3
7,2003,140400,13,11,2,1
8,2003,140400,8,7,1,0
9,2003,140400,21,21,0,0
10,2003,140400,7,6,1,1
11,2003,140400,15,15,0,0
12,2003,140400,14,13,1,2
1,2004,140400,5,5,0,0
2,2004,140400,10,9,1,0
3,2004,140400,14,14,0,1
4,2004,140400,4,4,0,2
5,2004,140400,9,9,0,1
6,2004,140400,7,7,0,0
7,2004,140400,8,8,0,0
8,2004,140400,15,14,1,0
9,2004,140400,7,6,1,4
10,2004,140400,13,12,1,0
11,2004,140400,14,14,0,0
12,2004,140400,12,12,0,4
1,2005,140400,10,10,0,0
2,2005,140400,5,5,0,0
3,2005,140400,5,5,0,1
4,2005,140400,14,13,1,4
5,2005,140400,12,11,1,0
6,2005,140400,17,16,1,0
7,2005,140400,11,10,1,0
8,2005,140400,9,9,0,1
9,2005,140400,11,11,0,2
10,2005,140400,13,13,0,4
11,2005,140400,11,11,0,0
12,2005,140400,10,9,1,2
1,2006,140400,10,10,0,1
2,2006,140400,10,10,0,1
3,2006,140400,7,7,0,1
4,2006,140400,8,7,1,1
5,2006,140400,11,9,2,2
6,2006,140400,7,6,1,2
7,2006,140400,12,11,1,2
8,2006,140400,17,17,0,2
9,2006,140400,9,9,0,2
10,2006,140400,6,6,0,1
11,2006,140400,8,8,0,0
12,2006,140400,6,5,1,2
1,2007,140400,9,9,0,1
2,2007,140400,7,7,0,0
3,2007,140400,11,10,1,0
4,2007,140400,5,4,1,0
5,2007,140400,6,5,1,2
6,2007,140400,10,10,0,2
7,2007,140400,11,10,1,0
8,2007,140400,13,12,1,0
9,2007,140400,10,10,0,2
10,2007,140400,9,6,3,1
11,2007,140400,9,7,2,2
12,2007,140400,10,10,0,0
1,2008,140400,8,8,0,1
2,2008,140400,5,5,0,1
3,2008,140400,19,18,1,1
4,2008,140400,14,14,0,1
5,2008,140400,13,13,0,0
6,2008,140400,15,14,1,2
7,2008,140400,22,22,0,1
8,2008,140400,11,11,0,3
9,2008,140400,9,9,0,0
10,2008,140400,15,15,0,0
11,2008,140400,8,8,0,1
12,2008,140400,14,14,0,0
1,2009,140400,12,12,0,1
2,2009,140400,8,8,0,0
3,2009,140400,8,8,0,1
4,2009,140400,6,6,0,0
5,2009,140400,6,6,0,0
6,2009,140400,8,8,0,0
7,2009,140400,9,8,1,2
8,2009,140400,12,12,0,0
9,2009,140400,18,16,2,1
10,2009,140400,18,18,0,0
11,2009,140400,16,16,0,1
12,2009,140400,10,10,0,0
1,2010,140400,10,10,0,0
2,2010,140400,4,4,0,0
3,2010,140400,4,3,1,1
4,2010,140400,15,15,0,2
5,2010,140400,9,9,0,4
6,2010,140400,9,9,0,1
7,2010,140400,13,12,1,0
8,2010,140400,16,16,0,1
9,2010,140400,22,21,1,0
10,2010,140400,17,17,0,1
11,2010,140400,4,4,0,0
12,2010,140400,10,10,0,0
1,2011,140400,15,14,1,0
2,2011,140400,4,4,0,0
1,1999,140301,4,0,4,3
2,1999,140301,8,8,0,1
3,1999,140301,7,5,2,1
4,1999,140301,6,5,1,1
5,1999,140301,2,1,1,2
6,1999,140301,11,8,3,2
7,1999,140301,11,9,2,0
8,1999,140301,12,11,1,3
9,1999,140301,8,7,1,3
10,1999,140301,3,3,0,0
11,1999,140301,6,5,1,1
12,1999,140301,13,11,2,4
1,2000,140301,11,10,1,0
2,2000,140301,3,3,0,5
3,2000,140301,9,6,3,1
4,2000,140301,8,8,0,0
5,2000,140301,5,5,0,2
6,2000,140301,8,8,0,1
7,2000,140301,10,10,0,4
8,2000,140301,8,8,0,0
9,2000,140301,7,6,1,1
10,2000,140301,7,7,0,2
11,2000,140301,9,8,1,0
12,2000,140301,5,4,1,0
1,2001,140301,8,7,1,0
2,2001,140301,5,5,0,0
3,2001,140301,7,7,0,3
4,2001,140301,2,1,1,0
5,2001,140301,2,1,1,0
6,2001,140301,6,4,2,1
7,2001,140301,14,11,3,1
8,2001,140301,6,3,3,1
9,2001,140301,9,9,0,1
10,2001,140301,3,3,0,0
11,2001,140301,5,5,0,1
12,2001,140301,5,5,0,0
1,2002,140301,6,6,0,0
2,2002,140301,2,2,0,0
3,2002,140301,3,1,2,0
4,2002,140301,5,3,2,0
5,2002,140301,3,3,0,0
6,2002,140301,1,0,1,2
7,2002,140301,6,5,1,1
8,2002,140301,9,9,0,2
9,2002,140301,4,4,0,0
10,2002,140301,1,0,1,0
11,2002,140301,3,3,0,0
12,2002,140301,4,4,0,0
1,2003,140301,4,4,0,1
2,2003,140301,9,8,1,1
3,2003,140301,9,7,2,1
4,2003,140301,5,5,0,2
5,2003,140301,0,0,0,2
6,2003,140301,7,4,3,0
7,2003,140301,9,6,3,2
8,2003,140301,3,3,0,0
9,2003,140301,6,4,2,1
10,2003,140301,4,4,0,0
11,2003,140301,6,5,1,0
12,2003,140301,3,3,0,1
1,2004,140301,4,4,0,0
2,2004,140301,5,5,0,1
3,2004,140301,2,2,0,0
4,2004,140301,3,2,1,1
5,2004,140301,2,2,0,2
6,2004,140301,7,6,1,2
7,2004,140301,4,4,0,1
8,2004,140301,5,4,1,0
9,2004,140301,3,3,0,0
10,2004,140301,3,3,0,0
11,2004,140301,1,1,0,11
12,2004,140301,8,8,0,5
1,2005,140301,5,5,0,2
2,2005,140301,5,4,1,1
3,2005,140301,6,6,0,1
4,2005,140301,5,5,0,2
5,2005,140301,11,11,0,7
6,2005,140301,4,4,0,2
7,2005,140301,9,8,1,0
8,2005,140301,6,5,1,0
9,2005,140301,3,3,0,2
10,2005,140301,6,4,2,2
11,2005,140301,9,8,1,0
12,2005,140301,9,8,1,0
1,2006,140301,7,6,1,1
2,2006,140301,7,7,0,1
3,2006,140301,4,3,1,0
4,2006,140301,6,4,2,1
5,2006,140301,5,5,0,0
6,2006,140301,9,6,3,2
7,2006,140301,9,8,1,0
8,2006,140301,11,10,1,0
9,2006,140301,7,6,1,0
10,2006,140301,3,3,0,0
11,2006,140301,10,8,2,1
12,2006,140301,3,3,0,1
1,2007,140301,2,2,0,0
2,2007,140301,10,9,1,2
3,2007,140301,7,5,2,0
4,2007,140301,14,14,0,2
5,2007,140301,10,10,0,3
6,2007,140301,8,6,2,0
7,2007,140301,6,6,0,0
8,2007,140301,8,7,1,2
9,2007,140301,4,2,2,3
10,2007,140301,7,6,1,1
11,2007,140301,8,7,1,0
12,2007,140301,8,7,1,0
1,2008,140301,3,2,1,2
2,2008,140301,6,5,1,0
3,2008,140301,9,9,0,0
4,2008,140301,7,7,0,2
5,2008,140301,7,5,2,0
6,2008,140301,7,6,1,0
7,2008,140301,7,7,0,1
8,2008,140301,6,5,1,1
9,2008,140301,4,4,0,0
10,2008,140301,6,6,0,1
11,2008,140301,3,3,0,1
12,2008,140301,4,2,2,1
1,2009,140301,6,4,2,0
2,2009,140301,7,7,0,5
3,2009,140301,8,6,2,2
4,2009,140301,8,6,2,2
5,2009,140301,5,4,1,1
6,2009,140301,3,2,1,2
7,2009,140301,10,10,0,0
8,2009,140301,6,5,1,0
9,2009,140301,6,6,0,1
10,2009,140301,9,8,1,2
11,2009,140301,11,10,1,0
12,2009,140301,6,6,0,1
1,2010,140301,3,3,0,0
2,2010,140301,8,7,1,3
3,2010,140301,7,6,1,2
4,2010,140301,4,3,1,2
5,2010,140301,8,7,1,0
6,2010,140301,4,3,1,5
7,2010,140301,3,3,0,3
8,2010,140301,5,5,0,0
9,2010,140301,6,6,0,0
10,2010,140301,3,3,0,0
11,2010,140301,5,4,1,1
12,2010,140301,2,2,0,1
1,2011,140301,3,3,0,1
2,2011,140301,5,4,1,1
1,1999,140200,20,18,2,4
2,1999,140200,31,31,0,4
3,1999,140200,24,21,3,14
4,1999,140200,24,20,4,9
5,1999,140200,27,23,4,4
6,1999,140200,18,15,3,8
7,1999,140200,31,25,6,10
8,1999,140200,20,19,1,4
9,1999,140200,23,21,2,5
10,1999,140200,29,22,7,3
11,1999,140200,20,16,4,9
12,1999,140200,15,12,3,2
1,2000,140200,20,17,3,7
2,2000,140200,20,17,3,5
3,2000,140200,28,24,4,4
4,2000,140200,16,12,4,3
5,2000,140200,19,15,4,3
6,2000,140200,33,28,5,2
7,2000,140200,36,31,5,4
8,2000,140200,19,16,3,7
9,2000,140200,30,27,3,7
10,2000,140200,50,40,10,10
11,2000,140200,27,26,1,8
12,2000,140200,27,24,3,12
1,2001,140200,17,15,2,3
2,2001,140200,20,19,1,9
3,2001,140200,12,11,1,5
4,2001,140200,16,13,3,8
5,2001,140200,18,13,5,7
6,2001,140200,29,24,5,5
7,2001,140200,27,17,10,5
8,2001,140200,18,12,6,3
9,2001,140200,23,21,2,1
10,2001,140200,21,16,5,3
11,2001,140200,17,17,0,2
12,2001,140200,10,8,2,1
1,2002,140200,21,18,3,3
2,2002,140200,23,19,4,3
3,2002,140200,17,16,1,3
4,2002,140200,17,15,2,1
5,2002,140200,25,22,3,2
6,2002,140200,21,19,2,3
7,2002,140200,35,30,5,1
8,2002,140200,26,19,7,5
9,2002,140200,21,19,2,1
10,2002,140200,28,26,2,1
11,2002,140200,13,12,1,5
12,2002,140200,20,19,1,1
1,2003,140200,23,20,3,4
2,2003,140200,14,13,1,1
3,2003,140200,17,16,1,3
4,2003,140200,20,17,3,1
5,2003,140200,16,13,3,7
6,2003,140200,30,27,3,5
7,2003,140200,27,24,3,3
8,2003,140200,19,16,3,3
9,2003,140200,13,12,1,2
10,2003,140200,21,19,2,0
11,2003,140200,22,22,0,3
12,2003,140200,21,21,0,2
1,2004,140200,23,20,3,2
2,2004,140200,15,12,3,0
3,2004,140200,19,19,0,3
4,2004,140200,16,16,0,1
5,2004,140200,12,12,0,2
6,2004,140200,23,20,3,3
7,2004,140200,17,15,2,8
8,2004,140200,33,27,6,3
9,2004,140200,20,16,4,11
10,2004,140200,29,28,1,3
11,2004,140200,13,11,2,0
12,2004,140200,16,15,1,7
1,2005,140200,25,24,1,3
2,2005,140200,17,17,0,1
3,2005,140200,18,17,1,3
4,2005,140200,27,26,1,7
5,2005,140200,21,20,1,4
6,2005,140200,14,14,0,2
7,2005,140200,20,18,2,2
8,2005,140200,17,16,1,5
9,2005,140200,30,28,2,0
10,2005,140200,24,20,4,8
11,2005,140200,20,20,0,2
12,2005,140200,20,18,2,0
1,2006,140200,17,15,2,3
2,2006,140200,17,15,2,0
3,2006,140200,21,21,0,5
4,2006,140200,24,21,3,3
5,2006,140200,25,22,3,5
6,2006,140200,20,19,1,0
7,2006,140200,18,15,3,0
8,2006,140200,21,17,4,12
9,2006,140200,27,26,1,8
10,2006,140200,16,14,2,2
11,2006,140200,13,12,1,1
12,2006,140200,14,13,1,0
1,2007,140200,14,13,1,5
2,2007,140200,12,12,0,2
3,2007,140200,17,15,2,13
4,2007,140200,11,10,1,3
5,2007,140200,14,12,2,2
6,2007,140200,18,17,1,1
7,2007,140200,19,17,2,0
8,2007,140200,16,14,2,5
9,2007,140200,14,14,0,0
10,2007,140200,23,21,2,3
11,2007,140200,14,14,0,5
12,2007,140200,17,14,3,4
1,2008,140200,15,14,1,1
2,2008,140200,12,12,0,3
3,2008,140200,13,13,0,2
4,2008,140200,22,18,4,2
5,2008,140200,16,14,2,1
6,2008,140200,14,14,0,2
7,2008,140200,17,15,2,4
8,2008,140200,12,9,3,5
9,2008,140200,12,11,1,7
10,2008,140200,21,19,2,2
11,2008,140200,17,17,0,0
12,2008,140200,18,16,2,6
1,2009,140200,17,15,2,1
2,2009,140200,15,14,1,6
3,2009,140200,13,12,1,5
4,2009,140200,22,21,1,4
5,2009,140200,20,19,1,3
6,2009,140200,11,9,2,2
7,2009,140200,19,19,0,2
8,2009,140200,14,13,1,5
9,2009,140200,22,20,2,3
10,2009,140200,19,18,1,3
11,2009,140200,16,16,0,5
12,2009,140200,9,9,0,0
1,2010,140200,16,15,1,4
2,2010,140200,19,18,1,2
3,2010,140200,19,18,1,8
4,2010,140200,16,15,1,3
5,2010,140200,14,11,3,2
6,2010,140200,21,21,0,5
7,2010,140200,15,11,4,4
8,2010,140200,15,14,1,5
9,2010,140200,15,12,3,1
10,2010,140200,28,22,6,7
11,2010,140200,18,13,5,4
12,2010,140200,14,14,0,6
1,2011,140200,14,14,0,5
2,2011,140200,9,9,0,0
1,1999,140100,14,12,2,0
2,1999,140100,5,3,2,2
3,1999,140100,11,6,5,4
4,1999,140100,7,5,2,7
5,1999,140100,11,8,3,1
6,1999,140100,14,13,1,5
7,1999,140100,6,4,2,6
8,1999,140100,15,13,2,1
9,1999,140100,10,10,0,2
10,1999,140100,6,4,2,0
11,1999,140100,5,4,1,3
12,1999,140100,11,11,0,1
1,2000,140100,8,6,2,2
2,2000,140100,6,5,1,4
3,2000,140100,9,6,3,2
4,2000,140100,10,10,0,5
5,2000,140100,11,8,3,3
6,2000,140100,11,9,2,3
7,2000,140100,8,8,0,2
8,2000,140100,10,8,2,1
9,2000,140100,13,13,0,1
10,2000,140100,5,4,1,4
11,2000,140100,8,7,1,2
12,2000,140100,9,7,2,0
1,2001,140100,6,6,0,7
2,2001,140100,11,10,1,3
3,2001,140100,14,8,6,6
4,2001,140100,10,9,1,3
5,2001,140100,12,11,1,1
6,2001,140100,5,3,2,0
7,2001,140100,13,9,4,5
8,2001,140100,13,9,4,3
9,2001,140100,9,9,0,6
10,2001,140100,5,4,1,4
11,2001,140100,3,1,2,3
12,2001,140100,9,9,0,1
1,2002,140100,3,2,1,11
2,2002,140100,6,6,0,8
3,2002,140100,6,5,1,5
4,2002,140100,7,5,2,2
5,2002,140100,9,8,1,4
6,2002,140100,4,4,0,8
7,2002,140100,10,4,6,3
8,2002,140100,11,9,2,2
9,2002,140100,12,10,2,4
10,2002,140100,10,9,1,1
11,2002,140100,14,13,1,4
12,2002,140100,8,8,0,1
1,2003,140100,13,12,1,2
2,2003,140100,6,4,2,3
3,2003,140100,13,12,1,2
4,2003,140100,8,7,1,2
5,2003,140100,7,6,1,3
6,2003,140100,12,7,5,2
7,2003,140100,12,11,1,0
8,2003,140100,15,11,4,5
9,2003,140100,12,10,2,0
10,2003,140100,9,8,1,0
11,2003,140100,10,8,2,4
12,2003,140100,11,11,0,0
1,2004,140100,9,9,0,0
2,2004,140100,11,8,3,0
3,2004,140100,7,6,1,0
4,2004,140100,12,12,0,0
5,2004,140100,14,14,0,0
6,2004,140100,8,7,1,0
7,2004,140100,10,9,1,2
8,2004,140100,5,5,0,0
9,2004,140100,12,11,1,3
10,2004,140100,13,13,0,2
11,2004,140100,8,7,1,1
12,2004,140100,5,5,0,2
1,2005,140100,6,6,0,0
2,2005,140100,10,10,0,0
3,2005,140100,9,7,2,3
4,2005,140100,5,3,2,1
5,2005,140100,8,7,1,2
6,2005,140100,4,2,2,1
7,2005,140100,5,4,1,0
8,2005,140100,8,8,0,2
9,2005,140100,9,7,2,1
10,2005,140100,7,6,1,1
11,2005,140100,5,5,0,0
12,2005,140100,10,10,0,1
1,2006,140100,6,4,2,2
2,2006,140100,5,5,0,1
3,2006,140100,4,4,0,2
4,2006,140100,9,8,1,0
5,2006,140100,6,5,1,0
6,2006,140100,5,5,0,1
7,2006,140100,5,3,2,2
8,2006,140100,10,8,2,1
9,2006,140100,9,5,4,1
10,2006,140100,4,3,1,3
11,2006,140100,3,3,0,0
12,2006,140100,4,4,0,1
1,2007,140100,7,6,1,1
2,2007,140100,3,2,1,1
3,2007,140100,5,5,0,3
4,2007,140100,7,6,1,5
5,2007,140100,6,6,0,1
6,2007,140100,7,6,1,2
7,2007,140100,8,6,2,0
8,2007,140100,7,3,4,3
9,2007,140100,3,3,0,5
10,2007,140100,3,3,0,1
11,2007,140100,9,8,1,6
12,2007,140100,6,5,1,2
1,2008,140100,4,4,0,1
2,2008,140100,4,4,0,3
3,2008,140100,8,7,1,7
4,2008,140100,7,6,1,0
5,2008,140100,6,5,1,1
6,2008,140100,8,7,1,0
7,2008,140100,11,7,4,1
8,2008,140100,8,8,0,1
9,2008,140100,12,10,2,5
10,2008,140100,12,8,4,3
11,2008,140100,7,6,1,2
12,2008,140100,7,7,0,1
1,2009,140100,6,4,2,2
2,2009,140100,12,11,1,0
3,2009,140100,9,8,1,3
4,2009,140100,6,5,1,5
5,2009,140100,9,6,3,1
6,2009,140100,3,2,1,1
7,2009,140100,4,4,0,1
8,2009,140100,11,11,0,4
9,2009,140100,4,4,0,1
10,2009,140100,5,4,1,1
11,2009,140100,2,2,0,2
12,2009,140100,6,5,1,0
1,2010,140100,6,4,2,2
2,2010,140100,9,8,1,3
3,2010,140100,9,7,2,4
4,2010,140100,2,1,1,3
5,2010,140100,6,3,3,3
6,2010,140100,9,8,1,7
7,2010,140100,13,13,0,3
8,2010,140100,8,5,3,2
9,2010,140100,7,6,1,2
10,2010,140100,8,6,2,3
11,2010,140100,10,9,1,2
12,2010,140100,4,3,1,1
1,2011,140100,4,4,0,3
2,2011,140100,2,2,0,2
1,1999,040300,10,8,2,0
2,1999,040300,13,12,1,0
3,1999,040300,10,7,3,0
4,1999,040300,10,8,2,2
5,1999,040300,4,2,2,0
6,1999,040300,16,14,2,0
7,1999,040300,14,13,1,1
8,1999,040300,13,11,2,1
9,1999,040300,13,12,1,0
10,1999,040300,10,7,3,1
11,1999,040300,16,14,2,0
12,1999,040300,6,6,0,1
1,2000,040300,14,12,2,1
2,2000,040300,11,8,3,2
3,2000,040300,15,12,3,0
4,2000,040300,20,15,5,1
5,2000,040300,12,10,2,0
6,2000,040300,23,21,2,0
7,2000,040300,11,10,1,1
8,2000,040300,20,19,1,0
9,2000,040300,13,9,4,4
10,2000,040300,6,5,1,2
11,2000,040300,14,12,2,1
12,2000,040300,10,7,3,1
1,2001,040300,4,4,0,1
2,2001,040300,11,10,1,0
3,2001,040300,8,7,1,1
4,2001,040300,10,10,0,2
5,2001,040300,10,9,1,0
6,2001,040300,3,2,1,1
7,2001,040300,17,15,2,0
8,2001,040300,17,17,0,3
9,2001,040300,10,9,1,2
10,2001,040300,7,6,1,0
11,2001,040300,8,8,0,1
12,2001,040300,15,15,0,2
1,2002,040300,9,9,0,1
2,2002,040300,11,11,0,0
3,2002,040300,10,9,1,0
4,2002,040300,9,6,3,0
5,2002,040300,8,6,2,0
6,2002,040300,14,12,2,0
7,2002,040300,12,9,3,0
8,2002,040300,9,8,1,0
9,2002,040300,11,10,1,0
10,2002,040300,18,15,3,0
11,2002,040300,17,16,1,0
12,2002,040300,11,10,1,0
1,2003,040300,10,10,0,3
2,2003,040300,7,7,0,0
3,2003,040300,8,6,2,0
4,2003,040300,8,7,1,2
5,2003,040300,11,7,4,0
6,2003,040300,14,10,4,1
7,2003,040300,11,11,0,2
8,2003,040300,20,15,5,1
9,2003,040300,17,14,3,0
10,2003,040300,17,15,2,0
11,2003,040300,14,13,1,0
12,2003,040300,14,14,0,0
1,2004,040300,13,13,0,1
2,2004,040300,5,4,1,3
3,2004,040300,6,6,0,2
4,2004,040300,10,9,1,0
5,2004,040300,7,5,2,1
6,2004,040300,16,15,1,1
7,2004,040300,18,17,1,1
8,2004,040300,20,18,2,0
9,2004,040300,12,12,0,0
10,2004,040300,12,10,2,0
11,2004,040300,11,9,2,1
12,2004,040300,11,11,0,0
1,2005,040300,10,8,2,0
2,2005,040300,4,3,1,0
3,2005,040300,11,9,2,3
4,2005,040300,11,11,0,8
5,2005,040300,8,7,1,4
6,2005,040300,14,13,1,0
7,2005,040300,15,10,5,7
8,2005,040300,12,10,2,2
9,2005,040300,20,20,0,0
10,2005,040300,21,21,0,3
11,2005,040300,17,17,0,5
12,2005,040300,10,9,1,1
1,2006,040300,11,11,0,0
2,2006,040300,11,11,0,2
3,2006,040300,7,7,0,2
4,2006,040300,9,8,1,5
5,2006,040300,17,17,0,7
6,2006,040300,6,6,0,1
7,2006,040300,10,10,0,0
8,2006,040300,13,13,0,2
9,2006,040300,8,7,1,5
10,2006,040300,5,4,1,3
11,2006,040300,9,8,1,2
12,2006,040300,13,13,0,1
1,2007,040300,11,11,0,3
2,2007,040300,6,6,0,1
3,2007,040300,6,6,0,4
4,2007,040300,14,12,2,2
5,2007,040300,7,7,0,1
6,2007,040300,10,8,2,1
7,2007,040300,9,9,0,2
8,2007,040300,12,12,0,2
9,2007,040300,8,6,2,2
10,2007,040300,13,12,1,0
11,2007,040300,8,8,0,2
12,2007,040300,12,12,0,2
1,2008,040300,13,12,1,1
2,2008,040300,9,9,0,0
3,2008,040300,6,6,0,1
4,2008,040300,5,5,0,1
5,2008,040300,6,4,2,5
6,2008,040300,11,11,0,1
7,2008,040300,14,11,3,0
8,2008,040300,9,9,0,0
9,2008,040300,17,17,0,4
10,2008,040300,14,12,2,0
11,2008,040300,17,16,1,0
12,2008,040300,14,13,1,2
1,2009,040300,4,4,0,0
2,2009,040300,9,7,2,2
3,2009,040300,13,11,2,1
4,2009,040300,5,4,1,3
5,2009,040300,14,12,2,0
6,2009,040300,14,13,1,3
7,2009,040300,13,13,0,1
8,2009,040300,15,15,0,1
9,2009,040300,7,7,0,2
10,2009,040300,4,4,0,0
11,2009,040300,5,5,0,2
12,2009,040300,11,10,1,1
1,2010,040300,9,9,0,3
2,2010,040300,9,8,1,4
3,2010,040300,5,5,0,0
4,2010,040300,8,7,1,1
5,2010,040300,12,11,1,1
6,2010,040300,10,10,0,1
7,2010,040300,16,16,0,2
8,2010,040300,10,10,0,1
9,2010,040300,9,9,0,1
10,2010,040300,11,10,1,2
11,2010,040300,5,4,1,2
12,2010,040300,8,7,1,0
1,2011,040300,13,11,2,1
2,2011,040300,3,3,0,2
1,1999,040201,11,9,2,0
2,1999,040201,23,20,3,6
3,1999,040201,13,11,2,3
4,1999,040201,13,11,2,0
5,1999,040201,24,21,3,2
6,1999,040201,18,14,4,6
7,1999,040201,30,26,4,1
8,1999,040201,23,17,6,2
9,1999,040201,21,19,2,1
10,1999,040201,22,21,1,3
11,1999,040201,16,15,1,3
12,1999,040201,10,8,2,0
1,2000,040201,19,17,2,2
2,2000,040201,15,13,2,2
3,2000,040201,14,13,1,1
4,2000,040201,12,10,2,0
5,2000,040201,20,19,1,3
6,2000,040201,20,20,0,2
7,2000,040201,29,24,5,1
8,2000,040201,20,17,3,4
9,2000,040201,24,22,2,6
10,2000,040201,18,18,0,2
11,2000,040201,16,15,1,0
12,2000,040201,14,10,4,1
1,2001,040201,18,14,4,1
2,2001,040201,6,4,2,1
3,2001,040201,17,16,1,3
4,2001,040201,14,8,6,2
5,2001,040201,18,13,5,1
6,2001,040201,13,12,1,3
7,2001,040201,17,14,3,3
8,2001,040201,13,11,2,0
9,2001,040201,14,12,2,0
10,2001,040201,17,16,1,0
11,2001,040201,21,21,0,0
12,2001,040201,8,7,1,0
1,2002,040201,19,18,1,0
2,2002,040201,14,13,1,2
3,2002,040201,11,10,1,3
4,2002,040201,11,11,0,0
5,2002,040201,9,9,0,1
6,2002,040201,16,15,1,1
7,2002,040201,13,12,1,5
8,2002,040201,17,15,2,2
9,2002,040201,15,9,6,4
10,2002,040201,21,20,1,0
11,2002,040201,12,11,1,0
12,2002,040201,21,17,4,3
1,2003,040201,12,11,1,1
2,2003,040201,14,11,3,1
3,2003,040201,16,15,1,0
4,2003,040201,16,13,3,2
5,2003,040201,11,11,0,0
6,2003,040201,15,12,3,1
7,2003,040201,16,16,0,3
8,2003,040201,28,25,3,0
9,2003,040201,17,16,1,0
10,2003,040201,14,14,0,2
11,2003,040201,20,18,2,1
12,2003,040201,19,18,1,2
1,2004,040201,5,3,2,1
2,2004,040201,9,9,0,1
3,2004,040201,14,14,0,0
4,2004,040201,15,14,1,0
5,2004,040201,9,9,0,2
6,2004,040201,27,23,4,2
7,2004,040201,21,19,2,3
8,2004,040201,12,11,1,0
9,2004,040201,21,20,1,0
10,2004,040201,19,17,2,1
11,2004,040201,23,23,0,1
12,2004,040201,19,16,3,1
1,2005,040201,18,15,3,1
2,2005,040201,15,15,0,2
3,2005,040201,19,19,0,3
4,2005,040201,10,9,1,2
5,2005,040201,16,14,2,2
6,2005,040201,10,10,0,1
7,2005,040201,7,7,0,1
8,2005,040201,26,25,1,1
9,2005,040201,21,19,2,2
10,2005,040201,20,19,1,2
11,2005,040201,18,17,1,2
12,2005,040201,12,10,2,0
1,2006,040201,14,14,0,1
2,2006,040201,13,13,0,4
3,2006,040201,13,13,0,0
4,2006,040201,12,11,1,1
5,2006,040201,18,18,0,3
6,2006,040201,10,9,1,1
7,2006,040201,13,13,0,2
8,2006,040201,17,16,1,2
9,2006,040201,13,13,0,3
10,2006,040201,11,11,0,3
11,2006,040201,15,15,0,1
12,2006,040201,10,10,0,0
1,2007,040201,12,12,0,3
2,2007,040201,8,8,0,2
3,2007,040201,10,9,1,2
4,2007,040201,6,6,0,1
5,2007,040201,14,12,2,3
6,2007,040201,7,6,1,2
7,2007,040201,10,10,0,0
8,2007,040201,15,14,1,1
9,2007,040201,14,13,1,2
10,2007,040201,7,7,0,1
11,2007,040201,7,6,1,0
12,2007,040201,12,11,1,0
1,2008,040201,15,15,0,1
2,2008,040201,16,16,0,2
3,2008,040201,7,7,0,3
4,2008,040201,13,11,2,0
5,2008,040201,11,10,1,3
6,2008,040201,18,16,2,1
7,2008,040201,14,14,0,2
8,2008,040201,16,14,2,5
9,2008,040201,19,17,2,2
10,2008,040201,10,8,2,0
11,2008,040201,14,14,0,0
12,2008,040201,13,12,1,0
1,2009,040201,10,9,1,1
2,2009,040201,8,8,0,2
3,2009,040201,16,15,1,0
4,2009,040201,16,15,1,2
5,2009,040201,15,15,0,3
6,2009,040201,6,6,0,0
7,2009,040201,15,13,2,3
8,2009,040201,14,13,1,1
9,2009,040201,9,8,1,0
10,2009,040201,16,14,2,1
11,2009,040201,12,10,2,2
12,2009,040201,13,12,1,1
1,2010,040201,11,7,4,2
2,2010,040201,9,8,1,7
3,2010,040201,8,6,2,0
4,2010,040201,15,14,1,3
5,2010,040201,11,10,1,1
6,2010,040201,9,9,0,2
7,2010,040201,9,9,0,6
8,2010,040201,14,13,1,0
9,2010,040201,10,10,0,3
10,2010,040201,12,11,1,2
11,2010,040201,11,11,0,0
12,2010,040201,9,8,1,3
1,2011,040201,5,5,0,1
2,2011,040201,8,7,1,6
1,1999,100700,7,7,0,0
2,1999,100700,0,0,0,0
3,1999,100700,4,4,0,0
4,1999,100700,2,2,0,1
5,1999,100700,5,5,0,0
6,1999,100700,2,2,0,0
7,1999,100700,5,5,0,0
8,1999,100700,9,9,0,0
9,1999,100700,2,2,0,2
10,1999,100700,3,3,0,0
11,1999,100700,5,4,1,0
12,1999,100700,3,3,0,0
1,2000,100700,4,4,0,0
2,2000,100700,3,3,0,0
3,2000,100700,4,4,0,0
4,2000,100700,7,6,1,0
5,2000,100700,2,2,0,0
6,2000,100700,3,3,0,0
7,2000,100700,8,8,0,0
8,2000,100700,8,8,0,0
9,2000,100700,10,10,0,0
10,2000,100700,3,3,0,0
11,2000,100700,6,6,0,0
12,2000,100700,3,3,0,2
1,2001,100700,3,3,0,0
2,2001,100700,6,6,0,0
3,2001,100700,4,4,0,0
4,2001,100700,4,4,0,0
5,2001,100700,4,4,0,0
6,2001,100700,5,5,0,0
7,2001,100700,4,4,0,0
8,2001,100700,8,8,0,2
9,2001,100700,6,6,0,0
10,2001,100700,2,2,0,0
11,2001,100700,4,3,1,0
12,2001,100700,3,3,0,0
1,2002,100700,6,6,0,0
2,2002,100700,2,2,0,1
3,2002,100700,4,4,0,0
4,2002,100700,9,8,1,0
5,2002,100700,3,3,0,1
6,2002,100700,5,5,0,0
7,2002,100700,9,9,0,0
8,2002,100700,6,6,0,1
9,2002,100700,5,3,2,0
10,2002,100700,6,6,0,0
11,2002,100700,2,2,0,0
12,2002,100700,5,5,0,0
1,2003,100700,2,2,0,0
2,2003,100700,3,3,0,0
3,2003,100700,1,1,0,1
4,2003,100700,2,2,0,0
5,2003,100700,5,5,0,0
6,2003,100700,7,7,0,0
7,2003,100700,16,16,0,0
8,2003,100700,11,11,0,0
9,2003,100700,3,3,0,0
10,2003,100700,4,3,1,0
11,2003,100700,4,4,0,0
12,2003,100700,6,6,0,0
1,2004,100700,2,2,0,0
2,2004,100700,0,0,0,0
3,2004,100700,4,2,2,1
4,2004,100700,1,1,0,1
5,2004,100700,1,1,0,0
6,2004,100700,3,3,0,0
7,2004,100700,4,4,0,1
8,2004,100700,8,7,1,1
9,2004,100700,1,1,0,0
10,2004,100700,3,1,2,0
11,2004,100700,4,4,0,0
12,2004,100700,8,8,0,0
1,2005,100700,4,4,0,0
2,2005,100700,4,4,0,0
3,2005,100700,4,4,0,0
4,2005,100700,1,1,0,1
5,2005,100700,2,2,0,1
6,2005,100700,3,3,0,0
7,2005,100700,3,3,0,1
8,2005,100700,5,5,0,2
9,2005,100700,4,4,0,0
10,2005,100700,3,3,0,0
11,2005,100700,6,6,0,0
12,2005,100700,3,3,0,1
1,2006,100700,9,9,0,0
2,2006,100700,2,2,0,0
3,2006,100700,3,3,0,0
4,2006,100700,3,2,1,0
5,2006,100700,6,6,0,0
6,2006,100700,4,4,0,0
7,2006,100700,6,6,0,0
8,2006,100700,7,7,0,0
9,2006,100700,4,4,0,0
10,2006,100700,7,7,0,0
11,2006,100700,0,0,0,0
12,2006,100700,3,3,0,0
1,2007,100700,1,1,0,0
2,2007,100700,5,4,1,0
3,2007,100700,4,3,1,0
4,2007,100700,6,6,0,0
5,2007,100700,4,4,0,0
6,2007,100700,1,1,0,0
7,2007,100700,4,4,0,0
8,2007,100700,10,10,0,0
9,2007,100700,4,4,0,0
10,2007,100700,2,2,0,0
11,2007,100700,3,3,0,0
12,2007,100700,8,8,0,1
1,2008,100700,5,4,1,0
2,2008,100700,3,3,0,1
3,2008,100700,3,3,0,0
4,2008,100700,6,6,0,1
5,2008,100700,6,6,0,1
6,2008,100700,7,7,0,1
7,2008,100700,9,9,0,0
8,2008,100700,7,7,0,0
9,2008,100700,3,3,0,0
10,2008,100700,5,5,0,0
11,2008,100700,5,5,0,0
12,2008,100700,5,5,0,0
1,2009,100700,6,6,0,0
2,2009,100700,6,6,0,0
3,2009,100700,5,5,0,0
4,2009,100700,4,4,0,0
5,2009,100700,2,2,0,1
6,2009,100700,4,4,0,1
7,2009,100700,3,3,0,0
8,2009,100700,2,2,0,1
9,2009,100700,2,2,0,0
10,2009,100700,5,5,0,0
11,2009,100700,3,3,0,0
12,2009,100700,2,2,0,0
1,2010,100700,0,0,0,0
2,2010,100700,6,5,1,0
3,2010,100700,6,6,0,0
4,2010,100700,2,2,0,1
5,2010,100700,3,2,1,0
6,2010,100700,2,2,0,0
7,2010,100700,2,2,0,1
8,2010,100700,3,3,0,0
9,2010,100700,6,6,0,1
10,2010,100700,8,7,1,1
11,2010,100700,2,2,0,0
12,2010,100700,5,5,0,0
1,2011,100700,3,2,1,0
2,2011,100700,3,3,0,0
1,1999,040401,6,5,1,0
2,1999,040401,8,8,0,1
3,1999,040401,7,5,2,0
4,1999,040401,5,5,0,0
5,1999,040401,6,6,0,0
6,1999,040401,13,13,0,0
7,1999,040401,10,9,1,3
8,1999,040401,14,12,2,1
9,1999,040401,11,10,1,0
10,1999,040401,7,5,2,0
11,1999,040401,10,9,1,2
12,1999,040401,12,10,2,1
1,2000,040401,5,5,0,0
2,2000,040401,7,7,0,0
3,2000,040401,13,12,1,1
4,2000,040401,16,16,0,1
5,2000,040401,12,12,0,0
6,2000,040401,7,5,2,1
7,2000,040401,10,10,0,1
8,2000,040401,12,10,2,1
9,2000,040401,8,7,1,2
10,2000,040401,9,8,1,0
11,2000,040401,6,6,0,0
12,2000,040401,10,10,0,2
1,2001,040401,6,6,0,0
2,2001,040401,3,3,0,0
3,2001,040401,3,3,0,0
4,2001,040401,5,5,0,0
5,2001,040401,3,3,0,1
6,2001,040401,13,13,0,0
7,2001,040401,7,7,0,1
8,2001,040401,9,9,0,0
9,2001,040401,15,15,0,0
10,2001,040401,9,9,0,0
11,2001,040401,14,11,3,0
12,2001,040401,18,17,1,0
1,2002,040401,5,5,0,1
2,2002,040401,8,8,0,0
3,2002,040401,5,5,0,0
4,2002,040401,3,3,0,0
5,2002,040401,2,2,0,0
6,2002,040401,7,7,0,1
7,2002,040401,9,9,0,0
8,2002,040401,10,9,1,0
9,2002,040401,8,7,1,1
10,2002,040401,8,7,1,0
11,2002,040401,5,5,0,0
12,2002,040401,4,4,0,1
1,2003,040401,2,2,0,0
2,2003,040401,7,7,0,0
3,2003,040401,4,4,0,0
4,2003,040401,13,12,1,0
5,2003,040401,10,10,0,0
6,2003,040401,3,3,0,0
7,2003,040401,6,6,0,0
8,2003,040401,11,9,2,0
9,2003,040401,7,7,0,0
10,2003,040401,6,6,0,1
11,2003,040401,6,6,0,0
12,2003,040401,1,1,0,1
1,2004,040401,3,3,0,0
2,2004,040401,4,4,0,0
3,2004,040401,6,6,0,0
4,2004,040401,5,5,0,1
5,2004,040401,3,3,0,0
6,2004,040401,3,3,0,1
7,2004,040401,7,7,0,0
8,2004,040401,11,11,0,1
9,2004,040401,9,9,0,1
10,2004,040401,9,9,0,0
11,2004,040401,11,11,0,0
12,2004,040401,3,3,0,0
1,2005,040401,5,5,0,1
2,2005,040401,8,8,0,1
3,2005,040401,7,7,0,0
4,2005,040401,7,6,1,0
5,2005,040401,7,7,0,1
6,2005,040401,6,6,0,0
7,2005,040401,9,9,0,2
8,2005,040401,7,7,0,0
9,2005,040401,10,10,0,0
10,2005,040401,5,5,0,0
11,2005,040401,2,2,0,0
12,2005,040401,6,6,0,0
1,2006,040401,4,3,1,0
2,2006,040401,8,8,0,2
3,2006,040401,6,6,0,0
4,2006,040401,5,5,0,0
5,2006,040401,6,6,0,0
6,2006,040401,8,8,0,2
7,2006,040401,6,6,0,1
8,2006,040401,1,1,0,0
9,2006,040401,8,7,1,1
10,2006,040401,11,10,1,0
11,2006,040401,0,0,0,1
12,2006,040401,3,3,0,2
1,2007,040401,5,5,0,0
2,2007,040401,5,5,0,0
3,2007,040401,2,2,0,0
4,2007,040401,8,8,0,0
5,2007,040401,9,9,0,0
6,2007,040401,4,4,0,0
7,2007,040401,4,4,0,0
8,2007,040401,5,5,0,0
9,2007,040401,6,5,1,0
10,2007,040401,4,4,0,2
11,2007,040401,4,3,1,0
12,2007,040401,3,3,0,0
1,2008,040401,5,5,0,0
2,2008,040401,4,4,0,0
3,2008,040401,5,4,1,0
4,2008,040401,3,3,0,0
5,2008,040401,5,5,0,0
6,2008,040401,10,10,0,0
7,2008,040401,7,7,0,0
8,2008,040401,7,6,1,0
9,2008,040401,10,8,2,0
10,2008,040401,7,7,0,0
11,2008,040401,5,5,0,0
12,2008,040401,4,4,0,0
1,2009,040401,4,4,0,0
2,2009,040401,4,3,1,1
3,2009,040401,2,2,0,0
4,2009,040401,7,7,0,0
5,2009,040401,8,8,0,0
6,2009,040401,4,4,0,0
7,2009,040401,2,2,0,0
8,2009,040401,2,2,0,0
9,2009,040401,4,4,0,2
10,2009,040401,4,4,0,1
11,2009,040401,2,1,1,1
12,2009,040401,3,3,0,3
1,2010,040401,4,3,1,1
2,2010,040401,4,4,0,0
3,2010,040401,4,4,0,4
4,2010,040401,3,3,0,0
5,2010,040401,5,5,0,0
6,2010,040401,8,8,0,2
7,2010,040401,10,10,0,0
8,2010,040401,7,7,0,0
9,2010,040401,3,3,0,1
10,2010,040401,5,5,0,1
11,2010,040401,4,4,0,0
12,2010,040401,4,4,0,0
1,2011,040401,6,6,0,0
2,2011,040401,2,2,0,0
1,1999,040402,31,27,4,1
2,1999,040402,25,25,0,5
3,1999,040402,23,21,2,3
4,1999,040402,31,29,2,4
5,1999,040402,38,34,4,4
6,1999,040402,31,30,1,3
7,1999,040402,36,32,4,4
8,1999,040402,24,23,1,0
9,1999,040402,22,22,0,3
10,1999,040402,39,36,3,5
11,1999,040402,23,19,4,3
12,1999,040402,19,17,2,3
1,2000,040402,29,27,2,5
2,2000,040402,38,34,4,3
3,2000,040402,30,30,0,2
4,2000,040402,25,22,3,6
5,2000,040402,24,21,3,10
6,2000,040402,35,32,3,2
7,2000,040402,41,40,1,1
8,2000,040402,30,29,1,1
9,2000,040402,29,27,2,5
10,2000,040402,34,32,2,4
11,2000,040402,25,23,2,1
12,2000,040402,20,20,0,4
1,2001,040402,23,22,1,2
2,2001,040402,18,14,4,5
3,2001,040402,23,21,2,9
4,2001,040402,29,27,2,3
5,2001,040402,31,31,0,3
6,2001,040402,22,20,2,4
7,2001,040402,37,34,3,3
8,2001,040402,51,50,1,6
9,2001,040402,37,36,1,5
10,2001,040402,38,36,2,4
11,2001,040402,17,16,1,3
12,2001,040402,24,24,0,4
1,2002,040402,14,12,2,7
2,2002,040402,9,8,1,2
3,2002,040402,8,7,1,4
4,2002,040402,18,17,1,1
5,2002,040402,18,17,1,10
6,2002,040402,24,22,2,4
7,2002,040402,16,14,2,0
8,2002,040402,26,25,1,0
9,2002,040402,18,14,4,1
10,2002,040402,25,20,5,0
11,2002,040402,19,15,4,3
12,2002,040402,42,41,1,3
1,2003,040402,20,18,2,4
2,2003,040402,18,18,0,2
3,2003,040402,30,30,0,2
4,2003,040402,14,12,2,1
5,2003,040402,16,15,1,4
6,2003,040402,26,22,4,1
7,2003,040402,22,22,0,1
8,2003,040402,17,17,0,0
9,2003,040402,19,15,4,6
10,2003,040402,31,31,0,1
11,2003,040402,19,19,0,4
12,2003,040402,18,18,0,4
1,2004,040402,12,12,0,3
2,2004,040402,17,17,0,2
3,2004,040402,24,24,0,0
4,2004,040402,13,11,2,0
5,2004,040402,23,19,4,1
6,2004,040402,15,15,0,3
7,2004,040402,17,16,1,1
8,2004,040402,28,28,0,0
9,2004,040402,10,7,3,0
10,2004,040402,20,18,2,5
11,2004,040402,27,23,4,3
12,2004,040402,27,27,0,0
1,2005,040402,25,23,2,3
2,2005,040402,20,17,3,2
3,2005,040402,19,18,1,2
4,2005,040402,17,17,0,1
5,2005,040402,16,15,1,2
6,2005,040402,21,20,1,1
7,2005,040402,21,21,0,0
8,2005,040402,14,12,2,1
9,2005,040402,22,21,1,4
10,2005,040402,33,29,4,3
11,2005,040402,28,28,0,3
12,2005,040402,20,20,0,4
1,2006,040402,23,20,3,2
2,2006,040402,13,13,0,1
3,2006,040402,26,26,0,2
4,2006,040402,18,17,1,2
5,2006,040402,22,22,0,3
6,2006,040402,17,16,1,1
7,2006,040402,20,20,0,6
8,2006,040402,11,11,0,0
9,2006,040402,14,14,0,2
10,2006,040402,10,8,2,3
11,2006,040402,13,13,0,1
12,2006,040402,19,19,0,1
1,2007,040402,20,20,0,5
2,2007,040402,10,9,1,7
3,2007,040402,21,20,1,5
4,2007,040402,10,10,0,0
5,2007,040402,15,15,0,2
6,2007,040402,17,16,1,0
7,2007,040402,16,16,0,0
8,2007,040402,10,10,0,1
9,2007,040402,21,21,0,1
10,2007,040402,12,12,0,1
11,2007,040402,16,16,0,4
12,2007,040402,24,24,0,3
1,2008,040402,11,11,0,9
2,2008,040402,12,11,1,8
3,2008,040402,17,17,0,2
4,2008,040402,8,5,3,9
5,2008,040402,11,11,0,2
6,2008,040402,26,25,1,0
7,2008,040402,15,15,0,0
8,2008,040402,17,16,1,1
9,2008,040402,16,16,0,4
10,2008,040402,16,15,1,2
11,2008,040402,16,16,0,2
12,2008,040402,13,13,0,7
1,2009,040402,16,14,2,13
2,2009,040402,12,12,0,12
3,2009,040402,16,13,3,11
4,2009,040402,17,17,0,4
5,2009,040402,21,20,1,3
6,2009,040402,18,16,2,1
7,2009,040402,15,15,0,0
8,2009,040402,16,16,0,1
9,2009,040402,15,15,0,12
10,2009,040402,28,26,2,3
11,2009,040402,13,12,1,4
12,2009,040402,25,25,0,9
1,2010,040402,13,12,1,3
2,2010,040402,10,10,0,3
3,2010,040402,7,6,1,17
4,2010,040402,26,24,2,3
5,2010,040402,27,27,0,3
6,2010,040402,25,25,0,8
7,2010,040402,17,15,2,0
8,2010,040402,11,11,0,2
9,2010,040402,21,20,1,3
10,2010,040402,25,25,0,3
11,2010,040402,12,12,0,6
12,2010,040402,9,9,0,4
1,2011,040402,7,7,0,3
2,2011,040402,11,9,2,5
1,1999,110502,7,6,1,4
2,1999,110502,12,12,0,5
3,1999,110502,10,9,1,5
4,1999,110502,10,10,0,10
5,1999,110502,8,6,2,3
6,1999,110502,11,8,3,4
7,1999,110502,8,8,0,3
8,1999,110502,9,9,0,5
9,1999,110502,12,11,1,6
10,1999,110502,5,5,0,5
11,1999,110502,10,9,1,4
12,1999,110502,4,4,0,3
1,2000,110502,7,6,1,8
2,2000,110502,8,5,3,1
3,2000,110502,3,3,0,4
4,2000,110502,10,9,1,0
5,2000,110502,8,7,1,3
6,2000,110502,11,9,2,3
7,2000,110502,11,11,0,7
8,2000,110502,14,12,2,2
9,2000,110502,10,9,1,5
10,2000,110502,9,9,0,2
11,2000,110502,3,3,0,5
12,2000,110502,8,7,1,1
1,2001,110502,7,7,0,2
2,2001,110502,7,7,0,2
3,2001,110502,7,7,0,3
4,2001,110502,4,4,0,1
5,2001,110502,7,7,0,2
6,2001,110502,11,11,0,2
7,2001,110502,12,11,1,2
8,2001,110502,13,11,2,4
9,2001,110502,4,4,0,2
10,2001,110502,4,4,0,2
11,2001,110502,5,5,0,3
12,2001,110502,10,8,2,0
1,2002,110502,4,4,0,1
2,2002,110502,8,6,2,5
3,2002,110502,1,1,0,2
4,2002,110502,5,5,0,1
5,2002,110502,8,7,1,3
6,2002,110502,9,9,0,1
7,2002,110502,12,11,1,1
8,2002,110502,7,7,0,3
9,2002,110502,11,9,2,0
10,2002,110502,5,5,0,2
11,2002,110502,8,7,1,0
12,2002,110502,6,5,1,0
1,2003,110502,5,5,0,1
2,2003,110502,2,2,0,1
3,2003,110502,8,7,1,5
4,2003,110502,5,4,1,3
5,2003,110502,6,4,2,1
6,2003,110502,7,7,0,1
7,2003,110502,5,5,0,1
8,2003,110502,7,6,1,4
9,2003,110502,15,14,1,0
10,2003,110502,7,5,2,2
11,2003,110502,2,2,0,2
12,2003,110502,7,6,1,2
1,2004,110502,6,5,1,5
2,2004,110502,4,4,0,0
3,2004,110502,5,5,0,5
4,2004,110502,4,3,1,1
5,2004,110502,3,3,0,2
6,2004,110502,5,4,1,1
7,2004,110502,9,9,0,1
8,2004,110502,9,9,0,1
9,2004,110502,5,4,1,0
10,2004,110502,2,2,0,0
11,2004,110502,8,7,1,2
12,2004,110502,11,10,1,0
1,2005,110502,6,5,1,1
2,2005,110502,6,6,0,1
3,2005,110502,1,1,0,3
4,2005,110502,8,5,3,0
5,2005,110502,8,8,0,0
6,2005,110502,9,8,1,0
7,2005,110502,13,12,1,0
8,2005,110502,9,9,0,0
9,2005,110502,8,8,0,0
10,2005,110502,17,17,0,3
11,2005,110502,11,10,1,0
12,2005,110502,4,4,0,1
1,2006,110502,8,8,0,0
2,2006,110502,7,6,1,0
3,2006,110502,10,10,0,0
4,2006,110502,9,8,1,0
5,2006,110502,4,4,0,3
6,2006,110502,6,6,0,1
7,2006,110502,5,4,1,0
8,2006,110502,19,16,3,2
9,2006,110502,5,5,0,1
10,2006,110502,9,8,1,2
11,2006,110502,8,7,1,1
12,2006,110502,11,11,0,1
1,2007,110502,5,4,1,1
2,2007,110502,3,3,0,1
3,2007,110502,7,6,1,0
4,2007,110502,6,6,0,0
5,2007,110502,7,7,0,0
6,2007,110502,9,8,1,1
7,2007,110502,10,9,1,0
8,2007,110502,6,5,1,3
9,2007,110502,4,4,0,1
10,2007,110502,5,5,0,0
11,2007,110502,7,7,0,0
12,2007,110502,4,4,0,1
1,2008,110502,11,11,0,2
2,2008,110502,6,6,0,0
3,2008,110502,6,6,0,2
4,2008,110502,8,7,1,0
5,2008,110502,9,7,2,0
6,2008,110502,12,12,0,3
7,2008,110502,11,9,2,2
8,2008,110502,6,6,0,2
9,2008,110502,9,9,0,1
10,2008,110502,6,6,0,3
11,2008,110502,9,9,0,0
12,2008,110502,4,3,1,2
1,2009,110502,5,4,1,1
2,2009,110502,1,1,0,2
3,2009,110502,12,12,0,1
4,2009,110502,3,2,1,6
5,2009,110502,6,4,2,1
6,2009,110502,5,4,1,0
7,2009,110502,13,11,2,1
8,2009,110502,10,10,0,2
9,2009,110502,9,9,0,0
10,2009,110502,4,4,0,3
11,2009,110502,5,3,2,0
12,2009,110502,3,3,0,1
1,2010,110502,5,5,0,1
2,2010,110502,7,6,1,2
3,2010,110502,5,4,1,1
4,2010,110502,5,5,0,2
5,2010,110502,5,5,0,0
6,2010,110502,10,9,1,1
7,2010,110502,5,5,0,0
8,2010,110502,5,3,2,0
9,2010,110502,7,7,0,2
10,2010,110502,7,6,1,3
11,2010,110502,1,1,0,1
12,2010,110502,9,9,0,2
1,2011,110502,6,6,0,2
2,2011,110502,3,3,0,0
1,1999,031000,30,27,3,2
2,1999,031000,20,18,2,5
3,1999,031000,22,20,2,4
4,1999,031000,24,24,0,4
5,1999,031000,28,26,2,3
6,1999,031000,40,35,5,3
7,1999,031000,25,23,2,1
8,1999,031000,30,26,4,1
9,1999,031000,30,30,0,4
10,1999,031000,23,21,2,3
11,1999,031000,25,24,1,2
12,1999,031000,15,15,0,4
1,2000,031000,17,16,1,4
2,2000,031000,10,9,1,1
3,2000,031000,15,15,0,0
4,2000,031000,8,8,0,1
5,2000,031000,17,16,1,1
6,2000,031000,23,22,1,1
7,2000,031000,24,22,2,5
8,2000,031000,28,25,3,1
9,2000,031000,14,14,0,3
10,2000,031000,23,23,0,1
11,2000,031000,15,15,0,2
12,2000,031000,16,14,2,1
1,2001,031000,16,13,3,1
2,2001,031000,18,15,3,0
3,2001,031000,15,12,3,3
4,2001,031000,12,10,2,0
5,2001,031000,15,14,1,5
6,2001,031000,18,17,1,4
7,2001,031000,17,15,2,1
8,2001,031000,14,13,1,1
9,2001,031000,12,12,0,5
10,2001,031000,16,14,2,3
11,2001,031000,14,13,1,2
12,2001,031000,16,14,2,0
1,2002,031000,8,8,0,3
2,2002,031000,13,12,1,2
3,2002,031000,10,10,0,2
4,2002,031000,17,16,1,1
5,2002,031000,16,13,3,0
6,2002,031000,22,22,0,1
7,2002,031000,10,7,3,2
8,2002,031000,25,23,2,1
9,2002,031000,19,18,1,0
10,2002,031000,17,15,2,1
11,2002,031000,16,15,1,0
12,2002,031000,18,15,3,2
1,2003,031000,11,10,1,1
2,2003,031000,13,11,2,2
3,2003,031000,13,12,1,1
4,2003,031000,10,9,1,2
5,2003,031000,12,12,0,1
6,2003,031000,9,9,0,3
7,2003,031000,21,18,3,5
8,2003,031000,23,21,2,1
9,2003,031000,21,21,0,0
10,2003,031000,22,21,1,1
11,2003,031000,7,7,0,2
12,2003,031000,13,12,1,1
1,2004,031000,11,10,1,1
2,2004,031000,12,11,1,0
3,2004,031000,10,8,2,2
4,2004,031000,15,14,1,4
5,2004,031000,14,12,2,0
6,2004,031000,19,15,4,0
7,2004,031000,14,13,1,1
8,2004,031000,16,14,2,1
9,2004,031000,16,15,1,2
10,2004,031000,16,16,0,1
11,2004,031000,19,17,2,1
12,2004,031000,18,17,1,0
1,2005,031000,10,9,1,2
2,2005,031000,9,9,0,0
3,2005,031000,13,13,0,3
4,2005,031000,12,12,0,5
5,2005,031000,13,12,1,3
6,2005,031000,21,19,2,3
7,2005,031000,20,18,2,1
8,2005,031000,15,13,2,0
9,2005,031000,18,18,0,1
10,2005,031000,16,16,0,0
11,2005,031000,11,11,0,0
12,2005,031000,18,18,0,0
1,2006,031000,18,18,0,2
2,2006,031000,8,8,0,0
3,2006,031000,10,9,1,1
4,2006,031000,18,16,2,1
5,2006,031000,24,22,2,1
6,2006,031000,14,14,0,0
7,2006,031000,19,18,1,0
8,2006,031000,18,18,0,1
9,2006,031000,13,13,0,0
10,2006,031000,15,15,0,0
11,2006,031000,15,14,1,1
12,2006,031000,15,14,1,2
1,2007,031000,14,14,0,5
2,2007,031000,13,13,0,1
3,2007,031000,17,16,1,0
4,2007,031000,24,21,3,2
5,2007,031000,14,12,2,3
6,2007,031000,24,24,0,6
7,2007,031000,19,18,1,0
8,2007,031000,7,6,1,5
9,2007,031000,11,11,0,2
10,2007,031000,12,12,0,0
11,2007,031000,14,12,2,2
12,2007,031000,16,16,0,0
1,2008,031000,14,14,0,0
2,2008,031000,10,10,0,2
3,2008,031000,6,6,0,2
4,2008,031000,10,10,0,1
5,2008,031000,8,8,0,1
6,2008,031000,14,13,1,3
7,2008,031000,12,10,2,0
8,2008,031000,16,15,1,0
9,2008,031000,14,14,0,1
10,2008,031000,12,12,0,1
11,2008,031000,11,11,0,0
12,2008,031000,14,14,0,0
1,2009,031000,6,5,1,0
2,2009,031000,15,12,3,2
3,2009,031000,12,11,1,1
4,2009,031000,9,9,0,2
5,2009,031000,14,13,1,0
6,2009,031000,10,10,0,1
7,2009,031000,10,10,0,0
8,2009,031000,10,10,0,1
9,2009,031000,12,12,0,0
10,2009,031000,14,14,0,1
11,2009,031000,10,10,0,2
12,2009,031000,13,12,1,2
1,2010,031000,10,9,1,1
2,2010,031000,4,4,0,2
3,2010,031000,8,8,0,1
4,2010,031000,5,5,0,0
5,2010,031000,10,9,1,1
6,2010,031000,14,12,2,2
7,2010,031000,14,13,1,1
8,2010,031000,16,16,0,0
9,2010,031000,17,16,1,0
10,2010,031000,19,18,1,0
11,2010,031000,7,5,2,1
12,2010,031000,9,9,0,0
1,2011,031000,13,13,0,0
2,2011,031000,6,6,0,0
1,1999,031100,24,24,0,3
2,1999,031100,24,22,2,3
3,1999,031100,28,28,0,5
4,1999,031100,24,22,2,2
5,1999,031100,33,31,2,6
6,1999,031100,40,40,0,6
7,1999,031100,32,28,4,5
8,1999,031100,42,39,3,9
9,1999,031100,33,32,1,6
10,1999,031100,32,30,2,5
11,1999,031100,30,28,2,6
12,1999,031100,18,17,1,4
1,2000,031100,18,17,1,6
2,2000,031100,16,14,2,7
3,2000,031100,19,19,0,5
4,2000,031100,18,16,2,6
5,2000,031100,29,26,3,5
6,2000,031100,22,19,3,7
7,2000,031100,21,18,3,8
8,2000,031100,29,27,2,8
9,2000,031100,32,31,1,5
10,2000,031100,21,20,1,8
11,2000,031100,27,26,1,1
12,2000,031100,24,23,1,3
1,2001,031100,23,22,1,4
2,2001,031100,18,17,1,1
3,2001,031100,13,11,2,0
4,2001,031100,18,17,1,4
5,2001,031100,18,18,0,2
6,2001,031100,15,15,0,2
7,2001,031100,22,19,3,1
8,2001,031100,21,21,0,4
9,2001,031100,31,25,6,6
10,2001,031100,23,23,0,9
11,2001,031100,16,15,1,7
12,2001,031100,13,12,1,4
1,2002,031100,14,13,1,5
2,2002,031100,14,14,0,2
3,2002,031100,18,16,2,6
4,2002,031100,21,18,3,8
5,2002,031100,22,20,2,4
6,2002,031100,19,18,1,3
7,2002,031100,16,16,0,11
8,2002,031100,24,21,3,14
9,2002,031100,29,28,1,4
10,2002,031100,20,20,0,4
11,2002,031100,23,21,2,4
12,2002,031100,23,21,2,5
1,2003,031100,14,13,1,3
2,2003,031100,14,14,0,5
3,2003,031100,19,18,1,5
4,2003,031100,18,17,1,4
5,2003,031100,22,21,1,4
6,2003,031100,17,16,1,4
7,2003,031100,24,24,0,1
8,2003,031100,18,18,0,4
9,2003,031100,26,24,2,1
10,2003,031100,16,16,0,4
11,2003,031100,18,17,1,9
12,2003,031100,18,16,2,2
1,2004,031100,14,14,0,2
2,2004,031100,9,6,3,6
3,2004,031100,8,8,0,2
4,2004,031100,12,12,0,2
5,2004,031100,11,10,1,2
6,2004,031100,23,20,3,4
7,2004,031100,18,17,1,3
8,2004,031100,26,25,1,5
9,2004,031100,25,25,0,2
10,2004,031100,14,14,0,3
11,2004,031100,27,27,0,2
12,2004,031100,11,10,1,6
1,2005,031100,23,21,2,2
2,2005,031100,12,11,1,1
3,2005,031100,17,16,1,2
4,2005,031100,16,15,1,3
5,2005,031100,14,14,0,5
6,2005,031100,19,18,1,2
7,2005,031100,17,16,1,3
8,2005,031100,21,19,2,6
9,2005,031100,15,15,0,5
10,2005,031100,17,17,0,3
11,2005,031100,14,13,1,1
12,2005,031100,17,17,0,1
1,2006,031100,16,15,1,0
2,2006,031100,14,13,1,5
3,2006,031100,14,10,4,6
4,2006,031100,12,12,0,4
5,2006,031100,16,16,0,1
6,2006,031100,17,17,0,2
7,2006,031100,12,11,1,3
8,2006,031100,27,25,2,7
9,2006,031100,13,12,1,3
10,2006,031100,11,11,0,3
11,2006,031100,20,20,0,2
12,2006,031100,21,21,0,1
1,2007,031100,15,14,1,7
2,2007,031100,4,4,0,3
3,2007,031100,10,9,1,0
4,2007,031100,14,13,1,5
5,2007,031100,15,15,0,2
6,2007,031100,15,15,0,2
7,2007,031100,12,9,3,1
8,2007,031100,20,18,2,5
9,2007,031100,11,11,0,1
10,2007,031100,11,10,1,1
11,2007,031100,16,13,3,1
12,2007,031100,7,7,0,2
1,2008,031100,12,11,1,2
2,2008,031100,10,9,1,3
3,2008,031100,14,14,0,3
4,2008,031100,7,7,0,3
5,2008,031100,20,17,3,3
6,2008,031100,11,10,1,0
7,2008,031100,20,20,0,1
8,2008,031100,20,19,1,4
9,2008,031100,10,10,0,0
10,2008,031100,17,16,1,2
11,2008,031100,21,19,2,3
12,2008,031100,14,13,1,2
1,2009,031100,14,14,0,1
2,2009,031100,6,5,1,0
3,2009,031100,10,10,0,3
4,2009,031100,4,4,0,3
5,2009,031100,16,16,0,3
6,2009,031100,8,8,0,1
7,2009,031100,9,9,0,1
8,2009,031100,14,14,0,2
9,2009,031100,15,13,2,1
10,2009,031100,9,8,1,1
11,2009,031100,12,11,1,1
12,2009,031100,6,5,1,4
1,2010,031100,10,9,1,2
2,2010,031100,3,3,0,2
3,2010,031100,11,10,1,1
4,2010,031100,12,12,0,1
5,2010,031100,10,10,0,4
6,2010,031100,7,7,0,1
7,2010,031100,22,18,4,2
8,2010,031100,15,14,1,2
9,2010,031100,18,17,1,1
10,2010,031100,18,18,0,2
11,2010,031100,10,9,1,1
12,2010,031100,10,10,0,2
1,2011,031100,18,17,1,4
2,2011,031100,5,4,1,2
1,1999,031200,32,28,4,35
2,1999,031200,33,28,5,26
3,1999,031200,45,35,10,57
4,1999,031200,38,29,9,25
5,1999,031200,38,30,8,36
6,1999,031200,52,37,15,31
7,1999,031200,45,34,11,37
8,1999,031200,59,49,10,44
9,1999,031200,54,48,6,39
10,1999,031200,44,38,6,27
11,1999,031200,30,22,8,39
12,1999,031200,35,31,4,36
1,2000,031200,32,26,6,38
2,2000,031200,27,21,6,54
3,2000,031200,33,27,6,59
4,2000,031200,38,34,4,35
5,2000,031200,42,32,10,39
6,2000,031200,42,38,4,39
7,2000,031200,64,54,10,46
8,2000,031200,41,34,7,54
9,2000,031200,37,27,10,54
10,2000,031200,37,28,9,55
11,2000,031200,37,31,6,40
12,2000,031200,32,28,4,20
1,2001,031200,43,37,6,63
2,2001,031200,29,22,7,69
3,2001,031200,33,26,7,63
4,2001,031200,19,16,3,48
5,2001,031200,32,27,5,30
6,2001,031200,33,24,9,34
7,2001,031200,39,31,8,27
8,2001,031200,39,37,2,52
9,2001,031200,39,35,4,33
10,2001,031200,45,35,10,77
11,2001,031200,20,14,6,59
12,2001,031200,18,15,3,10
1,2002,031200,25,22,3,36
2,2002,031200,24,21,3,23
3,2002,031200,22,19,3,28
4,2002,031200,24,23,1,29
5,2002,031200,26,25,1,25
6,2002,031200,33,28,5,25
7,2002,031200,27,20,7,25
8,2002,031200,28,23,5,21
9,2002,031200,29,22,7,22
10,2002,031200,20,17,3,18
11,2002,031200,23,21,2,17
12,2002,031200,21,16,5,7
1,2003,031200,21,20,1,8
2,2003,031200,23,22,1,13
3,2003,031200,18,15,3,13
4,2003,031200,28,24,4,22
5,2003,031200,26,21,5,25
6,2003,031200,27,22,5,20
7,2003,031200,22,20,2,21
8,2003,031200,19,13,6,61
9,2003,031200,25,20,5,13
10,2003,031200,18,17,1,12
11,2003,031200,20,16,4,11
12,2003,031200,22,19,3,12
1,2004,031200,22,19,3,14
2,2004,031200,25,23,2,12
3,2004,031200,12,10,2,24
4,2004,031200,18,16,2,9
5,2004,031200,27,17,10,16
6,2004,031200,28,22,6,8
7,2004,031200,31,27,4,29
8,2004,031200,32,29,3,14
9,2004,031200,29,26,3,24
10,2004,031200,20,18,2,24
11,2004,031200,18,16,2,28
12,2004,031200,19,16,3,18
1,2005,031200,9,8,1,21
2,2005,031200,9,8,1,30
3,2005,031200,12,11,1,26
4,2005,031200,23,21,2,14
5,2005,031200,30,25,5,26
6,2005,031200,34,31,3,19
7,2005,031200,33,32,1,26
8,2005,031200,33,25,8,27
9,2005,031200,24,21,3,20
10,2005,031200,28,24,4,29
11,2005,031200,26,24,2,27
12,2005,031200,19,18,1,17
1,2006,031200,19,19,0,30
2,2006,031200,19,17,2,22
3,2006,031200,18,16,2,20
4,2006,031200,14,12,2,40
5,2006,031200,21,17,4,21
6,2006,031200,16,14,2,15
7,2006,031200,29,26,3,32
8,2006,031200,17,15,2,30
9,2006,031200,26,24,2,15
10,2006,031200,18,16,2,38
11,2006,031200,17,17,0,23
12,2006,031200,16,16,0,28
1,2007,031200,20,19,1,30
2,2007,031200,14,13,1,11
3,2007,031200,14,12,2,40
4,2007,031200,22,20,2,23
5,2007,031200,19,17,2,22
6,2007,031200,28,28,0,19
7,2007,031200,22,16,6,26
8,2007,031200,22,20,2,13
9,2007,031200,24,20,4,21
10,2007,031200,16,12,4,18
11,2007,031200,21,18,3,37
12,2007,031200,16,16,0,13
1,2008,031200,19,19,0,16
2,2008,031200,18,15,3,12
3,2008,031200,16,13,3,3
4,2008,031200,24,21,3,7
5,2008,031200,19,15,4,15
6,2008,031200,22,20,2,11
7,2008,031200,22,19,3,6
8,2008,031200,26,20,6,25
9,2008,031200,31,26,5,12
10,2008,031200,21,19,2,9
11,2008,031200,23,18,5,7
12,2008,031200,14,12,2,3
1,2009,031200,17,13,4,8
2,2009,031200,13,12,1,10
3,2009,031200,15,13,2,2
4,2009,031200,22,18,4,9
5,2009,031200,19,17,2,7
6,2009,031200,20,18,2,8
7,2009,031200,20,20,0,6
8,2009,031200,24,23,1,10
9,2009,031200,21,14,7,10
10,2009,031200,27,23,4,5
11,2009,031200,11,9,2,3
12,2009,031200,19,17,2,8
1,2010,031200,14,13,1,5
2,2010,031200,12,9,3,7
3,2010,031200,14,12,2,6
4,2010,031200,15,13,2,4
5,2010,031200,11,11,0,9
6,2010,031200,25,18,7,7
7,2010,031200,17,16,1,8
8,2010,031200,19,14,5,13
9,2010,031200,14,14,0,9
10,2010,031200,30,27,3,14
11,2010,031200,18,16,2,13
12,2010,031200,9,8,1,15
1,2011,031200,13,8,5,18
2,2011,031200,9,6,3,9
1,1999,110400,9,9,0,2
2,1999,110400,4,4,0,1
3,1999,110400,8,6,2,0
4,1999,110400,14,14,0,0
5,1999,110400,6,5,1,0
6,1999,110400,15,15,0,1
7,1999,110400,5,5,0,0
8,1999,110400,13,12,1,0
9,1999,110400,3,3,0,0
10,1999,110400,8,7,1,1
11,1999,110400,7,7,0,0
12,1999,110400,5,5,0,0
1,2000,110400,9,9,0,0
2,2000,110400,6,6,0,0
3,2000,110400,10,10,0,0
4,2000,110400,5,4,1,1
5,2000,110400,6,6,0,3
6,2000,110400,9,8,1,0
7,2000,110400,8,7,1,2
8,2000,110400,17,17,0,1
9,2000,110400,17,17,0,0
10,2000,110400,12,12,0,0
11,2000,110400,7,7,0,2
12,2000,110400,4,2,2,0
1,2001,110400,4,4,0,0
2,2001,110400,4,4,0,0
3,2001,110400,5,5,0,0
4,2001,110400,11,11,0,0
5,2001,110400,3,3,0,0
6,2001,110400,10,9,1,0
7,2001,110400,8,7,1,0
8,2001,110400,8,8,0,0
9,2001,110400,11,11,0,0
10,2001,110400,5,5,0,0
11,2001,110400,4,3,1,0
12,2001,110400,9,9,0,1
1,2002,110400,3,3,0,1
2,2002,110400,6,4,2,0
3,2002,110400,6,5,1,0
4,2002,110400,10,9,1,0
5,2002,110400,6,6,0,6
6,2002,110400,5,4,1,0
7,2002,110400,8,8,0,0
8,2002,110400,7,7,0,0
9,2002,110400,15,15,0,1
10,2002,110400,10,10,0,2
11,2002,110400,7,7,0,0
12,2002,110400,12,11,1,0
1,2003,110400,13,13,0,1
2,2003,110400,11,11,0,0
3,2003,110400,4,4,0,0
4,2003,110400,12,12,0,0
5,2003,110400,9,9,0,0
6,2003,110400,7,7,0,0
7,2003,110400,9,9,0,2
8,2003,110400,9,9,0,2
9,2003,110400,8,8,0,1
10,2003,110400,9,9,0,0
11,2003,110400,5,4,1,0
12,2003,110400,6,6,0,0
1,2004,110400,8,8,0,0
2,2004,110400,5,5,0,1
3,2004,110400,3,3,0,1
4,2004,110400,1,1,0,0
5,2004,110400,12,12,0,1
6,2004,110400,8,8,0,2
7,2004,110400,4,4,0,0
8,2004,110400,5,5,0,1
9,2004,110400,4,4,0,1
10,2004,110400,10,9,1,1
11,2004,110400,4,4,0,2
12,2004,110400,3,3,0,0
1,2005,110400,8,7,1,1
2,2005,110400,4,4,0,0
3,2005,110400,11,10,1,0
4,2005,110400,6,6,0,0
5,2005,110400,6,6,0,1
6,2005,110400,6,6,0,1
7,2005,110400,4,4,0,1
8,2005,110400,3,3,0,0
9,2005,110400,4,4,0,0
10,2005,110400,3,3,0,1
11,2005,110400,6,6,0,2
12,2005,110400,3,3,0,0
1,2006,110400,4,3,1,0
2,2006,110400,8,6,2,0
3,2006,110400,7,7,0,0
4,2006,110400,3,3,0,0
5,2006,110400,8,7,1,1
6,2006,110400,7,6,1,0
7,2006,110400,7,7,0,0
8,2006,110400,7,5,2,2
9,2006,110400,4,4,0,1
10,2006,110400,3,3,0,2
11,2006,110400,8,7,1,0
12,2006,110400,5,5,0,0
1,2007,110400,5,5,0,3
2,2007,110400,1,1,0,1
3,2007,110400,10,10,0,0
4,2007,110400,1,1,0,0
5,2007,110400,2,2,0,0
6,2007,110400,6,5,1,3
7,2007,110400,2,2,0,1
8,2007,110400,9,9,0,0
9,2007,110400,6,5,1,3
10,2007,110400,7,7,0,1
11,2007,110400,9,9,0,0
12,2007,110400,10,10,0,0
1,2008,110400,12,11,1,0
2,2008,110400,5,5,0,2
3,2008,110400,4,3,1,0
4,2008,110400,4,4,0,0
5,2008,110400,10,10,0,0
6,2008,110400,8,8,0,1
7,2008,110400,1,1,0,1
8,2008,110400,6,6,0,1
9,2008,110400,12,12,0,2
10,2008,110400,9,9,0,1
11,2008,110400,6,6,0,0
12,2008,110400,5,5,0,1
1,2009,110400,9,9,0,1
2,2009,110400,2,2,0,0
3,2009,110400,9,9,0,3
4,2009,110400,3,3,0,0
5,2009,110400,7,7,0,2
6,2009,110400,4,4,0,0
7,2009,110400,7,7,0,1
8,2009,110400,6,6,0,3
9,2009,110400,6,6,0,0
10,2009,110400,5,5,0,0
11,2009,110400,5,5,0,0
12,2009,110400,9,7,2,1
1,2010,110400,8,8,0,2
2,2010,110400,4,3,1,1
3,2010,110400,5,5,0,0
4,2010,110400,6,5,1,2
5,2010,110400,3,3,0,1
6,2010,110400,4,4,0,0
7,2010,110400,8,8,0,2
8,2010,110400,3,3,0,2
9,2010,110400,6,5,1,0
10,2010,110400,8,8,0,0
11,2010,110400,8,8,0,0
12,2010,110400,2,2,0,1
1,2011,110400,3,3,0,2
2,2011,110400,4,4,0,0
1,1999,031300,12,10,2,1
2,1999,031300,9,9,0,3
3,1999,031300,6,5,1,9
4,1999,031300,28,23,5,5
5,1999,031300,11,10,1,0
6,1999,031300,18,17,1,0
7,1999,031300,18,16,2,4
8,1999,031300,22,22,0,1
9,1999,031300,20,20,0,1
10,1999,031300,20,17,3,0
11,1999,031300,12,10,2,2
12,1999,031300,18,17,1,3
1,2000,031300,18,18,0,0
2,2000,031300,9,9,0,0
3,2000,031300,7,6,1,1
4,2000,031300,14,13,1,0
5,2000,031300,12,12,0,5
6,2000,031300,13,11,2,0
7,2000,031300,15,15,0,1
8,2000,031300,25,22,3,3
9,2000,031300,19,19,0,2
10,2000,031300,18,18,0,4
11,2000,031300,20,20,0,3
12,2000,031300,21,20,1,1
1,2001,031300,22,22,0,1
2,2001,031300,12,12,0,3
3,2001,031300,13,13,0,1
4,2001,031300,16,15,1,2
5,2001,031300,12,9,3,4
6,2001,031300,15,14,1,0
7,2001,031300,20,19,1,1
8,2001,031300,25,25,0,3
9,2001,031300,24,19,5,0
10,2001,031300,14,13,1,2
11,2001,031300,16,16,0,0
12,2001,031300,8,7,1,2
1,2002,031300,12,11,1,4
2,2002,031300,3,3,0,3
3,2002,031300,10,9,1,1
4,2002,031300,9,9,0,6
5,2002,031300,13,13,0,0
6,2002,031300,9,8,1,0
7,2002,031300,21,19,2,0
8,2002,031300,13,13,0,1
9,2002,031300,15,15,0,1
10,2002,031300,5,4,1,1
11,2002,031300,5,4,1,1
12,2002,031300,8,8,0,0
1,2003,031300,4,4,0,0
2,2003,031300,8,7,1,0
3,2003,031300,10,10,0,2
4,2003,031300,15,12,3,1
5,2003,031300,8,7,1,0
6,2003,031300,14,14,0,0
7,2003,031300,13,10,3,3
8,2003,031300,21,19,2,4
9,2003,031300,11,10,1,0
10,2003,031300,7,5,2,2
11,2003,031300,9,9,0,1
12,2003,031300,17,17,0,4
1,2004,031300,7,7,0,2
2,2004,031300,6,5,1,4
3,2004,031300,10,10,0,2
4,2004,031300,10,8,2,0
5,2004,031300,12,9,3,2
6,2004,031300,9,9,0,1
7,2004,031300,22,19,3,7
8,2004,031300,13,12,1,5
9,2004,031300,26,26,0,3
10,2004,031300,17,16,1,2
11,2004,031300,11,11,0,2
12,2004,031300,9,7,2,3
1,2005,031300,7,6,1,6
2,2005,031300,6,6,0,4
3,2005,031300,9,8,1,4
4,2005,031300,6,6,0,8
5,2005,031300,11,11,0,7
6,2005,031300,11,7,4,1
7,2005,031300,15,15,0,7
8,2005,031300,16,16,0,4
9,2005,031300,15,14,1,3
10,2005,031300,11,10,1,3
11,2005,031300,9,8,1,6
12,2005,031300,5,5,0,2
1,2006,031300,12,11,1,2
2,2006,031300,9,7,2,0
3,2006,031300,7,7,0,1
4,2006,031300,8,8,0,1
5,2006,031300,7,7,0,3
6,2006,031300,9,9,0,3
7,2006,031300,12,12,0,5
8,2006,031300,12,12,0,4
9,2006,031300,7,6,1,3
10,2006,031300,6,6,0,1
11,2006,031300,11,11,0,5
12,2006,031300,14,14,0,3
1,2007,031300,6,6,0,1
2,2007,031300,6,6,0,1
3,2007,031300,14,14,0,3
4,2007,031300,12,10,2,3
5,2007,031300,12,12,0,3
6,2007,031300,11,10,1,4
7,2007,031300,13,12,1,5
8,2007,031300,16,16,0,4
9,2007,031300,11,11,0,5
10,2007,031300,9,9,0,2
11,2007,031300,14,12,2,4
12,2007,031300,15,12,3,0
1,2008,031300,16,16,0,1
2,2008,031300,6,6,0,0
3,2008,031300,7,7,0,0
4,2008,031300,12,11,1,3
5,2008,031300,7,7,0,3
6,2008,031300,12,9,3,6
7,2008,031300,23,23,0,3
8,2008,031300,15,13,2,6
9,2008,031300,9,7,2,2
10,2008,031300,13,13,0,2
11,2008,031300,10,10,0,0
12,2008,031300,6,5,1,1
1,2009,031300,9,9,0,2
2,2009,031300,6,5,1,0
3,2009,031300,6,6,0,1
4,2009,031300,7,6,1,2
5,2009,031300,8,7,1,0
6,2009,031300,10,7,3,5
7,2009,031300,12,12,0,3
8,2009,031300,10,9,1,1
9,2009,031300,15,14,1,4
10,2009,031300,12,10,2,0
11,2009,031300,7,7,0,0
12,2009,031300,5,5,0,1
1,2010,031300,6,5,1,5
2,2010,031300,3,3,0,0
3,2010,031300,7,6,1,2
4,2010,031300,11,11,0,1
5,2010,031300,10,10,0,5
6,2010,031300,8,8,0,2
7,2010,031300,5,5,0,8
8,2010,031300,17,15,2,3
9,2010,031300,11,8,3,10
10,2010,031300,5,5,0,2
11,2010,031300,8,8,0,3
12,2010,031300,10,8,2,3
1,2011,031300,3,2,1,0
2,2011,031300,3,1,2,3
1,1999,770902,0,0,0,0
2,1999,770902,0,0,0,0
3,1999,770902,0,0,0,0
4,1999,770902,1,1,0,0
5,1999,770902,0,0,0,0
6,1999,770902,0,0,0,0
7,1999,770902,2,2,0,0
8,1999,770902,0,0,0,0
9,1999,770902,0,0,0,0
10,1999,770902,0,0,0,0
11,1999,770902,0,0,0,0
12,1999,770902,0,0,0,0
1,2000,770902,0,0,0,0
2,2000,770902,0,0,0,0
3,2000,770902,0,0,0,0
4,2000,770902,0,0,0,0
5,2000,770902,0,0,0,0
6,2000,770902,0,0,0,0
7,2000,770902,0,0,0,0
8,2000,770902,0,0,0,0
9,2000,770902,0,0,0,0
10,2000,770902,0,0,0,0
11,2000,770902,0,0,0,0
12,2000,770902,0,0,0,0
1,2001,770902,0,0,0,0
2,2001,770902,0,0,0,0
3,2001,770902,0,0,0,0
4,2001,770902,0,0,0,0
5,2001,770902,0,0,0,0
6,2001,770902,0,0,0,0
7,2001,770902,0,0,0,0
8,2001,770902,0,0,0,0
9,2001,770902,1,1,0,0
10,2001,770902,0,0,0,0
11,2001,770902,0,0,0,0
12,2001,770902,0,0,0,0
1,2002,770902,0,0,0,0
2,2002,770902,0,0,0,0
3,2002,770902,1,1,0,0
4,2002,770902,0,0,0,0
5,2002,770902,0,0,0,0
6,2002,770902,0,0,0,0
7,2002,770902,0,0,0,0
8,2002,770902,0,0,0,0
9,2002,770902,0,0,0,0
10,2002,770902,0,0,0,0
11,2002,770902,0,0,0,0
12,2002,770902,1,1,0,0
1,2003,770902,0,0,0,0
2,2003,770902,0,0,0,0
3,2003,770902,2,2,0,0
4,2003,770902,0,0,0,0
5,2003,770902,0,0,0,0
6,2003,770902,0,0,0,0
7,2003,770902,1,1,0,0
8,2003,770902,0,0,0,0
9,2003,770902,0,0,0,0
10,2003,770902,0,0,0,0
11,2003,770902,0,0,0,0
12,2003,770902,0,0,0,0
1,2004,770902,0,0,0,0
2,2004,770902,0,0,0,0
3,2004,770902,0,0,0,0
4,2004,770902,1,0,1,0
5,2004,770902,0,0,0,0
6,2004,770902,0,0,0,0
7,2004,770902,0,0,0,0
8,2004,770902,0,0,0,0
9,2004,770902,0,0,0,0
10,2004,770902,1,1,0,0
11,2004,770902,0,0,0,0
12,2004,770902,0,0,0,0
1,2005,770902,1,1,0,0
2,2005,770902,0,0,0,0
3,2005,770902,0,0,0,0
4,2005,770902,0,0,0,0
5,2005,770902,0,0,0,0
6,2005,770902,0,0,0,0
7,2005,770902,0,0,0,0
8,2005,770902,0,0,0,0
9,2005,770902,0,0,0,0
10,2005,770902,1,0,1,0
11,2005,770902,0,0,0,0
12,2005,770902,0,0,0,0
1,2006,770902,0,0,0,0
2,2006,770902,0,0,0,0
3,2006,770902,0,0,0,0
4,2006,770902,0,0,0,0
5,2006,770902,0,0,0,0
6,2006,770902,1,1,0,0
7,2006,770902,0,0,0,0
8,2006,770902,0,0,0,0
9,2006,770902,1,1,0,0
10,2006,770902,0,0,0,0
11,2006,770902,0,0,0,0
12,2006,770902,0,0,0,1
1,2007,770902,0,0,0,0
2,2007,770902,0,0,0,0
3,2007,770902,0,0,0,0
4,2007,770902,0,0,0,0
5,2007,770902,0,0,0,0
6,2007,770902,0,0,0,0
7,2007,770902,0,0,0,0
8,2007,770902,2,2,0,0
9,2007,770902,0,0,0,0
10,2007,770902,0,0,0,0
11,2007,770902,0,0,0,0
12,2007,770902,0,0,0,0
1,2008,770902,0,0,0,0
2,2008,770902,0,0,0,0
3,2008,770902,0,0,0,0
4,2008,770902,0,0,0,0
5,2008,770902,0,0,0,0
6,2008,770902,1,1,0,0
7,2008,770902,1,1,0,0
8,2008,770902,0,0,0,0
9,2008,770902,1,1,0,0
10,2008,770902,0,0,0,0
11,2008,770902,1,1,0,0
12,2008,770902,1,1,0,0
1,2009,770902,1,1,0,0
2,2009,770902,1,1,0,0
3,2009,770902,0,0,0,0
4,2009,770902,1,1,0,0
5,2009,770902,0,0,0,0
6,2009,770902,0,0,0,0
7,2009,770902,0,0,0,0
8,2009,770902,0,0,0,0
9,2009,770902,1,1,0,0
10,2009,770902,1,1,0,0
11,2009,770902,0,0,0,0
12,2009,770902,1,1,0,0
1,2010,770902,0,0,0,0
2,2010,770902,0,0,0,0
3,2010,770902,1,1,0,0
4,2010,770902,0,0,0,0
5,2010,770902,0,0,0,0
6,2010,770902,0,0,0,0
7,2010,770902,0,0,0,0
8,2010,770902,0,0,0,0
9,2010,770902,0,0,0,0
10,2010,770902,0,0,0,0
11,2010,770902,0,0,0,0
12,2010,770902,1,1,0,0
1,2011,770902,0,0,0,0
2,2011,770902,0,0,0,0
1,1999,110300,10,9,1,1
2,1999,110300,8,6,2,0
3,1999,110300,3,3,0,0
4,1999,110300,5,5,0,4
5,1999,110300,12,12,0,0
6,1999,110300,13,12,1,0
7,1999,110300,7,7,0,1
8,1999,110300,6,6,0,2
9,1999,110300,3,3,0,0
10,1999,110300,12,11,1,1
11,1999,110300,6,5,1,0
12,1999,110300,4,4,0,1
1,2000,110300,6,6,0,0
2,2000,110300,1,1,0,0
3,2000,110300,18,17,1,1
4,2000,110300,21,20,1,0
5,2000,110300,14,14,0,0
6,2000,110300,20,19,1,0
7,2000,110300,19,19,0,0
8,2000,110300,25,25,0,1
9,2000,110300,14,14,0,0
10,2000,110300,10,10,0,0
11,2000,110300,14,13,1,0
12,2000,110300,14,14,0,1
1,2001,110300,10,10,0,5
2,2001,110300,3,3,0,0
3,2001,110300,13,13,0,0
4,2001,110300,6,6,0,0
5,2001,110300,7,7,0,0
6,2001,110300,14,14,0,0
7,2001,110300,12,11,1,0
8,2001,110300,9,8,1,2
9,2001,110300,6,6,0,0
10,2001,110300,12,11,1,1
11,2001,110300,9,9,0,0
12,2001,110300,13,12,1,0
1,2002,110300,14,14,0,0
2,2002,110300,10,9,1,4
3,2002,110300,5,5,0,0
4,2002,110300,12,10,2,0
5,2002,110300,10,10,0,0
6,2002,110300,12,12,0,1
7,2002,110300,11,11,0,0
8,2002,110300,10,10,0,0
9,2002,110300,16,12,4,2
10,2002,110300,20,19,1,0
11,2002,110300,11,10,1,0
12,2002,110300,17,15,2,1
1,2003,110300,12,12,0,2
2,2003,110300,11,11,0,1
3,2003,110300,12,10,2,0
4,2003,110300,16,16,0,0
5,2003,110300,14,13,1,0
6,2003,110300,21,21,0,0
7,2003,110300,16,16,0,1
8,2003,110300,15,15,0,0
9,2003,110300,6,6,0,0
10,2003,110300,16,15,1,2
11,2003,110300,14,13,1,0
12,2003,110300,13,13,0,0
1,2004,110300,12,11,1,0
2,2004,110300,9,9,0,0
3,2004,110300,9,8,1,0
4,2004,110300,8,8,0,2
5,2004,110300,10,9,1,0
6,2004,110300,22,21,1,0
7,2004,110300,7,5,2,2
8,2004,110300,10,10,0,0
9,2004,110300,16,16,0,1
10,2004,110300,19,17,2,0
11,2004,110300,9,9,0,1
12,2004,110300,6,6,0,2
1,2005,110300,9,9,0,0
2,2005,110300,14,12,2,1
3,2005,110300,9,8,1,2
4,2005,110300,18,16,2,1
5,2005,110300,11,10,1,0
6,2005,110300,8,8,0,1
7,2005,110300,17,16,1,0
8,2005,110300,18,18,0,0
9,2005,110300,10,10,0,1
10,2005,110300,15,15,0,2
11,2005,110300,12,11,1,0
12,2005,110300,4,4,0,0
1,2006,110300,5,5,0,0
2,2006,110300,12,11,1,0
3,2006,110300,13,13,0,0
4,2006,110300,7,7,0,0
5,2006,110300,6,6,0,0
6,2006,110300,10,10,0,0
7,2006,110300,9,9,0,0
8,2006,110300,7,7,0,2
9,2006,110300,12,11,1,0
10,2006,110300,11,11,0,0
11,2006,110300,13,13,0,4
12,2006,110300,10,10,0,1
1,2007,110300,6,6,0,1
2,2007,110300,8,8,0,0
3,2007,110300,13,13,0,0
4,2007,110300,14,14,0,0
5,2007,110300,8,8,0,1
6,2007,110300,9,9,0,0
7,2007,110300,11,11,0,0
8,2007,110300,15,13,2,0
9,2007,110300,10,10,0,0
10,2007,110300,12,11,1,0
11,2007,110300,9,9,0,1
12,2007,110300,10,8,2,0
1,2008,110300,16,15,1,1
2,2008,110300,3,2,1,0
3,2008,110300,8,8,0,0
4,2008,110300,8,8,0,0
5,2008,110300,8,7,1,1
6,2008,110300,15,14,1,4
7,2008,110300,8,8,0,2
8,2008,110300,11,11,0,0
9,2008,110300,12,12,0,1
10,2008,110300,15,15,0,1
11,2008,110300,14,14,0,0
12,2008,110300,15,14,1,1
1,2009,110300,9,8,1,3
2,2009,110300,8,8,0,3
3,2009,110300,15,15,0,1
4,2009,110300,4,4,0,1
5,2009,110300,11,11,0,0
6,2009,110300,10,10,0,0
7,2009,110300,8,8,0,0
8,2009,110300,4,4,0,0
9,2009,110300,4,4,0,0
10,2009,110300,8,8,0,0
11,2009,110300,5,5,0,0
12,2009,110300,3,3,0,1
1,2010,110300,6,6,0,0
2,2010,110300,7,7,0,0
3,2010,110300,16,16,0,0
4,2010,110300,13,13,0,1
5,2010,110300,9,7,2,0
6,2010,110300,8,7,1,0
7,2010,110300,9,8,1,0
8,2010,110300,14,14,0,0
9,2010,110300,3,3,0,1
10,2010,110300,11,11,0,0
11,2010,110300,8,7,1,0
12,2010,110300,14,14,0,0
1,2011,110300,8,8,0,0
2,2011,110300,4,4,0,1
1,1999,140302,10,7,3,0
2,1999,140302,3,3,0,1
3,1999,140302,12,12,0,0
4,1999,140302,4,4,0,2
5,1999,140302,7,7,0,2
6,1999,140302,9,9,0,0
7,1999,140302,6,5,1,0
8,1999,140302,16,15,1,1
9,1999,140302,9,9,0,0
10,1999,140302,6,6,0,0
11,1999,140302,4,4,0,3
12,1999,140302,12,11,1,0
1,2000,140302,8,8,0,1
2,2000,140302,10,8,2,0
3,2000,140302,3,2,1,0
4,2000,140302,5,5,0,1
5,2000,140302,8,8,0,0
6,2000,140302,13,11,2,2
7,2000,140302,17,17,0,1
8,2000,140302,13,13,0,2
9,2000,140302,10,10,0,2
10,2000,140302,8,8,0,0
11,2000,140302,8,6,2,0
12,2000,140302,2,2,0,0
1,2001,140302,10,8,2,0
2,2001,140302,4,4,0,0
3,2001,140302,9,9,0,1
4,2001,140302,7,7,0,2
5,2001,140302,5,4,1,0
6,2001,140302,7,7,0,2
7,2001,140302,14,12,2,1
8,2001,140302,5,4,1,1
9,2001,140302,3,3,0,0
10,2001,140302,10,9,1,0
11,2001,140302,4,4,0,0
12,2001,140302,4,3,1,0
1,2002,140302,3,3,0,1
2,2002,140302,4,3,1,0
3,2002,140302,4,4,0,0
4,2002,140302,3,3,0,0
5,2002,140302,3,3,0,1
6,2002,140302,3,2,1,1
7,2002,140302,2,2,0,0
8,2002,140302,11,9,2,0
9,2002,140302,9,9,0,1
10,2002,140302,4,4,0,1
11,2002,140302,3,3,0,0
12,2002,140302,5,4,1,0
1,2003,140302,10,10,0,0
2,2003,140302,5,5,0,0
3,2003,140302,6,4,2,0
4,2003,140302,6,5,1,0
5,2003,140302,6,6,0,0
6,2003,140302,4,3,1,0
7,2003,140302,6,5,1,1
8,2003,140302,11,9,2,9
9,2003,140302,6,5,1,2
10,2003,140302,4,4,0,2
11,2003,140302,9,8,1,0
12,2003,140302,7,6,1,0
1,2004,140302,6,6,0,0
2,2004,140302,5,5,0,0
3,2004,140302,3,3,0,0
4,2004,140302,4,4,0,0
5,2004,140302,3,2,1,1
6,2004,140302,4,3,1,0
7,2004,140302,3,3,0,0
8,2004,140302,10,10,0,0
9,2004,140302,6,6,0,3
10,2004,140302,9,8,1,0
11,2004,140302,2,2,0,0
12,2004,140302,6,6,0,1
1,2005,140302,4,4,0,1
2,2005,140302,4,4,0,0
3,2005,140302,7,7,0,0
4,2005,140302,6,5,1,0
5,2005,140302,8,8,0,0
6,2005,140302,6,6,0,2
7,2005,140302,5,5,0,1
8,2005,140302,7,6,1,2
9,2005,140302,6,4,2,0
10,2005,140302,8,7,1,0
11,2005,140302,1,1,0,0
12,2005,140302,4,4,0,2
1,2006,140302,7,6,1,1
2,2006,140302,6,4,2,0
3,2006,140302,1,1,0,0
4,2006,140302,2,2,0,0
5,2006,140302,4,4,0,1
6,2006,140302,4,4,0,1
7,2006,140302,4,4,0,0
8,2006,140302,5,4,1,3
9,2006,140302,3,3,0,0
10,2006,140302,5,5,0,2
11,2006,140302,4,4,0,2
12,2006,140302,4,4,0,2
1,2007,140302,3,3,0,0
2,2007,140302,4,3,1,0
3,2007,140302,4,4,0,3
4,2007,140302,6,4,2,0
5,2007,140302,6,6,0,1
6,2007,140302,6,6,0,2
7,2007,140302,8,6,2,7
8,2007,140302,6,4,2,0
9,2007,140302,12,11,1,3
10,2007,140302,2,2,0,1
11,2007,140302,3,3,0,3
12,2007,140302,4,4,0,0
1,2008,140302,5,4,1,1
2,2008,140302,5,4,1,0
3,2008,140302,1,1,0,4
4,2008,140302,6,5,1,2
5,2008,140302,4,1,3,0
6,2008,140302,8,8,0,0
7,2008,140302,4,4,0,1
8,2008,140302,6,5,1,0
9,2008,140302,8,6,2,0
10,2008,140302,3,3,0,0
11,2008,140302,5,5,0,1
12,2008,140302,3,3,0,0
1,2009,140302,11,6,5,0
2,2009,140302,8,7,1,2
3,2009,140302,4,3,1,0
4,2009,140302,1,1,0,0
5,2009,140302,4,4,0,1
6,2009,140302,8,7,1,2
7,2009,140302,7,7,0,1
8,2009,140302,5,5,0,0
9,2009,140302,12,11,1,2
10,2009,140302,11,10,1,0
11,2009,140302,7,6,1,3
12,2009,140302,4,2,2,1
1,2010,140302,4,3,1,1
2,2010,140302,1,1,0,3
3,2010,140302,8,8,0,3
4,2010,140302,6,6,0,0
5,2010,140302,6,6,0,1
6,2010,140302,6,5,1,1
7,2010,140302,9,7,2,1
8,2010,140302,4,4,0,0
9,2010,140302,9,9,0,2
10,2010,140302,4,3,1,2
11,2010,140302,1,1,0,1
12,2010,140302,5,5,0,0
1,2011,140302,3,2,1,1
2,2011,140302,1,1,0,1
1,1999,100500,4,2,2,0
2,1999,100500,5,3,2,0
3,1999,100500,5,5,0,0
4,1999,100500,5,4,1,0
5,1999,100500,4,4,0,0
6,1999,100500,4,4,0,0
7,1999,100500,2,2,0,1
8,1999,100500,4,4,0,1
9,1999,100500,4,4,0,0
10,1999,100500,4,4,0,0
11,1999,100500,6,5,1,0
12,1999,100500,3,2,1,0
1,2000,100500,1,1,0,0
2,2000,100500,1,1,0,0
3,2000,100500,2,2,0,0
4,2000,100500,1,1,0,0
5,2000,100500,2,2,0,1
6,2000,100500,5,5,0,0
7,2000,100500,3,3,0,1
8,2000,100500,4,3,1,0
9,2000,100500,6,5,1,0
10,2000,100500,4,4,0,0
11,2000,100500,5,5,0,1
12,2000,100500,6,6,0,0
1,2001,100500,2,2,0,0
2,2001,100500,5,4,1,0
3,2001,100500,3,3,0,0
4,2001,100500,4,4,0,0
5,2001,100500,4,4,0,0
6,2001,100500,2,2,0,0
7,2001,100500,5,4,1,0
8,2001,100500,8,6,2,2
9,2001,100500,4,4,0,0
10,2001,100500,9,8,1,0
11,2001,100500,4,4,0,0
12,2001,100500,9,9,0,0
1,2002,100500,4,4,0,0
2,2002,100500,2,2,0,0
3,2002,100500,5,4,1,0
4,2002,100500,5,3,2,0
5,2002,100500,4,4,0,0
6,2002,100500,4,4,0,0
7,2002,100500,4,4,0,0
8,2002,100500,9,8,1,0
9,2002,100500,2,2,0,0
10,2002,100500,3,3,0,0
11,2002,100500,4,4,0,0
12,2002,100500,5,3,2,0
1,2003,100500,5,5,0,0
2,2003,100500,1,1,0,0
3,2003,100500,2,2,0,0
4,2003,100500,10,10,0,0
5,2003,100500,4,4,0,0
6,2003,100500,5,5,0,0
7,2003,100500,11,11,0,0
8,2003,100500,11,11,0,2
9,2003,100500,4,4,0,0
10,2003,100500,8,8,0,2
11,2003,100500,4,4,0,0
12,2003,100500,3,3,0,0
1,2004,100500,8,7,1,0
2,2004,100500,4,4,0,0
3,2004,100500,3,2,1,0
4,2004,100500,3,3,0,0
5,2004,100500,5,5,0,0
6,2004,100500,3,3,0,1
7,2004,100500,6,5,1,0
8,2004,100500,4,4,0,0
9,2004,100500,6,6,0,0
10,2004,100500,1,0,1,0
11,2004,100500,6,5,1,1
12,2004,100500,7,7,0,0
1,2005,100500,5,4,1,0
2,2005,100500,5,4,1,0
3,2005,100500,3,3,0,0
4,2005,100500,7,5,2,0
5,2005,100500,4,3,1,0
6,2005,100500,7,6,1,0
7,2005,100500,7,7,0,1
8,2005,100500,9,8,1,0
9,2005,100500,1,1,0,0
10,2005,100500,8,8,0,0
11,2005,100500,6,6,0,0
12,2005,100500,2,2,0,0
1,2006,100500,4,4,0,0
2,2006,100500,1,0,1,0
3,2006,100500,0,0,0,0
4,2006,100500,6,6,0,0
5,2006,100500,5,5,0,0
6,2006,100500,7,6,1,0
7,2006,100500,5,5,0,0
8,2006,100500,5,4,1,0
9,2006,100500,3,2,1,0
10,2006,100500,2,2,0,0
11,2006,100500,6,6,0,0
12,2006,100500,3,3,0,0
1,2007,100500,2,2,0,0
2,2007,100500,1,1,0,0
3,2007,100500,2,2,0,0
4,2007,100500,1,1,0,0
5,2007,100500,1,1,0,0
6,2007,100500,5,5,0,1
7,2007,100500,6,6,0,0
8,2007,100500,11,11,0,2
9,2007,100500,4,4,0,0
10,2007,100500,5,5,0,0
11,2007,100500,7,7,0,0
12,2007,100500,2,1,1,0
1,2008,100500,4,4,0,0
2,2008,100500,6,6,0,0
3,2008,100500,5,5,0,0
4,2008,100500,2,2,0,0
5,2008,100500,5,4,1,0
6,2008,100500,2,2,0,0
7,2008,100500,5,5,0,1
8,2008,100500,3,3,0,2
9,2008,100500,5,5,0,0
10,2008,100500,15,15,0,0
11,2008,100500,12,12,0,0
12,2008,100500,2,2,0,0
1,2009,100500,3,2,1,0
2,2009,100500,3,3,0,0
3,2009,100500,2,2,0,0
4,2009,100500,7,7,0,1
5,2009,100500,1,1,0,0
6,2009,100500,4,4,0,0
7,2009,100500,4,4,0,0
8,2009,100500,9,9,0,0
9,2009,100500,4,3,1,0
10,2009,100500,5,5,0,2
11,2009,100500,5,5,0,0
12,2009,100500,6,6,0,0
1,2010,100500,3,3,0,0
2,2010,100500,2,1,1,0
3,2010,100500,1,1,0,0
4,2010,100500,0,0,0,0
5,2010,100500,3,3,0,0
6,2010,100500,2,2,0,1
7,2010,100500,2,2,0,1
8,2010,100500,4,4,0,0
9,2010,100500,6,6,0,0
10,2010,100500,4,4,0,0
11,2010,100500,3,2,1,0
12,2010,100500,3,3,0,0
1,2011,100500,1,1,0,0
2,2011,100500,7,7,0,0
1,1999,831800,13,11,2,6
2,1999,831800,15,14,1,0
3,1999,831800,24,21,3,1
4,1999,831800,18,14,4,0
5,1999,831800,26,21,5,2
6,1999,831800,32,28,4,2
7,1999,831800,33,31,2,0
8,1999,831800,36,33,3,0
9,1999,831800,33,33,0,2
10,1999,831800,31,30,1,2
11,1999,831800,32,32,0,0
12,1999,831800,30,27,3,1
1,2000,831800,21,19,2,2
2,2000,831800,23,19,4,6
3,2000,831800,19,18,1,3
4,2000,831800,22,22,0,3
5,2000,831800,32,28,4,8
6,2000,831800,25,24,1,2
7,2000,831800,27,22,5,2
8,2000,831800,34,32,2,1
9,2000,831800,20,19,1,0
10,2000,831800,27,27,0,1
11,2000,831800,20,20,0,2
12,2000,831800,19,19,0,1
1,2001,831800,23,21,2,1
2,2001,831800,25,22,3,2
3,2001,831800,25,25,0,3
4,2001,831800,25,23,2,4
5,2001,831800,19,15,4,0
6,2001,831800,20,20,0,0
7,2001,831800,23,20,3,1
8,2001,831800,23,23,0,1
9,2001,831800,28,26,2,4
10,2001,831800,22,20,2,5
11,2001,831800,21,21,0,3
12,2001,831800,17,17,0,3
1,2002,831800,21,20,1,0
2,2002,831800,21,20,1,7
3,2002,831800,16,16,0,5
4,2002,831800,16,16,0,1
5,2002,831800,18,18,0,4
6,2002,831800,28,26,2,0
7,2002,831800,17,16,1,0
8,2002,831800,19,18,1,0
9,2002,831800,21,18,3,2
10,2002,831800,40,39,1,1
11,2002,831800,21,20,1,0
12,2002,831800,18,16,2,3
1,2003,831800,21,19,2,5
2,2003,831800,26,25,1,6
3,2003,831800,33,32,1,0
4,2003,831800,25,23,2,6
5,2003,831800,18,17,1,6
6,2003,831800,25,23,2,4
7,2003,831800,21,19,2,2
8,2003,831800,23,23,0,0
9,2003,831800,28,26,2,3
10,2003,831800,22,21,1,1
11,2003,831800,19,17,2,0
12,2003,831800,22,21,1,4
1,2004,831800,28,27,1,2
2,2004,831800,20,19,1,4
3,2004,831800,19,18,1,1
4,2004,831800,23,21,2,7
5,2004,831800,19,17,2,3
6,2004,831800,30,28,2,0
7,2004,831800,18,17,1,0
8,2004,831800,25,24,1,1
9,2004,831800,28,26,2,0
10,2004,831800,28,28,0,2
11,2004,831800,32,30,2,2
12,2004,831800,20,17,3,1
1,2005,831800,13,10,3,0
2,2005,831800,18,17,1,2
3,2005,831800,26,23,3,6
4,2005,831800,30,29,1,2
5,2005,831800,25,22,3,2
6,2005,831800,24,23,1,1
7,2005,831800,32,30,2,4
8,2005,831800,12,12,0,2
9,2005,831800,28,26,2,0
10,2005,831800,28,25,3,5
11,2005,831800,27,26,1,2
12,2005,831800,17,17,0,1
1,2006,831800,23,21,2,6
2,2006,831800,28,26,2,1
3,2006,831800,24,23,1,0
4,2006,831800,17,17,0,3
5,2006,831800,13,12,1,4
6,2006,831800,15,14,1,4
7,2006,831800,26,25,1,5
8,2006,831800,21,20,1,5
9,2006,831800,30,28,2,0
10,2006,831800,15,15,0,3
11,2006,831800,21,19,2,1
12,2006,831800,7,5,2,4
1,2007,831800,22,21,1,4
2,2007,831800,19,19,0,2
3,2007,831800,20,17,3,6
4,2007,831800,20,19,1,2
5,2007,831800,21,20,1,3
6,2007,831800,30,29,1,4
7,2007,831800,18,16,2,1
8,2007,831800,23,18,5,2
9,2007,831800,17,17,0,3
10,2007,831800,30,30,0,2
11,2007,831800,29,29,0,3
12,2007,831800,14,12,2,5
1,2008,831800,16,14,2,1
2,2008,831800,12,11,1,6
3,2008,831800,14,13,1,3
4,2008,831800,13,13,0,6
5,2008,831800,20,19,1,6
6,2008,831800,25,24,1,0
7,2008,831800,20,19,1,2
8,2008,831800,19,18,1,3
9,2008,831800,30,27,3,3
10,2008,831800,25,22,3,2
11,2008,831800,29,26,3,4
12,2008,831800,26,24,2,1
1,2009,831800,14,13,1,3
2,2009,831800,23,22,1,7
3,2009,831800,27,26,1,6
4,2009,831800,27,23,4,4
5,2009,831800,19,18,1,4
6,2009,831800,12,10,2,2
7,2009,831800,19,18,1,1
8,2009,831800,23,23,0,1
9,2009,831800,31,30,1,1
10,2009,831800,22,20,2,0
11,2009,831800,32,32,0,2
12,2009,831800,22,21,1,0
1,2010,831800,16,16,0,2
2,2010,831800,17,16,1,4
3,2010,831800,20,20,0,6
4,2010,831800,17,15,2,0
5,2010,831800,19,18,1,2
6,2010,831800,19,19,0,3
7,2010,831800,22,21,1,2
8,2010,831800,13,13,0,2
9,2010,831800,35,32,3,3
10,2010,831800,27,25,2,5
11,2010,831800,26,25,1,2
12,2010,831800,16,14,2,3
1,2011,831800,15,15,0,4
2,2011,831800,7,7,0,0
1,1999,760803,6,5,1,0
2,1999,760803,16,16,0,0
3,1999,760803,15,15,0,0
4,1999,760803,15,15,0,0
5,1999,760803,14,13,1,0
6,1999,760803,10,9,1,0
7,1999,760803,8,8,0,2
8,1999,760803,12,10,2,1
9,1999,760803,15,12,3,1
10,1999,760803,8,7,1,0
11,1999,760803,8,8,0,0
12,1999,760803,9,8,1,0
1,2000,760803,3,2,1,0
2,2000,760803,8,7,1,0
3,2000,760803,9,9,0,0
4,2000,760803,10,9,1,0
5,2000,760803,10,8,2,2
6,2000,760803,9,8,1,1
7,2000,760803,6,6,0,0
8,2000,760803,11,11,0,0
9,2000,760803,7,7,0,0
10,2000,760803,11,11,0,0
11,2000,760803,11,11,0,1
12,2000,760803,12,12,0,0
1,2001,760803,11,11,0,0
2,2001,760803,11,9,2,0
3,2001,760803,6,5,1,0
4,2001,760803,11,10,1,1
5,2001,760803,16,16,0,0
6,2001,760803,17,15,2,0
7,2001,760803,13,11,2,0
8,2001,760803,17,16,1,2
9,2001,760803,5,5,0,2
10,2001,760803,11,10,1,0
11,2001,760803,5,5,0,0
12,2001,760803,11,11,0,0
1,2002,760803,9,8,1,0
2,2002,760803,6,6,0,0
3,2002,760803,6,6,0,2
4,2002,760803,13,12,1,0
5,2002,760803,8,8,0,0
6,2002,760803,3,3,0,0
7,2002,760803,15,14,1,0
8,2002,760803,11,11,0,0
9,2002,760803,18,17,1,0
10,2002,760803,11,9,2,0
11,2002,760803,5,4,1,1
12,2002,760803,6,4,2,0
1,2003,760803,12,11,1,0
2,2003,760803,3,3,0,0
3,2003,760803,16,15,1,0
4,2003,760803,10,10,0,0
5,2003,760803,11,11,0,2
6,2003,760803,18,16,2,0
7,2003,760803,11,11,0,1
8,2003,760803,12,11,1,0
9,2003,760803,8,7,1,0
10,2003,760803,13,11,2,1
11,2003,760803,13,13,0,0
12,2003,760803,13,12,1,0
1,2004,760803,6,5,1,1
2,2004,760803,12,11,1,0
3,2004,760803,5,5,0,1
4,2004,760803,11,10,1,1
5,2004,760803,4,4,0,0
6,2004,760803,9,8,1,0
7,2004,760803,5,4,1,0
8,2004,760803,4,3,1,2
9,2004,760803,4,4,0,2
10,2004,760803,9,9,0,0
11,2004,760803,7,6,1,1
12,2004,760803,10,9,1,1
1,2005,760803,10,9,1,0
2,2005,760803,6,5,1,0
3,2005,760803,5,5,0,1
4,2005,760803,6,5,1,2
5,2005,760803,6,6,0,0
6,2005,760803,3,3,0,1
7,2005,760803,10,9,1,0
8,2005,760803,14,14,0,0
9,2005,760803,4,4,0,0
10,2005,760803,8,6,2,0
11,2005,760803,5,4,1,4
12,2005,760803,7,5,2,0
1,2006,760803,9,7,2,0
2,2006,760803,6,6,0,0
3,2006,760803,9,9,0,0
4,2006,760803,7,7,0,1
5,2006,760803,9,9,0,0
6,2006,760803,9,9,0,0
7,2006,760803,8,6,2,0
8,2006,760803,3,2,1,0
9,2006,760803,3,3,0,0
10,2006,760803,6,6,0,0
11,2006,760803,7,6,1,0
12,2006,760803,9,8,1,2
1,2007,760803,7,7,0,3
2,2007,760803,5,4,1,2
3,2007,760803,9,9,0,0
4,2007,760803,9,9,0,3
5,2007,760803,6,6,0,2
6,2007,760803,12,11,1,0
7,2007,760803,17,16,1,1
8,2007,760803,9,8,1,2
9,2007,760803,3,3,0,2
10,2007,760803,5,5,0,1
11,2007,760803,4,4,0,0
12,2007,760803,3,3,0,0
1,2008,760803,9,9,0,1
2,2008,760803,5,4,1,0
3,2008,760803,6,6,0,1
4,2008,760803,7,7,0,0
5,2008,760803,7,7,0,2
6,2008,760803,7,7,0,1
7,2008,760803,12,10,2,1
8,2008,760803,13,12,1,0
9,2008,760803,19,18,1,0
10,2008,760803,10,10,0,0
11,2008,760803,5,4,1,0
12,2008,760803,4,4,0,1
1,2009,760803,7,6,1,1
2,2009,760803,7,7,0,0
3,2009,760803,7,6,1,1
4,2009,760803,2,2,0,2
5,2009,760803,7,7,0,1
6,2009,760803,9,9,0,0
7,2009,760803,14,12,2,0
8,2009,760803,12,12,0,0
9,2009,760803,8,7,1,1
10,2009,760803,7,7,0,3
11,2009,760803,4,4,0,0
12,2009,760803,8,7,1,0
1,2010,760803,6,4,2,0
2,2010,760803,7,7,0,0
3,2010,760803,6,6,0,1
4,2010,760803,4,4,0,0
5,2010,760803,3,3,0,2
6,2010,760803,10,9,1,1
7,2010,760803,5,4,1,2
8,2010,760803,3,3,0,0
9,2010,760803,3,3,0,0
10,2010,760803,9,9,0,0
11,2010,760803,4,4,0,1
12,2010,760803,6,4,2,2
1,2011,760803,5,5,0,0
2,2011,760803,1,1,0,0
1,1999,110501,4,2,2,1
2,1999,110501,8,6,2,0
3,1999,110501,10,10,0,0
4,1999,110501,16,15,1,0
5,1999,110501,13,13,0,0
6,1999,110501,17,16,1,0
7,1999,110501,13,12,1,0
8,1999,110501,11,11,0,0
9,1999,110501,13,13,0,2
10,1999,110501,8,7,1,1
11,1999,110501,8,8,0,0
12,1999,110501,6,6,0,1
1,2000,110501,9,9,0,0
2,2000,110501,11,10,1,0
3,2000,110501,13,11,2,0
4,2000,110501,16,16,0,3
5,2000,110501,10,10,0,0
6,2000,110501,15,14,1,0
7,2000,110501,15,15,0,0
8,2000,110501,18,17,1,2
9,2000,110501,11,11,0,0
10,2000,110501,16,15,1,0
11,2000,110501,3,3,0,1
12,2000,110501,9,9,0,1
1,2001,110501,7,6,1,2
2,2001,110501,10,10,0,1
3,2001,110501,17,16,1,0
4,2001,110501,11,8,3,0
5,2001,110501,14,13,1,0
6,2001,110501,10,10,0,0
7,2001,110501,15,15,0,2
8,2001,110501,15,15,0,1
9,2001,110501,10,10,0,0
10,2001,110501,10,10,0,2
11,2001,110501,8,8,0,1
12,2001,110501,6,6,0,0
1,2002,110501,19,19,0,1
2,2002,110501,11,10,1,0
3,2002,110501,15,15,0,1
4,2002,110501,8,8,0,0
5,2002,110501,20,20,0,2
6,2002,110501,14,14,0,0
7,2002,110501,10,10,0,0
8,2002,110501,14,13,1,1
9,2002,110501,14,13,1,0
10,2002,110501,9,9,0,0
11,2002,110501,17,17,0,1
12,2002,110501,15,15,0,2
1,2003,110501,15,14,1,0
2,2003,110501,8,8,0,0
3,2003,110501,13,13,0,0
4,2003,110501,5,5,0,0
5,2003,110501,16,15,1,0
6,2003,110501,18,16,2,0
7,2003,110501,11,11,0,0
8,2003,110501,10,8,2,0
9,2003,110501,8,7,1,0
10,2003,110501,9,9,0,0
11,2003,110501,3,3,0,0
12,2003,110501,8,8,0,0
1,2004,110501,12,12,0,0
2,2004,110501,10,9,1,1
3,2004,110501,7,6,1,0
4,2004,110501,6,6,0,0
5,2004,110501,7,7,0,1
6,2004,110501,20,20,0,4
7,2004,110501,7,7,0,1
8,2004,110501,12,12,0,2
9,2004,110501,7,7,0,0
10,2004,110501,7,5,2,0
11,2004,110501,10,8,2,1
12,2004,110501,18,17,1,0
1,2005,110501,18,18,0,0
2,2005,110501,13,12,1,2
3,2005,110501,10,9,1,0
4,2005,110501,11,11,0,0
5,2005,110501,4,4,0,1
6,2005,110501,9,7,2,0
7,2005,110501,10,8,2,0
8,2005,110501,10,10,0,0
9,2005,110501,13,13,0,0
10,2005,110501,5,5,0,1
11,2005,110501,6,6,0,0
12,2005,110501,10,10,0,1
1,2006,110501,9,9,0,0
2,2006,110501,16,16,0,0
3,2006,110501,7,6,1,0
4,2006,110501,11,11,0,2
5,2006,110501,14,13,1,2
6,2006,110501,11,10,1,1
7,2006,110501,7,7,0,1
8,2006,110501,9,8,1,1
9,2006,110501,12,12,0,0
10,2006,110501,13,13,0,0
11,2006,110501,10,8,2,1
12,2006,110501,13,12,1,0
1,2007,110501,13,13,0,0
2,2007,110501,9,9,0,1
3,2007,110501,5,5,0,0
4,2007,110501,8,8,0,2
5,2007,110501,16,16,0,0
6,2007,110501,13,12,1,1
7,2007,110501,9,9,0,0
8,2007,110501,6,6,0,0
9,2007,110501,5,5,0,0
10,2007,110501,6,6,0,0
11,2007,110501,9,9,0,0
12,2007,110501,7,7,0,1
1,2008,110501,11,10,1,0
2,2008,110501,7,7,0,0
3,2008,110501,8,8,0,0
4,2008,110501,11,11,0,0
5,2008,110501,10,10,0,2
6,2008,110501,15,13,2,0
7,2008,110501,8,7,1,0
8,2008,110501,8,8,0,0
9,2008,110501,13,13,0,0
10,2008,110501,11,11,0,1
11,2008,110501,10,10,0,2
12,2008,110501,10,10,0,1
1,2009,110501,7,7,0,0
2,2009,110501,16,16,0,1
3,2009,110501,7,7,0,0
4,2009,110501,7,6,1,0
5,2009,110501,10,9,1,0
6,2009,110501,12,11,1,1
7,2009,110501,9,8,1,1
8,2009,110501,6,4,2,2
9,2009,110501,17,17,0,1
10,2009,110501,17,17,0,4
11,2009,110501,4,3,1,0
12,2009,110501,2,2,0,0
1,2010,110501,6,6,0,0
2,2010,110501,4,4,0,0
3,2010,110501,6,6,0,4
4,2010,110501,12,11,1,0
5,2010,110501,4,4,0,0
6,2010,110501,9,9,0,0
7,2010,110501,18,17,1,0
8,2010,110501,6,6,0,0
9,2010,110501,5,4,1,0
10,2010,110501,10,9,1,1
11,2010,110501,4,4,0,0
12,2010,110501,7,7,0,0
1,2011,110501,6,6,0,2
2,2011,110501,3,3,0,0
1,1999,130200,5,5,0,0
2,1999,130200,4,4,0,0
3,1999,130200,0,0,0,0
4,1999,130200,2,2,0,2
5,1999,130200,5,5,0,1
6,1999,130200,4,4,0,0
7,1999,130200,6,6,0,0
8,1999,130200,5,5,0,0
9,1999,130200,6,4,2,0
10,1999,130200,6,6,0,0
11,1999,130200,4,4,0,0
12,1999,130200,5,4,1,0
1,2000,130200,4,4,0,0
2,2000,130200,2,2,0,0
3,2000,130200,3,3,0,0
4,2000,130200,2,2,0,2
5,2000,130200,6,6,0,0
6,2000,130200,5,5,0,1
7,2000,130200,4,4,0,0
8,2000,130200,3,3,0,0
9,2000,130200,5,5,0,0
10,2000,130200,5,5,0,0
11,2000,130200,5,5,0,0
12,2000,130200,5,5,0,0
1,2001,130200,0,0,0,0
2,2001,130200,0,0,0,2
3,2001,130200,3,3,0,0
4,2001,130200,2,2,0,0
5,2001,130200,5,5,0,0
6,2001,130200,1,1,0,0
7,2001,130200,3,2,1,0
8,2001,130200,5,5,0,0
9,2001,130200,2,2,0,2
10,2001,130200,4,4,0,0
11,2001,130200,0,0,0,0
12,2001,130200,0,0,0,0
1,2002,130200,4,4,0,0
2,2002,130200,1,0,1,1
3,2002,130200,0,0,0,0
4,2002,130200,2,2,0,0
5,2002,130200,2,2,0,0
6,2002,130200,3,3,0,0
7,2002,130200,4,3,1,2
8,2002,130200,9,9,0,0
9,2002,130200,2,2,0,0
10,2002,130200,4,3,1,1
11,2002,130200,2,2,0,0
12,2002,130200,3,2,1,0
1,2003,130200,2,2,0,0
2,2003,130200,0,0,0,0
3,2003,130200,3,3,0,0
4,2003,130200,2,2,0,0
5,2003,130200,4,4,0,0
6,2003,130200,4,4,0,0
7,2003,130200,3,3,0,3
8,2003,130200,5,5,0,0
9,2003,130200,1,1,0,1
10,2003,130200,2,2,0,1
11,2003,130200,5,5,0,0
12,2003,130200,5,5,0,1
1,2004,130200,1,0,1,0
2,2004,130200,1,1,0,0
3,2004,130200,2,1,1,0
4,2004,130200,3,3,0,0
5,2004,130200,5,5,0,0
6,2004,130200,6,5,1,1
7,2004,130200,6,6,0,2
8,2004,130200,3,3,0,0
9,2004,130200,7,7,0,0
10,2004,130200,3,3,0,0
11,2004,130200,6,6,0,1
12,2004,130200,3,3,0,0
1,2005,130200,0,0,0,0
2,2005,130200,1,1,0,0
3,2005,130200,4,4,0,0
4,2005,130200,2,2,0,0
5,2005,130200,12,10,2,1
6,2005,130200,3,2,1,0
7,2005,130200,5,5,0,1
8,2005,130200,4,4,0,0
9,2005,130200,4,4,0,0
10,2005,130200,2,2,0,0
11,2005,130200,5,5,0,0
12,2005,130200,2,2,0,0
1,2006,130200,4,4,0,1
2,2006,130200,3,3,0,2
3,2006,130200,1,1,0,3
4,2006,130200,1,1,0,4
5,2006,130200,0,0,0,4
6,2006,130200,6,5,1,3
7,2006,130200,4,3,1,1
8,2006,130200,2,2,0,0
9,2006,130200,0,0,0,0
10,2006,130200,1,1,0,0
11,2006,130200,2,2,0,2
12,2006,130200,2,2,0,0
1,2007,130200,4,4,0,1
2,2007,130200,4,4,0,4
3,2007,130200,5,4,1,0
4,2007,130200,1,1,0,3
5,2007,130200,3,2,1,2
6,2007,130200,8,8,0,2
7,2007,130200,0,0,0,2
8,2007,130200,4,4,0,2
9,2007,130200,3,3,0,1
10,2007,130200,1,1,0,0
11,2007,130200,3,3,0,0
12,2007,130200,3,3,0,0
1,2008,130200,6,6,0,3
2,2008,130200,3,3,0,0
3,2008,130200,4,4,0,0
4,2008,130200,1,1,0,0
5,2008,130200,2,2,0,0
6,2008,130200,5,5,0,0
7,2008,130200,4,4,0,1
8,2008,130200,5,4,1,0
9,2008,130200,8,7,1,1
10,2008,130200,4,4,0,2
11,2008,130200,5,5,0,0
12,2008,130200,3,3,0,1
1,2009,130200,0,0,0,1
2,2009,130200,0,0,0,2
3,2009,130200,2,2,0,3
4,2009,130200,4,4,0,1
5,2009,130200,1,1,0,0
6,2009,130200,3,3,0,1
7,2009,130200,4,4,0,0
8,2009,130200,4,4,0,5
9,2009,130200,2,2,0,1
10,2009,130200,9,9,0,1
11,2009,130200,9,9,0,4
12,2009,130200,3,3,0,0
1,2010,130200,1,1,0,4
2,2010,130200,1,1,0,2
3,2010,130200,3,3,0,2
4,2010,130200,4,4,0,6
5,2010,130200,2,2,0,2
6,2010,130200,7,6,1,4
7,2010,130200,2,2,0,0
8,2010,130200,2,2,0,6
9,2010,130200,6,6,0,2
10,2010,130200,4,3,1,3
11,2010,130200,0,0,0,1
12,2010,130200,1,1,0,0
1,2011,130200,5,5,0,1
2,2011,130200,3,2,1,0
1,1999,110200,8,7,1,1
2,1999,110200,7,6,1,1
3,1999,110200,4,4,0,0
4,1999,110200,6,6,0,0
5,1999,110200,7,6,1,2
6,1999,110200,5,5,0,1
7,1999,110200,9,9,0,2
8,1999,110200,12,12,0,4
9,1999,110200,4,3,1,3
10,1999,110200,4,4,0,8
11,1999,110200,7,5,2,3
12,1999,110200,4,4,0,0
1,2000,110200,7,7,0,5
2,2000,110200,7,6,1,10
3,2000,110200,5,3,2,7
4,2000,110200,6,4,2,7
5,2000,110200,14,13,1,2
6,2000,110200,2,2,0,2
7,2000,110200,7,7,0,7
8,2000,110200,9,9,0,3
9,2000,110200,8,7,1,4
10,2000,110200,5,5,0,2
11,2000,110200,6,6,0,3
12,2000,110200,6,5,1,1
1,2001,110200,4,4,0,1
2,2001,110200,3,3,0,0
3,2001,110200,7,5,2,2
4,2001,110200,4,4,0,1
5,2001,110200,5,3,2,3
6,2001,110200,7,6,1,1
7,2001,110200,12,10,2,3
8,2001,110200,12,12,0,4
9,2001,110200,7,7,0,1
10,2001,110200,7,7,0,1
11,2001,110200,8,6,2,2
12,2001,110200,2,2,0,2
1,2002,110200,4,4,0,1
2,2002,110200,7,6,1,0
3,2002,110200,5,4,1,3
4,2002,110200,3,3,0,5
5,2002,110200,9,8,1,2
6,2002,110200,4,2,2,3
7,2002,110200,6,5,1,0
8,2002,110200,5,4,1,2
9,2002,110200,6,6,0,0
10,2002,110200,8,7,1,2
11,2002,110200,10,9,1,4
12,2002,110200,8,8,0,1
1,2003,110200,6,6,0,1
2,2003,110200,4,4,0,0
3,2003,110200,4,4,0,7
4,2003,110200,2,2,0,4
5,2003,110200,7,7,0,3
6,2003,110200,13,11,2,1
7,2003,110200,8,8,0,3
8,2003,110200,8,8,0,5
9,2003,110200,14,11,3,6
10,2003,110200,4,3,1,2
11,2003,110200,4,3,1,3
12,2003,110200,6,6,0,4
1,2004,110200,4,4,0,0
2,2004,110200,2,1,1,0
3,2004,110200,8,8,0,1
4,2004,110200,11,11,0,1
5,2004,110200,3,3,0,1
6,2004,110200,7,7,0,0
7,2004,110200,9,8,1,8
8,2004,110200,6,6,0,4
9,2004,110200,4,3,1,1
10,2004,110200,7,7,0,1
11,2004,110200,6,5,1,0
12,2004,110200,6,6,0,2
1,2005,110200,12,12,0,1
2,2005,110200,4,3,1,1
3,2005,110200,7,6,1,3
4,2005,110200,2,2,0,0
5,2005,110200,3,3,0,3
6,2005,110200,6,6,0,0
7,2005,110200,10,10,0,0
8,2005,110200,5,4,1,1
9,2005,110200,6,6,0,0
10,2005,110200,8,7,1,1
11,2005,110200,10,9,1,0
12,2005,110200,8,8,0,0
1,2006,110200,7,7,0,0
2,2006,110200,7,7,0,0
3,2006,110200,4,4,0,0
4,2006,110200,8,7,1,0
5,2006,110200,3,3,0,0
6,2006,110200,8,8,0,0
7,2006,110200,10,10,0,0
8,2006,110200,6,4,2,0
9,2006,110200,8,7,1,0
10,2006,110200,10,10,0,2
11,2006,110200,4,4,0,0
12,2006,110200,6,5,1,0
1,2007,110200,4,4,0,1
2,2007,110200,5,3,2,0
3,2007,110200,3,3,0,3
4,2007,110200,9,9,0,0
5,2007,110200,4,3,1,3
6,2007,110200,1,1,0,3
7,2007,110200,4,3,1,0
8,2007,110200,9,8,1,0
9,2007,110200,5,5,0,4
10,2007,110200,3,3,0,1
11,2007,110200,1,1,0,0
12,2007,110200,11,10,1,0
1,2008,110200,8,7,1,1
2,2008,110200,8,7,1,1
3,2008,110200,6,6,0,2
4,2008,110200,2,2,0,1
5,2008,110200,4,4,0,2
6,2008,110200,9,8,1,0
7,2008,110200,8,8,0,1
8,2008,110200,7,7,0,1
9,2008,110200,4,4,0,0
10,2008,110200,8,6,2,1
11,2008,110200,4,4,0,1
12,2008,110200,3,3,0,0
1,2009,110200,1,1,0,0
2,2009,110200,2,2,0,0
3,2009,110200,2,2,0,0
4,2009,110200,2,2,0,3
5,2009,110200,5,4,1,0
6,2009,110200,7,6,1,0
7,2009,110200,10,10,0,0
8,2009,110200,6,5,1,3
9,2009,110200,6,5,1,0
10,2009,110200,8,6,2,0
11,2009,110200,8,8,0,2
12,2009,110200,0,0,0,0
1,2010,110200,2,2,0,2
2,2010,110200,1,1,0,1
3,2010,110200,7,7,0,0
4,2010,110200,5,5,0,3
5,2010,110200,7,4,3,0
6,2010,110200,9,8,1,2
7,2010,110200,5,5,0,4
8,2010,110200,10,9,1,3
9,2010,110200,5,5,0,2
10,2010,110200,2,2,0,0
11,2010,110200,2,1,1,0
12,2010,110200,4,4,0,0
1,2011,110200,2,2,0,0
2,2011,110200,3,3,0,0
1,1999,100600,108,108,0,0
2,1999,100600,91,89,2,0
3,1999,100600,81,81,0,0
4,1999,100600,92,92,0,0
5,1999,100600,96,92,4,0
6,1999,100600,105,105,0,0
7,1999,100600,120,118,2,0
8,1999,100600,120,120,0,0
9,1999,100600,106,106,0,0
10,1999,100600,120,117,3,0
11,1999,100600,72,72,0,0
12,1999,100600,63,62,1,0
1,2000,100600,41,41,0,0
2,2000,100600,26,26,0,0
3,2000,100600,12,11,1,0
4,2000,100600,6,6,0,0
5,2000,100600,5,5,0,1
6,2000,100600,11,10,1,0
7,2000,100600,8,8,0,1
8,2000,100600,12,12,0,2
9,2000,100600,12,11,1,0
10,2000,100600,6,6,0,0
11,2000,100600,5,5,0,0
12,2000,100600,6,5,1,0
1,2001,100600,4,4,0,0
2,2001,100600,6,6,0,0
3,2001,100600,5,5,0,0
4,2001,100600,6,6,0,1
5,2001,100600,5,5,0,0
6,2001,100600,7,5,2,0
7,2001,100600,6,6,0,0
8,2001,100600,12,11,1,0
9,2001,100600,8,8,0,0
10,2001,100600,4,4,0,0
11,2001,100600,3,3,0,0
12,2001,100600,4,4,0,2
1,2002,100600,13,13,0,0
2,2002,100600,2,2,0,0
3,2002,100600,4,4,0,0
4,2002,100600,9,9,0,0
5,2002,100600,5,5,0,0
6,2002,100600,4,2,2,0
7,2002,100600,10,8,2,0
8,2002,100600,2,2,0,0
9,2002,100600,6,6,0,0
10,2002,100600,3,3,0,1
11,2002,100600,4,4,0,0
12,2002,100600,8,8,0,1
1,2003,100600,6,5,1,3
2,2003,100600,4,4,0,2
3,2003,100600,10,9,1,6
4,2003,100600,6,6,0,0
5,2003,100600,7,7,0,3
6,2003,100600,9,9,0,1
7,2003,100600,14,14,0,2
8,2003,100600,8,8,0,0
9,2003,100600,10,9,1,6
10,2003,100600,9,8,1,2
11,2003,100600,10,8,2,1
12,2003,100600,6,6,0,2
1,2004,100600,6,6,0,1
2,2004,100600,2,2,0,1
3,2004,100600,6,6,0,3
4,2004,100600,9,8,1,1
5,2004,100600,14,13,1,3
6,2004,100600,6,5,1,0
7,2004,100600,6,6,0,2
8,2004,100600,6,6,0,0
9,2004,100600,6,6,0,1
10,2004,100600,6,6,0,2
11,2004,100600,4,4,0,1
12,2004,100600,6,6,0,3
1,2005,100600,4,4,0,0
2,2005,100600,5,4,1,0
3,2005,100600,2,2,0,1
4,2005,100600,5,5,0,2
5,2005,100600,4,4,0,0
6,2005,100600,5,5,0,0
7,2005,100600,4,4,0,0
8,2005,100600,9,9,0,0
9,2005,100600,4,4,0,2
10,2005,100600,9,9,0,0
11,2005,100600,6,6,0,4
12,2005,100600,9,9,0,0
1,2006,100600,10,9,1,1
2,2006,100600,7,7,0,0
3,2006,100600,7,7,0,1
4,2006,100600,12,12,0,1
5,2006,100600,13,13,0,5
6,2006,100600,8,8,0,1
7,2006,100600,9,9,0,0
8,2006,100600,2,1,1,1
9,2006,100600,6,6,0,0
10,2006,100600,8,8,0,1
11,2006,100600,7,7,0,4
12,2006,100600,4,4,0,0
1,2007,100600,8,8,0,2
2,2007,100600,5,5,0,0
3,2007,100600,8,7,1,1
4,2007,100600,6,6,0,0
5,2007,100600,7,7,0,0
6,2007,100600,5,5,0,1
7,2007,100600,15,15,0,0
8,2007,100600,7,5,2,1
9,2007,100600,10,10,0,1
10,2007,100600,5,5,0,1
11,2007,100600,10,10,0,1
12,2007,100600,8,8,0,0
1,2008,100600,11,11,0,1
2,2008,100600,9,9,0,2
3,2008,100600,10,10,0,0
4,2008,100600,10,8,2,0
5,2008,100600,5,5,0,1
6,2008,100600,7,7,0,2
7,2008,100600,9,9,0,0
8,2008,100600,7,7,0,0
9,2008,100600,14,13,1,3
10,2008,100600,10,10,0,1
11,2008,100600,7,7,0,0
12,2008,100600,9,9,0,0
1,2009,100600,12,12,0,2
2,2009,100600,2,2,0,3
3,2009,100600,5,4,1,5
4,2009,100600,7,7,0,0
5,2009,100600,2,2,0,5
6,2009,100600,5,5,0,1
7,2009,100600,13,13,0,0
8,2009,100600,3,3,0,0
9,2009,100600,4,2,2,3
10,2009,100600,5,2,3,1
11,2009,100600,7,7,0,2
12,2009,100600,3,3,0,1
1,2010,100600,9,9,0,0
2,2010,100600,3,3,0,0
3,2010,100600,9,8,1,3
4,2010,100600,11,11,0,2
5,2010,100600,6,6,0,2
6,2010,100600,6,6,0,0
7,2010,100600,6,6,0,0
8,2010,100600,8,8,0,0
9,2010,100600,11,11,0,1
10,2010,100600,4,4,0,2
11,2010,100600,7,6,1,0
12,2010,100600,3,3,0,0
1,2011,100600,6,6,0,0
2,2011,100600,5,5,0,2
1,1999,040100,8,7,1,1
2,1999,040100,12,11,1,2
3,1999,040100,4,4,0,0
4,1999,040100,8,6,2,3
5,1999,040100,9,8,1,2
6,1999,040100,7,6,1,0
7,1999,040100,13,11,2,0
8,1999,040100,7,7,0,0
9,1999,040100,10,10,0,4
10,1999,040100,8,7,1,2
11,1999,040100,8,7,1,1
12,1999,040100,11,10,1,0
1,2000,040100,7,6,1,0
2,2000,040100,10,8,2,0
3,2000,040100,17,14,3,0
4,2000,040100,12,12,0,0
5,2000,040100,4,3,1,2
6,2000,040100,11,11,0,2
7,2000,040100,11,10,1,1
8,2000,040100,8,7,1,0
9,2000,040100,15,14,1,1
10,2000,040100,5,5,0,1
11,2000,040100,11,9,2,2
12,2000,040100,8,8,0,0
1,2001,040100,3,2,1,0
2,2001,040100,9,9,0,1
3,2001,040100,4,3,1,0
4,2001,040100,7,7,0,5
5,2001,040100,9,9,0,2
6,2001,040100,8,7,1,2
7,2001,040100,11,11,0,1
8,2001,040100,4,3,1,2
9,2001,040100,11,11,0,1
10,2001,040100,9,8,1,1
11,2001,040100,6,6,0,0
12,2001,040100,7,7,0,0
1,2002,040100,2,2,0,1
2,2002,040100,7,7,0,3
3,2002,040100,7,7,0,2
4,2002,040100,5,5,0,0
5,2002,040100,7,7,0,2
6,2002,040100,10,10,0,1
7,2002,040100,11,11,0,0
8,2002,040100,9,8,1,0
9,2002,040100,10,10,0,0
10,2002,040100,9,9,0,1
11,2002,040100,2,2,0,0
12,2002,040100,5,5,0,0
1,2003,040100,6,5,1,1
2,2003,040100,5,4,1,3
3,2003,040100,4,4,0,0
4,2003,040100,11,11,0,0
5,2003,040100,9,7,2,0
6,2003,040100,9,9,0,1
7,2003,040100,12,12,0,1
8,2003,040100,9,9,0,0
9,2003,040100,10,9,1,1
10,2003,040100,7,5,2,0
11,2003,040100,12,12,0,0
12,2003,040100,6,6,0,1
1,2004,040100,14,13,1,0
2,2004,040100,9,8,1,0
3,2004,040100,7,6,1,2
4,2004,040100,6,6,0,1
5,2004,040100,11,10,1,0
6,2004,040100,7,7,0,0
7,2004,040100,9,8,1,1
8,2004,040100,13,13,0,2
9,2004,040100,16,16,0,2
10,2004,040100,20,19,1,1
11,2004,040100,7,7,0,0
12,2004,040100,12,11,1,0
1,2005,040100,12,11,1,1
2,2005,040100,8,7,1,0
3,2005,040100,5,5,0,1
4,2005,040100,7,7,0,0
5,2005,040100,8,8,0,2
6,2005,040100,6,5,1,2
7,2005,040100,13,12,1,0
8,2005,040100,10,9,1,0
9,2005,040100,17,17,0,1
10,2005,040100,6,6,0,0
11,2005,040100,5,5,0,0
12,2005,040100,9,9,0,0
1,2006,040100,7,7,0,0
2,2006,040100,9,9,0,0
3,2006,040100,13,13,0,0
4,2006,040100,7,7,0,1
5,2006,040100,7,7,0,2
6,2006,040100,8,8,0,0
7,2006,040100,9,8,1,1
8,2006,040100,11,9,2,0
9,2006,040100,7,7,0,6
10,2006,040100,6,6,0,0
11,2006,040100,6,6,0,0
12,2006,040100,6,6,0,0
1,2007,040100,11,9,2,1
2,2007,040100,7,6,1,1
3,2007,040100,4,4,0,0
4,2007,040100,3,3,0,4
5,2007,040100,4,4,0,0
6,2007,040100,7,6,1,2
7,2007,040100,6,6,0,0
8,2007,040100,10,10,0,1
9,2007,040100,10,9,1,2
10,2007,040100,11,11,0,3
11,2007,040100,10,8,2,0
12,2007,040100,4,4,0,0
1,2008,040100,14,13,1,1
2,2008,040100,5,5,0,0
3,2008,040100,6,5,1,1
4,2008,040100,5,5,0,1
5,2008,040100,3,3,0,0
6,2008,040100,6,6,0,0
7,2008,040100,13,13,0,1
8,2008,040100,13,9,4,0
9,2008,040100,13,13,0,0
10,2008,040100,12,12,0,0
11,2008,040100,5,5,0,0
12,2008,040100,14,13,1,0
1,2009,040100,5,5,0,1
2,2009,040100,12,10,2,2
3,2009,040100,7,6,1,0
4,2009,040100,7,7,0,1
5,2009,040100,9,9,0,0
6,2009,040100,7,7,0,0
7,2009,040100,10,9,1,0
8,2009,040100,8,8,0,2
9,2009,040100,7,7,0,0
10,2009,040100,6,5,1,0
11,2009,040100,7,6,1,0
12,2009,040100,8,8,0,2
1,2010,040100,6,6,0,1
2,2010,040100,2,2,0,0
3,2010,040100,5,5,0,2
4,2010,040100,6,5,1,0
5,2010,040100,6,6,0,0
6,2010,040100,11,11,0,0
7,2010,040100,12,11,1,1
8,2010,040100,6,6,0,1
9,2010,040100,9,9,0,0
10,2010,040100,4,4,0,0
11,2010,040100,8,8,0,2
12,2010,040100,10,10,0,2
1,2011,040100,6,6,0,1
2,2011,040100,3,2,1,0
1,1999,030900,14,14,0,0
2,1999,030900,14,14,0,0
3,1999,030900,16,15,1,0
4,1999,030900,17,17,0,2
5,1999,030900,17,17,0,0
6,1999,030900,28,27,1,0
7,1999,030900,21,21,0,0
8,1999,030900,15,15,0,2
9,1999,030900,17,17,0,0
10,1999,030900,14,13,1,2
11,1999,030900,14,14,0,1
12,1999,030900,27,27,0,2
1,2000,030900,19,18,1,1
2,2000,030900,20,20,0,1
3,2000,030900,18,18,0,0
4,2000,030900,16,15,1,2
5,2000,030900,17,14,3,0
6,2000,030900,15,15,0,0
7,2000,030900,17,15,2,1
8,2000,030900,20,19,1,1
9,2000,030900,11,10,1,1
10,2000,030900,14,11,3,0
11,2000,030900,21,20,1,0
12,2000,030900,17,17,0,0
1,2001,030900,19,18,1,1
2,2001,030900,12,10,2,0
3,2001,030900,9,8,1,1
4,2001,030900,8,6,2,2
5,2001,030900,18,17,1,0
6,2001,030900,16,16,0,1
7,2001,030900,16,16,0,1
8,2001,030900,12,10,2,1
9,2001,030900,18,18,0,1
10,2001,030900,21,21,0,0
11,2001,030900,16,16,0,1
12,2001,030900,12,11,1,1
1,2002,030900,9,9,0,1
2,2002,030900,8,8,0,2
3,2002,030900,26,23,3,0
4,2002,030900,14,13,1,0
5,2002,030900,15,15,0,0
6,2002,030900,14,13,1,1
7,2002,030900,24,23,1,1
8,2002,030900,21,21,0,0
9,2002,030900,19,19,0,0
10,2002,030900,12,12,0,0
11,2002,030900,14,14,0,0
12,2002,030900,10,10,0,0
1,2003,030900,7,6,1,1
2,2003,030900,7,7,0,0
3,2003,030900,12,11,1,0
4,2003,030900,13,12,1,0
5,2003,030900,13,13,0,0
6,2003,030900,17,17,0,0
7,2003,030900,13,12,1,0
8,2003,030900,9,8,1,1
9,2003,030900,16,16,0,0
10,2003,030900,18,15,3,1
11,2003,030900,14,14,0,0
12,2003,030900,9,9,0,0
1,2004,030900,5,5,0,0
2,2004,030900,12,11,1,0
3,2004,030900,14,12,2,0
4,2004,030900,3,3,0,1
5,2004,030900,7,7,0,0
6,2004,030900,13,13,0,0
7,2004,030900,15,15,0,1
8,2004,030900,9,9,0,0
9,2004,030900,11,11,0,1
10,2004,030900,24,21,3,0
11,2004,030900,15,14,1,3
12,2004,030900,17,17,0,1
1,2005,030900,7,7,0,0
2,2005,030900,7,7,0,0
3,2005,030900,11,10,1,0
4,2005,030900,21,19,2,0
5,2005,030900,11,10,1,0
6,2005,030900,12,12,0,1
7,2005,030900,20,20,0,1
8,2005,030900,20,20,0,0
9,2005,030900,14,14,0,0
10,2005,030900,13,13,0,0
11,2005,030900,22,21,1,0
12,2005,030900,8,8,0,0
1,2006,030900,18,18,0,0
2,2006,030900,7,7,0,1
3,2006,030900,14,13,1,0
4,2006,030900,15,15,0,0
5,2006,030900,14,13,1,1
6,2006,030900,20,20,0,1
7,2006,030900,15,14,1,1
8,2006,030900,14,14,0,1
9,2006,030900,9,9,0,0
10,2006,030900,16,16,0,0
11,2006,030900,14,14,0,1
12,2006,030900,11,11,0,0
1,2007,030900,19,19,0,1
2,2007,030900,9,9,0,0
3,2007,030900,9,9,0,0
4,2007,030900,9,9,0,0
5,2007,030900,8,8,0,0
6,2007,030900,13,12,1,0
7,2007,030900,9,8,1,2
8,2007,030900,11,10,1,2
9,2007,030900,11,11,0,0
10,2007,030900,15,14,1,1
11,2007,030900,9,9,0,3
12,2007,030900,15,15,0,0
1,2008,030900,13,13,0,1
2,2008,030900,13,12,1,1
3,2008,030900,7,7,0,1
4,2008,030900,6,6,0,0
5,2008,030900,12,12,0,0
6,2008,030900,12,12,0,3
7,2008,030900,11,11,0,0
8,2008,030900,9,9,0,0
9,2008,030900,11,11,0,0
10,2008,030900,17,16,1,0
11,2008,030900,19,19,0,3
12,2008,030900,15,15,0,0
1,2009,030900,6,6,0,1
2,2009,030900,10,9,1,0
3,2009,030900,10,9,1,0
4,2009,030900,10,9,1,2
5,2009,030900,6,6,0,1
6,2009,030900,9,9,0,0
7,2009,030900,15,15,0,0
8,2009,030900,11,11,0,3
9,2009,030900,5,4,1,0
10,2009,030900,7,7,0,1
11,2009,030900,14,14,0,0
12,2009,030900,9,9,0,1
1,2010,030900,6,6,0,0
2,2010,030900,9,7,2,1
3,2010,030900,8,8,0,2
4,2010,030900,12,10,2,2
5,2010,030900,14,14,0,0
6,2010,030900,10,9,1,0
7,2010,030900,7,5,2,3
8,2010,030900,3,3,0,0
9,2010,030900,15,15,0,0
10,2010,030900,18,18,0,1
11,2010,030900,11,11,0,0
12,2010,030900,6,6,0,0
1,2011,030900,8,7,1,0
2,2011,030900,0,0,0,0
1,1999,030800,5,4,1,0
2,1999,030800,7,7,0,2
3,1999,030800,8,7,1,1
4,1999,030800,6,6,0,2
5,1999,030800,11,11,0,1
6,1999,030800,18,18,0,0
7,1999,030800,27,27,0,0
8,1999,030800,19,19,0,1
9,1999,030800,17,17,0,3
10,1999,030800,9,9,0,0
11,1999,030800,22,21,1,0
12,1999,030800,12,11,1,0
1,2000,030800,7,7,0,0
2,2000,030800,4,4,0,1
3,2000,030800,9,7,2,0
4,2000,030800,6,6,0,0
5,2000,030800,8,8,0,0
6,2000,030800,11,11,0,1
7,2000,030800,18,17,1,0
8,2000,030800,17,17,0,0
9,2000,030800,8,8,0,2
10,2000,030800,7,6,1,1
11,2000,030800,11,11,0,1
12,2000,030800,8,8,0,0
1,2001,030800,3,3,0,1
2,2001,030800,10,10,0,0
3,2001,030800,7,7,0,1
4,2001,030800,9,8,1,0
5,2001,030800,7,7,0,0
6,2001,030800,11,10,1,1
7,2001,030800,11,11,0,1
8,2001,030800,11,11,0,0
9,2001,030800,16,16,0,0
10,2001,030800,9,9,0,1
11,2001,030800,15,15,0,2
12,2001,030800,8,8,0,0
1,2002,030800,5,5,0,1
2,2002,030800,8,8,0,0
3,2002,030800,9,9,0,0
4,2002,030800,8,7,1,1
5,2002,030800,11,10,1,1
6,2002,030800,13,12,1,0
7,2002,030800,14,14,0,1
8,2002,030800,7,7,0,0
9,2002,030800,6,5,1,0
10,2002,030800,11,11,0,0
11,2002,030800,9,9,0,0
12,2002,030800,12,12,0,0
1,2003,030800,7,7,0,0
2,2003,030800,10,10,0,0
3,2003,030800,8,8,0,0
4,2003,030800,7,7,0,1
5,2003,030800,7,6,1,0
6,2003,030800,5,5,0,0
7,2003,030800,8,8,0,1
8,2003,030800,8,8,0,1
9,2003,030800,4,4,0,0
10,2003,030800,6,6,0,3
11,2003,030800,12,12,0,1
12,2003,030800,5,5,0,0
1,2004,030800,5,5,0,0
2,2004,030800,4,4,0,0
3,2004,030800,6,6,0,0
4,2004,030800,10,10,0,1
5,2004,030800,7,7,0,0
6,2004,030800,12,12,0,0
7,2004,030800,8,7,1,1
8,2004,030800,10,10,0,0
9,2004,030800,9,9,0,1
10,2004,030800,7,7,0,0
11,2004,030800,5,5,0,0
12,2004,030800,10,9,1,0
1,2005,030800,11,11,0,0
2,2005,030800,10,8,2,0
3,2005,030800,10,10,0,0
4,2005,030800,3,3,0,0
5,2005,030800,4,4,0,0
6,2005,030800,8,8,0,0
7,2005,030800,10,10,0,0
8,2005,030800,13,13,0,0
9,2005,030800,14,14,0,3
10,2005,030800,7,7,0,0
11,2005,030800,9,8,1,0
12,2005,030800,8,8,0,0
1,2006,030800,10,10,0,0
2,2006,030800,1,1,0,1
3,2006,030800,6,6,0,0
4,2006,030800,7,7,0,0
5,2006,030800,6,5,1,0
6,2006,030800,5,5,0,1
7,2006,030800,7,6,1,0
8,2006,030800,4,4,0,4
9,2006,030800,15,15,0,0
10,2006,030800,13,13,0,0
11,2006,030800,12,12,0,0
12,2006,030800,4,4,0,2
1,2007,030800,6,6,0,0
2,2007,030800,4,4,0,0
3,2007,030800,6,5,1,0
4,2007,030800,8,8,0,1
5,2007,030800,7,7,0,0
6,2007,030800,8,8,0,1
7,2007,030800,9,9,0,0
8,2007,030800,10,10,0,0
9,2007,030800,9,8,1,0
10,2007,030800,6,6,0,1
11,2007,030800,5,5,0,0
12,2007,030800,8,8,0,0
1,2008,030800,4,4,0,0
2,2008,030800,4,3,1,0
3,2008,030800,5,5,0,0
4,2008,030800,7,7,0,0
5,2008,030800,9,9,0,0
6,2008,030800,8,8,0,0
7,2008,030800,13,13,0,0
8,2008,030800,5,5,0,0
9,2008,030800,8,8,0,0
10,2008,030800,7,7,0,0
11,2008,030800,9,9,0,0
12,2008,030800,9,9,0,0
1,2009,030800,8,8,0,1
2,2009,030800,5,5,0,0
3,2009,030800,5,5,0,0
4,2009,030800,7,7,0,1
5,2009,030800,4,4,0,1
6,2009,030800,12,12,0,1
7,2009,030800,10,9,1,0
8,2009,030800,5,5,0,0
9,2009,030800,8,8,0,2
10,2009,030800,5,5,0,1
11,2009,030800,3,3,0,0
12,2009,030800,7,7,0,0
1,2010,030800,7,7,0,3
2,2010,030800,1,1,0,0
3,2010,030800,4,4,0,1
4,2010,030800,6,6,0,0
5,2010,030800,13,12,1,0
6,2010,030800,9,9,0,1
7,2010,030800,17,17,0,0
8,2010,030800,8,8,0,0
9,2010,030800,7,7,0,1
10,2010,030800,9,9,0,1
11,2010,030800,7,7,0,1
12,2010,030800,8,8,0,0
1,2011,030800,4,4,0,1
2,2011,030800,5,5,0,0
1,1999,810400,0,0,0,0
2,1999,810400,0,0,0,0
3,1999,810400,0,0,0,0
4,1999,810400,0,0,0,0
5,1999,810400,0,0,0,0
6,1999,810400,0,0,0,0
7,1999,810400,1,1,0,0
8,1999,810400,0,0,0,0
9,1999,810400,0,0,0,0
10,1999,810400,1,1,0,0
11,1999,810400,1,1,0,0
12,1999,810400,0,0,0,0
1,2000,810400,0,0,0,0
2,2000,810400,1,1,0,0
3,2000,810400,1,1,0,0
4,2000,810400,0,0,0,0
5,2000,810400,1,1,0,0
6,2000,810400,0,0,0,0
7,2000,810400,0,0,0,0
8,2000,810400,1,1,0,0
9,2000,810400,0,0,0,0
10,2000,810400,1,1,0,0
11,2000,810400,1,1,0,0
12,2000,810400,0,0,0,0
1,2001,810400,0,0,0,0
2,2001,810400,0,0,0,0
3,2001,810400,0,0,0,0
4,2001,810400,1,1,0,0
5,2001,810400,0,0,0,0
6,2001,810400,1,1,0,0
7,2001,810400,0,0,0,0
8,2001,810400,0,0,0,0
9,2001,810400,0,0,0,0
10,2001,810400,0,0,0,0
11,2001,810400,0,0,0,0
12,2001,810400,0,0,0,0
1,2002,810400,2,2,0,0
2,2002,810400,0,0,0,0
3,2002,810400,0,0,0,0
4,2002,810400,0,0,0,0
5,2002,810400,0,0,0,0
6,2002,810400,0,0,0,0
7,2002,810400,0,0,0,0
8,2002,810400,0,0,0,0
9,2002,810400,0,0,0,0
10,2002,810400,0,0,0,0
11,2002,810400,1,1,0,0
12,2002,810400,0,0,0,0
1,2003,810400,0,0,0,0
2,2003,810400,0,0,0,0
3,2003,810400,1,1,0,0
4,2003,810400,0,0,0,0
5,2003,810400,0,0,0,0
6,2003,810400,0,0,0,0
7,2003,810400,0,0,0,0
8,2003,810400,1,1,0,0
9,2003,810400,0,0,0,0
10,2003,810400,0,0,0,0
11,2003,810400,0,0,0,0
12,2003,810400,0,0,0,0
1,2004,810400,2,2,0,0
2,2004,810400,0,0,0,0
3,2004,810400,0,0,0,0
4,2004,810400,0,0,0,0
5,2004,810400,1,1,0,0
6,2004,810400,0,0,0,0
7,2004,810400,0,0,0,0
8,2004,810400,0,0,0,0
9,2004,810400,0,0,0,0
10,2004,810400,0,0,0,0
11,2004,810400,0,0,0,0
12,2004,810400,2,2,0,0
1,2005,810400,0,0,0,0
2,2005,810400,0,0,0,0
3,2005,810400,0,0,0,0
4,2005,810400,0,0,0,0
5,2005,810400,1,1,0,0
6,2005,810400,1,1,0,0
7,2005,810400,0,0,0,0
8,2005,810400,0,0,0,0
9,2005,810400,1,1,0,0
10,2005,810400,0,0,0,0
11,2005,810400,0,0,0,0
12,2005,810400,0,0,0,0
1,2006,810400,0,0,0,0
2,2006,810400,1,1,0,0
3,2006,810400,0,0,0,0
4,2006,810400,0,0,0,0
5,2006,810400,0,0,0,0
6,2006,810400,0,0,0,0
7,2006,810400,1,1,0,0
8,2006,810400,0,0,0,0
9,2006,810400,1,1,0,0
10,2006,810400,0,0,0,0
11,2006,810400,0,0,0,0
12,2006,810400,0,0,0,0
1,2007,810400,0,0,0,0
2,2007,810400,1,0,1,0
3,2007,810400,0,0,0,0
4,2007,810400,0,0,0,0
5,2007,810400,0,0,0,0
6,2007,810400,0,0,0,0
7,2007,810400,0,0,0,0
8,2007,810400,0,0,0,0
9,2007,810400,0,0,0,0
10,2007,810400,0,0,0,0
11,2007,810400,0,0,0,0
12,2007,810400,0,0,0,0
1,2008,810400,0,0,0,0
2,2008,810400,0,0,0,0
3,2008,810400,0,0,0,0
4,2008,810400,0,0,0,0
5,2008,810400,0,0,0,0
6,2008,810400,1,1,0,0
7,2008,810400,0,0,0,0
8,2008,810400,1,1,0,0
9,2008,810400,0,0,0,0
10,2008,810400,0,0,0,0
11,2008,810400,0,0,0,0
12,2008,810400,1,1,0,0
1,2009,810400,0,0,0,0
2,2009,810400,0,0,0,0
3,2009,810400,0,0,0,0
4,2009,810400,0,0,0,0
5,2009,810400,0,0,0,0
6,2009,810400,0,0,0,0
7,2009,810400,0,0,0,0
8,2009,810400,0,0,0,0
9,2009,810400,0,0,0,0
10,2009,810400,0,0,0,0
11,2009,810400,0,0,0,0
12,2009,810400,2,2,0,0
1,2010,810400,0,0,0,0
2,2010,810400,0,0,0,0
3,2010,810400,0,0,0,0
4,2010,810400,0,0,0,0
5,2010,810400,0,0,0,0
6,2010,810400,0,0,0,0
7,2010,810400,0,0,0,0
8,2010,810400,1,1,0,0
9,2010,810400,0,0,0,0
10,2010,810400,0,0,0,0
11,2010,810400,0,0,0,0
12,2010,810400,0,0,0,0
1,2011,810400,0,0,0,0
2,2011,810400,1,1,0,0
1,1999,030703,11,10,1,1
2,1999,030703,6,5,1,0
3,1999,030703,10,9,1,0
4,1999,030703,8,7,1,1
5,1999,030703,12,11,1,1
6,1999,030703,11,10,1,4
7,1999,030703,19,17,2,1
8,1999,030703,24,19,5,1
9,1999,030703,18,17,1,0
10,1999,030703,12,8,4,0
11,1999,030703,17,16,1,2
12,1999,030703,21,21,0,4
1,2000,030703,12,11,1,2
2,2000,030703,9,6,3,4
3,2000,030703,16,16,0,0
4,2000,030703,9,7,2,0
5,2000,030703,5,5,0,0
6,2000,030703,15,14,1,1
7,2000,030703,10,9,1,2
8,2000,030703,17,13,4,2
9,2000,030703,13,11,2,1
10,2000,030703,11,7,4,4
11,2000,030703,20,17,3,1
12,2000,030703,8,8,0,2
1,2001,030703,8,8,0,1
2,2001,030703,9,9,0,2
3,2001,030703,10,9,1,1
4,2001,030703,7,6,1,0
5,2001,030703,10,9,1,3
6,2001,030703,12,12,0,0
7,2001,030703,9,7,2,2
8,2001,030703,10,8,2,3
9,2001,030703,7,7,0,3
10,2001,030703,11,9,2,3
11,2001,030703,6,6,0,1
12,2001,030703,9,8,1,0
1,2002,030703,7,7,0,1
2,2002,030703,12,11,1,1
3,2002,030703,7,6,1,2
4,2002,030703,13,12,1,2
5,2002,030703,7,7,0,2
6,2002,030703,6,5,1,0
7,2002,030703,7,6,1,0
8,2002,030703,5,5,0,2
9,2002,030703,6,5,1,5
10,2002,030703,5,5,0,1
11,2002,030703,8,7,1,2
12,2002,030703,5,5,0,0
1,2003,030703,8,8,0,3
2,2003,030703,9,8,1,2
3,2003,030703,6,6,0,2
4,2003,030703,13,11,2,3
5,2003,030703,4,3,1,1
6,2003,030703,11,11,0,1
7,2003,030703,6,6,0,3
8,2003,030703,8,8,0,0
9,2003,030703,4,4,0,2
10,2003,030703,9,7,2,0
11,2003,030703,2,2,0,2
12,2003,030703,9,5,4,0
1,2004,030703,4,2,2,0
2,2004,030703,5,3,2,1
3,2004,030703,7,6,1,2
4,2004,030703,2,2,0,5
5,2004,030703,9,9,0,7
6,2004,030703,4,4,0,0
7,2004,030703,5,5,0,4
8,2004,030703,21,20,1,1
9,2004,030703,10,9,1,2
10,2004,030703,10,9,1,2
11,2004,030703,5,5,0,2
12,2004,030703,11,11,0,0
1,2005,030703,7,6,1,1
2,2005,030703,3,2,1,2
3,2005,030703,8,8,0,8
4,2005,030703,10,9,1,2
5,2005,030703,8,7,1,0
6,2005,030703,16,14,2,1
7,2005,030703,14,13,1,5
8,2005,030703,6,6,0,2
9,2005,030703,12,12,0,3
10,2005,030703,3,2,1,2
11,2005,030703,7,7,0,0
12,2005,030703,5,4,1,1
1,2006,030703,7,7,0,3
2,2006,030703,5,5,0,1
3,2006,030703,9,9,0,0
4,2006,030703,7,7,0,5
5,2006,030703,9,8,1,1
6,2006,030703,5,5,0,0
7,2006,030703,9,9,0,0
8,2006,030703,12,12,0,2
9,2006,030703,8,8,0,0
10,2006,030703,3,3,0,1
11,2006,030703,1,0,1,0
12,2006,030703,8,7,1,1
1,2007,030703,8,8,0,1
2,2007,030703,10,8,2,0
3,2007,030703,4,4,0,1
4,2007,030703,8,7,1,2
5,2007,030703,8,8,0,0
6,2007,030703,13,13,0,2
7,2007,030703,17,15,2,2
8,2007,030703,6,4,2,1
9,2007,030703,6,5,1,1
10,2007,030703,9,7,2,1
11,2007,030703,2,2,0,0
12,2007,030703,5,5,0,1
1,2008,030703,6,6,0,0
2,2008,030703,1,1,0,0
3,2008,030703,5,5,0,0
4,2008,030703,10,10,0,0
5,2008,030703,8,6,2,0
6,2008,030703,11,10,1,1
7,2008,030703,3,3,0,0
8,2008,030703,9,9,0,0
9,2008,030703,4,3,1,1
10,2008,030703,7,7,0,1
11,2008,030703,6,5,1,1
12,2008,030703,9,9,0,1
1,2009,030703,3,3,0,0
2,2009,030703,4,4,0,0
3,2009,030703,7,7,0,0
4,2009,030703,4,4,0,0
5,2009,030703,11,11,0,0
6,2009,030703,7,7,0,0
7,2009,030703,7,7,0,0
8,2009,030703,8,7,1,0
9,2009,030703,10,9,1,0
10,2009,030703,7,7,0,1
11,2009,030703,3,3,0,1
12,2009,030703,5,3,2,1
1,2010,030703,9,8,1,1
2,2010,030703,2,2,0,0
3,2010,030703,2,2,0,1
4,2010,030703,2,2,0,0
5,2010,030703,0,0,0,1
6,2010,030703,11,11,0,0
7,2010,030703,14,14,0,2
8,2010,030703,6,6,0,1
9,2010,030703,6,6,0,0
10,2010,030703,6,4,2,1
11,2010,030703,8,8,0,2
12,2010,030703,8,7,1,1
1,2011,030703,4,4,0,2
2,2011,030703,7,7,0,0
1,1999,030706,16,16,0,3
2,1999,030706,14,14,0,1
3,1999,030706,18,18,0,1
4,1999,030706,23,21,2,5
5,1999,030706,19,19,0,15
6,1999,030706,16,11,5,3
7,1999,030706,29,29,0,3
8,1999,030706,25,24,1,2
9,1999,030706,14,12,2,1
10,1999,030706,18,18,0,1
11,1999,030706,20,19,1,1
12,1999,030706,11,10,1,1
1,2000,030706,5,3,2,2
2,2000,030706,14,14,0,8
3,2000,030706,16,15,1,1
4,2000,030706,11,11,0,4
5,2000,030706,11,10,1,2
6,2000,030706,22,21,1,0
7,2000,030706,29,27,2,8
8,2000,030706,25,22,3,4
9,2000,030706,17,15,2,4
10,2000,030706,11,11,0,5
11,2000,030706,16,13,3,10
12,2000,030706,13,10,3,1
1,2001,030706,8,6,2,0
2,2001,030706,8,8,0,0
3,2001,030706,11,10,1,1
4,2001,030706,13,9,4,4
5,2001,030706,13,12,1,2
6,2001,030706,25,23,2,5
7,2001,030706,23,22,1,4
8,2001,030706,18,18,0,2
9,2001,030706,20,19,1,2
10,2001,030706,12,11,1,1
11,2001,030706,7,7,0,1
12,2001,030706,9,9,0,1
1,2002,030706,10,10,0,1
2,2002,030706,9,9,0,2
3,2002,030706,9,9,0,1
4,2002,030706,16,16,0,0
5,2002,030706,24,20,4,2
6,2002,030706,22,20,2,3
7,2002,030706,13,13,0,1
8,2002,030706,13,12,1,4
9,2002,030706,15,14,1,2
10,2002,030706,11,11,0,1
11,2002,030706,6,5,1,1
12,2002,030706,13,13,0,0
1,2003,030706,11,9,2,4
2,2003,030706,9,8,1,1
3,2003,030706,7,6,1,1
4,2003,030706,14,13,1,1
5,2003,030706,8,7,1,3
6,2003,030706,9,9,0,6
7,2003,030706,17,17,0,2
8,2003,030706,14,11,3,3
9,2003,030706,12,11,1,2
10,2003,030706,8,5,3,6
11,2003,030706,8,8,0,2
12,2003,030706,8,8,0,5
1,2004,030706,12,12,0,3
2,2004,030706,5,4,1,2
3,2004,030706,10,10,0,0
4,2004,030706,12,12,0,2
5,2004,030706,8,8,0,4
6,2004,030706,13,10,3,2
7,2004,030706,9,8,1,4
8,2004,030706,12,10,2,4
9,2004,030706,17,16,1,4
10,2004,030706,14,11,3,2
11,2004,030706,7,7,0,2
12,2004,030706,9,8,1,0
1,2005,030706,8,8,0,0
2,2005,030706,11,11,0,0
3,2005,030706,8,7,1,2
4,2005,030706,13,12,1,3
5,2005,030706,13,11,2,5
6,2005,030706,12,11,1,3
7,2005,030706,16,14,2,2
8,2005,030706,24,23,1,3
9,2005,030706,17,14,3,3
10,2005,030706,15,14,1,1
11,2005,030706,9,8,1,4
12,2005,030706,10,10,0,0
1,2006,030706,13,12,1,2
2,2006,030706,3,3,0,2
3,2006,030706,3,3,0,1
4,2006,030706,8,8,0,3
5,2006,030706,8,7,1,3
6,2006,030706,5,5,0,2
7,2006,030706,12,12,0,3
8,2006,030706,12,11,1,1
9,2006,030706,11,11,0,0
10,2006,030706,9,9,0,2
11,2006,030706,7,7,0,1
12,2006,030706,9,9,0,0
1,2007,030706,3,3,0,1
2,2007,030706,6,6,0,0
3,2007,030706,5,5,0,0
4,2007,030706,5,5,0,2
5,2007,030706,10,9,1,6
6,2007,030706,13,12,1,4
7,2007,030706,8,7,1,6
8,2007,030706,10,10,0,3
9,2007,030706,8,8,0,5
10,2007,030706,9,9,0,1
11,2007,030706,7,7,0,0
12,2007,030706,6,6,0,1
1,2008,030706,5,5,0,2
2,2008,030706,12,11,1,2
3,2008,030706,5,5,0,1
4,2008,030706,8,7,1,0
5,2008,030706,12,9,3,2
6,2008,030706,13,10,3,1
7,2008,030706,16,16,0,3
8,2008,030706,14,14,0,0
9,2008,030706,5,5,0,3
10,2008,030706,9,7,2,0
11,2008,030706,14,14,0,1
12,2008,030706,12,12,0,2
1,2009,030706,5,5,0,2
2,2009,030706,5,5,0,1
3,2009,030706,9,9,0,0
4,2009,030706,4,4,0,1
5,2009,030706,9,8,1,2
6,2009,030706,10,9,1,0
7,2009,030706,13,13,0,2
8,2009,030706,17,17,0,1
9,2009,030706,17,16,1,1
10,2009,030706,4,4,0,0
11,2009,030706,6,6,0,0
12,2009,030706,4,4,0,1
1,2010,030706,6,6,0,1
2,2010,030706,3,3,0,0
3,2010,030706,3,3,0,0
4,2010,030706,1,1,0,0
5,2010,030706,2,2,0,2
6,2010,030706,9,8,1,1
7,2010,030706,7,7,0,3
8,2010,030706,14,14,0,2
9,2010,030706,7,6,1,2
10,2010,030706,9,6,3,0
11,2010,030706,7,5,2,0
12,2010,030706,7,6,1,1
1,2011,030706,16,15,1,0
2,2011,030706,6,6,0,3
1,1999,040202,12,10,2,0
2,1999,040202,18,18,0,1
3,1999,040202,5,4,1,1
4,1999,040202,3,3,0,0
5,1999,040202,11,11,0,0
6,1999,040202,10,9,1,1
7,1999,040202,16,16,0,0
8,1999,040202,17,15,2,4
9,1999,040202,16,14,2,1
10,1999,040202,15,15,0,0
11,1999,040202,6,5,1,1
12,1999,040202,11,10,1,0
1,2000,040202,8,8,0,1
2,2000,040202,11,11,0,0
3,2000,040202,8,7,1,1
4,2000,040202,13,11,2,1
5,2000,040202,15,15,0,1
6,2000,040202,19,17,2,0
7,2000,040202,18,16,2,0
8,2000,040202,16,14,2,3
9,2000,040202,20,20,0,0
10,2000,040202,14,12,2,0
11,2000,040202,16,16,0,0
12,2000,040202,14,14,0,0
1,2001,040202,10,10,0,1
2,2001,040202,6,6,0,0
3,2001,040202,10,8,2,1
4,2001,040202,16,16,0,0
5,2001,040202,13,13,0,0
6,2001,040202,15,14,1,2
7,2001,040202,5,4,1,1
8,2001,040202,14,11,3,1
9,2001,040202,12,11,1,1
10,2001,040202,9,8,1,1
11,2001,040202,14,14,0,0
12,2001,040202,13,13,0,1
1,2002,040202,13,10,3,1
2,2002,040202,15,15,0,0
3,2002,040202,11,10,1,0
4,2002,040202,16,15,1,0
5,2002,040202,10,10,0,2
6,2002,040202,15,14,1,0
7,2002,040202,16,15,1,0
8,2002,040202,15,14,1,0
9,2002,040202,9,9,0,0
10,2002,040202,13,13,0,1
11,2002,040202,17,16,1,1
12,2002,040202,21,20,1,2
1,2003,040202,6,5,1,2
2,2003,040202,3,3,0,1
3,2003,040202,13,13,0,0
4,2003,040202,10,10,0,0
5,2003,040202,5,4,1,1
6,2003,040202,9,9,0,1
7,2003,040202,9,6,3,1
8,2003,040202,12,12,0,0
9,2003,040202,10,9,1,0
10,2003,040202,7,7,0,0
11,2003,040202,10,10,0,0
12,2003,040202,12,10,2,0
1,2004,040202,5,5,0,0
2,2004,040202,9,9,0,5
3,2004,040202,5,5,0,1
4,2004,040202,6,6,0,1
5,2004,040202,9,9,0,1
6,2004,040202,9,8,1,1
7,2004,040202,10,10,0,0
8,2004,040202,18,18,0,1
9,2004,040202,12,12,0,1
10,2004,040202,13,11,2,1
11,2004,040202,17,16,1,0
12,2004,040202,15,14,1,4
1,2005,040202,7,7,0,1
2,2005,040202,9,9,0,0
3,2005,040202,10,10,0,1
4,2005,040202,11,10,1,1
5,2005,040202,16,15,1,0
6,2005,040202,8,7,1,1
7,2005,040202,14,14,0,1
8,2005,040202,15,12,3,3
9,2005,040202,8,7,1,1
10,2005,040202,3,3,0,0
11,2005,040202,14,13,1,0
12,2005,040202,4,4,0,0
1,2006,040202,10,10,0,2
2,2006,040202,11,10,1,0
3,2006,040202,9,9,0,1
4,2006,040202,15,11,4,1
5,2006,040202,12,12,0,1
6,2006,040202,14,14,0,0
7,2006,040202,14,14,0,0
8,2006,040202,6,5,1,0
9,2006,040202,9,9,0,1
10,2006,040202,12,12,0,0
11,2006,040202,8,7,1,2
12,2006,040202,12,12,0,1
1,2007,040202,12,12,0,2
2,2007,040202,7,7,0,1
3,2007,040202,8,8,0,0
4,2007,040202,12,12,0,0
5,2007,040202,9,9,0,0
6,2007,040202,10,9,1,1
7,2007,040202,6,6,0,0
8,2007,040202,7,4,3,0
9,2007,040202,10,9,1,1
10,2007,040202,13,13,0,5
11,2007,040202,11,10,1,1
12,2007,040202,12,11,1,0
1,2008,040202,12,12,0,1
2,2008,040202,12,11,1,0
3,2008,040202,17,16,1,1
4,2008,040202,11,10,1,0
5,2008,040202,10,9,1,2
6,2008,040202,18,18,0,3
7,2008,040202,10,10,0,0
8,2008,040202,8,6,2,0
9,2008,040202,14,14,0,0
10,2008,040202,17,13,4,0
11,2008,040202,15,15,0,1
12,2008,040202,8,8,0,1
1,2009,040202,12,11,1,1
2,2009,040202,6,6,0,0
3,2009,040202,8,6,2,0
4,2009,040202,14,14,0,0
5,2009,040202,10,10,0,0
6,2009,040202,10,9,1,0
7,2009,040202,2,2,0,0
8,2009,040202,11,11,0,0
9,2009,040202,8,6,2,1
10,2009,040202,8,7,1,1
11,2009,040202,17,16,1,0
12,2009,040202,10,10,0,1
1,2010,040202,5,5,0,0
2,2010,040202,10,10,0,0
3,2010,040202,11,9,2,1
4,2010,040202,12,12,0,3
5,2010,040202,7,7,0,0
6,2010,040202,13,13,0,0
7,2010,040202,14,14,0,2
8,2010,040202,9,8,1,0
9,2010,040202,6,6,0,0
10,2010,040202,10,9,1,0
11,2010,040202,13,11,2,2
12,2010,040202,8,4,4,0
1,2011,040202,4,4,0,1
2,2011,040202,4,4,0,2
1,1999,760801,12,11,1,0
2,1999,760801,12,12,0,0
3,1999,760801,21,20,1,0
4,1999,760801,17,17,0,0
5,1999,760801,14,14,0,0
6,1999,760801,16,15,1,0
7,1999,760801,10,10,0,1
8,1999,760801,22,22,0,0
9,1999,760801,13,13,0,3
10,1999,760801,11,10,1,0
11,1999,760801,12,11,1,0
12,1999,760801,9,9,0,0
1,2000,760801,16,16,0,0
2,2000,760801,8,8,0,1
3,2000,760801,20,20,0,0
4,2000,760801,12,12,0,1
5,2000,760801,13,13,0,2
6,2000,760801,22,21,1,0
7,2000,760801,19,19,0,1
8,2000,760801,20,19,1,0
9,2000,760801,15,15,0,0
10,2000,760801,17,17,0,3
11,2000,760801,13,13,0,1
12,2000,760801,16,16,0,0
1,2001,760801,12,12,0,0
2,2001,760801,13,13,0,1
3,2001,760801,4,4,0,2
4,2001,760801,15,14,1,0
5,2001,760801,22,21,1,1
6,2001,760801,13,13,0,0
7,2001,760801,17,17,0,0
8,2001,760801,15,15,0,1
9,2001,760801,15,15,0,0
10,2001,760801,17,17,0,0
11,2001,760801,15,14,1,0
12,2001,760801,22,22,0,4
1,2002,760801,21,21,0,0
2,2002,760801,20,20,0,1
3,2002,760801,7,6,1,1
4,2002,760801,9,9,0,0
5,2002,760801,11,11,0,1
6,2002,760801,7,7,0,0
7,2002,760801,6,6,0,0
8,2002,760801,12,12,0,0
9,2002,760801,7,7,0,0
10,2002,760801,12,11,1,0
11,2002,760801,13,13,0,0
12,2002,760801,12,12,0,0
1,2003,760801,16,16,0,3
2,2003,760801,13,13,0,1
3,2003,760801,17,16,1,0
4,2003,760801,16,16,0,1
5,2003,760801,15,14,1,1
6,2003,760801,16,16,0,0
7,2003,760801,11,10,1,0
8,2003,760801,15,15,0,0
9,2003,760801,9,9,0,1
10,2003,760801,11,10,1,0
11,2003,760801,17,17,0,0
12,2003,760801,9,9,0,0
1,2004,760801,6,6,0,0
2,2004,760801,14,14,0,1
3,2004,760801,11,11,0,0
4,2004,760801,6,6,0,0
5,2004,760801,16,14,2,1
6,2004,760801,14,14,0,0
7,2004,760801,11,11,0,0
8,2004,760801,11,11,0,0
9,2004,760801,16,15,1,0
10,2004,760801,11,11,0,0
11,2004,760801,10,9,1,0
12,2004,760801,7,7,0,1
1,2005,760801,7,6,1,0
2,2005,760801,10,10,0,2
3,2005,760801,11,11,0,1
4,2005,760801,8,6,2,0
5,2005,760801,21,21,0,0
6,2005,760801,10,10,0,0
7,2005,760801,11,11,0,0
8,2005,760801,15,15,0,1
9,2005,760801,9,9,0,0
10,2005,760801,12,12,0,0
11,2005,760801,14,14,0,1
12,2005,760801,5,5,0,0
1,2006,760801,9,9,0,0
2,2006,760801,7,7,0,1
3,2006,760801,7,7,0,0
4,2006,760801,14,14,0,1
5,2006,760801,11,9,2,1
6,2006,760801,9,9,0,0
7,2006,760801,5,5,0,0
8,2006,760801,20,20,0,0
9,2006,760801,8,8,0,0
10,2006,760801,10,9,1,0
11,2006,760801,12,12,0,0
12,2006,760801,16,16,0,0
1,2007,760801,13,13,0,0
2,2007,760801,6,6,0,0
3,2007,760801,9,9,0,0
4,2007,760801,9,9,0,1
5,2007,760801,12,12,0,0
6,2007,760801,8,8,0,1
7,2007,760801,10,10,0,0
8,2007,760801,12,12,0,0
9,2007,760801,14,14,0,1
10,2007,760801,11,11,0,1
11,2007,760801,10,10,0,0
12,2007,760801,2,2,0,0
1,2008,760801,7,7,0,1
2,2008,760801,9,9,0,0
3,2008,760801,6,6,0,0
4,2008,760801,7,6,1,1
5,2008,760801,11,10,1,1
6,2008,760801,8,8,0,2
7,2008,760801,10,10,0,0
8,2008,760801,10,9,1,0
9,2008,760801,18,17,1,0
10,2008,760801,8,7,1,0
11,2008,760801,15,13,2,2
12,2008,760801,10,10,0,0
1,2009,760801,14,14,0,0
2,2009,760801,8,8,0,0
3,2009,760801,8,8,0,0
4,2009,760801,8,8,0,0
5,2009,760801,14,14,0,0
6,2009,760801,7,7,0,0
7,2009,760801,15,15,0,0
8,2009,760801,5,5,0,0
9,2009,760801,6,6,0,1
10,2009,760801,8,8,0,1
11,2009,760801,12,11,1,0
12,2009,760801,5,5,0,2
1,2010,760801,13,13,0,0
2,2010,760801,10,10,0,0
3,2010,760801,3,2,1,0
4,2010,760801,12,12,0,1
5,2010,760801,14,13,1,2
6,2010,760801,11,11,0,0
7,2010,760801,5,5,0,0
8,2010,760801,8,8,0,0
9,2010,760801,8,8,0,1
10,2010,760801,5,5,0,0
11,2010,760801,6,6,0,0
12,2010,760801,3,3,0,0
1,2011,760801,6,5,1,0
2,2011,760801,8,7,1,0
1,1999,110100,10,9,1,0
2,1999,110100,9,7,2,0
3,1999,110100,13,13,0,2
4,1999,110100,11,11,0,2
5,1999,110100,14,13,1,3
6,1999,110100,16,16,0,1
7,1999,110100,12,12,0,1
8,1999,110100,13,10,3,0
9,1999,110100,15,15,0,4
10,1999,110100,8,8,0,0
11,1999,110100,9,8,1,7
12,1999,110100,9,9,0,0
1,2000,110100,11,11,0,2
2,2000,110100,8,8,0,1
3,2000,110100,14,14,0,0
4,2000,110100,22,19,3,1
5,2000,110100,17,15,2,3
6,2000,110100,11,9,2,0
7,2000,110100,11,11,0,1
8,2000,110100,12,11,1,2
9,2000,110100,8,6,2,1
10,2000,110100,8,6,2,1
11,2000,110100,12,10,2,4
12,2000,110100,5,5,0,0
1,2001,110100,5,4,1,1
2,2001,110100,10,9,1,1
3,2001,110100,17,16,1,1
4,2001,110100,8,6,2,2
5,2001,110100,7,6,1,0
6,2001,110100,12,10,2,9
7,2001,110100,14,14,0,0
8,2001,110100,11,10,1,4
9,2001,110100,13,12,1,0
10,2001,110100,10,9,1,3
11,2001,110100,4,3,1,2
12,2001,110100,10,9,1,1
1,2002,110100,7,7,0,0
2,2002,110100,7,6,1,3
3,2002,110100,10,10,0,2
4,2002,110100,6,6,0,0
5,2002,110100,8,8,0,7
6,2002,110100,12,12,0,1
7,2002,110100,11,10,1,0
8,2002,110100,6,6,0,1
9,2002,110100,13,13,0,0
10,2002,110100,16,15,1,1
11,2002,110100,9,8,1,1
12,2002,110100,9,9,0,2
1,2003,110100,10,9,1,1
2,2003,110100,9,8,1,0
3,2003,110100,9,9,0,3
4,2003,110100,7,7,0,4
5,2003,110100,11,9,2,1
6,2003,110100,10,8,2,1
7,2003,110100,15,12,3,1
8,2003,110100,10,8,2,0
9,2003,110100,13,12,1,2
10,2003,110100,12,11,1,0
11,2003,110100,14,13,1,3
12,2003,110100,6,6,0,1
1,2004,110100,8,8,0,1
2,2004,110100,13,11,2,4
3,2004,110100,7,6,1,3
4,2004,110100,8,7,1,3
5,2004,110100,8,8,0,1
6,2004,110100,14,11,3,1
7,2004,110100,17,17,0,8
8,2004,110100,10,10,0,1
9,2004,110100,6,6,0,0
10,2004,110100,9,9,0,2
11,2004,110100,10,10,0,1
12,2004,110100,4,4,0,0
1,2005,110100,12,12,0,1
2,2005,110100,4,3,1,0
3,2005,110100,11,8,3,1
4,2005,110100,11,11,0,0
5,2005,110100,7,6,1,3
6,2005,110100,10,9,1,1
7,2005,110100,15,14,1,0
8,2005,110100,17,16,1,3
9,2005,110100,14,12,2,2
10,2005,110100,13,12,1,0
11,2005,110100,11,11,0,0
12,2005,110100,10,8,2,1
1,2006,110100,11,8,3,2
2,2006,110100,8,7,1,0
3,2006,110100,5,5,0,1
4,2006,110100,6,6,0,4
5,2006,110100,9,9,0,2
6,2006,110100,11,10,1,1
7,2006,110100,21,20,1,0
8,2006,110100,23,21,2,2
9,2006,110100,15,14,1,0
10,2006,110100,11,10,1,4
11,2006,110100,12,10,2,0
12,2006,110100,10,10,0,1
1,2007,110100,6,6,0,0
2,2007,110100,3,2,1,1
3,2007,110100,6,6,0,2
4,2007,110100,3,3,0,0
5,2007,110100,12,12,0,1
6,2007,110100,8,7,1,2
7,2007,110100,12,11,1,1
8,2007,110100,9,9,0,1
9,2007,110100,10,9,1,1
10,2007,110100,6,6,0,3
11,2007,110100,8,8,0,2
12,2007,110100,6,6,0,0
1,2008,110100,6,6,0,0
2,2008,110100,6,6,0,0
3,2008,110100,13,12,1,1
4,2008,110100,6,6,0,3
5,2008,110100,9,9,0,1
6,2008,110100,11,11,0,4
7,2008,110100,9,8,1,1
8,2008,110100,16,14,2,1
9,2008,110100,5,5,0,4
10,2008,110100,8,7,1,2
11,2008,110100,13,11,2,1
12,2008,110100,4,3,1,1
1,2009,110100,8,8,0,5
2,2009,110100,6,5,1,2
3,2009,110100,9,8,1,1
4,2009,110100,6,5,1,0
5,2009,110100,9,9,0,2
6,2009,110100,4,3,1,3
7,2009,110100,7,7,0,3
8,2009,110100,9,7,2,1
9,2009,110100,4,4,0,1
10,2009,110100,7,7,0,1
11,2009,110100,9,9,0,0
12,2009,110100,5,5,0,2
1,2010,110100,6,4,2,2
2,2010,110100,4,4,0,3
3,2010,110100,6,5,1,3
4,2010,110100,12,12,0,1
5,2010,110100,7,7,0,6
6,2010,110100,8,8,0,1
7,2010,110100,5,5,0,2
8,2010,110100,7,6,1,6
9,2010,110100,8,8,0,3
10,2010,110100,8,8,0,2
11,2010,110100,7,7,0,2
12,2010,110100,6,6,0,0
1,2011,110100,6,5,1,1
2,2011,110100,1,1,0,1
1,1999,030701,3,3,0,0
2,1999,030701,1,0,1,2
3,1999,030701,1,1,0,0
4,1999,030701,1,1,0,1
5,1999,030701,4,4,0,0
6,1999,030701,6,5,1,0
7,1999,030701,3,3,0,0
8,1999,030701,7,6,1,0
9,1999,030701,4,3,1,0
10,1999,030701,7,7,0,0
11,1999,030701,4,2,2,1
12,1999,030701,6,6,0,2
1,2000,030701,3,3,0,1
2,2000,030701,3,2,1,3
3,2000,030701,4,3,1,1
4,2000,030701,7,6,1,0
5,2000,030701,3,2,1,1
6,2000,030701,6,4,2,0
7,2000,030701,3,3,0,1
8,2000,030701,4,2,2,2
9,2000,030701,4,3,1,4
10,2000,030701,3,3,0,6
11,2000,030701,1,0,1,6
12,2000,030701,3,2,1,1
1,2001,030701,2,2,0,1
2,2001,030701,1,1,0,1
3,2001,030701,1,1,0,2
4,2001,030701,3,3,0,3
5,2001,030701,1,1,0,2
6,2001,030701,1,1,0,0
7,2001,030701,8,7,1,1
8,2001,030701,3,3,0,0
9,2001,030701,5,5,0,1
10,2001,030701,3,2,1,2
11,2001,030701,3,3,0,2
12,2001,030701,5,5,0,1
1,2002,030701,5,5,0,0
2,2002,030701,3,3,0,2
3,2002,030701,2,1,1,1
4,2002,030701,6,5,1,1
5,2002,030701,1,1,0,1
6,2002,030701,1,0,1,0
7,2002,030701,1,1,0,0
8,2002,030701,1,0,1,1
9,2002,030701,8,8,0,0
10,2002,030701,5,5,0,3
11,2002,030701,3,2,1,4
12,2002,030701,6,5,1,0
1,2003,030701,5,5,0,0
2,2003,030701,3,3,0,2
3,2003,030701,1,1,0,0
4,2003,030701,2,2,0,1
5,2003,030701,1,1,0,2
6,2003,030701,0,0,0,1
7,2003,030701,3,3,0,0
8,2003,030701,4,4,0,0
9,2003,030701,3,2,1,5
10,2003,030701,3,2,1,2
11,2003,030701,2,1,1,0
12,2003,030701,0,0,0,1
1,2004,030701,4,4,0,2
2,2004,030701,2,2,0,4
3,2004,030701,6,6,0,3
4,2004,030701,1,1,0,0
5,2004,030701,2,1,1,2
6,2004,030701,3,2,1,1
7,2004,030701,4,4,0,0
8,2004,030701,4,3,1,0
9,2004,030701,2,2,0,0
10,2004,030701,3,2,1,1
11,2004,030701,2,2,0,2
12,2004,030701,0,0,0,3
1,2005,030701,6,6,0,0
2,2005,030701,1,0,1,1
3,2005,030701,2,2,0,1
4,2005,030701,5,5,0,5
5,2005,030701,1,1,0,6
6,2005,030701,4,4,0,1
7,2005,030701,2,1,1,0
8,2005,030701,5,3,2,0
9,2005,030701,2,2,0,2
10,2005,030701,4,4,0,2
11,2005,030701,2,2,0,1
12,2005,030701,1,1,0,0
1,2006,030701,1,1,0,0
2,2006,030701,4,4,0,0
3,2006,030701,1,1,0,0
4,2006,030701,2,2,0,0
5,2006,030701,4,4,0,0
6,2006,030701,2,2,0,1
7,2006,030701,2,2,0,0
8,2006,030701,1,1,0,2
9,2006,030701,4,3,1,3
10,2006,030701,3,3,0,0
11,2006,030701,4,4,0,0
12,2006,030701,3,3,0,0
1,2007,030701,2,2,0,0
2,2007,030701,6,5,1,0
3,2007,030701,1,1,0,2
4,2007,030701,0,0,0,0
5,2007,030701,0,0,0,1
6,2007,030701,1,1,0,1
7,2007,030701,1,1,0,1
8,2007,030701,1,1,0,0
9,2007,030701,2,2,0,0
10,2007,030701,4,4,0,0
11,2007,030701,5,5,0,1
12,2007,030701,1,1,0,0
1,2008,030701,1,1,0,1
2,2008,030701,2,1,1,0
3,2008,030701,3,3,0,0
4,2008,030701,2,2,0,0
5,2008,030701,8,6,2,0
6,2008,030701,6,6,0,0
7,2008,030701,3,3,0,0
8,2008,030701,3,2,1,0
9,2008,030701,5,5,0,0
10,2008,030701,1,1,0,0
11,2008,030701,7,6,1,0
12,2008,030701,2,1,1,0
1,2009,030701,3,3,0,1
2,2009,030701,1,1,0,0
3,2009,030701,7,7,0,0
4,2009,030701,1,0,1,1
5,2009,030701,1,1,0,0
6,2009,030701,1,1,0,0
7,2009,030701,3,1,2,1
8,2009,030701,5,4,1,0
9,2009,030701,5,5,0,3
10,2009,030701,4,4,0,0
11,2009,030701,4,4,0,0
12,2009,030701,3,2,1,0
1,2010,030701,1,1,0,0
2,2010,030701,0,0,0,0
3,2010,030701,3,2,1,0
4,2010,030701,5,5,0,2
5,2010,030701,2,1,1,0
6,2010,030701,2,2,0,2
7,2010,030701,4,4,0,0
8,2010,030701,1,0,1,1
9,2010,030701,2,2,0,0
10,2010,030701,2,2,0,0
11,2010,030701,2,2,0,0
12,2010,030701,2,2,0,0
1,2011,030701,3,2,1,0
2,2011,030701,0,0,0,0
1,1999,120300,6,4,2,0
2,1999,120300,7,7,0,0
3,1999,120300,6,6,0,0
4,1999,120300,6,6,0,0
5,1999,120300,8,8,0,0
6,1999,120300,9,9,0,0
7,1999,120300,7,7,0,0
8,1999,120300,11,11,0,0
9,1999,120300,8,8,0,0
10,1999,120300,7,7,0,0
11,1999,120300,8,8,0,0
12,1999,120300,11,10,1,0
1,2000,120300,7,7,0,2
2,2000,120300,3,3,0,0
3,2000,120300,8,8,0,1
4,2000,120300,7,6,1,0
5,2000,120300,8,7,1,0
6,2000,120300,11,11,0,1
7,2000,120300,8,8,0,0
8,2000,120300,17,17,0,0
9,2000,120300,7,7,0,2
10,2000,120300,10,10,0,0
11,2000,120300,9,9,0,1
12,2000,120300,5,5,0,0
1,2001,120300,8,8,0,0
2,2001,120300,5,5,0,0
3,2001,120300,7,7,0,0
4,2001,120300,9,9,0,0
5,2001,120300,5,5,0,0
6,2001,120300,14,12,2,0
7,2001,120300,13,12,1,0
8,2001,120300,10,10,0,0
9,2001,120300,11,10,1,0
10,2001,120300,10,10,0,0
11,2001,120300,7,6,1,0
12,2001,120300,12,11,1,0
1,2002,120300,7,6,1,0
2,2002,120300,6,6,0,0
3,2002,120300,10,8,2,3
4,2002,120300,10,8,2,0
5,2002,120300,6,6,0,0
6,2002,120300,11,11,0,0
7,2002,120300,6,5,1,0
8,2002,120300,14,13,1,0
9,2002,120300,10,9,1,2
10,2002,120300,12,12,0,1
11,2002,120300,4,4,0,0
12,2002,120300,5,5,0,0
1,2003,120300,7,7,0,0
2,2003,120300,4,4,0,0
3,2003,120300,3,3,0,0
4,2003,120300,4,4,0,0
5,2003,120300,7,6,1,0
6,2003,120300,7,7,0,0
7,2003,120300,16,16,0,1
8,2003,120300,10,10,0,0
9,2003,120300,9,8,1,0
10,2003,120300,9,9,0,1
11,2003,120300,15,13,2,0
12,2003,120300,13,13,0,0
1,2004,120300,7,5,2,1
2,2004,120300,4,4,0,1
3,2004,120300,10,10,0,0
4,2004,120300,9,9,0,2
5,2004,120300,3,3,0,1
6,2004,120300,5,4,1,2
7,2004,120300,9,9,0,0
8,2004,120300,10,10,0,1
9,2004,120300,8,8,0,2
10,2004,120300,10,7,3,1
11,2004,120300,11,11,0,1
12,2004,120300,9,9,0,0
1,2005,120300,6,6,0,0
2,2005,120300,9,9,0,0
3,2005,120300,10,10,0,0
4,2005,120300,7,7,0,1
5,2005,120300,11,11,0,0
6,2005,120300,22,22,0,0
7,2005,120300,17,17,0,0
8,2005,120300,10,10,0,0
9,2005,120300,8,8,0,0
10,2005,120300,10,9,1,0
11,2005,120300,8,8,0,1
12,2005,120300,9,9,0,1
1,2006,120300,12,12,0,2
2,2006,120300,10,10,0,0
3,2006,120300,6,6,0,0
4,2006,120300,5,5,0,5
5,2006,120300,3,2,1,8
6,2006,120300,14,14,0,8
7,2006,120300,8,8,0,3
8,2006,120300,12,12,0,1
9,2006,120300,12,11,1,1
10,2006,120300,7,7,0,0
11,2006,120300,6,6,0,0
12,2006,120300,13,13,0,2
1,2007,120300,9,9,0,0
2,2007,120300,1,1,0,0
3,2007,120300,8,8,0,1
4,2007,120300,9,8,1,5
5,2007,120300,4,4,0,0
6,2007,120300,6,4,2,2
7,2007,120300,8,8,0,2
8,2007,120300,8,8,0,1
9,2007,120300,7,7,0,0
10,2007,120300,7,7,0,0
11,2007,120300,5,5,0,0
12,2007,120300,5,4,1,0
1,2008,120300,9,9,0,1
2,2008,120300,1,1,0,3
3,2008,120300,5,5,0,2
4,2008,120300,3,3,0,2
5,2008,120300,7,7,0,0
6,2008,120300,10,9,1,0
7,2008,120300,9,8,1,0
8,2008,120300,12,12,0,0
9,2008,120300,4,4,0,0
10,2008,120300,15,15,0,0
11,2008,120300,6,6,0,0
12,2008,120300,4,4,0,0
1,2009,120300,4,4,0,1
2,2009,120300,3,3,0,0
3,2009,120300,10,10,0,1
4,2009,120300,8,8,0,3
5,2009,120300,3,3,0,4
6,2009,120300,14,13,1,5
7,2009,120300,7,7,0,2
8,2009,120300,7,6,1,2
9,2009,120300,7,6,1,0
10,2009,120300,9,9,0,1
11,2009,120300,15,14,1,1
12,2009,120300,8,8,0,1
1,2010,120300,12,11,1,1
2,2010,120300,10,10,0,0
3,2010,120300,5,4,1,3
4,2010,120300,6,6,0,1
5,2010,120300,9,8,1,1
6,2010,120300,10,10,0,0
7,2010,120300,13,13,0,0
8,2010,120300,17,16,1,0
9,2010,120300,3,3,0,2
10,2010,120300,6,6,0,1
11,2010,120300,10,9,1,0
12,2010,120300,9,9,0,0
1,2011,120300,7,7,0,0
2,2011,120300,5,4,1,0
1,1999,100300,10,10,0,0
2,1999,100300,10,9,1,0
3,1999,100300,9,9,0,3
4,1999,100300,10,9,1,2
5,1999,100300,6,6,0,1
6,1999,100300,9,8,1,1
7,1999,100300,15,15,0,1
8,1999,100300,6,4,2,2
9,1999,100300,10,8,2,4
10,1999,100300,8,7,1,1
11,1999,100300,7,7,0,7
12,1999,100300,7,6,1,4
1,2000,100300,12,10,2,1
2,2000,100300,14,9,5,4
3,2000,100300,12,12,0,2
4,2000,100300,8,6,2,1
5,2000,100300,10,7,3,4
6,2000,100300,16,14,2,0
7,2000,100300,8,7,1,0
8,2000,100300,8,7,1,0
9,2000,100300,5,4,1,3
10,2000,100300,11,9,2,4
11,2000,100300,8,6,2,2
12,2000,100300,4,4,0,3
1,2001,100300,2,2,0,1
2,2001,100300,6,6,0,2
3,2001,100300,6,6,0,7
4,2001,100300,7,7,0,1
5,2001,100300,12,11,1,1
6,2001,100300,5,4,1,1
7,2001,100300,13,13,0,0
8,2001,100300,13,11,2,0
9,2001,100300,16,15,1,0
10,2001,100300,11,11,0,2
11,2001,100300,10,10,0,8
12,2001,100300,14,14,0,7
1,2002,100300,3,3,0,1
2,2002,100300,0,0,0,2
3,2002,100300,5,5,0,5
4,2002,100300,5,4,1,0
5,2002,100300,10,9,1,2
6,2002,100300,8,7,1,0
7,2002,100300,4,4,0,0
8,2002,100300,9,9,0,0
9,2002,100300,10,10,0,2
10,2002,100300,15,14,1,3
11,2002,100300,8,8,0,3
12,2002,100300,11,11,0,2
1,2003,100300,8,6,2,0
2,2003,100300,6,6,0,1
3,2003,100300,9,9,0,0
4,2003,100300,9,9,0,0
5,2003,100300,8,7,1,0
6,2003,100300,8,8,0,0
7,2003,100300,10,10,0,0
8,2003,100300,5,5,0,0
9,2003,100300,6,6,0,0
10,2003,100300,10,9,1,0
11,2003,100300,7,6,1,0
12,2003,100300,9,9,0,0
1,2004,100300,3,3,0,0
2,2004,100300,3,3,0,0
3,2004,100300,3,3,0,1
4,2004,100300,7,6,1,0
5,2004,100300,12,12,0,3
6,2004,100300,8,8,0,0
7,2004,100300,9,9,0,0
8,2004,100300,7,7,0,0
9,2004,100300,5,5,0,0
10,2004,100300,8,8,0,2
11,2004,100300,2,2,0,0
12,2004,100300,10,10,0,1
1,2005,100300,4,3,1,2
2,2005,100300,10,5,5,2
3,2005,100300,6,6,0,2
4,2005,100300,6,6,0,1
5,2005,100300,6,5,1,0
6,2005,100300,4,4,0,0
7,2005,100300,11,9,2,0
8,2005,100300,8,8,0,0
9,2005,100300,6,6,0,0
10,2005,100300,15,13,2,0
11,2005,100300,8,7,1,0
12,2005,100300,6,6,0,1
1,2006,100300,5,5,0,1
2,2006,100300,3,3,0,1
3,2006,100300,5,5,0,0
4,2006,100300,5,5,0,0
5,2006,100300,12,11,1,1
6,2006,100300,8,8,0,0
7,2006,100300,5,4,1,0
8,2006,100300,6,6,0,0
9,2006,100300,3,2,1,0
10,2006,100300,12,12,0,0
11,2006,100300,5,5,0,1
12,2006,100300,4,3,1,0
1,2007,100300,4,3,1,0
2,2007,100300,2,2,0,0
3,2007,100300,8,8,0,0
4,2007,100300,7,7,0,0
5,2007,100300,7,7,0,1
6,2007,100300,7,7,0,0
7,2007,100300,20,20,0,0
8,2007,100300,9,9,0,0
9,2007,100300,7,7,0,1
10,2007,100300,3,3,0,0
11,2007,100300,6,6,0,4
12,2007,100300,6,6,0,0
1,2008,100300,8,8,0,1
2,2008,100300,7,7,0,1
3,2008,100300,2,2,0,5
4,2008,100300,7,6,1,0
5,2008,100300,7,6,1,0
6,2008,100300,9,8,1,0
7,2008,100300,7,6,1,2
8,2008,100300,11,11,0,0
9,2008,100300,6,6,0,0
10,2008,100300,16,15,1,0
11,2008,100300,7,7,0,0
12,2008,100300,3,3,0,0
1,2009,100300,6,6,0,0
2,2009,100300,9,9,0,3
3,2009,100300,7,7,0,0
4,2009,100300,7,7,0,0
5,2009,100300,9,9,0,1
6,2009,100300,6,6,0,0
7,2009,100300,4,4,0,0
8,2009,100300,8,8,0,0
9,2009,100300,1,1,0,0
10,2009,100300,18,18,0,0
11,2009,100300,8,8,0,2
12,2009,100300,12,12,0,0
1,2010,100300,6,6,0,0
2,2010,100300,5,5,0,1
3,2010,100300,5,4,1,0
4,2010,100300,3,3,0,0
5,2010,100300,7,7,0,0
6,2010,100300,12,12,0,0
7,2010,100300,4,4,0,0
8,2010,100300,5,5,0,0
9,2010,100300,4,4,0,0
10,2010,100300,5,5,0,0
11,2010,100300,10,10,0,1
12,2010,100300,4,3,1,0
1,2011,100300,4,4,0,0
2,2011,100300,5,5,0,0
1,1999,100100,13,13,0,0
2,1999,100100,11,11,0,0
3,1999,100100,16,14,2,0
4,1999,100100,14,13,1,0
5,1999,100100,12,12,0,0
6,1999,100100,14,14,0,0
7,1999,100100,12,12,0,1
8,1999,100100,17,17,0,0
9,1999,100100,13,12,1,2
10,1999,100100,11,11,0,4
11,1999,100100,13,13,0,0
12,1999,100100,15,15,0,0
1,2000,100100,10,10,0,0
2,2000,100100,20,19,1,1
3,2000,100100,11,10,1,2
4,2000,100100,12,12,0,1
5,2000,100100,15,14,1,0
6,2000,100100,16,15,1,1
7,2000,100100,17,15,2,1
8,2000,100100,22,21,1,0
9,2000,100100,17,16,1,1
10,2000,100100,13,12,1,0
11,2000,100100,16,15,1,1
12,2000,100100,12,11,1,0
1,2001,100100,11,10,1,0
2,2001,100100,11,10,1,0
3,2001,100100,10,10,0,1
4,2001,100100,9,8,1,0
5,2001,100100,13,13,0,3
6,2001,100100,12,12,0,1
7,2001,100100,16,13,3,3
8,2001,100100,17,15,2,0
9,2001,100100,13,12,1,0
10,2001,100100,7,7,0,0
11,2001,100100,10,9,1,0
12,2001,100100,13,13,0,1
1,2002,100100,9,8,1,3
2,2002,100100,17,16,1,2
3,2002,100100,13,13,0,1
4,2002,100100,8,7,1,0
5,2002,100100,7,6,1,0
6,2002,100100,13,12,1,0
7,2002,100100,15,15,0,2
8,2002,100100,10,10,0,0
9,2002,100100,13,12,1,0
10,2002,100100,9,9,0,0
11,2002,100100,15,14,1,0
12,2002,100100,16,15,1,0
1,2003,100100,13,13,0,1
2,2003,100100,12,12,0,1
3,2003,100100,3,3,0,0
4,2003,100100,7,7,0,1
5,2003,100100,9,8,1,1
6,2003,100100,13,12,1,0
7,2003,100100,18,16,2,0
8,2003,100100,14,13,1,0
9,2003,100100,11,11,0,1
10,2003,100100,10,10,0,1
11,2003,100100,6,5,1,0
12,2003,100100,8,8,0,0
1,2004,100100,13,12,1,2
2,2004,100100,10,10,0,2
3,2004,100100,11,11,0,1
4,2004,100100,17,16,1,1
5,2004,100100,12,11,1,1
6,2004,100100,13,12,1,1
7,2004,100100,15,15,0,0
8,2004,100100,14,14,0,1
9,2004,100100,11,11,0,0
10,2004,100100,11,11,0,1
11,2004,100100,8,8,0,0
12,2004,100100,14,13,1,0
1,2005,100100,7,7,0,0
2,2005,100100,9,9,0,0
3,2005,100100,9,8,1,1
4,2005,100100,9,9,0,1
5,2005,100100,5,5,0,0
6,2005,100100,14,13,1,0
7,2005,100100,7,7,0,0
8,2005,100100,11,10,1,0
9,2005,100100,3,3,0,0
10,2005,100100,7,7,0,1
11,2005,100100,6,6,0,0
12,2005,100100,2,2,0,1
1,2006,100100,8,7,1,0
2,2006,100100,13,13,0,0
3,2006,100100,7,6,1,0
4,2006,100100,5,5,0,0
5,2006,100100,10,10,0,0
6,2006,100100,8,8,0,1
7,2006,100100,17,15,2,0
8,2006,100100,9,8,1,0
9,2006,100100,13,9,4,0
10,2006,100100,11,9,2,0
11,2006,100100,5,5,0,0
12,2006,100100,8,8,0,0
1,2007,100100,10,10,0,0
2,2007,100100,10,10,0,1
3,2007,100100,5,5,0,1
4,2007,100100,3,3,0,0
5,2007,100100,9,9,0,0
6,2007,100100,10,10,0,0
7,2007,100100,12,10,2,0
8,2007,100100,14,14,0,0
9,2007,100100,14,14,0,0
10,2007,100100,9,9,0,0
11,2007,100100,7,7,0,1
12,2007,100100,8,7,1,0
1,2008,100100,8,8,0,0
2,2008,100100,7,7,0,1
3,2008,100100,17,17,0,0
4,2008,100100,12,10,2,0
5,2008,100100,11,9,2,0
6,2008,100100,12,12,0,0
7,2008,100100,12,11,1,0
8,2008,100100,8,8,0,0
9,2008,100100,7,6,1,1
10,2008,100100,6,6,0,1
11,2008,100100,15,15,0,0
12,2008,100100,10,10,0,1
1,2009,100100,4,4,0,1
2,2009,100100,6,5,1,3
3,2009,100100,12,11,1,2
4,2009,100100,15,15,0,0
5,2009,100100,9,9,0,3
6,2009,100100,12,11,1,1
7,2009,100100,9,8,1,0
8,2009,100100,4,4,0,0
9,2009,100100,10,9,1,1
10,2009,100100,9,9,0,2
11,2009,100100,11,11,0,1
12,2009,100100,5,5,0,0
1,2010,100100,3,3,0,1
2,2010,100100,2,2,0,1
3,2010,100100,15,14,1,1
4,2010,100100,11,11,0,0
5,2010,100100,16,15,1,1
6,2010,100100,9,8,1,1
7,2010,100100,5,4,1,1
8,2010,100100,2,2,0,0
9,2010,100100,9,8,1,0
10,2010,100100,12,9,3,1
11,2010,100100,8,6,2,1
12,2010,100100,8,8,0,0
1,2011,100100,8,7,1,0
2,2011,100100,7,7,0,1
1,1999,130300,9,7,2,2
2,1999,130300,10,10,0,3
3,1999,130300,9,8,1,0
4,1999,130300,7,7,0,0
5,1999,130300,18,16,2,1
6,1999,130300,22,21,1,0
7,1999,130300,15,14,1,2
8,1999,130300,11,8,3,0
9,1999,130300,16,15,1,1
10,1999,130300,15,14,1,3
11,1999,130300,11,10,1,0
12,1999,130300,7,7,0,0
1,2000,130300,15,15,0,2
2,2000,130300,10,9,1,1
3,2000,130300,13,13,0,0
4,2000,130300,12,12,0,0
5,2000,130300,15,13,2,2
6,2000,130300,12,11,1,0
7,2000,130300,11,10,1,0
8,2000,130300,21,20,1,1
9,2000,130300,18,16,2,1
10,2000,130300,12,12,0,0
11,2000,130300,16,15,1,0
12,2000,130300,8,7,1,1
1,2001,130300,9,8,1,0
2,2001,130300,9,8,1,0
3,2001,130300,10,10,0,0
4,2001,130300,9,9,0,1
5,2001,130300,8,8,0,1
6,2001,130300,12,12,0,0
7,2001,130300,11,11,0,0
8,2001,130300,10,9,1,1
9,2001,130300,13,10,3,2
10,2001,130300,9,9,0,0
11,2001,130300,5,5,0,0
12,2001,130300,10,10,0,1
1,2002,130300,10,10,0,1
2,2002,130300,13,12,1,1
3,2002,130300,14,14,0,1
4,2002,130300,13,13,0,0
5,2002,130300,12,11,1,1
6,2002,130300,8,7,1,0
7,2002,130300,11,11,0,0
8,2002,130300,20,18,2,0
9,2002,130300,8,8,0,0
10,2002,130300,17,16,1,0
11,2002,130300,12,11,1,2
12,2002,130300,8,8,0,2
1,2003,130300,8,8,0,2
2,2003,130300,7,7,0,0
3,2003,130300,12,11,1,4
4,2003,130300,6,5,1,1
5,2003,130300,9,7,2,3
6,2003,130300,12,12,0,3
7,2003,130300,10,10,0,6
8,2003,130300,8,8,0,2
9,2003,130300,11,11,0,1
10,2003,130300,8,7,1,1
11,2003,130300,10,9,1,4
12,2003,130300,6,6,0,0
1,2004,130300,16,16,0,3
2,2004,130300,5,4,1,0
3,2004,130300,10,10,0,0
4,2004,130300,12,11,1,0
5,2004,130300,11,10,1,0
6,2004,130300,13,13,0,2
7,2004,130300,21,21,0,1
8,2004,130300,10,10,0,1
9,2004,130300,16,16,0,0
10,2004,130300,12,11,1,0
11,2004,130300,10,10,0,0
12,2004,130300,12,11,1,0
1,2005,130300,5,4,1,0
2,2005,130300,15,15,0,1
3,2005,130300,16,15,1,0
4,2005,130300,13,13,0,0
5,2005,130300,14,14,0,1
6,2005,130300,12,11,1,3
7,2005,130300,21,20,1,0
8,2005,130300,9,8,1,1
9,2005,130300,24,24,0,0
10,2005,130300,19,19,0,1
11,2005,130300,9,9,0,1
12,2005,130300,9,8,1,4
1,2006,130300,7,7,0,1
2,2006,130300,10,9,1,1
3,2006,130300,18,18,0,1
4,2006,130300,9,8,1,1
5,2006,130300,7,7,0,0
6,2006,130300,13,13,0,0
7,2006,130300,9,7,2,1
8,2006,130300,16,16,0,2
9,2006,130300,5,5,0,1
10,2006,130300,11,11,0,6
11,2006,130300,12,9,3,0
12,2006,130300,16,14,2,1
1,2007,130300,5,5,0,2
2,2007,130300,7,6,1,1
3,2007,130300,11,10,1,2
4,2007,130300,7,5,2,0
5,2007,130300,12,9,3,0
6,2007,130300,15,15,0,3
7,2007,130300,11,11,0,1
8,2007,130300,11,11,0,2
9,2007,130300,10,9,1,0
10,2007,130300,16,16,0,0
11,2007,130300,33,33,0,3
12,2007,130300,16,15,1,1
1,2008,130300,9,9,0,1
2,2008,130300,9,8,1,1
3,2008,130300,9,8,1,0
4,2008,130300,12,10,2,1
5,2008,130300,16,15,1,2
6,2008,130300,17,16,1,1
7,2008,130300,13,13,0,0
8,2008,130300,9,9,0,3
9,2008,130300,14,12,2,2
10,2008,130300,12,11,1,2
11,2008,130300,8,7,1,0
12,2008,130300,9,8,1,0
1,2009,130300,7,7,0,3
2,2009,130300,10,10,0,2
3,2009,130300,23,23,0,0
4,2009,130300,11,11,0,0
5,2009,130300,11,10,1,1
6,2009,130300,6,6,0,0
7,2009,130300,10,10,0,1
8,2009,130300,13,13,0,0
9,2009,130300,9,9,0,1
10,2009,130300,10,9,1,0
11,2009,130300,12,11,1,3
12,2009,130300,10,10,0,1
1,2010,130300,9,9,0,1
2,2010,130300,11,10,1,1
3,2010,130300,4,4,0,2
4,2010,130300,9,7,2,1
5,2010,130300,9,8,1,0
6,2010,130300,15,15,0,0
7,2010,130300,11,10,1,2
8,2010,130300,13,13,0,0
9,2010,130300,10,9,1,0
10,2010,130300,15,15,0,4
11,2010,130300,12,12,0,0
12,2010,130300,4,4,0,0
1,2011,130300,11,11,0,0
2,2011,130300,3,3,0,0
1,1999,130100,13,13,0,0
2,1999,130100,7,7,0,1
3,1999,130100,13,12,1,1
4,1999,130100,11,11,0,3
5,1999,130100,18,18,0,2
6,1999,130100,16,14,2,2
7,1999,130100,16,16,0,3
8,1999,130100,12,11,1,2
9,1999,130100,11,10,1,1
10,1999,130100,10,10,0,0
11,1999,130100,8,8,0,1
12,1999,130100,13,13,0,0
1,2000,130100,9,9,0,1
2,2000,130100,13,13,0,1
3,2000,130100,15,15,0,3
4,2000,130100,15,15,0,3
5,2000,130100,21,20,1,0
6,2000,130100,14,13,1,1
7,2000,130100,9,9,0,2
8,2000,130100,6,6,0,0
9,2000,130100,16,15,1,3
10,2000,130100,15,15,0,4
11,2000,130100,13,13,0,2
12,2000,130100,12,11,1,0
1,2001,130100,8,7,1,4
2,2001,130100,7,7,0,0
3,2001,130100,8,8,0,2
4,2001,130100,12,10,2,3
5,2001,130100,15,15,0,2
6,2001,130100,26,26,0,2
7,2001,130100,18,18,0,2
8,2001,130100,10,10,0,1
9,2001,130100,13,12,1,1
10,2001,130100,11,9,2,0
11,2001,130100,17,16,1,1
12,2001,130100,18,17,1,0
1,2002,130100,11,9,2,2
2,2002,130100,12,10,2,0
3,2002,130100,11,11,0,1
4,2002,130100,15,15,0,1
5,2002,130100,12,11,1,1
6,2002,130100,8,8,0,0
7,2002,130100,15,14,1,1
8,2002,130100,11,10,1,2
9,2002,130100,11,8,3,4
10,2002,130100,13,12,1,0
11,2002,130100,9,9,0,0
12,2002,130100,6,6,0,2
1,2003,130100,10,10,0,7
2,2003,130100,4,4,0,1
3,2003,130100,8,8,0,0
4,2003,130100,6,6,0,2
5,2003,130100,12,10,2,2
6,2003,130100,12,11,1,1
7,2003,130100,16,15,1,1
8,2003,130100,12,11,1,3
9,2003,130100,16,16,0,0
10,2003,130100,11,7,4,0
11,2003,130100,7,4,3,4
12,2003,130100,10,10,0,1
1,2004,130100,11,10,1,0
2,2004,130100,9,9,0,1
3,2004,130100,16,16,0,2
4,2004,130100,12,12,0,2
5,2004,130100,10,10,0,2
6,2004,130100,8,8,0,1
7,2004,130100,10,9,1,0
8,2004,130100,17,17,0,1
9,2004,130100,8,7,1,1
10,2004,130100,15,15,0,1
11,2004,130100,9,9,0,3
12,2004,130100,7,7,0,0
1,2005,130100,11,10,1,4
2,2005,130100,3,2,1,3
3,2005,130100,5,5,0,5
4,2005,130100,9,9,0,1
5,2005,130100,20,20,0,2
6,2005,130100,14,14,0,3
7,2005,130100,11,11,0,2
8,2005,130100,10,10,0,3
9,2005,130100,20,20,0,2
10,2005,130100,9,8,1,5
11,2005,130100,7,7,0,3
12,2005,130100,8,8,0,2
1,2006,130100,6,6,0,5
2,2006,130100,9,7,2,0
3,2006,130100,6,6,0,1
4,2006,130100,4,4,0,0
5,2006,130100,7,7,0,1
6,2006,130100,12,10,2,1
7,2006,130100,10,10,0,4
8,2006,130100,8,8,0,1
9,2006,130100,11,11,0,2
10,2006,130100,6,6,0,2
11,2006,130100,9,8,1,2
12,2006,130100,14,14,0,1
1,2007,130100,4,4,0,0
2,2007,130100,3,2,1,3
3,2007,130100,4,4,0,0
4,2007,130100,10,9,1,2
5,2007,130100,10,9,1,0
6,2007,130100,7,6,1,0
7,2007,130100,11,11,0,0
8,2007,130100,9,9,0,2
9,2007,130100,4,4,0,3
10,2007,130100,7,6,1,1
11,2007,130100,15,15,0,1
12,2007,130100,12,11,1,3
1,2008,130100,5,5,0,2
2,2008,130100,5,5,0,1
3,2008,130100,10,9,1,1
4,2008,130100,7,7,0,0
5,2008,130100,7,5,2,0
6,2008,130100,8,6,2,1
7,2008,130100,10,9,1,1
8,2008,130100,10,10,0,0
9,2008,130100,8,8,0,1
10,2008,130100,13,12,1,0
11,2008,130100,9,8,1,1
12,2008,130100,10,10,0,1
1,2009,130100,8,8,0,2
2,2009,130100,7,7,0,2
3,2009,130100,13,13,0,2
4,2009,130100,6,5,1,2
5,2009,130100,7,7,0,2
6,2009,130100,4,4,0,0
7,2009,130100,4,3,1,0
8,2009,130100,2,2,0,1
9,2009,130100,6,6,0,1
10,2009,130100,12,12,0,0
11,2009,130100,5,5,0,0
12,2009,130100,13,13,0,0
1,2010,130100,2,2,0,0
2,2010,130100,4,4,0,0
3,2010,130100,4,4,0,0
4,2010,130100,10,10,0,0
5,2010,130100,4,4,0,3
6,2010,130100,7,7,0,1
7,2010,130100,13,11,2,0
8,2010,130100,12,12,0,0
9,2010,130100,13,11,2,0
10,2010,130100,9,9,0,0
11,2010,130100,3,3,0,1
12,2010,130100,9,9,0,0
1,2011,130100,4,3,1,0
2,2011,130100,2,2,0,1
1,1999,100400,1,1,0,0
2,1999,100400,2,1,1,0
3,1999,100400,2,2,0,0
4,1999,100400,2,2,0,0
5,1999,100400,2,2,0,0
6,1999,100400,3,3,0,0
7,1999,100400,1,1,0,0
8,1999,100400,0,0,0,0
9,1999,100400,1,1,0,0
10,1999,100400,3,3,0,0
11,1999,100400,0,0,0,0
12,1999,100400,3,3,0,0
1,2000,100400,2,2,0,0
2,2000,100400,2,1,1,0
3,2000,100400,2,2,0,0
4,2000,100400,5,5,0,0
5,2000,100400,0,0,0,0
6,2000,100400,2,1,1,0
7,2000,100400,2,2,0,0
8,2000,100400,1,1,0,0
9,2000,100400,0,0,0,0
10,2000,100400,5,4,1,0
11,2000,100400,4,4,0,0
12,2000,100400,1,1,0,0
1,2001,100400,2,2,0,0
2,2001,100400,1,0,1,0
3,2001,100400,1,1,0,0
4,2001,100400,2,2,0,0
5,2001,100400,1,1,0,0
6,2001,100400,1,1,0,0
7,2001,100400,2,2,0,0
8,2001,100400,0,0,0,0
9,2001,100400,2,2,0,0
10,2001,100400,3,3,0,0
11,2001,100400,2,2,0,0
12,2001,100400,2,2,0,0
1,2002,100400,5,4,1,0
2,2002,100400,1,1,0,0
3,2002,100400,0,0,0,1
4,2002,100400,1,1,0,0
5,2002,100400,0,0,0,0
6,2002,100400,6,6,0,0
7,2002,100400,2,2,0,0
8,2002,100400,2,2,0,0
9,2002,100400,7,7,0,0
10,2002,100400,3,3,0,0
11,2002,100400,5,5,0,0
12,2002,100400,3,3,0,0
1,2003,100400,8,8,0,0
2,2003,100400,2,2,0,0
3,2003,100400,4,4,0,0
4,2003,100400,1,1,0,0
5,2003,100400,2,2,0,0
6,2003,100400,3,3,0,0
7,2003,100400,6,6,0,0
8,2003,100400,2,2,0,0
9,2003,100400,0,0,0,0
10,2003,100400,1,1,0,0
11,2003,100400,0,0,0,2
12,2003,100400,1,1,0,0
1,2004,100400,0,0,0,0
2,2004,100400,0,0,0,0
3,2004,100400,0,0,0,0
4,2004,100400,1,1,0,1
5,2004,100400,5,5,0,0
6,2004,100400,3,3,0,0
7,2004,100400,1,1,0,0
8,2004,100400,4,3,1,0
9,2004,100400,3,3,0,0
10,2004,100400,1,1,0,0
11,2004,100400,2,2,0,0
12,2004,100400,4,4,0,0
1,2005,100400,4,4,0,0
2,2005,100400,1,1,0,0
3,2005,100400,4,4,0,0
4,2005,100400,2,2,0,0
5,2005,100400,0,0,0,0
6,2005,100400,5,5,0,0
7,2005,100400,0,0,0,0
8,2005,100400,6,6,0,0
9,2005,100400,0,0,0,0
10,2005,100400,3,3,0,0
11,2005,100400,2,2,0,0
12,2005,100400,2,2,0,0
1,2006,100400,2,2,0,0
2,2006,100400,1,1,0,0
3,2006,100400,1,1,0,0
4,2006,100400,4,4,0,0
5,2006,100400,1,1,0,0
6,2006,100400,4,4,0,0
7,2006,100400,1,0,1,0
8,2006,100400,2,2,0,0
9,2006,100400,2,2,0,0
10,2006,100400,3,3,0,0
11,2006,100400,2,2,0,0
12,2006,100400,2,2,0,0
1,2007,100400,2,2,0,0
2,2007,100400,0,0,0,0
3,2007,100400,0,0,0,0
4,2007,100400,2,2,0,0
5,2007,100400,1,1,0,0
6,2007,100400,1,1,0,0
7,2007,100400,2,2,0,0
8,2007,100400,0,0,0,0
9,2007,100400,0,0,0,0
10,2007,100400,1,0,1,0
11,2007,100400,1,1,0,0
12,2007,100400,3,3,0,0
1,2008,100400,0,0,0,0
2,2008,100400,3,3,0,0
3,2008,100400,2,2,0,0
4,2008,100400,3,3,0,0
5,2008,100400,3,3,0,0
6,2008,100400,2,2,0,1
7,2008,100400,2,2,0,0
8,2008,100400,1,1,0,0
9,2008,100400,1,1,0,0
10,2008,100400,0,0,0,0
11,2008,100400,3,3,0,0
12,2008,100400,2,2,0,0
1,2009,100400,1,0,1,0
2,2009,100400,0,0,0,0
3,2009,100400,0,0,0,0
4,2009,100400,0,0,0,0
5,2009,100400,1,1,0,0
6,2009,100400,0,0,0,0
7,2009,100400,4,4,0,0
8,2009,100400,2,2,0,0
9,2009,100400,1,1,0,0
10,2009,100400,1,1,0,0
11,2009,100400,4,4,0,0
12,2009,100400,1,1,0,0
1,2010,100400,2,2,0,0
2,2010,100400,1,1,0,0
3,2010,100400,2,2,0,0
4,2010,100400,1,1,0,0
5,2010,100400,1,1,0,0
6,2010,100400,3,3,0,0
7,2010,100400,0,0,0,1
8,2010,100400,2,2,0,0
9,2010,100400,1,1,0,0
10,2010,100400,1,1,0,0
11,2010,100400,0,0,0,0
12,2010,100400,1,1,0,0
1,2011,100400,2,2,0,0
2,2011,100400,1,1,0,0
1,1999,020701,2,2,0,0
2,1999,020701,2,1,1,1
3,1999,020701,3,3,0,0
4,1999,020701,3,3,0,0
5,1999,020701,7,7,0,4
6,1999,020701,5,5,0,0
7,1999,020701,7,6,1,0
8,1999,020701,4,4,0,1
9,1999,020701,4,4,0,1
10,1999,020701,8,8,0,0
11,1999,020701,4,4,0,0
12,1999,020701,5,5,0,0
1,2000,020701,7,6,1,1
2,2000,020701,6,5,1,0
3,2000,020701,9,8,1,1
4,2000,020701,2,1,1,4
5,2000,020701,1,1,0,0
6,2000,020701,6,5,1,1
7,2000,020701,4,4,0,1
8,2000,020701,3,3,0,1
9,2000,020701,5,5,0,1
10,2000,020701,4,4,0,1
11,2000,020701,2,2,0,0
12,2000,020701,1,1,0,0
1,2001,020701,0,0,0,0
2,2001,020701,2,2,0,0
3,2001,020701,1,1,0,0
4,2001,020701,3,3,0,0
5,2001,020701,7,7,0,0
6,2001,020701,4,3,1,0
7,2001,020701,6,6,0,2
8,2001,020701,5,5,0,0
9,2001,020701,7,7,0,0
10,2001,020701,1,1,0,0
11,2001,020701,4,2,2,2
12,2001,020701,1,1,0,1
1,2002,020701,6,5,1,1
2,2002,020701,9,8,1,1
3,2002,020701,3,2,1,1
4,2002,020701,4,4,0,0
5,2002,020701,5,4,1,1
6,2002,020701,4,4,0,2
7,2002,020701,7,7,0,0
8,2002,020701,8,8,0,0
9,2002,020701,5,5,0,1
10,2002,020701,9,8,1,0
11,2002,020701,3,2,1,0
12,2002,020701,10,10,0,0
1,2003,020701,2,2,0,1
2,2003,020701,2,2,0,0
3,2003,020701,2,1,1,0
4,2003,020701,2,1,1,0
5,2003,020701,3,3,0,0
6,2003,020701,7,7,0,1
7,2003,020701,3,2,1,3
8,2003,020701,3,3,0,2
9,2003,020701,5,4,1,2
10,2003,020701,9,7,2,0
11,2003,020701,2,2,0,0
12,2003,020701,3,2,1,0
1,2004,020701,3,3,0,1
2,2004,020701,3,3,0,1
3,2004,020701,0,0,0,0
4,2004,020701,1,1,0,0
5,2004,020701,4,4,0,1
6,2004,020701,2,1,1,0
7,2004,020701,5,4,1,0
8,2004,020701,2,2,0,0
9,2004,020701,2,2,0,0
10,2004,020701,10,8,2,3
11,2004,020701,7,7,0,0
12,2004,020701,3,3,0,2
1,2005,020701,2,2,0,2
2,2005,020701,3,3,0,1
3,2005,020701,7,6,1,0
4,2005,020701,6,4,2,0
5,2005,020701,4,4,0,1
6,2005,020701,6,6,0,0
7,2005,020701,1,1,0,0
8,2005,020701,7,6,1,1
9,2005,020701,12,12,0,2
10,2005,020701,4,4,0,4
11,2005,020701,9,7,2,1
12,2005,020701,4,4,0,2
1,2006,020701,4,4,0,1
2,2006,020701,5,5,0,2
3,2006,020701,4,4,0,1
4,2006,020701,4,4,0,3
5,2006,020701,5,4,1,2
6,2006,020701,1,1,0,0
7,2006,020701,3,3,0,0
8,2006,020701,4,3,1,1
9,2006,020701,5,5,0,1
10,2006,020701,4,4,0,1
11,2006,020701,2,1,1,2
12,2006,020701,2,2,0,0
1,2007,020701,2,2,0,7
2,2007,020701,3,3,0,1
3,2007,020701,2,1,1,3
4,2007,020701,6,6,0,2
5,2007,020701,2,2,0,3
6,2007,020701,3,3,0,0
7,2007,020701,5,5,0,3
8,2007,020701,4,4,0,2
9,2007,020701,4,4,0,7
10,2007,020701,2,2,0,4
11,2007,020701,9,9,0,2
12,2007,020701,4,3,1,0
1,2008,020701,3,3,0,0
2,2008,020701,2,2,0,0
3,2008,020701,4,4,0,0
4,2008,020701,6,6,0,3
5,2008,020701,2,2,0,0
6,2008,020701,4,4,0,0
7,2008,020701,4,4,0,0
8,2008,020701,1,1,0,0
9,2008,020701,3,2,1,1
10,2008,020701,4,4,0,0
11,2008,020701,5,5,0,0
12,2008,020701,3,3,0,1
1,2009,020701,2,2,0,0
2,2009,020701,3,3,0,0
3,2009,020701,6,6,0,1
4,2009,020701,6,6,0,1
5,2009,020701,5,5,0,2
6,2009,020701,2,2,0,1
7,2009,020701,2,2,0,0
8,2009,020701,3,3,0,0
9,2009,020701,4,4,0,0
10,2009,020701,0,0,0,0
11,2009,020701,4,4,0,0
12,2009,020701,4,4,0,0
1,2010,020701,3,3,0,0
2,2010,020701,1,1,0,1
3,2010,020701,1,0,1,0
4,2010,020701,3,3,0,0
5,2010,020701,2,2,0,2
6,2010,020701,4,4,0,0
7,2010,020701,3,3,0,0
8,2010,020701,6,6,0,1
9,2010,020701,3,3,0,0
10,2010,020701,2,2,0,3
11,2010,020701,3,3,0,0
12,2010,020701,1,1,0,0
1,2011,020701,3,3,0,1
2,2011,020701,0,0,0,0
1,1999,020801,17,14,3,0
2,1999,020801,9,8,1,1
3,1999,020801,5,3,2,2
4,1999,020801,20,19,1,0
5,1999,020801,14,13,1,1
6,1999,020801,10,9,1,1
7,1999,020801,17,15,2,0
8,1999,020801,14,14,0,0
9,1999,020801,25,24,1,0
10,1999,020801,22,19,3,0
11,1999,020801,10,9,1,1
12,1999,020801,13,12,1,1
1,2000,020801,12,12,0,1
2,2000,020801,10,10,0,0
3,2000,020801,15,15,0,3
4,2000,020801,20,20,0,1
5,2000,020801,33,32,1,2
6,2000,020801,21,19,2,3
7,2000,020801,27,25,2,2
8,2000,020801,17,17,0,1
9,2000,020801,19,15,4,2
10,2000,020801,9,8,1,1
11,2000,020801,10,10,0,0
12,2000,020801,14,14,0,0
1,2001,020801,7,7,0,0
2,2001,020801,17,16,1,4
3,2001,020801,29,28,1,0
4,2001,020801,11,10,1,0
5,2001,020801,21,18,3,4
6,2001,020801,21,20,1,2
7,2001,020801,10,10,0,0
8,2001,020801,6,6,0,2
9,2001,020801,15,14,1,0
10,2001,020801,9,9,0,1
11,2001,020801,17,16,1,0
12,2001,020801,15,15,0,0
1,2002,020801,7,7,0,3
2,2002,020801,6,6,0,1
3,2002,020801,15,15,0,0
4,2002,020801,21,19,2,0
5,2002,020801,12,11,1,1
6,2002,020801,17,15,2,3
7,2002,020801,19,18,1,1
8,2002,020801,16,15,1,1
9,2002,020801,17,16,1,1
10,2002,020801,6,6,0,5
11,2002,020801,11,11,0,1
12,2002,020801,15,15,0,0
1,2003,020801,12,12,0,4
2,2003,020801,13,13,0,2
3,2003,020801,18,16,2,1
4,2003,020801,11,8,3,1
5,2003,020801,13,11,2,2
6,2003,020801,10,8,2,1
7,2003,020801,11,11,0,0
8,2003,020801,9,9,0,0
9,2003,020801,11,11,0,0
10,2003,020801,13,12,1,0
11,2003,020801,9,8,1,2
12,2003,020801,16,15,1,0
1,2004,020801,8,8,0,0
2,2004,020801,9,9,0,0
3,2004,020801,10,7,3,2
4,2004,020801,13,13,0,2
5,2004,020801,11,10,1,0
6,2004,020801,15,15,0,0
7,2004,020801,14,13,1,1
8,2004,020801,17,17,0,0
9,2004,020801,18,18,0,0
10,2004,020801,20,19,1,3
11,2004,020801,27,25,2,2
12,2004,020801,17,17,0,0
1,2005,020801,12,12,0,2
2,2005,020801,8,7,1,3
3,2005,020801,8,7,1,3
4,2005,020801,18,16,2,1
5,2005,020801,17,17,0,3
6,2005,020801,25,24,1,2
7,2005,020801,12,12,0,2
8,2005,020801,13,13,0,1
9,2005,020801,18,18,0,0
10,2005,020801,11,11,0,1
11,2005,020801,18,18,0,0
12,2005,020801,15,15,0,1
1,2006,020801,16,16,0,3
2,2006,020801,13,12,1,2
3,2006,020801,17,16,1,1
4,2006,020801,8,8,0,1
5,2006,020801,8,8,0,0
6,2006,020801,12,11,1,2
7,2006,020801,8,8,0,1
8,2006,020801,15,14,1,3
9,2006,020801,15,15,0,2
10,2006,020801,8,8,0,1
11,2006,020801,10,9,1,3
12,2006,020801,12,11,1,5
1,2007,020801,11,10,1,1
2,2007,020801,8,6,2,2
3,2007,020801,3,3,0,2
4,2007,020801,7,6,1,1
5,2007,020801,9,8,1,0
6,2007,020801,11,11,0,1
7,2007,020801,14,14,0,3
8,2007,020801,15,15,0,1
9,2007,020801,7,7,0,0
10,2007,020801,14,13,1,0
11,2007,020801,15,14,1,1
12,2007,020801,15,15,0,1
1,2008,020801,10,10,0,2
2,2008,020801,9,8,1,1
3,2008,020801,12,11,1,1
4,2008,020801,8,7,1,3
5,2008,020801,16,14,2,1
6,2008,020801,13,13,0,2
7,2008,020801,21,20,1,2
8,2008,020801,10,6,4,2
9,2008,020801,9,9,0,0
10,2008,020801,17,16,1,2
11,2008,020801,9,9,0,3
12,2008,020801,11,11,0,4
1,2009,020801,12,11,1,1
2,2009,020801,8,8,0,4
3,2009,020801,7,7,0,0
4,2009,020801,17,16,1,2
5,2009,020801,13,11,2,3
6,2009,020801,10,9,1,0
7,2009,020801,15,13,2,0
8,2009,020801,7,7,0,1
9,2009,020801,11,11,0,0
10,2009,020801,11,10,1,1
11,2009,020801,15,14,1,1
12,2009,020801,6,6,0,2
1,2010,020801,4,3,1,2
2,2010,020801,11,10,1,0
3,2010,020801,10,9,1,1
4,2010,020801,9,8,1,3
5,2010,020801,8,7,1,2
6,2010,020801,14,14,0,2
7,2010,020801,19,18,1,3
8,2010,020801,13,11,2,3
9,2010,020801,16,14,2,3
10,2010,020801,12,12,0,3
11,2010,020801,13,13,0,1
12,2010,020801,6,6,0,1
1,2011,020801,8,7,1,5
2,2011,020801,6,6,0,1
1,1999,030400,12,8,4,2
2,1999,030400,6,5,1,0
3,1999,030400,9,6,3,1
4,1999,030400,17,14,3,4
5,1999,030400,15,12,3,3
6,1999,030400,16,16,0,0
7,1999,030400,15,12,3,2
8,1999,030400,12,12,0,6
9,1999,030400,19,15,4,7
10,1999,030400,11,10,1,5
11,1999,030400,4,4,0,2
12,1999,030400,10,10,0,1
1,2000,030400,15,13,2,5
2,2000,030400,16,16,0,2
3,2000,030400,16,16,0,3
4,2000,030400,15,14,1,0
5,2000,030400,11,9,2,3
6,2000,030400,19,17,2,3
7,2000,030400,17,17,0,0
8,2000,030400,17,17,0,1
9,2000,030400,13,12,1,0
10,2000,030400,10,10,0,1
11,2000,030400,9,7,2,0
12,2000,030400,15,13,2,0
1,2001,030400,7,6,1,0
2,2001,030400,8,8,0,0
3,2001,030400,10,9,1,0
4,2001,030400,6,3,3,0
5,2001,030400,12,12,0,2
6,2001,030400,8,7,1,0
7,2001,030400,11,11,0,0
8,2001,030400,11,9,2,1
9,2001,030400,4,4,0,1
10,2001,030400,8,8,0,1
11,2001,030400,6,6,0,1
12,2001,030400,9,8,1,0
1,2002,030400,10,9,1,4
2,2002,030400,4,3,1,1
3,2002,030400,9,8,1,1
4,2002,030400,4,4,0,1
5,2002,030400,6,5,1,0
6,2002,030400,5,3,2,1
7,2002,030400,19,17,2,0
8,2002,030400,9,7,2,0
9,2002,030400,5,5,0,0
10,2002,030400,4,4,0,0
11,2002,030400,7,5,2,2
12,2002,030400,3,2,1,0
1,2003,030400,7,7,0,0
2,2003,030400,4,4,0,1
3,2003,030400,3,2,1,1
4,2003,030400,7,6,1,0
5,2003,030400,7,6,1,0
6,2003,030400,5,4,1,0
7,2003,030400,4,3,1,2
8,2003,030400,8,8,0,1
9,2003,030400,11,11,0,1
10,2003,030400,3,3,0,0
11,2003,030400,8,8,0,0
12,2003,030400,4,4,0,1
1,2004,030400,7,7,0,3
2,2004,030400,9,9,0,0
3,2004,030400,5,5,0,3
4,2004,030400,5,5,0,2
5,2004,030400,7,7,0,1
6,2004,030400,11,11,0,1
7,2004,030400,7,6,1,0
8,2004,030400,7,6,1,0
9,2004,030400,6,6,0,0
10,2004,030400,6,6,0,0
11,2004,030400,12,11,1,0
12,2004,030400,9,8,1,1
1,2005,030400,9,9,0,1
2,2005,030400,9,8,1,0
3,2005,030400,6,5,1,2
4,2005,030400,4,3,1,0
5,2005,030400,8,8,0,4
6,2005,030400,9,8,1,5
7,2005,030400,5,5,0,0
8,2005,030400,10,10,0,0
9,2005,030400,6,5,1,1
10,2005,030400,3,3,0,0
11,2005,030400,9,9,0,1
12,2005,030400,4,4,0,0
1,2006,030400,5,4,1,1
2,2006,030400,7,7,0,1
3,2006,030400,5,5,0,1
4,2006,030400,1,1,0,3
5,2006,030400,10,10,0,0
6,2006,030400,12,11,1,1
7,2006,030400,4,4,0,2
8,2006,030400,3,3,0,1
9,2006,030400,11,11,0,3
10,2006,030400,13,11,2,0
11,2006,030400,14,13,1,1
12,2006,030400,12,12,0,0
1,2007,030400,6,6,0,1
2,2007,030400,2,1,1,2
3,2007,030400,8,6,2,2
4,2007,030400,2,2,0,1
5,2007,030400,3,2,1,4
6,2007,030400,6,6,0,2
7,2007,030400,10,9,1,1
8,2007,030400,6,5,1,7
9,2007,030400,7,7,0,3
10,2007,030400,9,8,1,1
11,2007,030400,5,5,0,1
12,2007,030400,8,7,1,0
1,2008,030400,5,5,0,1
2,2008,030400,9,9,0,0
3,2008,030400,4,3,1,1
4,2008,030400,6,6,0,1
5,2008,030400,5,5,0,3
6,2008,030400,8,6,2,0
7,2008,030400,5,5,0,0
8,2008,030400,2,2,0,1
9,2008,030400,5,5,0,1
10,2008,030400,5,4,1,0
11,2008,030400,7,6,1,1
12,2008,030400,1,1,0,1
1,2009,030400,3,3,0,3
2,2009,030400,5,5,0,0
3,2009,030400,6,6,0,0
4,2009,030400,9,9,0,0
5,2009,030400,6,6,0,1
6,2009,030400,8,8,0,1
7,2009,030400,6,6,0,0
8,2009,030400,12,11,1,0
9,2009,030400,7,7,0,0
10,2009,030400,3,3,0,2
11,2009,030400,3,3,0,0
12,2009,030400,4,3,1,0
1,2010,030400,11,10,1,1
2,2010,030400,1,1,0,2
3,2010,030400,8,7,1,0
4,2010,030400,3,2,1,1
5,2010,030400,3,3,0,2
6,2010,030400,6,6,0,1
7,2010,030400,11,10,1,0
8,2010,030400,3,1,2,1
9,2010,030400,6,6,0,0
10,2010,030400,5,5,0,2
11,2010,030400,3,2,1,2
12,2010,030400,6,6,0,1
1,2011,030400,5,5,0,1
2,2011,030400,5,5,0,0
1,1999,030500,14,13,1,2
2,1999,030500,12,11,1,1
3,1999,030500,25,22,3,3
4,1999,030500,26,18,8,4
5,1999,030500,21,17,4,1
6,1999,030500,22,21,1,0
7,1999,030500,36,31,5,5
8,1999,030500,29,26,3,5
9,1999,030500,31,30,1,9
10,1999,030500,27,23,4,5
11,1999,030500,25,23,2,6
12,1999,030500,35,33,2,2
1,2000,030500,27,25,2,5
2,2000,030500,13,13,0,6
3,2000,030500,22,20,2,10
4,2000,030500,22,19,3,4
5,2000,030500,25,21,4,8
6,2000,030500,21,18,3,4
7,2000,030500,17,14,3,2
8,2000,030500,42,40,2,1
9,2000,030500,23,21,2,3
10,2000,030500,14,12,2,4
11,2000,030500,19,13,6,4
12,2000,030500,17,16,1,5
1,2001,030500,15,13,2,6
2,2001,030500,17,15,2,3
3,2001,030500,15,11,4,4
4,2001,030500,17,13,4,2
5,2001,030500,23,22,1,4
6,2001,030500,23,22,1,4
7,2001,030500,35,32,3,11
8,2001,030500,36,34,2,3
9,2001,030500,24,24,0,5
10,2001,030500,32,27,5,2
11,2001,030500,36,33,3,2
12,2001,030500,20,20,0,7
1,2002,030500,21,21,0,2
2,2002,030500,16,16,0,9
3,2002,030500,21,21,0,0
4,2002,030500,39,37,2,5
5,2002,030500,20,18,2,6
6,2002,030500,18,15,3,1
7,2002,030500,17,16,1,3
8,2002,030500,33,33,0,9
9,2002,030500,18,16,2,2
10,2002,030500,22,19,3,3
11,2002,030500,18,16,2,3
12,2002,030500,16,15,1,0
1,2003,030500,15,14,1,2
2,2003,030500,13,12,1,7
3,2003,030500,12,11,1,2
4,2003,030500,13,12,1,1
5,2003,030500,25,23,2,3
6,2003,030500,24,24,0,6
7,2003,030500,13,12,1,3
8,2003,030500,13,12,1,7
9,2003,030500,17,15,2,2
10,2003,030500,21,21,0,2
11,2003,030500,13,13,0,5
12,2003,030500,10,10,0,1
1,2004,030500,12,10,2,2
2,2004,030500,13,11,2,3
3,2004,030500,14,14,0,4
4,2004,030500,11,11,0,3
5,2004,030500,14,12,2,6
6,2004,030500,16,14,2,1
7,2004,030500,22,21,1,4
8,2004,030500,18,18,0,1
9,2004,030500,19,18,1,3
10,2004,030500,23,23,0,1
11,2004,030500,21,19,2,2
12,2004,030500,20,18,2,0
1,2005,030500,13,11,2,1
2,2005,030500,14,13,1,2
3,2005,030500,28,27,1,2
4,2005,030500,21,19,2,4
5,2005,030500,10,10,0,4
6,2005,030500,18,15,3,2
7,2005,030500,17,15,2,1
8,2005,030500,28,26,2,3
9,2005,030500,35,32,3,6
10,2005,030500,18,14,4,3
11,2005,030500,19,18,1,3
12,2005,030500,14,13,1,1
1,2006,030500,15,14,1,2
2,2006,030500,14,14,0,2
3,2006,030500,16,16,0,5
4,2006,030500,22,22,0,5
5,2006,030500,19,18,1,3
6,2006,030500,21,18,3,2
7,2006,030500,28,25,3,2
8,2006,030500,16,14,2,2
9,2006,030500,14,12,2,2
10,2006,030500,25,25,0,3
11,2006,030500,25,21,4,5
12,2006,030500,15,14,1,3
1,2007,030500,18,17,1,5
2,2007,030500,7,6,1,3
3,2007,030500,19,16,3,5
4,2007,030500,16,15,1,4
5,2007,030500,18,18,0,5
6,2007,030500,16,16,0,4
7,2007,030500,19,19,0,2
8,2007,030500,12,10,2,2
9,2007,030500,22,19,3,0
10,2007,030500,20,17,3,4
11,2007,030500,16,16,0,6
12,2007,030500,17,14,3,3
1,2008,030500,12,11,1,4
2,2008,030500,5,4,1,3
3,2008,030500,11,10,1,4
4,2008,030500,20,19,1,0
5,2008,030500,15,15,0,2
6,2008,030500,18,16,2,3
7,2008,030500,30,30,0,2
8,2008,030500,26,24,2,5
9,2008,030500,21,19,2,1
10,2008,030500,19,17,2,0
11,2008,030500,12,12,0,3
12,2008,030500,23,23,0,2
1,2009,030500,3,3,0,2
2,2009,030500,9,8,1,1
3,2009,030500,23,22,1,3
4,2009,030500,13,13,0,2
5,2009,030500,17,16,1,0
6,2009,030500,19,17,2,1
7,2009,030500,13,13,0,0
8,2009,030500,15,15,0,4
9,2009,030500,17,15,2,4
10,2009,030500,17,16,1,1
11,2009,030500,22,20,2,6
12,2009,030500,16,16,0,2
1,2010,030500,21,19,2,2
2,2010,030500,11,9,2,6
3,2010,030500,15,15,0,2
4,2010,030500,9,8,1,4
5,2010,030500,10,10,0,7
6,2010,030500,23,22,1,2
7,2010,030500,15,14,1,1
8,2010,030500,7,7,0,1
9,2010,030500,15,15,0,2
10,2010,030500,12,9,3,2
11,2010,030500,11,10,1,0
12,2010,030500,15,14,1,3
1,2011,030500,14,14,0,3
2,2011,030500,13,13,0,0
1,1999,120200,9,9,0,0
2,1999,120200,2,2,0,0
3,1999,120200,3,3,0,0
4,1999,120200,4,4,0,0
5,1999,120200,6,6,0,0
6,1999,120200,6,5,1,1
7,1999,120200,14,13,1,2
8,1999,120200,15,14,1,0
9,1999,120200,9,9,0,1
10,1999,120200,9,9,0,0
11,1999,120200,4,3,1,0
12,1999,120200,5,4,1,1
1,2000,120200,2,2,0,0
2,2000,120200,12,11,1,3
3,2000,120200,7,5,2,1
4,2000,120200,3,3,0,4
5,2000,120200,10,10,0,3
6,2000,120200,5,4,1,1
7,2000,120200,10,10,0,10
8,2000,120200,11,10,1,3
9,2000,120200,7,7,0,0
10,2000,120200,10,10,0,0
11,2000,120200,9,9,0,2
12,2000,120200,5,5,0,3
1,2001,120200,10,10,0,2
2,2001,120200,2,2,0,0
3,2001,120200,9,8,1,1
4,2001,120200,4,2,2,1
5,2001,120200,6,5,1,1
6,2001,120200,5,5,0,0
7,2001,120200,9,7,2,2
8,2001,120200,6,5,1,4
9,2001,120200,10,10,0,0
10,2001,120200,4,3,1,2
11,2001,120200,3,2,1,0
12,2001,120200,6,6,0,2
1,2002,120200,6,6,0,3
2,2002,120200,2,2,0,3
3,2002,120200,8,8,0,2
4,2002,120200,7,7,0,1
5,2002,120200,6,4,2,2
6,2002,120200,13,11,2,2
7,2002,120200,10,10,0,2
8,2002,120200,11,10,1,2
9,2002,120200,7,7,0,0
10,2002,120200,13,13,0,3
11,2002,120200,9,9,0,2
12,2002,120200,12,11,1,2
1,2003,120200,7,7,0,1
2,2003,120200,4,3,1,4
3,2003,120200,5,4,1,3
4,2003,120200,4,4,0,0
5,2003,120200,7,6,1,3
6,2003,120200,5,4,1,1
7,2003,120200,14,13,1,1
8,2003,120200,8,7,1,1
9,2003,120200,10,8,2,2
10,2003,120200,12,11,1,58
11,2003,120200,8,7,1,2
12,2003,120200,13,13,0,1
1,2004,120200,3,2,1,1
2,2004,120200,2,2,0,2
3,2004,120200,3,3,0,2
4,2004,120200,8,8,0,3
5,2004,120200,8,8,0,1
6,2004,120200,7,7,0,1
7,2004,120200,5,5,0,6
8,2004,120200,7,7,0,2
9,2004,120200,9,9,0,1
10,2004,120200,5,5,0,1
11,2004,120200,11,10,1,36
12,2004,120200,5,4,1,3
1,2005,120200,4,4,0,1
2,2005,120200,4,4,0,2
3,2005,120200,4,4,0,0
4,2005,120200,5,4,1,0
5,2005,120200,6,6,0,0
6,2005,120200,5,5,0,1
7,2005,120200,3,3,0,1
8,2005,120200,7,7,0,0
9,2005,120200,12,12,0,1
10,2005,120200,6,6,0,5
11,2005,120200,7,7,0,1
12,2005,120200,2,2,0,7
1,2006,120200,12,11,1,0
2,2006,120200,9,8,1,1
3,2006,120200,1,1,0,0
4,2006,120200,3,3,0,4
5,2006,120200,3,3,0,6
6,2006,120200,3,2,1,3
7,2006,120200,7,6,1,1
8,2006,120200,3,2,1,1
9,2006,120200,6,6,0,0
10,2006,120200,1,1,0,2
11,2006,120200,6,6,0,2
12,2006,120200,10,10,0,1
1,2007,120200,7,5,2,0
2,2007,120200,0,0,0,0
3,2007,120200,3,3,0,0
4,2007,120200,4,4,0,1
5,2007,120200,4,4,0,0
6,2007,120200,6,6,0,1
7,2007,120200,6,6,0,0
8,2007,120200,8,8,0,0
9,2007,120200,4,4,0,0
10,2007,120200,2,2,0,1
11,2007,120200,5,5,0,0
12,2007,120200,4,4,0,0
1,2008,120200,4,4,0,1
2,2008,120200,6,6,0,1
3,2008,120200,1,1,0,0
4,2008,120200,10,8,2,0
5,2008,120200,7,7,0,0
6,2008,120200,4,4,0,1
7,2008,120200,5,5,0,0
8,2008,120200,9,9,0,0
9,2008,120200,5,5,0,0
10,2008,120200,9,9,0,0
11,2008,120200,6,6,0,0
12,2008,120200,6,6,0,0
1,2009,120200,4,4,0,0
2,2009,120200,5,5,0,0
3,2009,120200,16,15,1,2
4,2009,120200,6,6,0,0
5,2009,120200,9,8,1,0
6,2009,120200,7,6,1,0
7,2009,120200,6,5,1,0
8,2009,120200,8,8,0,0
9,2009,120200,8,8,0,0
10,2009,120200,4,4,0,1
11,2009,120200,5,5,0,0
12,2009,120200,7,6,1,1
1,2010,120200,10,9,1,0
2,2010,120200,3,3,0,1
3,2010,120200,7,6,1,1
4,2010,120200,4,4,0,0
5,2010,120200,6,6,0,1
6,2010,120200,6,6,0,0
7,2010,120200,5,5,0,0
8,2010,120200,11,11,0,1
9,2010,120200,5,5,0,0
10,2010,120200,1,1,0,0
11,2010,120200,3,3,0,0
12,2010,120200,8,8,0,1
1,2011,120200,5,5,0,0
2,2011,120200,4,4,0,0
1,1999,030603,10,9,1,11
2,1999,030603,10,10,0,7
3,1999,030603,10,9,1,6
4,1999,030603,5,5,0,6
5,1999,030603,9,9,0,4
6,1999,030603,10,8,2,6
7,1999,030603,11,9,2,8
8,1999,030603,15,12,3,6
9,1999,030603,7,6,1,9
10,1999,030603,13,11,2,6
11,1999,030603,12,10,2,3
12,1999,030603,21,17,4,8
1,2000,030603,7,5,2,15
2,2000,030603,8,6,2,20
3,2000,030603,4,4,0,13
4,2000,030603,7,5,2,6
5,2000,030603,12,12,0,8
6,2000,030603,15,13,2,1
7,2000,030603,15,13,2,8
8,2000,030603,12,9,3,10
9,2000,030603,7,7,0,6
10,2000,030603,12,11,1,12
11,2000,030603,13,11,2,5
12,2000,030603,14,10,4,6
1,2001,030603,9,8,1,17
2,2001,030603,9,8,1,15
3,2001,030603,10,10,0,9
4,2001,030603,11,10,1,13
5,2001,030603,6,5,1,13
6,2001,030603,11,7,4,4
7,2001,030603,8,8,0,10
8,2001,030603,7,7,0,5
9,2001,030603,11,8,3,2
10,2001,030603,13,12,1,1
11,2001,030603,3,3,0,4
12,2001,030603,6,6,0,5
1,2002,030603,8,8,0,2
2,2002,030603,6,5,1,5
3,2002,030603,7,5,2,4
4,2002,030603,4,4,0,5
5,2002,030603,11,10,1,1
6,2002,030603,3,3,0,3
7,2002,030603,7,7,0,1
8,2002,030603,9,8,1,2
9,2002,030603,10,10,0,4
10,2002,030603,8,8,0,4
11,2002,030603,6,5,1,7
12,2002,030603,5,5,0,1
1,2003,030603,11,11,0,5
2,2003,030603,4,3,1,2
3,2003,030603,3,3,0,3
4,2003,030603,13,11,2,3
5,2003,030603,5,4,1,4
6,2003,030603,6,6,0,6
7,2003,030603,13,12,1,6
8,2003,030603,11,9,2,1
9,2003,030603,7,5,2,0
10,2003,030603,10,8,2,1
11,2003,030603,8,8,0,6
12,2003,030603,3,3,0,4
1,2004,030603,5,4,1,8
2,2004,030603,12,10,2,2
3,2004,030603,3,3,0,7
4,2004,030603,3,2,1,4
5,2004,030603,3,3,0,2
6,2004,030603,9,7,2,5
7,2004,030603,4,4,0,1
8,2004,030603,6,4,2,3
9,2004,030603,7,7,0,6
10,2004,030603,6,5,1,3
11,2004,030603,3,2,1,2
12,2004,030603,7,6,1,3
1,2005,030603,6,4,2,4
2,2005,030603,6,6,0,11
3,2005,030603,6,5,1,10
4,2005,030603,3,3,0,5
5,2005,030603,5,5,0,3
6,2005,030603,13,13,0,3
7,2005,030603,14,14,0,4
8,2005,030603,9,8,1,2
9,2005,030603,10,9,1,3
10,2005,030603,7,7,0,4
11,2005,030603,4,4,0,4
12,2005,030603,4,4,0,2
1,2006,030603,12,10,2,5
2,2006,030603,3,3,0,2
3,2006,030603,3,3,0,1
4,2006,030603,7,6,1,2
5,2006,030603,3,3,0,2
6,2006,030603,6,5,1,0
7,2006,030603,9,8,1,7
8,2006,030603,4,4,0,5
9,2006,030603,4,4,0,4
10,2006,030603,4,4,0,1
11,2006,030603,6,5,1,0
12,2006,030603,10,10,0,1
1,2007,030603,6,6,0,1
2,2007,030603,3,2,1,0
3,2007,030603,5,5,0,1
4,2007,030603,9,8,1,1
5,2007,030603,9,8,1,3
6,2007,030603,4,3,1,1
7,2007,030603,4,4,0,2
8,2007,030603,2,2,0,2
9,2007,030603,7,7,0,1
10,2007,030603,8,6,2,2
11,2007,030603,3,3,0,0
12,2007,030603,4,3,1,1
1,2008,030603,4,4,0,0
2,2008,030603,3,3,0,1
3,2008,030603,5,5,0,1
4,2008,030603,3,1,2,0
5,2008,030603,4,2,2,0
6,2008,030603,9,9,0,0
7,2008,030603,9,8,1,5
8,2008,030603,7,7,0,4
9,2008,030603,16,14,2,2
10,2008,030603,10,9,1,1
11,2008,030603,3,3,0,3
12,2008,030603,4,4,0,1
1,2009,030603,2,2,0,2
2,2009,030603,5,5,0,1
3,2009,030603,2,2,0,0
4,2009,030603,8,8,0,3
5,2009,030603,4,3,1,0
6,2009,030603,6,6,0,0
7,2009,030603,5,3,2,0
8,2009,030603,6,6,0,1
9,2009,030603,6,5,1,4
10,2009,030603,5,5,0,1
11,2009,030603,5,5,0,2
12,2009,030603,1,1,0,0
1,2010,030603,6,5,1,0
2,2010,030603,5,5,0,0
3,2010,030603,10,9,1,3
4,2010,030603,4,4,0,1
5,2010,030603,2,2,0,4
6,2010,030603,6,5,1,4
7,2010,030603,7,5,2,1
8,2010,030603,6,6,0,1
9,2010,030603,0,0,0,2
10,2010,030603,2,1,1,0
11,2010,030603,5,5,0,0
12,2010,030603,5,5,0,0
1,2011,030603,13,10,3,3
2,2011,030603,5,3,2,2
1,1999,030604,9,9,0,0
2,1999,030604,11,9,2,1
3,1999,030604,8,8,0,0
4,1999,030604,6,6,0,0
5,1999,030604,11,10,1,0
6,1999,030604,9,9,0,0
7,1999,030604,13,12,1,0
8,1999,030604,9,9,0,0
9,1999,030604,12,8,4,1
10,1999,030604,12,12,0,0
11,1999,030604,13,10,3,0
12,1999,030604,8,8,0,1
1,2000,030604,7,5,2,0
2,2000,030604,9,7,2,0
3,2000,030604,7,7,0,1
4,2000,030604,5,4,1,3
5,2000,030604,10,8,2,1
6,2000,030604,5,4,1,0
7,2000,030604,7,5,2,1
8,2000,030604,9,6,3,1
9,2000,030604,6,6,0,1
10,2000,030604,7,7,0,2
11,2000,030604,12,11,1,1
12,2000,030604,6,5,1,1
1,2001,030604,11,11,0,0
2,2001,030604,8,8,0,0
3,2001,030604,6,6,0,4
4,2001,030604,5,4,1,0
5,2001,030604,10,10,0,2
6,2001,030604,11,9,2,1
7,2001,030604,8,7,1,4
8,2001,030604,10,10,0,0
9,2001,030604,9,9,0,1
10,2001,030604,2,2,0,0
11,2001,030604,8,7,1,0
12,2001,030604,7,6,1,2
1,2002,030604,8,8,0,0
2,2002,030604,1,1,0,0
3,2002,030604,5,5,0,1
4,2002,030604,11,8,3,0
5,2002,030604,8,8,0,0
6,2002,030604,3,3,0,0
7,2002,030604,5,5,0,0
8,2002,030604,9,8,1,3
9,2002,030604,4,3,1,1
10,2002,030604,8,8,0,2
11,2002,030604,4,3,1,1
12,2002,030604,10,9,1,0
1,2003,030604,7,6,1,0
2,2003,030604,9,8,1,1
3,2003,030604,4,4,0,0
4,2003,030604,3,3,0,0
5,2003,030604,6,6,0,0
6,2003,030604,2,2,0,0
7,2003,030604,10,9,1,3
8,2003,030604,11,11,0,1
9,2003,030604,6,6,0,2
10,2003,030604,7,5,2,1
11,2003,030604,6,5,1,0
12,2003,030604,5,5,0,2
1,2004,030604,5,4,1,0
2,2004,030604,9,7,2,0
3,2004,030604,6,6,0,1
4,2004,030604,8,7,1,1
5,2004,030604,8,7,1,2
6,2004,030604,10,8,2,2
7,2004,030604,6,6,0,0
8,2004,030604,6,6,0,2
9,2004,030604,4,4,0,0
10,2004,030604,6,6,0,0
11,2004,030604,9,9,0,2
12,2004,030604,5,5,0,0
1,2005,030604,3,3,0,0
2,2005,030604,4,4,0,2
3,2005,030604,2,2,0,0
4,2005,030604,4,4,0,2
5,2005,030604,8,8,0,1
6,2005,030604,10,10,0,1
7,2005,030604,4,3,1,1
8,2005,030604,9,8,1,1
9,2005,030604,8,8,0,0
10,2005,030604,6,5,1,1
11,2005,030604,8,8,0,2
12,2005,030604,4,4,0,0
1,2006,030604,4,3,1,0
2,2006,030604,10,10,0,1
3,2006,030604,2,2,0,1
4,2006,030604,4,3,1,0
5,2006,030604,9,7,2,1
6,2006,030604,5,5,0,1
7,2006,030604,8,8,0,1
8,2006,030604,7,6,1,1
9,2006,030604,8,8,0,1
10,2006,030604,12,12,0,3
11,2006,030604,10,10,0,0
12,2006,030604,10,7,3,0
1,2007,030604,6,6,0,0
2,2007,030604,1,1,0,1
3,2007,030604,4,2,2,0
4,2007,030604,1,1,0,0
5,2007,030604,5,4,1,0
6,2007,030604,5,4,1,0
7,2007,030604,10,9,1,0
8,2007,030604,5,4,1,1
9,2007,030604,4,4,0,0
10,2007,030604,3,2,1,0
11,2007,030604,6,4,2,1
12,2007,030604,6,6,0,1
1,2008,030604,3,2,1,2
2,2008,030604,1,1,0,1
3,2008,030604,7,5,2,2
4,2008,030604,4,4,0,0
5,2008,030604,5,5,0,0
6,2008,030604,8,8,0,1
7,2008,030604,9,8,1,0
8,2008,030604,12,12,0,0
9,2008,030604,2,2,0,1
10,2008,030604,5,5,0,2
11,2008,030604,5,5,0,1
12,2008,030604,8,8,0,1
1,2009,030604,2,1,1,1
2,2009,030604,2,1,1,1
3,2009,030604,4,4,0,2
4,2009,030604,5,4,1,0
5,2009,030604,4,4,0,0
6,2009,030604,8,8,0,0
7,2009,030604,5,5,0,0
8,2009,030604,5,5,0,0
9,2009,030604,11,9,2,0
10,2009,030604,8,7,1,0
11,2009,030604,4,4,0,2
12,2009,030604,3,1,2,1
1,2010,030604,3,3,0,1
2,2010,030604,1,1,0,2
3,2010,030604,7,6,1,1
4,2010,030604,7,6,1,0
5,2010,030604,3,2,1,1
6,2010,030604,8,8,0,1
7,2010,030604,6,4,2,3
8,2010,030604,5,5,0,1
9,2010,030604,8,8,0,0
10,2010,030604,6,5,1,3
11,2010,030604,7,5,2,1
12,2010,030604,9,9,0,0
1,2011,030604,9,7,2,1
2,2011,030604,3,3,0,0
1,1999,100200,7,5,2,0
2,1999,100200,6,5,1,0
3,1999,100200,11,9,2,0
4,1999,100200,6,6,0,1
5,1999,100200,6,6,0,0
6,1999,100200,10,9,1,0
7,1999,100200,22,20,2,0
8,1999,100200,8,7,1,1
9,1999,100200,12,11,1,0
10,1999,100200,7,7,0,0
11,1999,100200,10,9,1,0
12,1999,100200,9,9,0,0
1,2000,100200,9,9,0,0
2,2000,100200,6,5,1,0
3,2000,100200,7,7,0,9
4,2000,100200,4,4,0,1
5,2000,100200,13,12,1,0
6,2000,100200,11,10,1,0
7,2000,100200,23,22,1,1
8,2000,100200,13,12,1,1
9,2000,100200,8,8,0,2
10,2000,100200,11,9,2,0
11,2000,100200,9,8,1,0
12,2000,100200,10,10,0,0
1,2001,100200,8,8,0,0
2,2001,100200,5,5,0,0
3,2001,100200,14,13,1,0
4,2001,100200,5,5,0,0
5,2001,100200,11,11,0,0
6,2001,100200,13,11,2,1
7,2001,100200,12,10,2,1
8,2001,100200,13,13,0,0
9,2001,100200,10,10,0,0
10,2001,100200,9,9,0,0
11,2001,100200,3,3,0,0
12,2001,100200,14,14,0,2
1,2002,100200,9,8,1,0
2,2002,100200,5,5,0,0
3,2002,100200,6,6,0,0
4,2002,100200,10,9,1,0
5,2002,100200,10,9,1,0
6,2002,100200,13,11,2,0
7,2002,100200,12,9,3,0
8,2002,100200,14,14,0,0
9,2002,100200,7,7,0,0
10,2002,100200,12,11,1,0
11,2002,100200,15,15,0,0
12,2002,100200,8,8,0,0
1,2003,100200,7,6,1,0
2,2003,100200,5,5,0,0
3,2003,100200,10,10,0,0
4,2003,100200,12,12,0,0
5,2003,100200,13,13,0,0
6,2003,100200,14,13,1,1
7,2003,100200,7,6,1,0
8,2003,100200,8,8,0,0
9,2003,100200,8,8,0,3
10,2003,100200,14,12,2,1
11,2003,100200,2,2,0,0
12,2003,100200,7,7,0,0
1,2004,100200,7,7,0,0
2,2004,100200,7,7,0,0
3,2004,100200,8,8,0,0
4,2004,100200,10,9,1,0
5,2004,100200,8,8,0,0
6,2004,100200,14,13,1,0
7,2004,100200,10,10,0,1
8,2004,100200,13,13,0,0
9,2004,100200,5,4,1,0
10,2004,100200,10,10,0,0
11,2004,100200,4,4,0,0
12,2004,100200,9,8,1,0
1,2005,100200,4,4,0,0
2,2005,100200,4,4,0,4
3,2005,100200,9,9,0,0
4,2005,100200,8,7,1,0
5,2005,100200,6,6,0,0
6,2005,100200,6,6,0,0
7,2005,100200,10,10,0,0
8,2005,100200,6,6,0,0
9,2005,100200,12,12,0,0
10,2005,100200,9,9,0,0
11,2005,100200,7,6,1,0
12,2005,100200,9,9,0,1
1,2006,100200,7,7,0,0
2,2006,100200,5,5,0,0
3,2006,100200,6,5,1,0
4,2006,100200,7,7,0,2
5,2006,100200,15,15,0,0
6,2006,100200,4,3,1,1
7,2006,100200,11,11,0,0
8,2006,100200,3,3,0,1
9,2006,100200,5,5,0,0
10,2006,100200,11,9,2,0
11,2006,100200,8,7,1,0
12,2006,100200,6,5,1,0
1,2007,100200,13,13,0,0
2,2007,100200,3,2,1,0
3,2007,100200,7,5,2,0
4,2007,100200,9,8,1,0
5,2007,100200,16,15,1,0
6,2007,100200,8,7,1,0
7,2007,100200,5,5,0,0
8,2007,100200,7,6,1,0
9,2007,100200,10,10,0,0
10,2007,100200,8,7,1,0
11,2007,100200,6,6,0,1
12,2007,100200,7,7,0,1
1,2008,100200,6,5,1,0
2,2008,100200,9,7,2,0
3,2008,100200,6,6,0,0
4,2008,100200,7,7,0,0
5,2008,100200,15,15,0,0
6,2008,100200,4,4,0,0
7,2008,100200,14,14,0,1
8,2008,100200,4,4,0,0
9,2008,100200,7,7,0,1
10,2008,100200,7,7,0,0
11,2008,100200,13,12,1,0
12,2008,100200,6,5,1,0
1,2009,100200,0,0,0,0
2,2009,100200,8,7,1,1
3,2009,100200,10,10,0,0
4,2009,100200,5,5,0,1
5,2009,100200,11,11,0,0
6,2009,100200,11,11,0,4
7,2009,100200,13,12,1,0
8,2009,100200,9,9,0,1
9,2009,100200,8,8,0,0
10,2009,100200,6,6,0,0
11,2009,100200,10,10,0,0
12,2009,100200,7,7,0,0
1,2010,100200,7,6,1,0
2,2010,100200,4,4,0,0
3,2010,100200,11,11,0,0
4,2010,100200,4,4,0,1
5,2010,100200,12,12,0,0
6,2010,100200,6,5,1,0
7,2010,100200,5,5,0,0
8,2010,100200,11,11,0,0
9,2010,100200,6,6,0,0
10,2010,100200,11,10,1,0
11,2010,100200,9,9,0,0
12,2010,100200,4,4,0,0
1,2011,100200,5,5,0,0
2,2011,100200,3,3,0,0
1,1999,030601,12,11,1,2
2,1999,030601,12,10,2,4
3,1999,030601,4,3,1,1
4,1999,030601,12,10,2,0
5,1999,030601,10,9,1,3
6,1999,030601,13,10,3,5
7,1999,030601,13,11,2,5
8,1999,030601,15,14,1,0
9,1999,030601,8,8,0,5
10,1999,030601,10,9,1,1
11,1999,030601,3,3,0,0
12,1999,030601,14,12,2,4
1,2000,030601,11,11,0,5
2,2000,030601,3,1,2,8
3,2000,030601,7,5,2,1
4,2000,030601,7,7,0,2
5,2000,030601,4,3,1,2
6,2000,030601,6,5,1,1
7,2000,030601,11,11,0,1
8,2000,030601,12,11,1,2
9,2000,030601,11,10,1,1
10,2000,030601,12,10,2,2
11,2000,030601,12,11,1,0
12,2000,030601,11,9,2,0
1,2001,030601,16,15,1,1
2,2001,030601,2,2,0,5
3,2001,030601,9,8,1,1
4,2001,030601,7,6,1,2
5,2001,030601,10,9,1,2
6,2001,030601,11,8,3,0
7,2001,030601,12,10,2,8
8,2001,030601,8,7,1,2
9,2001,030601,11,8,3,6
10,2001,030601,10,8,2,9
11,2001,030601,5,5,0,0
12,2001,030601,5,4,1,0
1,2002,030601,3,3,0,2
2,2002,030601,6,4,2,2
3,2002,030601,9,8,1,0
4,2002,030601,7,7,0,4
5,2002,030601,2,1,1,5
6,2002,030601,10,7,3,0
7,2002,030601,9,8,1,2
8,2002,030601,10,9,1,0
9,2002,030601,7,5,2,0
10,2002,030601,9,8,1,1
11,2002,030601,4,3,1,1
12,2002,030601,5,5,0,3
1,2003,030601,7,5,2,0
2,2003,030601,3,3,0,3
3,2003,030601,5,5,0,0
4,2003,030601,7,7,0,0
5,2003,030601,9,8,1,0
6,2003,030601,10,8,2,1
7,2003,030601,6,5,1,2
8,2003,030601,7,5,2,0
9,2003,030601,5,4,1,1
10,2003,030601,2,1,1,0
11,2003,030601,3,2,1,0
12,2003,030601,9,9,0,3
1,2004,030601,5,5,0,0
2,2004,030601,5,5,0,0
3,2004,030601,7,7,0,0
4,2004,030601,6,6,0,1
5,2004,030601,9,9,0,0
6,2004,030601,7,6,1,1
7,2004,030601,7,7,0,1
8,2004,030601,8,7,1,1
9,2004,030601,10,10,0,1
10,2004,030601,5,5,0,3
11,2004,030601,11,10,1,2
12,2004,030601,8,7,1,0
1,2005,030601,3,2,1,1
2,2005,030601,7,6,1,0
3,2005,030601,5,5,0,2
4,2005,030601,5,5,0,2
5,2005,030601,3,3,0,0
6,2005,030601,9,9,0,2
7,2005,030601,16,12,4,3
8,2005,030601,6,6,0,1
9,2005,030601,4,4,0,4
10,2005,030601,11,11,0,0
11,2005,030601,8,7,1,3
12,2005,030601,7,5,2,1
1,2006,030601,7,5,2,2
2,2006,030601,5,4,1,3
3,2006,030601,5,4,1,1
4,2006,030601,3,2,1,1
5,2006,030601,9,9,0,3
6,2006,030601,4,4,0,0
7,2006,030601,12,11,1,1
8,2006,030601,6,6,0,3
9,2006,030601,7,6,1,1
10,2006,030601,5,5,0,2
11,2006,030601,5,5,0,0
12,2006,030601,9,9,0,5
1,2007,030601,8,7,1,1
2,2007,030601,10,10,0,1
3,2007,030601,8,7,1,0
4,2007,030601,4,4,0,9
5,2007,030601,7,6,1,1
6,2007,030601,8,7,1,1
7,2007,030601,7,6,1,4
8,2007,030601,3,2,1,0
9,2007,030601,6,6,0,1
10,2007,030601,4,4,0,1
11,2007,030601,8,8,0,0
12,2007,030601,5,4,1,0
1,2008,030601,7,5,2,0
2,2008,030601,5,5,0,1
3,2008,030601,6,6,0,0
4,2008,030601,11,10,1,1
5,2008,030601,4,4,0,1
6,2008,030601,11,11,0,4
7,2008,030601,11,9,2,2
8,2008,030601,11,10,1,5
9,2008,030601,5,5,0,1
10,2008,030601,8,7,1,6
11,2008,030601,5,4,1,3
12,2008,030601,7,6,1,2
1,2009,030601,2,1,1,3
2,2009,030601,3,3,0,2
3,2009,030601,5,5,0,0
4,2009,030601,3,2,1,3
5,2009,030601,7,6,1,0
6,2009,030601,8,8,0,2
7,2009,030601,11,8,3,0
8,2009,030601,2,2,0,1
9,2009,030601,9,9,0,1
10,2009,030601,5,3,2,0
11,2009,030601,7,6,1,1
12,2009,030601,9,5,4,0
1,2010,030601,4,4,0,0
2,2010,030601,5,4,1,0
3,2010,030601,5,3,2,0
4,2010,030601,6,6,0,1
5,2010,030601,9,9,0,1
6,2010,030601,4,4,0,1
7,2010,030601,2,2,0,3
8,2010,030601,7,4,3,2
9,2010,030601,10,9,1,3
10,2010,030601,10,9,1,1
11,2010,030601,9,8,1,0
12,2010,030601,5,5,0,2
1,2011,030601,9,8,1,0
2,2011,030601,6,6,0,2
1,1999,030200,35,32,3,2
2,1999,030200,36,33,3,0
3,1999,030200,33,33,0,0
4,1999,030200,31,27,4,0
5,1999,030200,34,31,3,6
6,1999,030200,30,30,0,1
7,1999,030200,43,43,0,0
8,1999,030200,55,54,1,4
9,1999,030200,46,45,1,2
10,1999,030200,35,33,2,3
11,1999,030200,34,34,0,5
12,1999,030200,34,34,0,3
1,2000,030200,33,31,2,1
2,2000,030200,30,30,0,1
3,2000,030200,35,34,1,1
4,2000,030200,34,33,1,3
5,2000,030200,31,31,0,2
6,2000,030200,27,26,1,3
7,2000,030200,30,30,0,2
8,2000,030200,43,41,2,1
9,2000,030200,59,57,2,5
10,2000,030200,38,37,1,3
11,2000,030200,28,27,1,3
12,2000,030200,19,18,1,2
1,2001,030200,27,27,0,2
2,2001,030200,12,10,2,4
3,2001,030200,31,28,3,4
4,2001,030200,39,37,2,2
5,2001,030200,33,32,1,1
6,2001,030200,27,27,0,1
7,2001,030200,42,39,3,0
8,2001,030200,31,31,0,2
9,2001,030200,38,37,1,0
10,2001,030200,45,45,0,2
11,2001,030200,28,27,1,1
12,2001,030200,30,29,1,1
1,2002,030200,31,30,1,0
2,2002,030200,41,41,0,1
3,2002,030200,37,37,0,3
4,2002,030200,40,36,4,0
5,2002,030200,38,37,1,1
6,2002,030200,42,42,0,3
7,2002,030200,42,39,3,1
8,2002,030200,45,44,1,7
9,2002,030200,41,40,1,0
10,2002,030200,42,41,1,1
11,2002,030200,24,24,0,1
12,2002,030200,37,37,0,1
1,2003,030200,28,25,3,6
2,2003,030200,15,15,0,2
3,2003,030200,26,26,0,0
4,2003,030200,25,24,1,0
5,2003,030200,31,30,1,4
6,2003,030200,24,21,3,1
7,2003,030200,28,28,0,0
8,2003,030200,34,33,1,3
9,2003,030200,27,26,1,5
10,2003,030200,32,31,1,0
11,2003,030200,28,28,0,1
12,2003,030200,23,23,0,3
1,2004,030200,32,31,1,0
2,2004,030200,30,30,0,3
3,2004,030200,26,25,1,0
4,2004,030200,32,31,1,1
5,2004,030200,34,34,0,0
6,2004,030200,32,32,0,1
7,2004,030200,38,36,2,2
8,2004,030200,31,31,0,2
9,2004,030200,34,33,1,1
10,2004,030200,28,25,3,2
11,2004,030200,35,34,1,3
12,2004,030200,35,34,1,3
1,2005,030200,32,32,0,0
2,2005,030200,26,25,1,5
3,2005,030200,35,35,0,3
4,2005,030200,22,21,1,4
5,2005,030200,17,16,1,4
6,2005,030200,25,25,0,1
7,2005,030200,43,43,0,0
8,2005,030200,47,44,3,6
9,2005,030200,36,36,0,0
10,2005,030200,21,21,0,4
11,2005,030200,24,22,2,4
12,2005,030200,13,13,0,5
1,2006,030200,34,34,0,6
2,2006,030200,27,26,1,4
3,2006,030200,30,30,0,4
4,2006,030200,30,29,1,1
5,2006,030200,23,23,0,1
6,2006,030200,30,29,1,2
7,2006,030200,38,37,1,5
8,2006,030200,25,23,2,2
9,2006,030200,27,27,0,3
10,2006,030200,35,35,0,4
11,2006,030200,35,35,0,0
12,2006,030200,30,30,0,6
1,2007,030200,20,19,1,3
2,2007,030200,20,19,1,1
3,2007,030200,18,18,0,2
4,2007,030200,28,27,1,4
5,2007,030200,31,28,3,1
6,2007,030200,30,30,0,1
7,2007,030200,38,38,0,2
8,2007,030200,39,39,0,3
9,2007,030200,56,56,0,2
10,2007,030200,38,38,0,2
11,2007,030200,32,31,1,1
12,2007,030200,24,24,0,2
1,2008,030200,17,17,0,2
2,2008,030200,21,20,1,6
3,2008,030200,32,30,2,4
4,2008,030200,38,38,0,4
5,2008,030200,19,18,1,3
6,2008,030200,30,28,2,6
7,2008,030200,36,34,2,1
8,2008,030200,43,43,0,1
9,2008,030200,33,32,1,1
10,2008,030200,39,39,0,0
11,2008,030200,29,26,3,3
12,2008,030200,26,25,1,0
1,2009,030200,16,16,0,6
2,2009,030200,20,20,0,2
3,2009,030200,30,29,1,1
4,2009,030200,14,12,2,2
5,2009,030200,29,28,1,3
6,2009,030200,19,19,0,1
7,2009,030200,25,25,0,2
8,2009,030200,18,17,1,4
9,2009,030200,23,22,1,1
10,2009,030200,30,28,2,1
11,2009,030200,21,20,1,3
12,2009,030200,27,26,1,1
1,2010,030200,12,11,1,4
2,2010,030200,12,12,0,1
3,2010,030200,25,24,1,2
4,2010,030200,24,24,0,0
5,2010,030200,27,24,3,1
6,2010,030200,28,27,1,1
7,2010,030200,48,46,2,2
8,2010,030200,39,38,1,2
9,2010,030200,39,39,0,7
10,2010,030200,33,33,0,1
11,2010,030200,21,21,0,1
12,2010,030200,14,14,0,0
1,2011,030200,15,15,0,1
2,2011,030200,16,14,2,1
1,1999,020702,22,21,1,3
2,1999,020702,14,14,0,0
3,1999,020702,13,13,0,1
4,1999,020702,15,15,0,3
5,1999,020702,34,31,3,0
6,1999,020702,21,19,2,0
7,1999,020702,16,16,0,2
8,1999,020702,23,20,3,5
9,1999,020702,23,21,2,2
10,1999,020702,39,38,1,1
11,1999,020702,16,16,0,0
12,1999,020702,24,23,1,1
1,2000,020702,16,16,0,0
2,2000,020702,12,7,5,3
3,2000,020702,25,23,2,0
4,2000,020702,24,24,0,0
5,2000,020702,20,18,2,2
6,2000,020702,21,20,1,0
7,2000,020702,21,20,1,0
8,2000,020702,25,23,2,0
9,2000,020702,16,16,0,2
10,2000,020702,23,21,2,2
11,2000,020702,18,16,2,1
12,2000,020702,17,16,1,1
1,2001,020702,19,18,1,0
2,2001,020702,10,10,0,0
3,2001,020702,16,12,4,0
4,2001,020702,14,12,2,1
5,2001,020702,18,16,2,0
6,2001,020702,12,11,1,0
7,2001,020702,24,22,2,0
8,2001,020702,23,20,3,1
9,2001,020702,27,23,4,1
10,2001,020702,24,24,0,3
11,2001,020702,15,15,0,1
12,2001,020702,20,20,0,1
1,2002,020702,23,23,0,0
2,2002,020702,18,15,3,2
3,2002,020702,15,15,0,1
4,2002,020702,20,17,3,2
5,2002,020702,26,25,1,0
6,2002,020702,14,13,1,0
7,2002,020702,22,22,0,2
8,2002,020702,23,22,1,2
9,2002,020702,28,26,2,1
10,2002,020702,20,17,3,2
11,2002,020702,20,20,0,1
12,2002,020702,13,13,0,2
1,2003,020702,11,11,0,3
2,2003,020702,10,9,1,1
3,2003,020702,9,7,2,2
4,2003,020702,15,13,2,1
5,2003,020702,22,21,1,2
6,2003,020702,24,22,2,1
7,2003,020702,16,15,1,3
8,2003,020702,21,19,2,2
9,2003,020702,15,13,2,2
10,2003,020702,19,19,0,2
11,2003,020702,16,16,0,2
12,2003,020702,16,15,1,3
1,2004,020702,19,18,1,1
2,2004,020702,18,16,2,1
3,2004,020702,15,15,0,2
4,2004,020702,18,18,0,4
5,2004,020702,20,20,0,0
6,2004,020702,26,25,1,1
7,2004,020702,23,21,2,2
8,2004,020702,20,17,3,0
9,2004,020702,18,16,2,2
10,2004,020702,29,29,0,1
11,2004,020702,38,36,2,2
12,2004,020702,10,10,0,0
1,2005,020702,12,12,0,1
2,2005,020702,13,13,0,0
3,2005,020702,19,18,1,2
4,2005,020702,19,19,0,2
5,2005,020702,26,23,3,2
6,2005,020702,18,15,3,2
7,2005,020702,24,21,3,3
8,2005,020702,24,23,1,2
9,2005,020702,22,20,2,3
10,2005,020702,24,22,2,4
11,2005,020702,20,19,1,5
12,2005,020702,13,11,2,1
1,2006,020702,21,21,0,3
2,2006,020702,22,20,2,2
3,2006,020702,13,10,3,1
4,2006,020702,21,20,1,7
5,2006,020702,23,18,5,2
6,2006,020702,18,18,0,5
7,2006,020702,26,25,1,3
8,2006,020702,25,24,1,3
9,2006,020702,19,16,3,2
10,2006,020702,26,25,1,1
11,2006,020702,20,19,1,4
12,2006,020702,13,12,1,1
1,2007,020702,14,11,3,3
2,2007,020702,6,6,0,3
3,2007,020702,15,14,1,1
4,2007,020702,12,11,1,1
5,2007,020702,11,10,1,1
6,2007,020702,14,13,1,5
7,2007,020702,15,14,1,2
8,2007,020702,24,22,2,3
9,2007,020702,21,18,3,3
10,2007,020702,10,9,1,3
11,2007,020702,16,16,0,1
12,2007,020702,18,17,1,0
1,2008,020702,17,14,3,2
2,2008,020702,12,10,2,1
3,2008,020702,12,11,1,3
4,2008,020702,16,16,0,5
5,2008,020702,16,14,2,6
6,2008,020702,9,9,0,2
7,2008,020702,14,13,1,2
8,2008,020702,12,10,2,2
9,2008,020702,19,18,1,5
10,2008,020702,23,21,2,2
11,2008,020702,17,16,1,2
12,2008,020702,18,17,1,1
1,2009,020702,11,11,0,5
2,2009,020702,13,13,0,2
3,2009,020702,18,17,1,5
4,2009,020702,22,21,1,5
5,2009,020702,7,6,1,5
6,2009,020702,17,14,3,3
7,2009,020702,16,16,0,3
8,2009,020702,19,16,3,4
9,2009,020702,11,11,0,3
10,2009,020702,19,18,1,1
11,2009,020702,11,10,1,1
12,2009,020702,14,13,1,2
1,2010,020702,9,9,0,1
2,2010,020702,6,6,0,0
3,2010,020702,11,11,0,2
4,2010,020702,14,11,3,2
5,2010,020702,6,5,1,1
6,2010,020702,18,15,3,1
7,2010,020702,20,19,1,2
8,2010,020702,18,16,2,0
9,2010,020702,16,15,1,0
10,2010,020702,13,10,3,0
11,2010,020702,13,12,1,3
12,2010,020702,13,13,0,2
1,2011,020702,10,9,1,1
2,2011,020702,14,11,3,1
1,1999,030101,4,4,0,1
2,1999,030101,9,7,2,0
3,1999,030101,6,5,1,1
4,1999,030101,10,10,0,0
5,1999,030101,7,6,1,10
6,1999,030101,9,9,0,0
7,1999,030101,11,11,0,2
8,1999,030101,11,7,4,4
9,1999,030101,5,5,0,2
10,1999,030101,8,6,2,2
11,1999,030101,8,7,1,1
12,1999,030101,5,5,0,1
1,2000,030101,2,2,0,0
2,2000,030101,3,2,1,0
3,2000,030101,2,2,0,1
4,2000,030101,5,5,0,0
5,2000,030101,6,5,1,1
6,2000,030101,6,5,1,3
7,2000,030101,6,5,1,2
8,2000,030101,9,8,1,1
9,2000,030101,6,5,1,0
10,2000,030101,6,5,1,1
11,2000,030101,5,5,0,2
12,2000,030101,4,4,0,3
1,2001,030101,12,11,1,1
2,2001,030101,10,10,0,0
3,2001,030101,10,8,2,2
4,2001,030101,3,3,0,7
5,2001,030101,5,5,0,1
6,2001,030101,10,9,1,1
7,2001,030101,6,5,1,6
8,2001,030101,8,7,1,5
9,2001,030101,4,4,0,3
10,2001,030101,8,6,2,6
11,2001,030101,6,6,0,3
12,2001,030101,9,6,3,0
1,2002,030101,8,8,0,1
2,2002,030101,4,3,1,1
3,2002,030101,7,5,2,1
4,2002,030101,9,8,1,3
5,2002,030101,5,4,1,4
6,2002,030101,3,3,0,3
7,2002,030101,13,12,1,4
8,2002,030101,5,5,0,0
9,2002,030101,11,8,3,1
10,2002,030101,5,5,0,2
11,2002,030101,4,4,0,0
12,2002,030101,9,7,2,0
1,2003,030101,9,8,1,1
2,2003,030101,8,8,0,2
3,2003,030101,5,5,0,1
4,2003,030101,6,6,0,0
5,2003,030101,8,7,1,1
6,2003,030101,7,6,1,0
7,2003,030101,4,4,0,3
8,2003,030101,7,6,1,2
9,2003,030101,9,7,2,3
10,2003,030101,10,8,2,1
11,2003,030101,4,3,1,0
12,2003,030101,4,4,0,1
1,2004,030101,6,6,0,4
2,2004,030101,10,6,4,2
3,2004,030101,9,8,1,4
4,2004,030101,8,8,0,2
5,2004,030101,5,5,0,5
6,2004,030101,8,7,1,1
7,2004,030101,6,4,2,3
8,2004,030101,7,7,0,0
9,2004,030101,4,3,1,4
10,2004,030101,5,5,0,2
11,2004,030101,7,7,0,1
12,2004,030101,5,4,1,2
1,2005,030101,10,9,1,0
2,2005,030101,6,6,0,2
3,2005,030101,4,4,0,2
4,2005,030101,9,7,2,11
5,2005,030101,9,7,2,4
6,2005,030101,8,6,2,2
7,2005,030101,3,3,0,1
8,2005,030101,8,8,0,3
9,2005,030101,9,9,0,5
10,2005,030101,6,6,0,4
11,2005,030101,3,2,1,0
12,2005,030101,4,4,0,2
1,2006,030101,3,3,0,3
2,2006,030101,6,5,1,0
3,2006,030101,7,6,1,3
4,2006,030101,10,7,3,0
5,2006,030101,5,4,1,2
6,2006,030101,6,3,3,3
7,2006,030101,13,11,2,2
8,2006,030101,9,9,0,3
9,2006,030101,8,8,0,1
10,2006,030101,3,3,0,2
11,2006,030101,5,4,1,1
12,2006,030101,7,7,0,3
1,2007,030101,4,3,1,2
2,2007,030101,8,7,1,1
3,2007,030101,2,1,1,2
4,2007,030101,3,3,0,1
5,2007,030101,3,1,2,0
6,2007,030101,9,8,1,2
7,2007,030101,7,7,0,4
8,2007,030101,4,4,0,2
9,2007,030101,6,6,0,0
10,2007,030101,6,4,2,2
11,2007,030101,6,5,1,1
12,2007,030101,1,1,0,2
1,2008,030101,3,2,1,3
2,2008,030101,3,3,0,0
3,2008,030101,5,5,0,1
4,2008,030101,1,1,0,1
5,2008,030101,4,4,0,2
6,2008,030101,9,8,1,1
7,2008,030101,8,8,0,1
8,2008,030101,6,3,3,1
9,2008,030101,8,7,1,4
10,2008,030101,9,8,1,3
11,2008,030101,4,4,0,5
12,2008,030101,7,7,0,3
1,2009,030101,7,6,1,3
2,2009,030101,7,5,2,2
3,2009,030101,9,8,1,0
4,2009,030101,9,7,2,1
5,2009,030101,2,2,0,1
6,2009,030101,1,1,0,1
7,2009,030101,4,4,0,2
8,2009,030101,5,5,0,1
9,2009,030101,3,3,0,5
10,2009,030101,8,7,1,5
11,2009,030101,8,7,1,1
12,2009,030101,2,2,0,2
1,2010,030101,5,5,0,2
2,2010,030101,4,3,1,0
3,2010,030101,4,3,1,3
4,2010,030101,6,6,0,1
5,2010,030101,6,4,2,5
6,2010,030101,7,6,1,4
7,2010,030101,9,6,3,1
8,2010,030101,9,8,1,5
9,2010,030101,4,4,0,4
10,2010,030101,5,5,0,1
11,2010,030101,6,6,0,0
12,2010,030101,5,5,0,1
1,2011,030101,5,1,4,2
2,2011,030101,4,4,0,0
1,1999,020802,28,27,1,0
2,1999,020802,36,35,1,2
3,1999,020802,29,29,0,1
4,1999,020802,30,28,2,6
5,1999,020802,46,44,2,2
6,1999,020802,25,24,1,4
7,1999,020802,39,36,3,1
8,1999,020802,39,34,5,1
9,1999,020802,50,46,4,2
10,1999,020802,23,20,3,1
11,1999,020802,22,21,1,1
12,1999,020802,23,20,3,3
1,2000,020802,42,39,3,2
2,2000,020802,25,24,1,4
3,2000,020802,38,37,1,5
4,2000,020802,40,37,3,2
5,2000,020802,37,31,6,2
6,2000,020802,35,33,2,2
7,2000,020802,37,35,2,1
8,2000,020802,44,38,6,0
9,2000,020802,42,41,1,5
10,2000,020802,33,32,1,3
11,2000,020802,30,28,2,2
12,2000,020802,31,30,1,2
1,2001,020802,26,24,2,2
2,2001,020802,23,21,2,6
3,2001,020802,21,21,0,3
4,2001,020802,28,23,5,5
5,2001,020802,25,22,3,5
6,2001,020802,26,23,3,5
7,2001,020802,32,30,2,1
8,2001,020802,26,21,5,2
9,2001,020802,21,19,2,2
10,2001,020802,30,28,2,3
11,2001,020802,20,19,1,4
12,2001,020802,18,16,2,1
1,2002,020802,29,25,4,1
2,2002,020802,21,20,1,2
3,2002,020802,28,26,2,2
4,2002,020802,22,21,1,3
5,2002,020802,29,26,3,2
6,2002,020802,32,31,1,1
7,2002,020802,36,34,2,1
8,2002,020802,30,30,0,4
9,2002,020802,41,37,4,1
10,2002,020802,30,26,4,2
11,2002,020802,30,30,0,1
12,2002,020802,27,27,0,0
1,2003,020802,31,28,3,4
2,2003,020802,25,23,2,3
3,2003,020802,28,26,2,1
4,2003,020802,15,14,1,0
5,2003,020802,25,23,2,4
6,2003,020802,22,20,2,3
7,2003,020802,32,30,2,5
8,2003,020802,41,41,0,1
9,2003,020802,29,26,3,1
10,2003,020802,27,27,0,0
11,2003,020802,33,27,6,8
12,2003,020802,23,22,1,0
1,2004,020802,26,23,3,0
2,2004,020802,35,33,2,0
3,2004,020802,31,30,1,1
4,2004,020802,34,29,5,3
5,2004,020802,42,39,3,6
6,2004,020802,36,35,1,0
7,2004,020802,39,38,1,4
8,2004,020802,33,33,0,1
9,2004,020802,39,36,3,6
10,2004,020802,31,30,1,6
11,2004,020802,35,34,1,1
12,2004,020802,27,27,0,1
1,2005,020802,16,14,2,0
2,2005,020802,21,20,1,0
3,2005,020802,33,33,0,2
4,2005,020802,29,28,1,0
5,2005,020802,29,27,2,1
6,2005,020802,48,42,6,2
7,2005,020802,29,27,2,7
8,2005,020802,31,27,4,4
9,2005,020802,50,48,2,2
10,2005,020802,34,31,3,7
11,2005,020802,31,29,2,6
12,2005,020802,38,37,1,3
1,2006,020802,50,48,2,7
2,2006,020802,28,26,2,4
3,2006,020802,38,36,2,5
4,2006,020802,41,39,2,8
5,2006,020802,23,19,4,7
6,2006,020802,30,29,1,9
7,2006,020802,39,35,4,4
8,2006,020802,48,44,4,8
9,2006,020802,46,44,2,3
10,2006,020802,41,39,2,1
11,2006,020802,25,23,2,5
12,2006,020802,27,26,1,3
1,2007,020802,31,29,2,3
2,2007,020802,20,18,2,2
3,2007,020802,26,25,1,7
4,2007,020802,18,17,1,6
5,2007,020802,28,24,4,6
6,2007,020802,17,16,1,3
7,2007,020802,18,18,0,5
8,2007,020802,34,29,5,12
9,2007,020802,21,19,2,8
10,2007,020802,30,26,4,9
11,2007,020802,27,27,0,3
12,2007,020802,23,23,0,3
1,2008,020802,21,18,3,1
2,2008,020802,16,15,1,2
3,2008,020802,14,13,1,2
4,2008,020802,27,24,3,3
5,2008,020802,17,15,2,2
6,2008,020802,21,21,0,4
7,2008,020802,22,21,1,3
8,2008,020802,24,24,0,10
9,2008,020802,32,30,2,5
10,2008,020802,28,25,3,2
11,2008,020802,23,20,3,7
12,2008,020802,26,26,0,5
1,2009,020802,16,16,0,0
2,2009,020802,12,10,2,4
3,2009,020802,23,16,7,7
4,2009,020802,26,23,3,10
5,2009,020802,29,27,2,5
6,2009,020802,22,18,4,6
7,2009,020802,23,22,1,3
8,2009,020802,26,25,1,5
9,2009,020802,19,17,2,4
10,2009,020802,28,27,1,5
11,2009,020802,29,29,0,10
12,2009,020802,13,12,1,13
1,2010,020802,13,12,1,6
2,2010,020802,18,14,4,6
3,2010,020802,13,10,3,4
4,2010,020802,21,16,5,5
5,2010,020802,26,19,7,5
6,2010,020802,31,29,2,5
7,2010,020802,23,21,2,4
8,2010,020802,32,28,4,6
9,2010,020802,22,21,1,4
10,2010,020802,27,20,7,4
11,2010,020802,24,24,0,3
12,2010,020802,30,26,4,3
1,2011,020802,20,19,1,2
2,2011,020802,14,14,0,0
1,1999,020901,14,11,3,2
2,1999,020901,8,7,1,0
3,1999,020901,11,10,1,0
4,1999,020901,11,11,0,1
5,1999,020901,15,15,0,2
6,1999,020901,16,15,1,1
7,1999,020901,20,15,5,1
8,1999,020901,16,12,4,2
9,1999,020901,36,34,2,1
10,1999,020901,12,9,3,1
11,1999,020901,16,13,3,5
12,1999,020901,16,16,0,0
1,2000,020901,16,15,1,2
2,2000,020901,14,14,0,2
3,2000,020901,18,14,4,1
4,2000,020901,11,11,0,6
5,2000,020901,19,16,3,3
6,2000,020901,15,14,1,2
7,2000,020901,17,15,2,3
8,2000,020901,17,16,1,3
9,2000,020901,21,21,0,2
10,2000,020901,13,12,1,3
11,2000,020901,15,13,2,1
12,2000,020901,9,8,1,1
1,2001,020901,11,11,0,3
2,2001,020901,10,7,3,0
3,2001,020901,9,8,1,1
4,2001,020901,13,11,2,5
5,2001,020901,16,13,3,3
6,2001,020901,15,15,0,5
7,2001,020901,12,12,0,2
8,2001,020901,15,14,1,1
9,2001,020901,21,19,2,4
10,2001,020901,14,11,3,1
11,2001,020901,23,19,4,1
12,2001,020901,7,5,2,1
1,2002,020901,9,5,4,1
2,2002,020901,10,9,1,1
3,2002,020901,10,9,1,1
4,2002,020901,11,9,2,0
5,2002,020901,13,11,2,3
6,2002,020901,11,11,0,1
7,2002,020901,22,19,3,0
8,2002,020901,18,16,2,0
9,2002,020901,13,13,0,0
10,2002,020901,18,17,1,1
11,2002,020901,20,17,3,0
12,2002,020901,11,11,0,0
1,2003,020901,11,10,1,1
2,2003,020901,10,8,2,0
3,2003,020901,13,9,4,0
4,2003,020901,11,11,0,2
5,2003,020901,5,4,1,1
6,2003,020901,10,10,0,1
7,2003,020901,15,14,1,0
8,2003,020901,17,14,3,3
9,2003,020901,11,10,1,1
10,2003,020901,15,12,3,5
11,2003,020901,11,10,1,2
12,2003,020901,11,10,1,1
1,2004,020901,20,19,1,0
2,2004,020901,6,5,1,2
3,2004,020901,16,15,1,0
4,2004,020901,12,11,1,3
5,2004,020901,11,9,2,0
6,2004,020901,14,11,3,2
7,2004,020901,14,12,2,1
8,2004,020901,24,22,2,1
9,2004,020901,19,18,1,1
10,2004,020901,18,17,1,4
11,2004,020901,22,21,1,2
12,2004,020901,17,16,1,1
1,2005,020901,14,14,0,1
2,2005,020901,11,10,1,3
3,2005,020901,14,13,1,1
4,2005,020901,10,9,1,4
5,2005,020901,12,11,1,4
6,2005,020901,12,12,0,1
7,2005,020901,20,18,2,3
8,2005,020901,29,28,1,5
9,2005,020901,14,12,2,0
10,2005,020901,19,17,2,4
11,2005,020901,10,8,2,4
12,2005,020901,14,11,3,1
1,2006,020901,12,10,2,4
2,2006,020901,11,9,2,0
3,2006,020901,22,20,2,5
4,2006,020901,13,10,3,7
5,2006,020901,18,15,3,4
6,2006,020901,21,19,2,3
7,2006,020901,24,20,4,0
8,2006,020901,27,24,3,5
9,2006,020901,11,10,1,5
10,2006,020901,12,11,1,3
11,2006,020901,9,8,1,0
12,2006,020901,7,7,0,9
1,2007,020901,8,8,0,7
2,2007,020901,5,5,0,2
3,2007,020901,8,7,1,2
4,2007,020901,9,9,0,2
5,2007,020901,13,11,2,3
6,2007,020901,8,6,2,3
7,2007,020901,7,5,2,3
8,2007,020901,10,10,0,2
9,2007,020901,17,15,2,10
10,2007,020901,11,10,1,5
11,2007,020901,9,9,0,3
12,2007,020901,10,10,0,3
1,2008,020901,12,11,1,4
2,2008,020901,8,8,0,2
3,2008,020901,13,9,4,6
4,2008,020901,12,11,1,1
5,2008,020901,13,11,2,1
6,2008,020901,16,14,2,2
7,2008,020901,17,17,0,0
8,2008,020901,13,12,1,2
9,2008,020901,14,13,1,7
10,2008,020901,15,13,2,2
11,2008,020901,9,7,2,2
12,2008,020901,6,6,0,2
1,2009,020901,11,11,0,1
2,2009,020901,7,6,1,1
3,2009,020901,19,16,3,1
4,2009,020901,13,10,3,2
5,2009,020901,13,12,1,1
6,2009,020901,21,18,3,7
7,2009,020901,15,12,3,4
8,2009,020901,14,14,0,4
9,2009,020901,13,11,2,1
10,2009,020901,27,26,1,2
11,2009,020901,10,10,0,2
12,2009,020901,10,9,1,4
1,2010,020901,13,11,2,4
2,2010,020901,6,5,1,1
3,2010,020901,9,9,0,2
4,2010,020901,8,7,1,1
5,2010,020901,12,12,0,5
6,2010,020901,18,18,0,4
7,2010,020901,16,13,3,1
8,2010,020901,16,15,1,1
9,2010,020901,12,10,2,1
10,2010,020901,19,18,1,4
11,2010,020901,26,25,1,0
12,2010,020901,22,22,0,0
1,2011,020901,9,9,0,1
2,2011,020901,8,7,1,1
1,1999,020902,7,7,0,1
2,1999,020902,11,11,0,0
3,1999,020902,7,6,1,0
4,1999,020902,10,10,0,1
5,1999,020902,14,11,3,2
6,1999,020902,17,16,1,1
7,1999,020902,10,9,1,0
8,1999,020902,14,11,3,1
9,1999,020902,16,15,1,1
10,1999,020902,17,15,2,1
11,1999,020902,14,12,2,4
12,1999,020902,18,18,0,3
1,2000,020902,11,9,2,0
2,2000,020902,5,5,0,1
3,2000,020902,9,9,0,0
4,2000,020902,8,8,0,1
5,2000,020902,12,12,0,2
6,2000,020902,8,7,1,0
7,2000,020902,9,7,2,1
8,2000,020902,16,15,1,0
9,2000,020902,12,11,1,2
10,2000,020902,10,8,2,2
11,2000,020902,6,5,1,1
12,2000,020902,9,9,0,0
1,2001,020902,1,1,0,2
2,2001,020902,2,2,0,1
3,2001,020902,9,7,2,1
4,2001,020902,6,6,0,1
5,2001,020902,6,3,3,0
6,2001,020902,5,4,1,0
7,2001,020902,9,7,2,0
8,2001,020902,8,8,0,4
9,2001,020902,12,12,0,0
10,2001,020902,4,4,0,1
11,2001,020902,7,7,0,0
12,2001,020902,7,6,1,0
1,2002,020902,6,6,0,0
2,2002,020902,9,9,0,0
3,2002,020902,8,8,0,1
4,2002,020902,9,8,1,0
5,2002,020902,9,8,1,2
6,2002,020902,5,5,0,0
7,2002,020902,11,11,0,3
8,2002,020902,14,13,1,1
9,2002,020902,9,9,0,1
10,2002,020902,9,8,1,2
11,2002,020902,6,5,1,2
12,2002,020902,10,8,2,0
1,2003,020902,6,6,0,0
2,2003,020902,11,11,0,0
3,2003,020902,8,8,0,0
4,2003,020902,10,10,0,1
5,2003,020902,2,2,0,0
6,2003,020902,4,4,0,0
7,2003,020902,10,10,0,0
8,2003,020902,12,12,0,0
9,2003,020902,6,6,0,0
10,2003,020902,7,5,2,1
11,2003,020902,7,7,0,1
12,2003,020902,5,5,0,0
1,2004,020902,5,5,0,0
2,2004,020902,13,13,0,0
3,2004,020902,11,10,1,0
4,2004,020902,9,9,0,0
5,2004,020902,9,8,1,1
6,2004,020902,12,10,2,1
7,2004,020902,8,8,0,0
8,2004,020902,9,9,0,1
9,2004,020902,12,12,0,0
10,2004,020902,9,8,1,0
11,2004,020902,16,16,0,2
12,2004,020902,9,8,1,5
1,2005,020902,5,4,1,1
2,2005,020902,7,7,0,0
3,2005,020902,8,8,0,0
4,2005,020902,6,6,0,1
5,2005,020902,10,9,1,0
6,2005,020902,8,7,1,0
7,2005,020902,14,14,0,1
8,2005,020902,15,15,0,1
9,2005,020902,2,2,0,3
10,2005,020902,6,6,0,1
11,2005,020902,8,8,0,0
12,2005,020902,14,13,1,0
1,2006,020902,4,4,0,4
2,2006,020902,4,4,0,1
3,2006,020902,2,2,0,0
4,2006,020902,12,11,1,9
5,2006,020902,10,10,0,2
6,2006,020902,14,13,1,0
7,2006,020902,19,19,0,2
8,2006,020902,11,11,0,1
9,2006,020902,6,6,0,1
10,2006,020902,6,5,1,0
11,2006,020902,8,7,1,1
12,2006,020902,6,6,0,2
1,2007,020902,9,8,1,1
2,2007,020902,4,3,1,0
3,2007,020902,7,5,2,1
4,2007,020902,4,4,0,2
5,2007,020902,3,2,1,0
6,2007,020902,4,3,1,1
7,2007,020902,8,7,1,4
8,2007,020902,5,5,0,2
9,2007,020902,12,11,1,1
10,2007,020902,0,0,0,1
11,2007,020902,4,4,0,0
12,2007,020902,5,2,3,0
1,2008,020902,6,6,0,1
2,2008,020902,3,3,0,0
3,2008,020902,9,6,3,0
4,2008,020902,7,6,1,0
5,2008,020902,7,7,0,0
6,2008,020902,3,2,1,0
7,2008,020902,12,12,0,2
8,2008,020902,8,5,3,1
9,2008,020902,9,8,1,0
10,2008,020902,8,5,3,2
11,2008,020902,13,12,1,0
12,2008,020902,4,4,0,0
1,2009,020902,5,4,1,0
2,2009,020902,6,5,1,2
3,2009,020902,7,7,0,1
4,2009,020902,12,12,0,0
5,2009,020902,11,9,2,3
6,2009,020902,9,7,2,0
7,2009,020902,8,8,0,0
8,2009,020902,8,7,1,5
9,2009,020902,7,7,0,2
10,2009,020902,10,10,0,3
11,2009,020902,8,7,1,0
12,2009,020902,6,6,0,0
1,2010,020902,11,9,2,0
2,2010,020902,4,4,0,0
3,2010,020902,12,11,1,0
4,2010,020902,10,10,0,1
5,2010,020902,11,10,1,1
6,2010,020902,13,13,0,0
7,2010,020902,4,3,1,0
8,2010,020902,14,12,2,0
9,2010,020902,17,17,0,0
10,2010,020902,6,5,1,1
11,2010,020902,4,3,1,0
12,2010,020902,7,7,0,1
1,2011,020902,17,16,1,0
2,2011,020902,1,1,0,0
1,1999,030300,15,12,3,0
2,1999,030300,17,17,0,2
3,1999,030300,14,13,1,1
4,1999,030300,15,12,3,0
5,1999,030300,15,14,1,3
6,1999,030300,23,17,6,5
7,1999,030300,18,17,1,0
8,1999,030300,12,11,1,2
9,1999,030300,20,18,2,5
10,1999,030300,20,19,1,3
11,1999,030300,24,22,2,7
12,1999,030300,32,27,5,0
1,2000,030300,10,10,0,2
2,2000,030300,23,19,4,2
3,2000,030300,20,17,3,2
4,2000,030300,11,11,0,0
5,2000,030300,8,8,0,1
6,2000,030300,17,16,1,2
7,2000,030300,28,23,5,4
8,2000,030300,18,16,2,1
9,2000,030300,22,20,2,0
10,2000,030300,19,17,2,0
11,2000,030300,15,15,0,0
12,2000,030300,13,12,1,1
1,2001,030300,15,13,2,3
2,2001,030300,9,9,0,0
3,2001,030300,14,13,1,6
4,2001,030300,9,9,0,0
5,2001,030300,17,13,4,2
6,2001,030300,25,21,4,5
7,2001,030300,15,14,1,7
8,2001,030300,25,21,4,0
9,2001,030300,15,13,2,1
10,2001,030300,15,14,1,1
11,2001,030300,16,15,1,1
12,2001,030300,14,14,0,0
1,2002,030300,18,17,1,0
2,2002,030300,11,9,2,1
3,2002,030300,10,10,0,2
4,2002,030300,26,25,1,3
5,2002,030300,24,23,1,1
6,2002,030300,19,17,2,1
7,2002,030300,23,20,3,0
8,2002,030300,11,9,2,1
9,2002,030300,19,15,4,2
10,2002,030300,11,11,0,1
11,2002,030300,18,17,1,4
12,2002,030300,21,19,2,0
1,2003,030300,13,13,0,4
2,2003,030300,17,17,0,3
3,2003,030300,21,20,1,3
4,2003,030300,23,21,2,1
5,2003,030300,9,9,0,5
6,2003,030300,12,12,0,3
7,2003,030300,26,22,4,5
8,2003,030300,18,16,2,4
9,2003,030300,16,16,0,0
10,2003,030300,18,16,2,0
11,2003,030300,12,10,2,3
12,2003,030300,16,16,0,0
1,2004,030300,18,17,1,3
2,2004,030300,19,19,0,0
3,2004,030300,12,10,2,3
4,2004,030300,15,13,2,3
5,2004,030300,22,20,2,1
6,2004,030300,14,14,0,0
7,2004,030300,24,23,1,2
8,2004,030300,25,24,1,6
9,2004,030300,23,23,0,1
10,2004,030300,18,17,1,1
11,2004,030300,17,17,0,2
12,2004,030300,16,15,1,3
1,2005,030300,19,18,1,2
2,2005,030300,13,12,1,3
3,2005,030300,19,19,0,3
4,2005,030300,13,13,0,5
5,2005,030300,15,14,1,4
6,2005,030300,19,15,4,1
7,2005,030300,24,21,3,0
8,2005,030300,10,10,0,2
9,2005,030300,16,13,3,1
10,2005,030300,8,8,0,0
11,2005,030300,20,19,1,1
12,2005,030300,17,17,0,2
1,2006,030300,14,13,1,2
2,2006,030300,11,11,0,1
3,2006,030300,10,10,0,1
4,2006,030300,12,12,0,0
5,2006,030300,25,21,4,6
6,2006,030300,19,19,0,1
7,2006,030300,14,11,3,0
8,2006,030300,20,18,2,1
9,2006,030300,17,16,1,2
10,2006,030300,16,15,1,2
11,2006,030300,16,15,1,3
12,2006,030300,11,11,0,0
1,2007,030300,15,13,2,3
2,2007,030300,8,7,1,3
3,2007,030300,8,7,1,3
4,2007,030300,17,15,2,1
5,2007,030300,15,14,1,1
6,2007,030300,11,9,2,5
7,2007,030300,10,8,2,3
8,2007,030300,11,11,0,2
9,2007,030300,18,14,4,3
10,2007,030300,25,19,6,2
11,2007,030300,13,11,2,4
12,2007,030300,8,7,1,0
1,2008,030300,10,10,0,3
2,2008,030300,9,9,0,1
3,2008,030300,11,9,2,3
4,2008,030300,12,12,0,6
5,2008,030300,7,6,1,2
6,2008,030300,18,17,1,3
7,2008,030300,11,8,3,1
8,2008,030300,19,18,1,3
9,2008,030300,16,14,2,3
10,2008,030300,15,13,2,3
11,2008,030300,6,5,1,1
12,2008,030300,5,5,0,1
1,2009,030300,5,5,0,2
2,2009,030300,9,7,2,3
3,2009,030300,13,12,1,3
4,2009,030300,11,9,2,2
5,2009,030300,14,13,1,2
6,2009,030300,7,4,3,2
7,2009,030300,19,18,1,0
8,2009,030300,13,12,1,0
9,2009,030300,10,8,2,0
10,2009,030300,8,7,1,2
11,2009,030300,11,8,3,3
12,2009,030300,7,7,0,2
1,2010,030300,6,6,0,2
2,2010,030300,8,8,0,3
3,2010,030300,13,12,1,3
4,2010,030300,9,7,2,1
5,2010,030300,17,15,2,3
6,2010,030300,12,11,1,0
7,2010,030300,11,9,2,1
8,2010,030300,7,7,0,2
9,2010,030300,8,8,0,0
10,2010,030300,10,9,1,0
11,2010,030300,8,7,1,0
12,2010,030300,4,4,0,4
1,2011,030300,9,7,2,0
2,2011,030300,1,1,0,3
1,1999,120100,3,2,1,0
2,1999,120100,4,3,1,0
3,1999,120100,3,2,1,0
4,1999,120100,2,2,0,0
5,1999,120100,8,8,0,0
6,1999,120100,5,4,1,0
7,1999,120100,5,4,1,0
8,1999,120100,8,8,0,1
9,1999,120100,7,6,1,1
10,1999,120100,3,3,0,0
11,1999,120100,4,4,0,0
12,1999,120100,3,3,0,2
1,2000,120100,1,1,0,0
2,2000,120100,2,2,0,1
3,2000,120100,8,6,2,1
4,2000,120100,3,3,0,0
5,2000,120100,2,2,0,0
6,2000,120100,4,3,1,2
7,2000,120100,6,6,0,0
8,2000,120100,5,4,1,0
9,2000,120100,4,4,0,0
10,2000,120100,8,8,0,1
11,2000,120100,9,8,1,0
12,2000,120100,6,6,0,0
1,2001,120100,5,4,1,0
2,2001,120100,2,2,0,0
3,2001,120100,2,2,0,0
4,2001,120100,1,1,0,0
5,2001,120100,6,5,1,0
6,2001,120100,4,4,0,1
7,2001,120100,8,8,0,0
8,2001,120100,2,2,0,0
9,2001,120100,2,2,0,0
10,2001,120100,7,7,0,0
11,2001,120100,2,2,0,0
12,2001,120100,0,0,0,1
1,2002,120100,3,3,0,1
2,2002,120100,5,4,1,0
3,2002,120100,4,3,1,0
4,2002,120100,4,4,0,0
5,2002,120100,2,1,1,0
6,2002,120100,7,7,0,1
7,2002,120100,3,3,0,2
8,2002,120100,5,5,0,0
9,2002,120100,4,4,0,0
10,2002,120100,2,2,0,0
11,2002,120100,3,2,1,0
12,2002,120100,2,2,0,0
1,2003,120100,2,2,0,1
2,2003,120100,1,1,0,0
3,2003,120100,6,6,0,0
4,2003,120100,2,2,0,1
5,2003,120100,4,4,0,0
6,2003,120100,2,2,0,1
7,2003,120100,3,2,1,1
8,2003,120100,7,6,1,0
9,2003,120100,1,1,0,0
10,2003,120100,2,1,1,1
11,2003,120100,2,2,0,2
12,2003,120100,6,6,0,1
1,2004,120100,5,5,0,1
2,2004,120100,2,2,0,0
3,2004,120100,4,4,0,0
4,2004,120100,5,4,1,0
5,2004,120100,3,3,0,0
6,2004,120100,3,2,1,0
7,2004,120100,3,2,1,0
8,2004,120100,4,4,0,0
9,2004,120100,1,1,0,1
10,2004,120100,2,2,0,0
11,2004,120100,2,2,0,0
12,2004,120100,6,5,1,0
1,2005,120100,7,7,0,0
2,2005,120100,3,3,0,0
3,2005,120100,1,1,0,0
4,2005,120100,1,1,0,0
5,2005,120100,1,1,0,0
6,2005,120100,4,4,0,0
7,2005,120100,4,4,0,0
8,2005,120100,4,4,0,0
9,2005,120100,4,4,0,0
10,2005,120100,5,4,1,0
11,2005,120100,1,1,0,0
12,2005,120100,4,4,0,0
1,2006,120100,1,1,0,1
2,2006,120100,1,1,0,0
3,2006,120100,4,4,0,0
4,2006,120100,2,2,0,0
5,2006,120100,2,2,0,0
6,2006,120100,0,0,0,0
7,2006,120100,5,5,0,0
8,2006,120100,3,3,0,0
9,2006,120100,4,4,0,0
10,2006,120100,4,3,1,1
11,2006,120100,4,4,0,1
12,2006,120100,5,5,0,0
1,2007,120100,2,2,0,0
2,2007,120100,2,1,1,0
3,2007,120100,1,1,0,0
4,2007,120100,3,3,0,0
5,2007,120100,2,2,0,1
6,2007,120100,4,4,0,0
7,2007,120100,3,3,0,0
8,2007,120100,5,5,0,0
9,2007,120100,9,9,0,0
10,2007,120100,5,5,0,0
11,2007,120100,2,2,0,0
12,2007,120100,3,3,0,0
1,2008,120100,4,4,0,1
2,2008,120100,4,4,0,0
3,2008,120100,1,1,0,0
4,2008,120100,5,5,0,0
5,2008,120100,4,4,0,0
6,2008,120100,8,7,1,0
7,2008,120100,8,8,0,0
8,2008,120100,6,6,0,0
9,2008,120100,3,3,0,0
10,2008,120100,3,3,0,0
11,2008,120100,6,6,0,0
12,2008,120100,3,3,0,0
1,2009,120100,2,2,0,0
2,2009,120100,1,1,0,0
3,2009,120100,0,0,0,0
4,2009,120100,1,1,0,0
5,2009,120100,2,2,0,0
6,2009,120100,2,2,0,0
7,2009,120100,8,7,1,0
8,2009,120100,11,10,1,0
9,2009,120100,6,6,0,0
10,2009,120100,6,5,1,0
11,2009,120100,6,6,0,1
12,2009,120100,4,4,0,0
1,2010,120100,4,3,1,0
2,2010,120100,1,1,0,0
3,2010,120100,2,2,0,0
4,2010,120100,3,2,1,1
5,2010,120100,4,4,0,0
6,2010,120100,1,1,0,0
7,2010,120100,3,3,0,1
8,2010,120100,5,5,0,0
9,2010,120100,4,4,0,0
10,2010,120100,2,2,0,0
11,2010,120100,1,1,0,0
12,2010,120100,0,0,0,0
1,2011,120100,3,3,0,0
2,2011,120100,1,1,0,0
1,1999,030102,7,5,2,0
2,1999,030102,6,5,1,0
3,1999,030102,9,8,1,4
4,1999,030102,5,5,0,2
5,1999,030102,5,4,1,0
6,1999,030102,9,5,4,2
7,1999,030102,5,5,0,1
8,1999,030102,8,8,0,5
9,1999,030102,9,8,1,2
10,1999,030102,11,10,1,3
11,1999,030102,6,6,0,0
12,1999,030102,7,7,0,0
1,2000,030102,12,11,1,0
2,2000,030102,4,4,0,1
3,2000,030102,4,4,0,0
4,2000,030102,6,6,0,2
5,2000,030102,4,4,0,2
6,2000,030102,7,7,0,1
7,2000,030102,13,13,0,0
8,2000,030102,11,9,2,1
9,2000,030102,8,7,1,2
10,2000,030102,7,6,1,2
11,2000,030102,8,7,1,1
12,2000,030102,4,4,0,0
1,2001,030102,8,7,1,1
2,2001,030102,4,3,1,1
3,2001,030102,6,5,1,1
4,2001,030102,6,6,0,2
5,2001,030102,10,10,0,0
6,2001,030102,4,4,0,0
7,2001,030102,9,9,0,2
8,2001,030102,2,2,0,0
9,2001,030102,12,12,0,2
10,2001,030102,9,9,0,0
11,2001,030102,3,3,0,1
12,2001,030102,6,6,0,0
1,2002,030102,5,5,0,0
2,2002,030102,1,1,0,0
3,2002,030102,4,4,0,2
4,2002,030102,3,2,1,0
5,2002,030102,5,5,0,4
6,2002,030102,7,6,1,0
7,2002,030102,11,9,2,1
8,2002,030102,8,8,0,0
9,2002,030102,7,5,2,1
10,2002,030102,8,6,2,2
11,2002,030102,6,6,0,2
12,2002,030102,5,4,1,0
1,2003,030102,2,1,1,0
2,2003,030102,4,4,0,3
3,2003,030102,3,2,1,0
4,2003,030102,10,9,1,1
5,2003,030102,13,11,2,1
6,2003,030102,4,4,0,0
7,2003,030102,9,6,3,1
8,2003,030102,9,9,0,3
9,2003,030102,5,3,2,0
10,2003,030102,5,4,1,0
11,2003,030102,7,6,1,0
12,2003,030102,3,3,0,2
1,2004,030102,3,3,0,0
2,2004,030102,2,2,0,0
3,2004,030102,2,1,1,2
4,2004,030102,1,1,0,0
5,2004,030102,12,11,1,2
6,2004,030102,4,4,0,0
7,2004,030102,6,6,0,2
8,2004,030102,4,4,0,1
9,2004,030102,11,11,0,0
10,2004,030102,11,10,1,3
11,2004,030102,3,3,0,2
12,2004,030102,9,7,2,3
1,2005,030102,6,3,3,0
2,2005,030102,5,4,1,3
3,2005,030102,4,3,1,1
4,2005,030102,1,1,0,1
5,2005,030102,1,1,0,1
6,2005,030102,6,4,2,4
7,2005,030102,11,9,2,1
8,2005,030102,5,4,1,1
9,2005,030102,9,9,0,4
10,2005,030102,3,3,0,2
11,2005,030102,6,5,1,1
12,2005,030102,4,4,0,2
1,2006,030102,4,3,1,0
2,2006,030102,1,1,0,1
3,2006,030102,8,6,2,0
4,2006,030102,1,1,0,4
5,2006,030102,4,2,2,0
6,2006,030102,10,10,0,2
7,2006,030102,5,5,0,1
8,2006,030102,10,9,1,1
9,2006,030102,3,3,0,0
10,2006,030102,7,7,0,3
11,2006,030102,5,5,0,2
12,2006,030102,2,2,0,1
1,2007,030102,3,3,0,0
2,2007,030102,7,6,1,1
3,2007,030102,2,2,0,0
4,2007,030102,9,7,2,1
5,2007,030102,8,8,0,2
6,2007,030102,5,5,0,0
7,2007,030102,9,8,1,1
8,2007,030102,7,5,2,4
9,2007,030102,3,3,0,3
10,2007,030102,11,10,1,2
11,2007,030102,6,6,0,3
12,2007,030102,3,3,0,0
1,2008,030102,4,3,1,0
2,2008,030102,4,3,1,2
3,2008,030102,5,4,1,1
4,2008,030102,5,5,0,0
5,2008,030102,1,1,0,2
6,2008,030102,6,6,0,0
7,2008,030102,9,8,1,0
8,2008,030102,6,6,0,3
9,2008,030102,5,5,0,0
10,2008,030102,9,9,0,1
11,2008,030102,3,2,1,0
12,2008,030102,1,1,0,0
1,2009,030102,2,2,0,0
2,2009,030102,2,2,0,0
3,2009,030102,5,4,1,0
4,2009,030102,9,9,0,0
5,2009,030102,4,4,0,0
6,2009,030102,3,3,0,0
7,2009,030102,10,9,1,0
8,2009,030102,4,4,0,1
9,2009,030102,5,3,2,2
10,2009,030102,7,7,0,0
11,2009,030102,3,2,1,0
12,2009,030102,7,5,2,0
1,2010,030102,4,4,0,0
2,2010,030102,4,3,1,0
3,2010,030102,4,3,1,0
4,2010,030102,6,6,0,0
5,2010,030102,7,6,1,1
6,2010,030102,4,3,1,1
7,2010,030102,6,5,1,0
8,2010,030102,2,2,0,1
9,2010,030102,4,4,0,0
10,2010,030102,4,3,1,1
11,2010,030102,6,5,1,2
12,2010,030102,8,8,0,1
1,2011,030102,5,5,0,0
2,2011,030102,3,3,0,1
1,1999,030103,6,6,0,1
2,1999,030103,6,6,0,2
3,1999,030103,5,5,0,0
4,1999,030103,6,5,1,2
5,1999,030103,5,5,0,0
6,1999,030103,7,7,0,0
7,1999,030103,6,4,2,1
8,1999,030103,8,7,1,1
9,1999,030103,5,4,1,2
10,1999,030103,8,8,0,7
11,1999,030103,8,7,1,1
12,1999,030103,4,4,0,2
1,2000,030103,5,4,1,3
2,2000,030103,3,2,1,1
3,2000,030103,6,6,0,2
4,2000,030103,12,12,0,1
5,2000,030103,7,5,2,1
6,2000,030103,17,17,0,0
7,2000,030103,7,4,3,1
8,2000,030103,12,11,1,1
9,2000,030103,11,9,2,0
10,2000,030103,8,8,0,1
11,2000,030103,6,6,0,5
12,2000,030103,5,4,1,2
1,2001,030103,3,3,0,3
2,2001,030103,5,5,0,4
3,2001,030103,6,6,0,5
4,2001,030103,8,8,0,3
5,2001,030103,5,5,0,1
6,2001,030103,7,6,1,0
7,2001,030103,14,14,0,2
8,2001,030103,7,7,0,2
9,2001,030103,8,8,0,0
10,2001,030103,11,11,0,0
11,2001,030103,4,4,0,1
12,2001,030103,7,7,0,0
1,2002,030103,2,2,0,0
2,2002,030103,5,4,1,0
3,2002,030103,5,5,0,1
4,2002,030103,8,8,0,1
5,2002,030103,10,6,4,1
6,2002,030103,7,7,0,1
7,2002,030103,5,4,1,0
8,2002,030103,6,4,2,0
9,2002,030103,4,4,0,1
10,2002,030103,6,5,1,0
11,2002,030103,2,2,0,1
12,2002,030103,4,4,0,0
1,2003,030103,4,4,0,2
2,2003,030103,3,3,0,2
3,2003,030103,8,8,0,5
4,2003,030103,2,2,0,1
5,2003,030103,3,2,1,1
6,2003,030103,10,8,2,0
7,2003,030103,5,3,2,2
8,2003,030103,9,9,0,1
9,2003,030103,5,5,0,3
10,2003,030103,2,2,0,2
11,2003,030103,6,6,0,0
12,2003,030103,10,10,0,3
1,2004,030103,2,2,0,5
2,2004,030103,3,3,0,5
3,2004,030103,3,2,1,1
4,2004,030103,3,3,0,1
5,2004,030103,7,7,0,1
6,2004,030103,5,5,0,0
7,2004,030103,5,4,1,3
8,2004,030103,5,4,1,0
9,2004,030103,9,9,0,4
10,2004,030103,8,8,0,2
11,2004,030103,4,3,1,2
12,2004,030103,9,9,0,7
1,2005,030103,9,9,0,2
2,2005,030103,2,2,0,2
3,2005,030103,5,5,0,1
4,2005,030103,4,4,0,2
5,2005,030103,17,14,3,3
6,2005,030103,6,6,0,0
7,2005,030103,10,9,1,3
8,2005,030103,4,3,1,0
9,2005,030103,4,4,0,1
10,2005,030103,3,3,0,2
11,2005,030103,7,7,0,2
12,2005,030103,7,6,1,1
1,2006,030103,4,3,1,0
2,2006,030103,4,3,1,2
3,2006,030103,6,6,0,1
4,2006,030103,5,5,0,0
5,2006,030103,3,2,1,1
6,2006,030103,6,5,1,2
7,2006,030103,8,7,1,1
8,2006,030103,5,4,1,1
9,2006,030103,3,3,0,0
10,2006,030103,5,5,0,1
11,2006,030103,3,3,0,0
12,2006,030103,5,5,0,2
1,2007,030103,7,7,0,4
2,2007,030103,3,3,0,1
3,2007,030103,4,4,0,0
4,2007,030103,3,3,0,1
5,2007,030103,7,7,0,0
6,2007,030103,3,3,0,2
7,2007,030103,6,6,0,0
8,2007,030103,5,5,0,1
9,2007,030103,4,4,0,1
10,2007,030103,2,2,0,1
11,2007,030103,4,4,0,0
12,2007,030103,6,6,0,1
1,2008,030103,1,1,0,0
2,2008,030103,3,3,0,1
3,2008,030103,9,8,1,0
4,2008,030103,5,5,0,1
5,2008,030103,6,4,2,0
6,2008,030103,7,7,0,0
7,2008,030103,8,8,0,0
8,2008,030103,5,5,0,0
9,2008,030103,7,7,0,1
10,2008,030103,5,5,0,0
11,2008,030103,6,5,1,0
12,2008,030103,0,0,0,0
1,2009,030103,4,2,2,0
2,2009,030103,3,3,0,0
3,2009,030103,5,4,1,0
4,2009,030103,5,5,0,0
5,2009,030103,5,5,0,0
6,2009,030103,2,2,0,0
7,2009,030103,9,9,0,0
8,2009,030103,3,3,0,0
9,2009,030103,8,8,0,0
10,2009,030103,3,3,0,0
11,2009,030103,4,4,0,0
12,2009,030103,4,4,0,0
1,2010,030103,7,6,1,0
2,2010,030103,1,1,0,0
3,2010,030103,7,5,2,0
4,2010,030103,2,1,1,0
5,2010,030103,5,5,0,0
6,2010,030103,3,3,0,0
7,2010,030103,8,8,0,0
8,2010,030103,4,4,0,0
9,2010,030103,0,0,0,0
10,2010,030103,3,2,1,0
11,2010,030103,4,4,0,0
12,2010,030103,5,5,0,0
1,2011,030103,3,3,0,0
2,2011,030103,4,4,0,3
1,1999,030104,3,3,0,0
2,1999,030104,2,1,1,0
3,1999,030104,3,3,0,0
4,1999,030104,3,3,0,0
5,1999,030104,6,6,0,0
6,1999,030104,6,5,1,0
7,1999,030104,6,5,1,0
8,1999,030104,6,4,2,1
9,1999,030104,5,4,1,2
10,1999,030104,8,8,0,0
11,1999,030104,7,6,1,1
12,1999,030104,4,4,0,0
1,2000,030104,4,4,0,0
2,2000,030104,3,2,1,3
3,2000,030104,2,2,0,0
4,2000,030104,5,5,0,1
5,2000,030104,6,6,0,0
6,2000,030104,4,4,0,1
7,2000,030104,8,7,1,0
8,2000,030104,7,7,0,0
9,2000,030104,11,11,0,0
10,2000,030104,6,6,0,0
11,2000,030104,4,2,2,1
12,2000,030104,3,2,1,0
1,2001,030104,2,1,1,0
2,2001,030104,4,4,0,1
3,2001,030104,1,1,0,1
4,2001,030104,3,2,1,1
5,2001,030104,3,2,1,1
6,2001,030104,4,4,0,0
7,2001,030104,10,9,1,0
8,2001,030104,4,3,1,0
9,2001,030104,5,5,0,0
10,2001,030104,7,7,0,0
11,2001,030104,3,2,1,0
12,2001,030104,1,1,0,0
1,2002,030104,1,1,0,1
2,2002,030104,7,7,0,0
3,2002,030104,1,1,0,1
4,2002,030104,1,1,0,0
5,2002,030104,4,4,0,0
6,2002,030104,2,2,0,0
7,2002,030104,3,3,0,0
8,2002,030104,0,0,0,0
9,2002,030104,3,2,1,0
10,2002,030104,6,4,2,0
11,2002,030104,3,3,0,0
12,2002,030104,5,5,0,0
1,2003,030104,2,2,0,0
2,2003,030104,3,3,0,0
3,2003,030104,5,4,1,0
4,2003,030104,7,6,1,1
5,2003,030104,4,4,0,0
6,2003,030104,3,3,0,0
7,2003,030104,3,3,0,2
8,2003,030104,4,4,0,0
9,2003,030104,3,3,0,0
10,2003,030104,5,5,0,0
11,2003,030104,2,2,0,0
12,2003,030104,4,4,0,1
1,2004,030104,3,3,0,0
2,2004,030104,5,4,1,0
3,2004,030104,0,0,0,0
4,2004,030104,10,10,0,0
5,2004,030104,5,5,0,0
6,2004,030104,4,4,0,1
7,2004,030104,0,0,0,1
8,2004,030104,4,4,0,0
9,2004,030104,0,0,0,1
10,2004,030104,2,2,0,2
11,2004,030104,2,2,0,0
12,2004,030104,5,4,1,0
1,2005,030104,3,3,0,1
2,2005,030104,2,2,0,0
3,2005,030104,4,4,0,1
4,2005,030104,4,4,0,0
5,2005,030104,1,1,0,0
6,2005,030104,3,3,0,0
7,2005,030104,0,0,0,3
8,2005,030104,7,7,0,0
9,2005,030104,1,1,0,0
10,2005,030104,2,2,0,0
11,2005,030104,4,4,0,0
12,2005,030104,4,4,0,2
1,2006,030104,1,1,0,0
2,2006,030104,1,1,0,0
3,2006,030104,1,0,1,0
4,2006,030104,1,1,0,0
5,2006,030104,3,3,0,0
6,2006,030104,4,4,0,1
7,2006,030104,8,8,0,0
8,2006,030104,3,3,0,1
9,2006,030104,3,3,0,0
10,2006,030104,3,3,0,1
11,2006,030104,2,2,0,0
12,2006,030104,3,3,0,0
1,2007,030104,4,4,0,0
2,2007,030104,0,0,0,0
3,2007,030104,3,3,0,0
4,2007,030104,2,2,0,0
5,2007,030104,2,0,2,0
6,2007,030104,0,0,0,0
7,2007,030104,4,4,0,0
8,2007,030104,3,2,1,0
9,2007,030104,2,1,1,1
10,2007,030104,3,3,0,0
11,2007,030104,2,2,0,0
12,2007,030104,2,2,0,0
1,2008,030104,1,1,0,0
2,2008,030104,3,3,0,1
3,2008,030104,0,0,0,0
4,2008,030104,1,0,1,0
5,2008,030104,4,4,0,0
6,2008,030104,5,5,0,0
7,2008,030104,3,3,0,0
8,2008,030104,1,1,0,0
9,2008,030104,3,2,1,0
10,2008,030104,2,2,0,1
11,2008,030104,3,3,0,1
12,2008,030104,2,1,1,0
1,2009,030104,1,1,0,0
2,2009,030104,3,3,0,0
3,2009,030104,3,1,2,0
4,2009,030104,0,0,0,0
5,2009,030104,5,4,1,0
6,2009,030104,3,3,0,0
7,2009,030104,7,7,0,1
8,2009,030104,4,2,2,0
9,2009,030104,0,0,0,1
10,2009,030104,6,5,1,0
11,2009,030104,2,2,0,1
12,2009,030104,2,2,0,0
1,2010,030104,5,4,1,0
2,2010,030104,2,2,0,0
3,2010,030104,1,0,1,0
4,2010,030104,4,4,0,0
5,2010,030104,1,1,0,0
6,2010,030104,5,4,1,0
7,2010,030104,3,2,1,0
8,2010,030104,5,5,0,0
9,2010,030104,1,1,0,0
10,2010,030104,7,7,0,0
11,2010,030104,5,5,0,2
12,2010,030104,3,3,0,0
1,2011,030104,1,1,0,0
2,2011,030104,1,1,0,0
1,1999,090300,1,1,0,0
2,1999,090300,2,2,0,0
3,1999,090300,2,2,0,0
4,1999,090300,1,0,1,0
5,1999,090300,1,1,0,0
6,1999,090300,1,1,0,0
7,1999,090300,2,2,0,1
8,1999,090300,3,3,0,0
9,1999,090300,1,1,0,0
10,1999,090300,0,0,0,0
11,1999,090300,1,1,0,0
12,1999,090300,0,0,0,0
1,2000,090300,2,1,1,3
2,2000,090300,1,0,1,0
3,2000,090300,0,0,0,0
4,2000,090300,0,0,0,2
5,2000,090300,1,1,0,0
6,2000,090300,2,2,0,0
7,2000,090300,7,7,0,0
8,2000,090300,1,1,0,1
9,2000,090300,1,1,0,1
10,2000,090300,5,5,0,0
11,2000,090300,4,3,1,0
12,2000,090300,3,3,0,0
1,2001,090300,0,0,0,0
2,2001,090300,2,2,0,0
3,2001,090300,3,3,0,0
4,2001,090300,1,1,0,0
5,2001,090300,0,0,0,0
6,2001,090300,2,2,0,0
7,2001,090300,2,2,0,0
8,2001,090300,2,2,0,0
9,2001,090300,3,2,1,0
10,2001,090300,0,0,0,0
11,2001,090300,4,4,0,2
12,2001,090300,0,0,0,0
1,2002,090300,0,0,0,0
2,2002,090300,1,1,0,0
3,2002,090300,1,1,0,0
4,2002,090300,0,0,0,0
5,2002,090300,0,0,0,0
6,2002,090300,2,2,0,0
7,2002,090300,1,1,0,0
8,2002,090300,2,2,0,0
9,2002,090300,1,1,0,0
10,2002,090300,1,1,0,0
11,2002,090300,1,1,0,0
12,2002,090300,3,3,0,0
1,2003,090300,1,0,1,0
2,2003,090300,2,2,0,0
3,2003,090300,2,2,0,0
4,2003,090300,1,1,0,0
5,2003,090300,1,1,0,0
6,2003,090300,1,0,1,0
7,2003,090300,1,1,0,0
8,2003,090300,1,1,0,0
9,2003,090300,0,0,0,0
10,2003,090300,0,0,0,0
11,2003,090300,1,0,1,1
12,2003,090300,3,3,0,0
1,2004,090300,0,0,0,0
2,2004,090300,1,1,0,0
3,2004,090300,2,2,0,0
4,2004,090300,1,1,0,0
5,2004,090300,1,1,0,1
6,2004,090300,1,1,0,0
7,2004,090300,1,1,0,0
8,2004,090300,1,1,0,0
9,2004,090300,1,1,0,0
10,2004,090300,2,2,0,1
11,2004,090300,1,1,0,0
12,2004,090300,1,1,0,0
1,2005,090300,1,1,0,0
2,2005,090300,3,3,0,0
3,2005,090300,2,2,0,0
4,2005,090300,1,1,0,0
5,2005,090300,5,5,0,0
6,2005,090300,3,3,0,0
7,2005,090300,1,1,0,0
8,2005,090300,3,3,0,1
9,2005,090300,1,1,0,0
10,2005,090300,1,1,0,0
11,2005,090300,1,1,0,0
12,2005,090300,1,1,0,0
1,2006,090300,3,3,0,0
2,2006,090300,3,3,0,0
3,2006,090300,1,1,0,0
4,2006,090300,1,1,0,0
5,2006,090300,4,4,0,0
6,2006,090300,1,1,0,0
7,2006,090300,0,0,0,0
8,2006,090300,0,0,0,0
9,2006,090300,1,1,0,1
10,2006,090300,3,3,0,0
11,2006,090300,1,1,0,0
12,2006,090300,0,0,0,0
1,2007,090300,0,0,0,0
2,2007,090300,0,0,0,0
3,2007,090300,1,1,0,0
4,2007,090300,0,0,0,0
5,2007,090300,3,2,1,0
6,2007,090300,2,1,1,2
7,2007,090300,4,3,1,0
8,2007,090300,5,3,2,0
9,2007,090300,0,0,0,0
10,2007,090300,1,1,0,0
11,2007,090300,2,2,0,0
12,2007,090300,0,0,0,0
1,2008,090300,3,3,0,0
2,2008,090300,4,4,0,0
3,2008,090300,0,0,0,0
4,2008,090300,3,3,0,0
5,2008,090300,2,2,0,0
6,2008,090300,2,2,0,0
7,2008,090300,1,1,0,0
8,2008,090300,1,1,0,0
9,2008,090300,1,1,0,0
10,2008,090300,1,1,0,0
11,2008,090300,0,0,0,0
12,2008,090300,1,1,0,0
1,2009,090300,3,2,1,0
2,2009,090300,1,1,0,0
3,2009,090300,2,2,0,0
4,2009,090300,2,2,0,0
5,2009,090300,0,0,0,1
6,2009,090300,1,0,1,0
7,2009,090300,2,2,0,0
8,2009,090300,3,3,0,0
9,2009,090300,1,1,0,0
10,2009,090300,0,0,0,0
11,2009,090300,1,1,0,0
12,2009,090300,1,1,0,0
1,2010,090300,1,1,0,0
2,2010,090300,0,0,0,0
3,2010,090300,0,0,0,0
4,2010,090300,1,1,0,0
5,2010,090300,0,0,0,0
6,2010,090300,1,1,0,1
7,2010,090300,0,0,0,1
8,2010,090300,2,2,0,0
9,2010,090300,0,0,0,0
10,2010,090300,1,1,0,0
11,2010,090300,2,2,0,0
12,2010,090300,1,1,0,0
1,2011,090300,1,1,0,0
2,2011,090300,0,0,0,0
1,1999,090200,13,13,0,0
2,1999,090200,8,8,0,0
3,1999,090200,9,9,0,2
4,1999,090200,9,8,1,0
5,1999,090200,8,7,1,0
6,1999,090200,9,9,0,1
7,1999,090200,12,11,1,5
8,1999,090200,17,15,2,1
9,1999,090200,6,5,1,2
10,1999,090200,3,3,0,0
11,1999,090200,8,8,0,1
12,1999,090200,8,8,0,2
1,2000,090200,11,10,1,1
2,2000,090200,14,14,0,0
3,2000,090200,8,8,0,0
4,2000,090200,3,2,1,0
5,2000,090200,9,8,1,0
6,2000,090200,7,7,0,0
7,2000,090200,14,12,2,0
8,2000,090200,10,9,1,0
9,2000,090200,7,7,0,0
10,2000,090200,16,15,1,0
11,2000,090200,9,8,1,0
12,2000,090200,7,7,0,0
1,2001,090200,8,7,1,0
2,2001,090200,6,6,0,0
3,2001,090200,7,7,0,0
4,2001,090200,20,19,1,0
5,2001,090200,12,12,0,0
6,2001,090200,17,15,2,0
7,2001,090200,10,10,0,0
8,2001,090200,13,13,0,0
9,2001,090200,9,9,0,0
10,2001,090200,8,7,1,0
11,2001,090200,4,4,0,1
12,2001,090200,12,11,1,0
1,2002,090200,11,10,1,0
2,2002,090200,3,3,0,1
3,2002,090200,6,5,1,0
4,2002,090200,7,7,0,1
5,2002,090200,5,5,0,1
6,2002,090200,16,12,4,0
7,2002,090200,8,8,0,0
8,2002,090200,7,7,0,0
9,2002,090200,11,10,1,1
10,2002,090200,3,2,1,0
11,2002,090200,8,8,0,0
12,2002,090200,7,6,1,0
1,2003,090200,4,4,0,0
2,2003,090200,7,7,0,0
3,2003,090200,5,5,0,0
4,2003,090200,4,4,0,0
5,2003,090200,5,5,0,0
6,2003,090200,3,3,0,1
7,2003,090200,5,4,1,1
8,2003,090200,7,7,0,0
9,2003,090200,4,4,0,0
10,2003,090200,5,5,0,0
11,2003,090200,3,3,0,1
12,2003,090200,6,6,0,0
1,2004,090200,1,1,0,0
2,2004,090200,9,8,1,0
3,2004,090200,4,3,1,0
4,2004,090200,4,4,0,0
5,2004,090200,6,6,0,0
6,2004,090200,8,7,1,0
7,2004,090200,7,4,3,1
8,2004,090200,5,4,1,0
9,2004,090200,10,9,1,1
10,2004,090200,7,6,1,0
11,2004,090200,8,8,0,0
12,2004,090200,2,2,0,0
1,2005,090200,8,8,0,2
2,2005,090200,3,2,1,0
3,2005,090200,9,8,1,0
4,2005,090200,4,4,0,0
5,2005,090200,10,10,0,0
6,2005,090200,4,3,1,0
7,2005,090200,7,7,0,0
8,2005,090200,8,4,4,1
9,2005,090200,10,10,0,0
10,2005,090200,4,4,0,1
11,2005,090200,2,1,1,1
12,2005,090200,11,11,0,1
1,2006,090200,4,4,0,1
2,2006,090200,3,3,0,0
3,2006,090200,5,5,0,0
4,2006,090200,9,7,2,0
5,2006,090200,8,8,0,1
6,2006,090200,11,11,0,0
7,2006,090200,12,12,0,0
8,2006,090200,6,6,0,1
9,2006,090200,2,2,0,2
10,2006,090200,3,3,0,0
11,2006,090200,10,9,1,0
12,2006,090200,4,4,0,0
1,2007,090200,9,9,0,0
2,2007,090200,7,7,0,0
3,2007,090200,6,6,0,0
4,2007,090200,6,5,1,0
5,2007,090200,3,3,0,0
6,2007,090200,5,4,1,0
7,2007,090200,5,5,0,0
8,2007,090200,4,3,1,0
9,2007,090200,6,6,0,1
10,2007,090200,3,3,0,0
11,2007,090200,4,4,0,0
12,2007,090200,7,6,1,0
1,2008,090200,5,5,0,0
2,2008,090200,6,6,0,0
3,2008,090200,3,3,0,0
4,2008,090200,9,9,0,0
5,2008,090200,11,10,1,0
6,2008,090200,6,6,0,0
7,2008,090200,10,10,0,0
8,2008,090200,11,11,0,0
9,2008,090200,1,1,0,0
10,2008,090200,4,4,0,1
11,2008,090200,4,4,0,0
12,2008,090200,5,5,0,0
1,2009,090200,2,2,0,0
2,2009,090200,4,4,0,0
3,2009,090200,5,5,0,0
4,2009,090200,11,11,0,0
5,2009,090200,5,5,0,1
6,2009,090200,9,9,0,0
7,2009,090200,12,10,2,0
8,2009,090200,5,4,1,0
9,2009,090200,11,9,2,2
10,2009,090200,12,11,1,0
11,2009,090200,6,5,1,0
12,2009,090200,4,3,1,0
1,2010,090200,5,5,0,1
2,2010,090200,8,8,0,0
3,2010,090200,3,3,0,0
4,2010,090200,6,5,1,0
5,2010,090200,6,6,0,0
6,2010,090200,5,5,0,1
7,2010,090200,6,6,0,0
8,2010,090200,6,6,0,1
9,2010,090200,3,3,0,0
10,2010,090200,10,9,1,0
11,2010,090200,1,1,0,0
12,2010,090200,2,2,0,0
1,2011,090200,8,8,0,0
2,2011,090200,5,4,1,0
1,1999,020601,12,11,1,0
2,1999,020601,21,21,0,1
3,1999,020601,14,10,4,1
4,1999,020601,18,18,0,0
5,1999,020601,20,19,1,1
6,1999,020601,14,14,0,1
7,1999,020601,16,13,3,1
8,1999,020601,19,16,3,0
9,1999,020601,22,22,0,1
10,1999,020601,21,20,1,0
11,1999,020601,16,16,0,2
12,1999,020601,15,14,1,0
1,2000,020601,14,14,0,1
2,2000,020601,14,14,0,7
3,2000,020601,14,14,0,4
4,2000,020601,19,19,0,1
5,2000,020601,17,17,0,1
6,2000,020601,21,21,0,0
7,2000,020601,12,12,0,1
8,2000,020601,24,22,2,4
9,2000,020601,17,17,0,3
10,2000,020601,18,16,2,1
11,2000,020601,14,13,1,1
12,2000,020601,23,20,3,0
1,2001,020601,10,9,1,1
2,2001,020601,10,10,0,1
3,2001,020601,12,11,1,8
4,2001,020601,10,10,0,0
5,2001,020601,10,10,0,0
6,2001,020601,14,14,0,1
7,2001,020601,17,15,2,0
8,2001,020601,16,16,0,0
9,2001,020601,11,11,0,1
10,2001,020601,9,9,0,0
11,2001,020601,14,13,1,2
12,2001,020601,13,12,1,0
1,2002,020601,6,5,1,0
2,2002,020601,17,16,1,0
3,2002,020601,12,12,0,0
4,2002,020601,10,9,1,0
5,2002,020601,18,18,0,3
6,2002,020601,18,18,0,1
7,2002,020601,28,25,3,1
8,2002,020601,10,10,0,4
9,2002,020601,11,11,0,0
10,2002,020601,19,17,2,1
11,2002,020601,12,12,0,1
12,2002,020601,16,15,1,0
1,2003,020601,11,11,0,1
2,2003,020601,16,16,0,0
3,2003,020601,13,13,0,0
4,2003,020601,12,9,3,0
5,2003,020601,13,13,0,0
6,2003,020601,11,10,1,1
7,2003,020601,11,11,0,1
8,2003,020601,20,20,0,4
9,2003,020601,14,13,1,0
10,2003,020601,13,11,2,0
11,2003,020601,16,14,2,1
12,2003,020601,11,11,0,0
1,2004,020601,17,16,1,3
2,2004,020601,6,5,1,1
3,2004,020601,15,13,2,1
4,2004,020601,11,10,1,2
5,2004,020601,20,19,1,0
6,2004,020601,17,17,0,0
7,2004,020601,21,21,0,0
8,2004,020601,16,15,1,0
9,2004,020601,16,16,0,2
10,2004,020601,23,22,1,1
11,2004,020601,15,13,2,1
12,2004,020601,11,11,0,0
1,2005,020601,13,13,0,1
2,2005,020601,16,14,2,0
3,2005,020601,14,13,1,0
4,2005,020601,5,4,1,2
5,2005,020601,16,15,1,2
6,2005,020601,15,14,1,2
7,2005,020601,14,11,3,0
8,2005,020601,15,14,1,1
9,2005,020601,32,29,3,2
10,2005,020601,24,24,0,1
11,2005,020601,15,15,0,4
12,2005,020601,8,7,1,2
1,2006,020601,13,12,1,2
2,2006,020601,17,15,2,0
3,2006,020601,13,11,2,0
4,2006,020601,13,13,0,0
5,2006,020601,19,18,1,3
6,2006,020601,14,14,0,1
7,2006,020601,18,17,1,1
8,2006,020601,10,10,0,2
9,2006,020601,15,15,0,0
10,2006,020601,10,9,1,3
11,2006,020601,12,12,0,1
12,2006,020601,9,9,0,0
1,2007,020601,7,6,1,2
2,2007,020601,11,11,0,0
3,2007,020601,11,10,1,0
4,2007,020601,6,6,0,0
5,2007,020601,5,4,1,3
6,2007,020601,7,7,0,2
7,2007,020601,15,14,1,2
8,2007,020601,14,13,1,2
9,2007,020601,5,4,1,0
10,2007,020601,14,13,1,3
11,2007,020601,16,15,1,3
12,2007,020601,5,4,1,1
1,2008,020601,9,7,2,0
2,2008,020601,5,5,0,1
3,2008,020601,9,7,2,0
4,2008,020601,16,14,2,2
5,2008,020601,8,8,0,2
6,2008,020601,21,21,0,3
7,2008,020601,12,10,2,0
8,2008,020601,15,14,1,1
9,2008,020601,13,11,2,3
10,2008,020601,12,12,0,2
11,2008,020601,20,20,0,8
12,2008,020601,11,11,0,1
1,2009,020601,9,8,1,3
2,2009,020601,10,10,0,5
3,2009,020601,12,10,2,2
4,2009,020601,15,14,1,2
5,2009,020601,22,19,3,2
6,2009,020601,12,11,1,0
7,2009,020601,18,17,1,4
8,2009,020601,12,10,2,0
9,2009,020601,17,16,1,0
10,2009,020601,11,11,0,4
11,2009,020601,12,11,1,3
12,2009,020601,14,13,1,1
1,2010,020601,9,7,2,2
2,2010,020601,8,7,1,0
3,2010,020601,15,15,0,2
4,2010,020601,6,3,3,0
5,2010,020601,12,12,0,1
6,2010,020601,15,14,1,0
7,2010,020601,18,18,0,1
8,2010,020601,15,14,1,1
9,2010,020601,14,14,0,0
10,2010,020601,15,14,1,1
11,2010,020601,13,11,2,0
12,2010,020601,9,9,0,0
1,2011,020601,13,13,0,3
2,2011,020601,8,8,0,0
1,1999,020602,14,14,0,3
2,1999,020602,10,9,1,0
3,1999,020602,14,12,2,1
4,1999,020602,10,10,0,0
5,1999,020602,17,16,1,0
6,1999,020602,8,8,0,0
7,1999,020602,25,24,1,0
8,1999,020602,13,13,0,2
9,1999,020602,20,20,0,0
10,1999,020602,25,24,1,0
11,1999,020602,8,8,0,0
12,1999,020602,13,12,1,2
1,2000,020602,8,8,0,0
2,2000,020602,11,9,2,0
3,2000,020602,10,10,0,2
4,2000,020602,17,16,1,0
5,2000,020602,20,19,1,0
6,2000,020602,14,11,3,0
7,2000,020602,21,20,1,0
8,2000,020602,16,15,1,0
9,2000,020602,28,25,3,0
10,2000,020602,19,16,3,0
11,2000,020602,15,15,0,2
12,2000,020602,17,17,0,0
1,2001,020602,13,12,1,1
2,2001,020602,18,14,4,0
3,2001,020602,6,6,0,1
4,2001,020602,8,7,1,0
5,2001,020602,14,13,1,2
6,2001,020602,16,14,2,0
7,2001,020602,9,7,2,1
8,2001,020602,13,10,3,0
9,2001,020602,15,14,1,2
10,2001,020602,20,20,0,1
11,2001,020602,18,17,1,0
12,2001,020602,10,10,0,0
1,2002,020602,11,10,1,0
2,2002,020602,12,11,1,0
3,2002,020602,8,7,1,2
4,2002,020602,10,8,2,0
5,2002,020602,10,9,1,2
6,2002,020602,18,14,4,0
7,2002,020602,20,17,3,3
8,2002,020602,9,8,1,1
9,2002,020602,12,12,0,0
10,2002,020602,10,8,2,0
11,2002,020602,10,10,0,1
12,2002,020602,13,11,2,1
1,2003,020602,3,2,1,0
2,2003,020602,9,8,1,2
3,2003,020602,11,10,1,1
4,2003,020602,7,5,2,0
5,2003,020602,13,10,3,3
6,2003,020602,15,12,3,1
7,2003,020602,14,14,0,0
8,2003,020602,16,13,3,1
9,2003,020602,6,6,0,0
10,2003,020602,11,11,0,2
11,2003,020602,11,10,1,0
12,2003,020602,14,11,3,3
1,2004,020602,11,11,0,1
2,2004,020602,9,9,0,0
3,2004,020602,9,8,1,1
4,2004,020602,15,14,1,0
5,2004,020602,14,13,1,1
6,2004,020602,12,12,0,0
7,2004,020602,7,7,0,1
8,2004,020602,28,26,2,0
9,2004,020602,11,11,0,3
10,2004,020602,21,19,2,0
11,2004,020602,13,13,0,1
12,2004,020602,11,11,0,2
1,2005,020602,12,11,1,3
2,2005,020602,10,9,1,2
3,2005,020602,6,6,0,1
4,2005,020602,9,9,0,0
5,2005,020602,9,9,0,1
6,2005,020602,12,12,0,0
7,2005,020602,15,13,2,5
8,2005,020602,16,16,0,2
9,2005,020602,15,15,0,1
10,2005,020602,12,12,0,2
11,2005,020602,10,8,2,0
12,2005,020602,7,6,1,0
1,2006,020602,15,13,2,2
2,2006,020602,11,11,0,0
3,2006,020602,9,8,1,5
4,2006,020602,17,15,2,2
5,2006,020602,12,11,1,2
6,2006,020602,15,15,0,3
7,2006,020602,12,11,1,4
8,2006,020602,19,18,1,2
9,2006,020602,18,17,1,1
10,2006,020602,6,6,0,3
11,2006,020602,17,17,0,0
12,2006,020602,11,11,0,1
1,2007,020602,14,13,1,2
2,2007,020602,7,6,1,1
3,2007,020602,8,8,0,2
4,2007,020602,4,3,1,2
5,2007,020602,12,11,1,0
6,2007,020602,7,6,1,5
7,2007,020602,9,8,1,1
8,2007,020602,13,12,1,0
9,2007,020602,11,10,1,2
10,2007,020602,11,10,1,2
11,2007,020602,4,4,0,3
12,2007,020602,8,8,0,0
1,2008,020602,4,4,0,2
2,2008,020602,5,5,0,0
3,2008,020602,12,12,0,2
4,2008,020602,14,13,1,1
5,2008,020602,14,14,0,5
6,2008,020602,12,11,1,5
7,2008,020602,14,14,0,5
8,2008,020602,9,9,0,10
9,2008,020602,10,9,1,2
10,2008,020602,15,14,1,3
11,2008,020602,15,15,0,2
12,2008,020602,12,11,1,2
1,2009,020602,9,6,3,4
2,2009,020602,12,12,0,2
3,2009,020602,15,15,0,3
4,2009,020602,7,7,0,5
5,2009,020602,12,12,0,3
6,2009,020602,8,7,1,0
7,2009,020602,15,13,2,4
8,2009,020602,6,5,1,3
9,2009,020602,8,8,0,3
10,2009,020602,12,12,0,4
11,2009,020602,12,10,2,1
12,2009,020602,7,7,0,0
1,2010,020602,7,7,0,5
2,2010,020602,8,8,0,3
3,2010,020602,12,10,2,1
4,2010,020602,6,4,2,1
5,2010,020602,16,16,0,1
6,2010,020602,15,12,3,1
7,2010,020602,14,13,1,2
8,2010,020602,18,15,3,3
9,2010,020602,9,9,0,3
10,2010,020602,7,7,0,3
11,2010,020602,17,15,2,1
12,2010,020602,7,7,0,1
1,2011,020602,7,7,0,0
2,2011,020602,4,4,0,0
1,1999,020500,32,29,3,2
2,1999,020500,22,18,4,1
3,1999,020500,31,29,2,3
4,1999,020500,22,18,4,2
5,1999,020500,29,27,2,3
6,1999,020500,28,28,0,6
7,1999,020500,34,33,1,2
8,1999,020500,35,30,5,3
9,1999,020500,38,37,1,3
10,1999,020500,30,28,2,5
11,1999,020500,24,23,1,5
12,1999,020500,36,33,3,2
1,2000,020500,26,25,1,5
2,2000,020500,26,24,2,8
3,2000,020500,31,29,2,5
4,2000,020500,23,21,2,8
5,2000,020500,29,28,1,2
6,2000,020500,21,19,2,2
7,2000,020500,25,23,2,2
8,2000,020500,26,24,2,6
9,2000,020500,22,19,3,2
10,2000,020500,24,21,3,3
11,2000,020500,22,22,0,4
12,2000,020500,23,21,2,4
1,2001,020500,23,21,2,1
2,2001,020500,12,10,2,3
3,2001,020500,15,14,1,3
4,2001,020500,18,13,5,0
5,2001,020500,17,12,5,0
6,2001,020500,19,16,3,1
7,2001,020500,24,21,3,4
8,2001,020500,27,23,4,1
9,2001,020500,25,18,7,2
10,2001,020500,23,22,1,3
11,2001,020500,17,16,1,2
12,2001,020500,28,26,2,2
1,2002,020500,17,15,2,1
2,2002,020500,16,13,3,7
3,2002,020500,19,19,0,3
4,2002,020500,16,13,3,1
5,2002,020500,17,13,4,1
6,2002,020500,18,18,0,5
7,2002,020500,20,19,1,2
8,2002,020500,21,18,3,3
9,2002,020500,14,9,5,0
10,2002,020500,16,16,0,1
11,2002,020500,20,20,0,2
12,2002,020500,25,24,1,1
1,2003,020500,12,12,0,3
2,2003,020500,20,18,2,0
3,2003,020500,16,13,3,1
4,2003,020500,16,12,4,2
5,2003,020500,16,15,1,0
6,2003,020500,12,11,1,1
7,2003,020500,21,18,3,2
8,2003,020500,18,14,4,0
9,2003,020500,16,15,1,3
10,2003,020500,30,29,1,0
11,2003,020500,21,20,1,0
12,2003,020500,18,16,2,0
1,2004,020500,18,14,4,0
2,2004,020500,19,16,3,0
3,2004,020500,22,19,3,4
4,2004,020500,17,15,2,2
5,2004,020500,22,21,1,2
6,2004,020500,22,21,1,1
7,2004,020500,22,21,1,1
8,2004,020500,23,21,2,1
9,2004,020500,19,18,1,0
10,2004,020500,27,27,0,1
11,2004,020500,28,26,2,2
12,2004,020500,13,13,0,3
1,2005,020500,21,21,0,2
2,2005,020500,18,18,0,1
3,2005,020500,22,22,0,5
4,2005,020500,16,15,1,2
5,2005,020500,21,21,0,6
6,2005,020500,22,19,3,1
7,2005,020500,25,22,3,7
8,2005,020500,22,19,3,4
9,2005,020500,25,23,2,2
10,2005,020500,20,18,2,4
11,2005,020500,20,17,3,3
12,2005,020500,14,12,2,2
1,2006,020500,22,22,0,2
2,2006,020500,13,13,0,6
3,2006,020500,24,22,2,2
4,2006,020500,17,12,5,5
5,2006,020500,21,18,3,3
6,2006,020500,9,6,3,2
7,2006,020500,22,20,2,2
8,2006,020500,17,15,2,4
9,2006,020500,22,21,1,3
10,2006,020500,16,14,2,0
11,2006,020500,19,17,2,1
12,2006,020500,23,22,1,5
1,2007,020500,13,12,1,2
2,2007,020500,9,8,1,4
3,2007,020500,20,18,2,1
4,2007,020500,12,12,0,2
5,2007,020500,9,7,2,4
6,2007,020500,10,9,1,1
7,2007,020500,17,15,2,3
8,2007,020500,13,12,1,3
9,2007,020500,24,20,4,3
10,2007,020500,14,13,1,2
11,2007,020500,15,14,1,7
12,2007,020500,8,7,1,2
1,2008,020500,19,19,0,2
2,2008,020500,16,16,0,5
3,2008,020500,21,21,0,9
4,2008,020500,16,15,1,1
5,2008,020500,14,13,1,3
6,2008,020500,15,13,2,3
7,2008,020500,22,18,4,0
8,2008,020500,36,34,2,7
9,2008,020500,21,20,1,2
10,2008,020500,25,24,1,7
11,2008,020500,16,14,2,8
12,2008,020500,14,12,2,1
1,2009,020500,11,10,1,3
2,2009,020500,12,11,1,2
3,2009,020500,19,17,2,2
4,2009,020500,15,15,0,6
5,2009,020500,8,8,0,3
6,2009,020500,15,13,2,5
7,2009,020500,20,18,2,6
8,2009,020500,21,19,2,7
9,2009,020500,21,19,2,3
10,2009,020500,22,20,2,4
11,2009,020500,28,26,2,4
12,2009,020500,20,19,1,3
1,2010,020500,24,23,1,2
2,2010,020500,16,16,0,7
3,2010,020500,13,12,1,4
4,2010,020500,9,9,0,6
5,2010,020500,22,19,3,1
6,2010,020500,21,19,2,6
7,2010,020500,17,14,3,3
8,2010,020500,21,20,1,4
9,2010,020500,17,15,2,3
10,2010,020500,14,13,1,6
11,2010,020500,24,22,2,4
12,2010,020500,27,26,1,0
1,2011,020500,40,35,5,1
2,2011,020500,11,10,1,3
1,1999,830600,21,16,5,12
2,1999,830600,36,30,6,9
3,1999,830600,26,24,2,19
4,1999,830600,20,13,7,19
5,1999,830600,30,25,5,11
6,1999,830600,27,25,2,14
7,1999,830600,39,31,8,13
8,1999,830600,35,31,4,15
9,1999,830600,45,38,7,19
10,1999,830600,32,27,5,22
11,1999,830600,22,20,2,15
12,1999,830600,32,29,3,11
1,2000,830600,41,37,4,14
2,2000,830600,26,25,1,7
3,2000,830600,30,24,6,10
4,2000,830600,23,19,4,7
5,2000,830600,35,28,7,5
6,2000,830600,28,21,7,9
7,2000,830600,28,26,2,19
8,2000,830600,29,27,2,15
9,2000,830600,32,29,3,22
10,2000,830600,21,18,3,16
11,2000,830600,21,14,7,6
12,2000,830600,17,14,3,6
1,2001,830600,18,15,3,26
2,2001,830600,16,13,3,17
3,2001,830600,18,16,2,12
4,2001,830600,22,18,4,13
5,2001,830600,21,16,5,6
6,2001,830600,20,20,0,15
7,2001,830600,34,33,1,7
8,2001,830600,20,19,1,11
9,2001,830600,25,21,4,5
10,2001,830600,31,27,4,18
11,2001,830600,20,17,3,12
12,2001,830600,17,13,4,14
1,2002,830600,21,19,2,6
2,2002,830600,19,17,2,9
3,2002,830600,16,12,4,7
4,2002,830600,24,22,2,5
5,2002,830600,23,21,2,10
6,2002,830600,6,4,2,4
7,2002,830600,29,26,3,3
8,2002,830600,24,19,5,12
9,2002,830600,25,19,6,3
10,2002,830600,31,23,8,6
11,2002,830600,16,14,2,6
12,2002,830600,27,24,3,7
1,2003,830600,13,12,1,7
2,2003,830600,16,13,3,6
3,2003,830600,20,17,3,11
4,2003,830600,16,13,3,16
5,2003,830600,22,19,3,11
6,2003,830600,24,22,2,6
7,2003,830600,26,25,1,7
8,2003,830600,31,24,7,5
9,2003,830600,27,22,5,13
10,2003,830600,14,11,3,5
11,2003,830600,21,19,2,9
12,2003,830600,20,19,1,4
1,2004,830600,18,17,1,2
2,2004,830600,21,18,3,8
3,2004,830600,19,17,2,4
4,2004,830600,20,16,4,5
5,2004,830600,25,22,3,4
6,2004,830600,20,14,6,7
7,2004,830600,18,17,1,5
8,2004,830600,39,35,4,3
9,2004,830600,31,28,3,15
10,2004,830600,14,14,0,10
11,2004,830600,30,26,4,6
12,2004,830600,21,20,1,1
1,2005,830600,17,15,2,6
2,2005,830600,15,11,4,3
3,2005,830600,8,8,0,4
4,2005,830600,13,12,1,12
5,2005,830600,19,17,2,9
6,2005,830600,28,24,4,4
7,2005,830600,19,16,3,7
8,2005,830600,21,20,1,2
9,2005,830600,21,19,2,15
10,2005,830600,14,12,2,9
11,2005,830600,16,15,1,6
12,2005,830600,18,16,2,8
1,2006,830600,24,19,5,8
2,2006,830600,25,25,0,6
3,2006,830600,15,15,0,4
4,2006,830600,7,5,2,9
5,2006,830600,23,21,2,10
6,2006,830600,22,21,1,7
7,2006,830600,18,15,3,14
8,2006,830600,24,19,5,11
9,2006,830600,19,18,1,12
10,2006,830600,31,27,4,7
11,2006,830600,33,32,1,3
12,2006,830600,18,18,0,2
1,2007,830600,10,9,1,6
2,2007,830600,11,10,1,9
3,2007,830600,22,21,1,4
4,2007,830600,19,19,0,6
5,2007,830600,25,20,5,5
6,2007,830600,20,17,3,9
7,2007,830600,25,24,1,7
8,2007,830600,20,19,1,6
9,2007,830600,14,13,1,4
10,2007,830600,20,19,1,6
11,2007,830600,16,14,2,1
12,2007,830600,11,10,1,3
1,2008,830600,22,20,2,4
2,2008,830600,10,9,1,2
3,2008,830600,20,18,2,6
4,2008,830600,18,18,0,6
5,2008,830600,20,18,2,8
6,2008,830600,16,16,0,7
7,2008,830600,27,22,5,3
8,2008,830600,23,23,0,7
9,2008,830600,17,15,2,6
10,2008,830600,24,21,3,5
11,2008,830600,20,17,3,5
12,2008,830600,11,11,0,7
1,2009,830600,12,9,3,5
2,2009,830600,6,6,0,6
3,2009,830600,10,9,1,5
4,2009,830600,12,12,0,4
5,2009,830600,23,20,3,3
6,2009,830600,28,26,2,5
7,2009,830600,20,18,2,4
8,2009,830600,20,18,2,7
9,2009,830600,21,18,3,7
10,2009,830600,14,12,2,4
11,2009,830600,12,10,2,5
12,2009,830600,17,15,2,3
1,2010,830600,10,10,0,4
2,2010,830600,11,10,1,5
3,2010,830600,14,14,0,1
4,2010,830600,15,13,2,8
5,2010,830600,12,11,1,5
6,2010,830600,13,12,1,4
7,2010,830600,20,17,3,1
8,2010,830600,13,12,1,3
9,2010,830600,14,12,2,4
10,2010,830600,15,12,3,3
11,2010,830600,22,20,2,5
12,2010,830600,12,8,4,2
1,2011,830600,11,11,0,1
2,2011,830600,9,8,1,1
1,1999,010600,33,29,4,11
2,1999,010600,35,32,3,8
3,1999,010600,34,32,2,9
4,1999,010600,29,24,5,17
5,1999,010600,27,22,5,27
6,1999,010600,45,37,8,11
7,1999,010600,36,28,8,5
8,1999,010600,44,40,4,8
9,1999,010600,37,31,6,12
10,1999,010600,47,43,4,6
11,1999,010600,34,32,2,7
12,1999,010600,37,33,4,13
1,2000,010600,45,42,3,10
2,2000,010600,35,32,3,12
3,2000,010600,42,35,7,24
4,2000,010600,19,15,4,9
5,2000,010600,45,36,9,13
6,2000,010600,46,41,5,12
7,2000,010600,28,25,3,25
8,2000,010600,28,23,5,17
9,2000,010600,51,44,7,29
10,2000,010600,33,29,4,17
11,2000,010600,40,34,6,14
12,2000,010600,24,21,3,6
1,2001,010600,25,21,4,20
2,2001,010600,19,15,4,13
3,2001,010600,25,19,6,19
4,2001,010600,42,36,6,4
5,2001,010600,34,28,6,9
6,2001,010600,38,36,2,8
7,2001,010600,35,32,3,21
8,2001,010600,35,33,2,9
9,2001,010600,42,36,6,10
10,2001,010600,40,36,4,11
11,2001,010600,42,36,6,14
12,2001,010600,22,22,0,12
1,2002,010600,30,24,6,17
2,2002,010600,22,17,5,20
3,2002,010600,28,23,5,18
4,2002,010600,30,26,4,15
5,2002,010600,28,27,1,15
6,2002,010600,32,29,3,15
7,2002,010600,24,23,1,17
8,2002,010600,34,33,1,14
9,2002,010600,27,26,1,10
10,2002,010600,34,29,5,11
11,2002,010600,22,22,0,13
12,2002,010600,39,37,2,11
1,2003,010600,22,22,0,13
2,2003,010600,22,17,5,13
3,2003,010600,34,33,1,10
4,2003,010600,31,29,2,17
5,2003,010600,32,29,3,22
6,2003,010600,28,26,2,6
7,2003,010600,19,18,1,12
8,2003,010600,38,38,0,11
9,2003,010600,24,21,3,6
10,2003,010600,19,18,1,11
11,2003,010600,21,18,3,18
12,2003,010600,31,27,4,11
1,2004,010600,14,12,2,9
2,2004,010600,35,33,2,7
3,2004,010600,14,12,2,6
4,2004,010600,27,27,0,12
5,2004,010600,32,29,3,10
6,2004,010600,40,38,2,6
7,2004,010600,41,40,1,16
8,2004,010600,43,38,5,11
9,2004,010600,26,22,4,10
10,2004,010600,25,24,1,18
11,2004,010600,25,24,1,6
12,2004,010600,17,17,0,9
1,2005,010600,18,15,3,16
2,2005,010600,23,19,4,13
3,2005,010600,16,15,1,7
4,2005,010600,23,21,2,5
5,2005,010600,23,22,1,3
6,2005,010600,21,19,2,3
7,2005,010600,23,21,2,7
8,2005,010600,28,28,0,10
9,2005,010600,26,23,3,10
10,2005,010600,30,27,3,15
11,2005,010600,22,22,0,5
12,2005,010600,23,20,3,12
1,2006,010600,21,21,0,11
2,2006,010600,18,13,5,5
3,2006,010600,37,35,2,5
4,2006,010600,17,16,1,11
5,2006,010600,24,18,6,3
6,2006,010600,17,13,4,8
7,2006,010600,31,28,3,13
8,2006,010600,23,18,5,3
9,2006,010600,28,26,2,11
10,2006,010600,28,27,1,4
11,2006,010600,20,19,1,7
12,2006,010600,10,9,1,6
1,2007,010600,18,15,3,12
2,2007,010600,16,15,1,6
3,2007,010600,10,10,0,9
4,2007,010600,14,13,1,17
5,2007,010600,28,27,1,10
6,2007,010600,23,22,1,5
7,2007,010600,34,31,3,5
8,2007,010600,30,27,3,12
9,2007,010600,29,25,4,8
10,2007,010600,33,31,2,9
11,2007,010600,15,13,2,7
12,2007,010600,11,9,2,6
1,2008,010600,14,12,2,10
2,2008,010600,8,6,2,7
3,2008,010600,15,15,0,6
4,2008,010600,22,21,1,5
5,2008,010600,16,14,2,6
6,2008,010600,21,20,1,7
7,2008,010600,22,22,0,5
8,2008,010600,40,40,0,11
9,2008,010600,28,26,2,10
10,2008,010600,22,21,1,5
11,2008,010600,19,19,0,6
12,2008,010600,15,15,0,5
1,2009,010600,21,20,1,5
2,2009,010600,15,14,1,1
3,2009,010600,15,14,1,12
4,2009,010600,16,15,1,4
5,2009,010600,25,24,1,9
6,2009,010600,19,17,2,4
7,2009,010600,24,23,1,3
8,2009,010600,17,14,3,4
9,2009,010600,11,9,2,6
10,2009,010600,14,12,2,4
11,2009,010600,26,26,0,4
12,2009,010600,12,11,1,6
1,2010,010600,17,15,2,4
2,2010,010600,10,10,0,4
3,2010,010600,22,21,1,5
4,2010,010600,25,23,2,2
5,2010,010600,22,20,2,1
6,2010,010600,25,22,3,4
7,2010,010600,22,18,4,3
8,2010,010600,19,17,2,1
9,2010,010600,25,24,1,2
10,2010,010600,23,22,1,6
11,2010,010600,24,24,0,3
12,2010,010600,13,9,4,1
1,2011,010600,13,11,2,1
2,2011,010600,11,8,3,0
1,1999,010503,13,11,2,1
2,1999,010503,12,12,0,0
3,1999,010503,6,6,0,2
4,1999,010503,15,12,3,0
5,1999,010503,10,9,1,0
6,1999,010503,10,10,0,0
7,1999,010503,19,19,0,0
8,1999,010503,14,13,1,0
9,1999,010503,15,14,1,0
10,1999,010503,18,18,0,1
11,1999,010503,13,12,1,1
12,1999,010503,16,14,2,1
1,2000,010503,6,5,1,0
2,2000,010503,9,8,1,0
3,2000,010503,9,7,2,2
4,2000,010503,8,8,0,0
5,2000,010503,16,15,1,0
6,2000,010503,17,14,3,0
7,2000,010503,16,15,1,1
8,2000,010503,16,15,1,0
9,2000,010503,16,16,0,1
10,2000,010503,19,19,0,1
11,2000,010503,14,14,0,1
12,2000,010503,11,10,1,0
1,2001,010503,7,5,2,0
2,2001,010503,7,7,0,2
3,2001,010503,11,9,2,1
4,2001,010503,18,17,1,2
5,2001,010503,8,6,2,0
6,2001,010503,13,12,1,1
7,2001,010503,11,10,1,3
8,2001,010503,5,4,1,2
9,2001,010503,10,10,0,1
10,2001,010503,7,6,1,2
11,2001,010503,9,7,2,0
12,2001,010503,12,10,2,0
1,2002,010503,14,13,1,0
2,2002,010503,3,2,1,0
3,2002,010503,6,6,0,3
4,2002,010503,9,9,0,4
5,2002,010503,9,9,0,1
6,2002,010503,18,18,0,0
7,2002,010503,9,9,0,1
8,2002,010503,17,17,0,0
9,2002,010503,18,18,0,1
10,2002,010503,16,15,1,1
11,2002,010503,13,13,0,0
12,2002,010503,7,7,0,0
1,2003,010503,13,13,0,0
2,2003,010503,11,10,1,0
3,2003,010503,15,14,1,0
4,2003,010503,8,7,1,0
5,2003,010503,21,20,1,1
6,2003,010503,9,8,1,1
7,2003,010503,10,9,1,0
8,2003,010503,16,15,1,1
9,2003,010503,12,12,0,0
10,2003,010503,11,11,0,0
11,2003,010503,6,5,1,1
12,2003,010503,16,14,2,1
1,2004,010503,11,9,2,0
2,2004,010503,9,8,1,0
3,2004,010503,11,9,2,1
4,2004,010503,9,8,1,0
5,2004,010503,9,9,0,1
6,2004,010503,14,14,0,0
7,2004,010503,9,8,1,0
8,2004,010503,12,12,0,2
9,2004,010503,7,7,0,2
10,2004,010503,11,11,0,1
11,2004,010503,8,8,0,0
12,2004,010503,10,10,0,0
1,2005,010503,7,6,1,3
2,2005,010503,4,2,2,0
3,2005,010503,11,11,0,1
4,2005,010503,20,20,0,1
5,2005,010503,12,12,0,2
6,2005,010503,8,8,0,2
7,2005,010503,12,12,0,4
8,2005,010503,11,11,0,1
9,2005,010503,11,10,1,0
10,2005,010503,13,12,1,1
11,2005,010503,9,8,1,0
12,2005,010503,9,8,1,2
1,2006,010503,10,9,1,1
2,2006,010503,2,2,0,4
3,2006,010503,10,10,0,4
4,2006,010503,6,5,1,2
5,2006,010503,4,4,0,5
6,2006,010503,11,10,1,2
7,2006,010503,19,17,2,0
8,2006,010503,10,10,0,4
9,2006,010503,9,8,1,1
10,2006,010503,7,6,1,1
11,2006,010503,8,7,1,2
12,2006,010503,9,9,0,2
1,2007,010503,10,8,2,1
2,2007,010503,6,6,0,5
3,2007,010503,9,9,0,1
4,2007,010503,7,7,0,2
5,2007,010503,22,22,0,1
6,2007,010503,9,9,0,0
7,2007,010503,14,13,1,2
8,2007,010503,8,7,1,0
9,2007,010503,5,5,0,3
10,2007,010503,10,9,1,3
11,2007,010503,11,11,0,3
12,2007,010503,4,4,0,2
1,2008,010503,5,4,1,1
2,2008,010503,4,4,0,0
3,2008,010503,4,4,0,0
4,2008,010503,8,8,0,2
5,2008,010503,3,2,1,1
6,2008,010503,7,6,1,0
7,2008,010503,12,12,0,2
8,2008,010503,10,10,0,0
9,2008,010503,14,13,1,1
10,2008,010503,14,14,0,1
11,2008,010503,8,8,0,0
12,2008,010503,14,13,1,0
1,2009,010503,12,12,0,1
2,2009,010503,9,8,1,0
3,2009,010503,10,9,1,0
4,2009,010503,9,9,0,0
5,2009,010503,10,8,2,4
6,2009,010503,7,7,0,0
7,2009,010503,17,14,3,1
8,2009,010503,19,19,0,1
9,2009,010503,17,15,2,1
10,2009,010503,8,7,1,2
11,2009,010503,8,8,0,0
12,2009,010503,5,5,0,3
1,2010,010503,14,14,0,3
2,2010,010503,4,4,0,6
3,2010,010503,7,6,1,1
4,2010,010503,4,3,1,1
5,2010,010503,10,10,0,0
6,2010,010503,13,13,0,0
7,2010,010503,11,11,0,0
8,2010,010503,9,9,0,1
9,2010,010503,13,12,1,0
10,2010,010503,11,11,0,2
11,2010,010503,14,13,1,2
12,2010,010503,9,9,0,1
1,2011,010503,5,4,1,1
2,2011,010503,9,7,2,1
1,1999,010400,6,5,1,1
2,1999,010400,11,11,0,0
3,1999,010400,9,7,2,0
4,1999,010400,8,8,0,2
5,1999,010400,6,5,1,1
6,1999,010400,13,9,4,0
7,1999,010400,10,10,0,1
8,1999,010400,10,7,3,0
9,1999,010400,12,10,2,4
10,1999,010400,8,8,0,0
11,1999,010400,13,11,2,0
12,1999,010400,12,12,0,3
1,2000,010400,6,6,0,0
2,2000,010400,8,8,0,0
3,2000,010400,7,7,0,2
4,2000,010400,9,9,0,0
5,2000,010400,10,10,0,4
6,2000,010400,14,12,2,2
7,2000,010400,19,17,2,2
8,2000,010400,11,10,1,0
9,2000,010400,11,10,1,2
10,2000,010400,6,6,0,0
11,2000,010400,8,7,1,0
12,2000,010400,5,5,0,0
1,2001,010400,3,2,1,1
2,2001,010400,7,7,0,0
3,2001,010400,7,7,0,1
4,2001,010400,9,7,2,2
5,2001,010400,15,14,1,1
6,2001,010400,10,8,2,1
7,2001,010400,13,12,1,1
8,2001,010400,16,15,1,1
9,2001,010400,8,7,1,0
10,2001,010400,6,6,0,5
11,2001,010400,8,8,0,3
12,2001,010400,8,7,1,0
1,2002,010400,7,4,3,2
2,2002,010400,3,3,0,4
3,2002,010400,8,7,1,0
4,2002,010400,4,4,0,1
5,2002,010400,12,12,0,2
6,2002,010400,15,13,2,2
7,2002,010400,18,16,2,0
8,2002,010400,13,13,0,0
9,2002,010400,9,9,0,0
10,2002,010400,15,12,3,0
11,2002,010400,8,8,0,0
12,2002,010400,5,5,0,1
1,2003,010400,12,9,3,0
2,2003,010400,5,5,0,0
3,2003,010400,13,13,0,2
4,2003,010400,4,3,1,1
5,2003,010400,8,7,1,1
6,2003,010400,12,12,0,3
7,2003,010400,6,6,0,2
8,2003,010400,18,17,1,4
9,2003,010400,4,4,0,2
10,2003,010400,6,5,1,1
11,2003,010400,15,14,1,0
12,2003,010400,5,4,1,0
1,2004,010400,3,3,0,2
2,2004,010400,6,6,0,1
3,2004,010400,9,9,0,1
4,2004,010400,13,12,1,2
5,2004,010400,8,7,1,0
6,2004,010400,9,8,1,1
7,2004,010400,16,14,2,5
8,2004,010400,9,9,0,1
9,2004,010400,16,14,2,0
10,2004,010400,13,11,2,0
11,2004,010400,6,6,0,0
12,2004,010400,6,6,0,1
1,2005,010400,7,7,0,3
2,2005,010400,8,8,0,1
3,2005,010400,7,7,0,2
4,2005,010400,4,3,1,0
5,2005,010400,11,11,0,0
6,2005,010400,8,8,0,3
7,2005,010400,9,9,0,5
8,2005,010400,7,6,1,3
9,2005,010400,12,11,1,2
10,2005,010400,12,11,1,0
11,2005,010400,5,5,0,1
12,2005,010400,2,2,0,0
1,2006,010400,3,3,0,0
2,2006,010400,4,3,1,0
3,2006,010400,3,3,0,1
4,2006,010400,2,2,0,1
5,2006,010400,7,7,0,1
6,2006,010400,10,9,1,3
7,2006,010400,7,7,0,4
8,2006,010400,10,9,1,4
9,2006,010400,4,4,0,0
10,2006,010400,5,4,1,3
11,2006,010400,4,4,0,3
12,2006,010400,4,4,0,0
1,2007,010400,1,1,0,2
2,2007,010400,1,0,1,0
3,2007,010400,1,1,0,0
4,2007,010400,5,5,0,0
5,2007,010400,9,8,1,5
6,2007,010400,9,8,1,4
7,2007,010400,16,14,2,5
8,2007,010400,11,10,1,4
9,2007,010400,8,8,0,1
10,2007,010400,9,8,1,0
11,2007,010400,10,10,0,2
12,2007,010400,3,2,1,0
1,2008,010400,4,4,0,0
2,2008,010400,3,2,1,0
3,2008,010400,10,10,0,0
4,2008,010400,4,3,1,0
5,2008,010400,2,1,1,1
6,2008,010400,5,5,0,2
7,2008,010400,6,6,0,0
8,2008,010400,15,15,0,1
9,2008,010400,11,10,1,0
10,2008,010400,7,6,1,1
11,2008,010400,6,4,2,0
12,2008,010400,6,6,0,0
1,2009,010400,5,5,0,0
2,2009,010400,3,3,0,1
3,2009,010400,3,3,0,3
4,2009,010400,6,6,0,0
5,2009,010400,11,10,1,2
6,2009,010400,15,15,0,1
7,2009,010400,11,10,1,1
8,2009,010400,6,6,0,0
9,2009,010400,11,11,0,2
10,2009,010400,1,1,0,0
11,2009,010400,7,6,1,0
12,2009,010400,2,1,1,0
1,2010,010400,2,2,0,2
2,2010,010400,3,3,0,0
3,2010,010400,5,4,1,0
4,2010,010400,4,4,0,1
5,2010,010400,4,2,2,1
6,2010,010400,9,8,1,2
7,2010,010400,7,5,2,1
8,2010,010400,7,6,1,1
9,2010,010400,8,8,0,0
10,2010,010400,7,7,0,1
11,2010,010400,2,2,0,0
12,2010,010400,2,2,0,1
1,2011,010400,4,3,1,0
2,2011,010400,2,2,0,1
1,1999,020301,6,6,0,1
2,1999,020301,9,9,0,0
3,1999,020301,6,6,0,0
4,1999,020301,9,8,1,0
5,1999,020301,7,7,0,0
6,1999,020301,11,11,0,0
7,1999,020301,13,8,5,0
8,1999,020301,6,6,0,2
9,1999,020301,5,4,1,2
10,1999,020301,4,4,0,0
11,1999,020301,8,8,0,0
12,1999,020301,8,8,0,0
1,2000,020301,5,5,0,0
2,2000,020301,8,7,1,0
3,2000,020301,8,8,0,0
4,2000,020301,2,2,0,0
5,2000,020301,4,3,1,1
6,2000,020301,9,9,0,0
7,2000,020301,6,5,1,0
8,2000,020301,7,7,0,0
9,2000,020301,8,8,0,0
10,2000,020301,11,11,0,0
11,2000,020301,6,6,0,0
12,2000,020301,6,6,0,0
1,2001,020301,7,7,0,0
2,2001,020301,5,5,0,1
3,2001,020301,5,5,0,0
4,2001,020301,3,3,0,0
5,2001,020301,7,7,0,0
6,2001,020301,4,4,0,0
7,2001,020301,4,4,0,0
8,2001,020301,3,3,0,0
9,2001,020301,4,4,0,0
10,2001,020301,5,5,0,0
11,2001,020301,5,4,1,1
12,2001,020301,4,4,0,0
1,2002,020301,4,4,0,0
2,2002,020301,11,10,1,0
3,2002,020301,3,3,0,0
4,2002,020301,6,6,0,0
5,2002,020301,4,4,0,1
6,2002,020301,2,2,0,0
7,2002,020301,12,11,1,0
8,2002,020301,14,14,0,0
9,2002,020301,5,5,0,2
10,2002,020301,5,5,0,0
11,2002,020301,7,7,0,0
12,2002,020301,6,5,1,0
1,2003,020301,6,5,1,1
2,2003,020301,2,2,0,0
3,2003,020301,4,4,0,0
4,2003,020301,3,2,1,2
5,2003,020301,2,2,0,0
6,2003,020301,6,6,0,0
7,2003,020301,13,12,1,0
8,2003,020301,2,2,0,0
9,2003,020301,2,2,0,0
10,2003,020301,4,4,0,3
11,2003,020301,9,9,0,0
12,2003,020301,5,5,0,0
1,2004,020301,9,9,0,0
2,2004,020301,3,3,0,0
3,2004,020301,6,6,0,0
4,2004,020301,5,5,0,0
5,2004,020301,3,3,0,0
6,2004,020301,10,10,0,0
7,2004,020301,9,9,0,1
8,2004,020301,11,11,0,0
9,2004,020301,7,6,1,0
10,2004,020301,3,3,0,0
11,2004,020301,7,7,0,1
12,2004,020301,8,8,0,0
1,2005,020301,9,9,0,1
2,2005,020301,0,0,0,0
3,2005,020301,3,3,0,0
4,2005,020301,2,2,0,0
5,2005,020301,3,3,0,0
6,2005,020301,1,1,0,0
7,2005,020301,12,12,0,1
8,2005,020301,9,7,2,0
9,2005,020301,11,11,0,0
10,2005,020301,4,4,0,0
11,2005,020301,9,9,0,0
12,2005,020301,10,10,0,2
1,2006,020301,6,6,0,0
2,2006,020301,8,8,0,0
3,2006,020301,4,4,0,0
4,2006,020301,4,4,0,1
5,2006,020301,3,3,0,0
6,2006,020301,5,3,2,0
7,2006,020301,9,8,1,0
8,2006,020301,6,6,0,0
9,2006,020301,8,7,1,3
10,2006,020301,4,3,1,0
11,2006,020301,6,5,1,0
12,2006,020301,4,4,0,0
1,2007,020301,4,4,0,1
2,2007,020301,2,2,0,0
3,2007,020301,2,2,0,0
4,2007,020301,1,1,0,0
5,2007,020301,7,7,0,0
6,2007,020301,5,5,0,0
7,2007,020301,6,5,1,1
8,2007,020301,3,3,0,0
9,2007,020301,6,6,0,0
10,2007,020301,4,4,0,0
11,2007,020301,5,5,0,0
12,2007,020301,2,2,0,0
1,2008,020301,6,6,0,0
2,2008,020301,2,2,0,0
3,2008,020301,2,2,0,0
4,2008,020301,2,2,0,0
5,2008,020301,4,4,0,0
6,2008,020301,7,7,0,0
7,2008,020301,5,5,0,1
8,2008,020301,3,2,1,2
9,2008,020301,9,9,0,0
10,2008,020301,5,4,1,1
11,2008,020301,2,2,0,1
12,2008,020301,6,6,0,1
1,2009,020301,6,6,0,2
2,2009,020301,2,2,0,0
3,2009,020301,4,4,0,0
4,2009,020301,6,6,0,2
5,2009,020301,8,8,0,1
6,2009,020301,5,4,1,0
7,2009,020301,5,5,0,0
8,2009,020301,8,8,0,0
9,2009,020301,9,9,0,1
10,2009,020301,6,5,1,0
11,2009,020301,2,1,1,2
12,2009,020301,1,1,0,0
1,2010,020301,4,3,1,0
2,2010,020301,5,4,1,0
3,2010,020301,14,14,0,2
4,2010,020301,1,1,0,0
5,2010,020301,8,7,1,0
6,2010,020301,4,4,0,0
7,2010,020301,5,5,0,0
8,2010,020301,9,9,0,1
9,2010,020301,6,6,0,0
10,2010,020301,9,9,0,0
11,2010,020301,2,2,0,0
12,2010,020301,3,3,0,0
1,2011,020301,2,2,0,1
2,2011,020301,1,1,0,1
1,1999,010502,14,14,0,3
2,1999,010502,17,16,1,1
3,1999,010502,18,17,1,2
4,1999,010502,23,20,3,2
5,1999,010502,18,15,3,2
6,1999,010502,22,22,0,2
7,1999,010502,24,22,2,1
8,1999,010502,33,30,3,0
9,1999,010502,25,22,3,10
10,1999,010502,32,30,2,0
11,1999,010502,26,25,1,2
12,1999,010502,26,25,1,1
1,2000,010502,28,26,2,3
2,2000,010502,14,14,0,0
3,2000,010502,21,19,2,0
4,2000,010502,19,15,4,2
5,2000,010502,31,24,7,0
6,2000,010502,27,24,3,1
7,2000,010502,23,21,2,2
8,2000,010502,24,21,3,2
9,2000,010502,27,23,4,3
10,2000,010502,25,20,5,2
11,2000,010502,21,21,0,1
12,2000,010502,17,17,0,4
1,2001,010502,20,18,2,2
2,2001,010502,16,15,1,2
3,2001,010502,23,17,6,4
4,2001,010502,17,15,2,1
5,2001,010502,21,20,1,1
6,2001,010502,22,20,2,2
7,2001,010502,29,27,2,3
8,2001,010502,24,23,1,0
9,2001,010502,13,12,1,1
10,2001,010502,27,26,1,8
11,2001,010502,16,14,2,0
12,2001,010502,21,19,2,0
1,2002,010502,16,14,2,2
2,2002,010502,13,12,1,2
3,2002,010502,23,22,1,3
4,2002,010502,30,28,2,0
5,2002,010502,22,22,0,0
6,2002,010502,31,27,4,3
7,2002,010502,19,19,0,0
8,2002,010502,34,30,4,5
9,2002,010502,21,19,2,3
10,2002,010502,24,23,1,3
11,2002,010502,10,10,0,2
12,2002,010502,18,17,1,1
1,2003,010502,15,12,3,3
2,2003,010502,17,15,2,2
3,2003,010502,25,22,3,5
4,2003,010502,23,22,1,4
5,2003,010502,29,28,1,3
6,2003,010502,24,23,1,2
7,2003,010502,32,30,2,1
8,2003,010502,25,25,0,2
9,2003,010502,14,12,2,4
10,2003,010502,21,20,1,1
11,2003,010502,19,17,2,0
12,2003,010502,18,15,3,3
1,2004,010502,13,12,1,2
2,2004,010502,17,17,0,4
3,2004,010502,16,14,2,0
4,2004,010502,22,22,0,1
5,2004,010502,21,21,0,3
6,2004,010502,19,19,0,1
7,2004,010502,26,24,2,3
8,2004,010502,30,29,1,3
9,2004,010502,25,23,2,2
10,2004,010502,15,15,0,6
11,2004,010502,18,16,2,3
12,2004,010502,17,16,1,4
1,2005,010502,9,9,0,3
2,2005,010502,13,12,1,2
3,2005,010502,21,19,2,3
4,2005,010502,21,20,1,4
5,2005,010502,13,11,2,3
6,2005,010502,13,13,0,3
7,2005,010502,25,23,2,0
8,2005,010502,24,21,3,7
9,2005,010502,21,21,0,2
10,2005,010502,14,12,2,6
11,2005,010502,13,13,0,1
12,2005,010502,11,11,0,1
1,2006,010502,19,18,1,2
2,2006,010502,14,13,1,1
3,2006,010502,6,5,1,0
4,2006,010502,15,15,0,1
5,2006,010502,9,9,0,3
6,2006,010502,11,10,1,5
7,2006,010502,22,18,4,4
8,2006,010502,22,21,1,3
9,2006,010502,21,20,1,5
10,2006,010502,20,19,1,2
11,2006,010502,15,15,0,4
12,2006,010502,20,17,3,7
1,2007,010502,12,9,3,2
2,2007,010502,9,8,1,0
3,2007,010502,13,13,0,0
4,2007,010502,10,9,1,1
5,2007,010502,16,16,0,2
6,2007,010502,17,15,2,2
7,2007,010502,20,20,0,2
8,2007,010502,28,26,2,0
9,2007,010502,14,11,3,1
10,2007,010502,12,11,1,0
11,2007,010502,8,8,0,2
12,2007,010502,11,11,0,2
1,2008,010502,12,12,0,3
2,2008,010502,12,11,1,1
3,2008,010502,10,8,2,4
4,2008,010502,13,11,2,0
5,2008,010502,11,11,0,0
6,2008,010502,14,10,4,0
7,2008,010502,13,12,1,0
8,2008,010502,13,11,2,5
9,2008,010502,17,17,0,2
10,2008,010502,11,11,0,5
11,2008,010502,16,14,2,1
12,2008,010502,9,9,0,2
1,2009,010502,10,9,1,1
2,2009,010502,7,7,0,2
3,2009,010502,10,10,0,2
4,2009,010502,11,11,0,1
5,2009,010502,7,7,0,0
6,2009,010502,5,3,2,3
7,2009,010502,17,17,0,1
8,2009,010502,12,12,0,1
9,2009,010502,13,11,2,1
10,2009,010502,15,13,2,1
11,2009,010502,9,9,0,3
12,2009,010502,8,7,1,1
1,2010,010502,12,10,2,1
2,2010,010502,12,12,0,0
3,2010,010502,11,11,0,2
4,2010,010502,12,10,2,1
5,2010,010502,10,10,0,1
6,2010,010502,18,17,1,0
7,2010,010502,15,14,1,1
8,2010,010502,13,13,0,2
9,2010,010502,14,12,2,2
10,2010,010502,13,12,1,2
11,2010,010502,19,19,0,3
12,2010,010502,6,5,1,0
1,2011,010502,10,9,1,1
2,2011,010502,10,9,1,1
1,1999,020302,9,9,0,0
2,1999,020302,8,8,0,1
3,1999,020302,9,9,0,1
4,1999,020302,14,14,0,1
5,1999,020302,16,15,1,0
6,1999,020302,5,5,0,2
7,1999,020302,19,19,0,2
8,1999,020302,16,16,0,0
9,1999,020302,14,14,0,2
10,1999,020302,20,19,1,0
11,1999,020302,7,5,2,2
12,1999,020302,12,11,1,0
1,2000,020302,5,4,1,0
2,2000,020302,5,4,1,0
3,2000,020302,5,5,0,0
4,2000,020302,16,15,1,1
5,2000,020302,16,15,1,0
6,2000,020302,12,11,1,0
7,2000,020302,12,11,1,0
8,2000,020302,11,11,0,2
9,2000,020302,12,12,0,2
10,2000,020302,12,11,1,0
11,2000,020302,6,5,1,4
12,2000,020302,5,5,0,0
1,2001,020302,4,4,0,1
2,2001,020302,10,9,1,0
3,2001,020302,18,17,1,0
4,2001,020302,8,7,1,1
5,2001,020302,15,15,0,1
6,2001,020302,6,6,0,1
7,2001,020302,10,8,2,0
8,2001,020302,12,12,0,1
9,2001,020302,14,13,1,1
10,2001,020302,8,8,0,0
11,2001,020302,17,16,1,4
12,2001,020302,11,11,0,4
1,2002,020302,8,8,0,0
2,2002,020302,9,9,0,1
3,2002,020302,7,7,0,1
4,2002,020302,8,8,0,1
5,2002,020302,19,19,0,0
6,2002,020302,11,10,1,0
7,2002,020302,19,18,1,2
8,2002,020302,20,20,0,0
9,2002,020302,10,9,1,0
10,2002,020302,16,16,0,0
11,2002,020302,9,8,1,2
12,2002,020302,9,9,0,1
1,2003,020302,10,9,1,1
2,2003,020302,16,14,2,2
3,2003,020302,11,11,0,2
4,2003,020302,8,7,1,0
5,2003,020302,8,5,3,0
6,2003,020302,9,8,1,1
7,2003,020302,15,14,1,0
8,2003,020302,13,12,1,1
9,2003,020302,7,7,0,1
10,2003,020302,13,13,0,0
11,2003,020302,10,10,0,1
12,2003,020302,16,14,2,0
1,2004,020302,6,6,0,1
2,2004,020302,14,13,1,0
3,2004,020302,8,8,0,0
4,2004,020302,8,8,0,0
5,2004,020302,9,9,0,3
6,2004,020302,18,17,1,1
7,2004,020302,17,16,1,0
8,2004,020302,14,14,0,1
9,2004,020302,17,16,1,1
10,2004,020302,33,32,1,0
11,2004,020302,8,8,0,1
12,2004,020302,7,7,0,0
1,2005,020302,11,11,0,0
2,2005,020302,13,13,0,2
3,2005,020302,12,12,0,0
4,2005,020302,7,7,0,4
5,2005,020302,10,10,0,0
6,2005,020302,13,12,1,1
7,2005,020302,16,15,1,2
8,2005,020302,12,12,0,1
9,2005,020302,15,14,1,1
10,2005,020302,15,15,0,1
11,2005,020302,12,11,1,0
12,2005,020302,15,14,1,1
1,2006,020302,17,16,1,2
2,2006,020302,6,4,2,0
3,2006,020302,12,11,1,2
4,2006,020302,8,8,0,0
5,2006,020302,10,10,0,3
6,2006,020302,15,15,0,0
7,2006,020302,12,12,0,3
8,2006,020302,15,13,2,2
9,2006,020302,15,14,1,4
10,2006,020302,8,8,0,0
11,2006,020302,8,8,0,1
12,2006,020302,10,10,0,1
1,2007,020302,9,9,0,0
2,2007,020302,18,18,0,1
3,2007,020302,13,12,1,2
4,2007,020302,10,10,0,0
5,2007,020302,6,5,1,1
6,2007,020302,13,10,3,3
7,2007,020302,12,10,2,4
8,2007,020302,8,8,0,0
9,2007,020302,16,15,1,1
10,2007,020302,6,6,0,0
11,2007,020302,6,5,1,1
12,2007,020302,7,7,0,2
1,2008,020302,8,8,0,1
2,2008,020302,3,3,0,2
3,2008,020302,9,9,0,1
4,2008,020302,7,6,1,0
5,2008,020302,8,7,1,0
6,2008,020302,8,8,0,1
7,2008,020302,10,10,0,4
8,2008,020302,10,10,0,4
9,2008,020302,3,3,0,3
10,2008,020302,11,11,0,4
11,2008,020302,9,9,0,3
12,2008,020302,10,9,1,1
1,2009,020302,7,6,1,2
2,2009,020302,7,6,1,5
3,2009,020302,5,5,0,2
4,2009,020302,13,11,2,5
5,2009,020302,8,8,0,1
6,2009,020302,10,10,0,0
7,2009,020302,8,7,1,3
8,2009,020302,10,8,2,0
9,2009,020302,7,7,0,5
10,2009,020302,5,5,0,1
11,2009,020302,5,4,1,2
12,2009,020302,8,8,0,0
1,2010,020302,9,8,1,2
2,2010,020302,5,5,0,3
3,2010,020302,8,8,0,2
4,2010,020302,8,7,1,0
5,2010,020302,7,7,0,1
6,2010,020302,8,7,1,2
7,2010,020302,11,11,0,1
8,2010,020302,11,11,0,0
9,2010,020302,9,9,0,4
10,2010,020302,9,8,1,1
11,2010,020302,10,8,2,1
12,2010,020302,9,9,0,0
1,2011,020302,7,7,0,0
2,2011,020302,6,6,0,0
1,1999,020400,9,8,1,1
2,1999,020400,7,7,0,0
3,1999,020400,8,8,0,1
4,1999,020400,7,7,0,0
5,1999,020400,7,7,0,0
6,1999,020400,9,9,0,0
7,1999,020400,4,4,0,0
8,1999,020400,7,7,0,0
9,1999,020400,11,9,2,0
10,1999,020400,8,7,1,0
11,1999,020400,7,7,0,0
12,1999,020400,5,5,0,0
1,2000,020400,7,7,0,2
2,2000,020400,10,9,1,0
3,2000,020400,12,12,0,0
4,2000,020400,15,15,0,0
5,2000,020400,14,14,0,0
6,2000,020400,9,9,0,1
7,2000,020400,11,8,3,0
8,2000,020400,5,5,0,0
9,2000,020400,7,7,0,1
10,2000,020400,7,7,0,0
11,2000,020400,8,8,0,0
12,2000,020400,4,3,1,1
1,2001,020400,6,6,0,0
2,2001,020400,2,1,1,1
3,2001,020400,9,9,0,1
4,2001,020400,5,4,1,0
5,2001,020400,6,6,0,0
6,2001,020400,13,13,0,0
7,2001,020400,7,6,1,0
8,2001,020400,6,6,0,0
9,2001,020400,4,4,0,0
10,2001,020400,3,3,0,1
11,2001,020400,6,5,1,0
12,2001,020400,9,9,0,0
1,2002,020400,9,9,0,0
2,2002,020400,4,4,0,0
3,2002,020400,6,5,1,1
4,2002,020400,5,5,0,0
5,2002,020400,8,8,0,2
6,2002,020400,12,10,2,0
7,2002,020400,8,7,1,0
8,2002,020400,10,10,0,0
9,2002,020400,3,3,0,0
10,2002,020400,8,8,0,0
11,2002,020400,11,11,0,0
12,2002,020400,6,6,0,0
1,2003,020400,5,4,1,0
2,2003,020400,14,14,0,0
3,2003,020400,9,9,0,0
4,2003,020400,5,5,0,0
5,2003,020400,8,6,2,1
6,2003,020400,10,10,0,1
7,2003,020400,15,15,0,0
8,2003,020400,10,9,1,0
9,2003,020400,3,3,0,1
10,2003,020400,12,11,1,0
11,2003,020400,5,5,0,0
12,2003,020400,8,7,1,0
1,2004,020400,1,1,0,3
2,2004,020400,7,6,1,1
3,2004,020400,4,2,2,0
4,2004,020400,3,3,0,0
5,2004,020400,2,2,0,0
6,2004,020400,12,11,1,1
7,2004,020400,11,11,0,0
8,2004,020400,11,11,0,0
9,2004,020400,7,7,0,2
10,2004,020400,23,23,0,0
11,2004,020400,14,14,0,0
12,2004,020400,10,9,1,0
1,2005,020400,7,7,0,0
2,2005,020400,7,6,1,1
3,2005,020400,13,13,0,1
4,2005,020400,10,9,1,0
5,2005,020400,5,5,0,0
6,2005,020400,4,4,0,0
7,2005,020400,8,8,0,1
8,2005,020400,15,13,2,0
9,2005,020400,16,16,0,0
10,2005,020400,9,8,1,0
11,2005,020400,7,7,0,1
12,2005,020400,6,6,0,0
1,2006,020400,9,9,0,1
2,2006,020400,7,7,0,0
3,2006,020400,7,6,1,2
4,2006,020400,7,6,1,3
5,2006,020400,7,7,0,1
6,2006,020400,10,10,0,3
7,2006,020400,6,6,0,1
8,2006,020400,5,5,0,0
9,2006,020400,3,3,0,0
10,2006,020400,10,8,2,1
11,2006,020400,10,10,0,0
12,2006,020400,9,9,0,0
1,2007,020400,5,5,0,0
2,2007,020400,3,3,0,0
3,2007,020400,5,5,0,0
4,2007,020400,4,4,0,0
5,2007,020400,7,6,1,0
6,2007,020400,8,7,1,0
7,2007,020400,6,5,1,2
8,2007,020400,14,14,0,0
9,2007,020400,6,6,0,3
10,2007,020400,4,4,0,1
11,2007,020400,16,13,3,0
12,2007,020400,5,5,0,0
1,2008,020400,5,5,0,0
2,2008,020400,6,4,2,0
3,2008,020400,3,3,0,0
4,2008,020400,8,8,0,1
5,2008,020400,6,6,0,1
6,2008,020400,8,7,1,2
7,2008,020400,9,8,1,0
8,2008,020400,9,8,1,4
9,2008,020400,8,8,0,1
10,2008,020400,7,7,0,1
11,2008,020400,11,11,0,0
12,2008,020400,9,7,2,1
1,2009,020400,5,4,1,1
2,2009,020400,9,7,2,0
3,2009,020400,8,8,0,3
4,2009,020400,8,8,0,0
5,2009,020400,10,9,1,0
6,2009,020400,11,11,0,1
7,2009,020400,2,2,0,3
8,2009,020400,3,3,0,0
9,2009,020400,7,7,0,3
10,2009,020400,4,4,0,1
11,2009,020400,7,7,0,2
12,2009,020400,8,7,1,1
1,2010,020400,7,7,0,0
2,2010,020400,9,9,0,0
3,2010,020400,9,9,0,3
4,2010,020400,2,2,0,1
5,2010,020400,9,9,0,0
6,2010,020400,9,9,0,3
7,2010,020400,10,9,1,0
8,2010,020400,8,7,1,1
9,2010,020400,7,5,2,1
10,2010,020400,9,8,1,1
11,2010,020400,8,7,1,0
12,2010,020400,6,6,0,1
1,2011,020400,8,8,0,1
2,2011,020400,7,7,0,0
1,1999,010701,14,13,1,0
2,1999,010701,14,12,2,0
3,1999,010701,7,7,0,0
4,1999,010701,7,5,2,1
5,1999,010701,5,5,0,0
6,1999,010701,11,11,0,1
7,1999,010701,16,15,1,1
8,1999,010701,14,13,1,0
9,1999,010701,7,6,1,2
10,1999,010701,7,7,0,2
11,1999,010701,10,9,1,1
12,1999,010701,6,5,1,1
1,2000,010701,12,12,0,1
2,2000,010701,11,9,2,2
3,2000,010701,12,9,3,0
4,2000,010701,10,10,0,2
5,2000,010701,16,16,0,0
6,2000,010701,5,5,0,0
7,2000,010701,17,14,3,0
8,2000,010701,10,9,1,1
9,2000,010701,5,5,0,1
10,2000,010701,12,12,0,2
11,2000,010701,9,9,0,0
12,2000,010701,7,7,0,0
1,2001,010701,13,13,0,1
2,2001,010701,1,0,1,1
3,2001,010701,11,11,0,1
4,2001,010701,8,8,0,1
5,2001,010701,6,6,0,1
6,2001,010701,6,6,0,1
7,2001,010701,9,9,0,0
8,2001,010701,5,5,0,2
9,2001,010701,7,7,0,1
10,2001,010701,13,12,1,0
11,2001,010701,6,6,0,0
12,2001,010701,4,3,1,0
1,2002,010701,9,8,1,1
2,2002,010701,4,4,0,0
3,2002,010701,9,8,1,0
4,2002,010701,12,12,0,3
5,2002,010701,10,10,0,1
6,2002,010701,12,11,1,0
7,2002,010701,12,12,0,1
8,2002,010701,9,8,1,2
9,2002,010701,8,8,0,1
10,2002,010701,7,6,1,0
11,2002,010701,13,13,0,2
12,2002,010701,12,12,0,0
1,2003,010701,4,4,0,3
2,2003,010701,6,5,1,0
3,2003,010701,5,4,1,0
4,2003,010701,7,7,0,0
5,2003,010701,5,5,0,0
6,2003,010701,8,8,0,1
7,2003,010701,10,9,1,0
8,2003,010701,8,7,1,1
9,2003,010701,7,7,0,1
10,2003,010701,5,5,0,0
11,2003,010701,4,4,0,0
12,2003,010701,7,6,1,1
1,2004,010701,7,7,0,2
2,2004,010701,5,5,0,1
3,2004,010701,21,21,0,0
4,2004,010701,6,6,0,2
5,2004,010701,9,8,1,1
6,2004,010701,13,13,0,1
7,2004,010701,14,14,0,1
8,2004,010701,14,14,0,0
9,2004,010701,10,8,2,1
10,2004,010701,12,12,0,0
11,2004,010701,9,9,0,0
12,2004,010701,9,8,1,0
1,2005,010701,4,4,0,1
2,2005,010701,6,6,0,0
3,2005,010701,6,6,0,1
4,2005,010701,7,7,0,0
5,2005,010701,9,7,2,2
6,2005,010701,7,7,0,3
7,2005,010701,10,9,1,0
8,2005,010701,7,5,2,0
9,2005,010701,3,3,0,2
10,2005,010701,9,9,0,1
11,2005,010701,1,1,0,1
12,2005,010701,4,4,0,0
1,2006,010701,9,9,0,3
2,2006,010701,5,5,0,2
3,2006,010701,3,2,1,1
4,2006,010701,3,3,0,0
5,2006,010701,7,7,0,1
6,2006,010701,6,5,1,1
7,2006,010701,7,6,1,1
8,2006,010701,3,2,1,0
9,2006,010701,6,6,0,0
10,2006,010701,2,2,0,0
11,2006,010701,5,5,0,1
12,2006,010701,12,11,1,2
1,2007,010701,16,15,1,1
2,2007,010701,5,5,0,0
3,2007,010701,4,3,1,2
4,2007,010701,6,5,1,2
5,2007,010701,7,7,0,0
6,2007,010701,5,5,0,1
7,2007,010701,2,2,0,2
8,2007,010701,9,9,0,0
9,2007,010701,12,11,1,2
10,2007,010701,11,8,3,2
11,2007,010701,9,9,0,0
12,2007,010701,7,7,0,1
1,2008,010701,4,4,0,0
2,2008,010701,3,3,0,0
3,2008,010701,2,2,0,1
4,2008,010701,7,7,0,0
5,2008,010701,2,2,0,3
6,2008,010701,1,1,0,2
7,2008,010701,3,3,0,1
8,2008,010701,3,3,0,0
9,2008,010701,9,7,2,1
10,2008,010701,9,7,2,2
11,2008,010701,2,2,0,3
12,2008,010701,8,8,0,0
1,2009,010701,5,5,0,0
2,2009,010701,7,6,1,0
3,2009,010701,6,5,1,1
4,2009,010701,6,6,0,1
5,2009,010701,8,8,0,3
6,2009,010701,9,9,0,2
7,2009,010701,9,7,2,1
8,2009,010701,7,7,0,1
9,2009,010701,11,8,3,1
10,2009,010701,7,6,1,0
11,2009,010701,5,5,0,2
12,2009,010701,8,7,1,0
1,2010,010701,3,3,0,2
2,2010,010701,2,2,0,1
3,2010,010701,7,7,0,0
4,2010,010701,7,7,0,0
5,2010,010701,10,9,1,1
6,2010,010701,12,12,0,0
7,2010,010701,8,8,0,1
8,2010,010701,9,9,0,0
9,2010,010701,4,4,0,0
10,2010,010701,5,5,0,1
11,2010,010701,7,7,0,0
12,2010,010701,1,1,0,0
1,2011,010701,6,5,1,0
2,2011,010701,2,2,0,0
1,1999,010702,21,16,5,6
2,1999,010702,23,15,8,32
3,1999,010702,31,28,3,17
4,1999,010702,27,21,6,15
5,1999,010702,28,16,12,14
6,1999,010702,29,24,5,11
7,1999,010702,40,30,10,14
8,1999,010702,33,25,8,11
9,1999,010702,26,22,4,15
10,1999,010702,28,25,3,8
11,1999,010702,42,40,2,3
12,1999,010702,33,29,4,4
1,2000,010702,24,21,3,15
2,2000,010702,19,17,2,12
3,2000,010702,43,35,8,11
4,2000,010702,24,21,3,6
5,2000,010702,29,25,4,6
6,2000,010702,33,27,6,4
7,2000,010702,35,29,6,8
8,2000,010702,33,24,9,11
9,2000,010702,28,24,4,8
10,2000,010702,28,25,3,4
11,2000,010702,37,33,4,7
12,2000,010702,23,17,6,12
1,2001,010702,20,20,0,7
2,2001,010702,17,10,7,6
3,2001,010702,25,22,3,6
4,2001,010702,37,27,10,9
5,2001,010702,18,17,1,3
6,2001,010702,17,14,3,2
7,2001,010702,32,30,2,3
8,2001,010702,29,22,7,7
9,2001,010702,25,23,2,2
10,2001,010702,19,14,5,6
11,2001,010702,28,25,3,10
12,2001,010702,24,20,4,8
1,2002,010702,27,24,3,10
2,2002,010702,13,12,1,4
3,2002,010702,16,13,3,5
4,2002,010702,23,21,2,4
5,2002,010702,22,21,1,8
6,2002,010702,18,15,3,10
7,2002,010702,31,25,6,9
8,2002,010702,28,23,5,11
9,2002,010702,44,37,7,9
10,2002,010702,33,28,5,2
11,2002,010702,22,20,2,7
12,2002,010702,25,21,4,6
1,2003,010702,22,20,2,8
2,2003,010702,15,10,5,6
3,2003,010702,17,17,0,4
4,2003,010702,20,16,4,6
5,2003,010702,35,32,3,4
6,2003,010702,20,17,3,8
7,2003,010702,21,18,3,4
8,2003,010702,21,16,5,2
9,2003,010702,25,20,5,2
10,2003,010702,14,14,0,4
11,2003,010702,19,19,0,3
12,2003,010702,29,28,1,2
1,2004,010702,24,21,3,10
2,2004,010702,22,19,3,5
3,2004,010702,17,13,4,4
4,2004,010702,13,12,1,1
5,2004,010702,15,11,4,7
6,2004,010702,25,22,3,1
7,2004,010702,26,24,2,2
8,2004,010702,28,25,3,5
9,2004,010702,19,16,3,6
10,2004,010702,24,21,3,2
11,2004,010702,14,10,4,5
12,2004,010702,20,19,1,3
1,2005,010702,16,14,2,9
2,2005,010702,14,13,1,8
3,2005,010702,13,10,3,15
4,2005,010702,20,19,1,5
5,2005,010702,20,18,2,4
6,2005,010702,22,20,2,8
7,2005,010702,25,21,4,1
8,2005,010702,21,18,3,6
9,2005,010702,23,20,3,11
10,2005,010702,14,13,1,6
11,2005,010702,18,17,1,7
12,2005,010702,17,13,4,3
1,2006,010702,17,15,2,5
2,2006,010702,15,13,2,4
3,2006,010702,8,8,0,3
4,2006,010702,5,4,1,0
5,2006,010702,22,18,4,5
6,2006,010702,19,19,0,4
7,2006,010702,26,23,3,10
8,2006,010702,10,9,1,10
9,2006,010702,13,12,1,3
10,2006,010702,21,21,0,4
11,2006,010702,15,14,1,6
12,2006,010702,19,15,4,2
1,2007,010702,13,11,2,6
2,2007,010702,10,8,2,7
3,2007,010702,17,15,2,6
4,2007,010702,17,14,3,5
5,2007,010702,18,16,2,4
6,2007,010702,16,11,5,5
7,2007,010702,15,14,1,4
8,2007,010702,15,15,0,4
9,2007,010702,13,10,3,6
10,2007,010702,17,17,0,4
11,2007,010702,14,13,1,8
12,2007,010702,13,11,2,5
1,2008,010702,13,10,3,4
2,2008,010702,8,7,1,6
3,2008,010702,10,9,1,3
4,2008,010702,20,16,4,4
5,2008,010702,15,11,4,4
6,2008,010702,14,11,3,7
7,2008,010702,12,10,2,3
8,2008,010702,14,13,1,8
9,2008,010702,18,16,2,4
10,2008,010702,12,11,1,4
11,2008,010702,17,15,2,4
12,2008,010702,11,9,2,4
1,2009,010702,6,6,0,2
2,2009,010702,16,14,2,3
3,2009,010702,7,7,0,9
4,2009,010702,6,6,0,1
5,2009,010702,9,8,1,2
6,2009,010702,19,17,2,0
7,2009,010702,10,7,3,4
8,2009,010702,21,16,5,4
9,2009,010702,12,12,0,4
10,2009,010702,14,10,4,1
11,2009,010702,23,21,2,1
12,2009,010702,17,14,3,3
1,2010,010702,10,7,3,7
2,2010,010702,4,4,0,2
3,2010,010702,10,10,0,3
4,2010,010702,8,5,3,5
5,2010,010702,12,9,3,3
6,2010,010702,18,14,4,2
7,2010,010702,11,8,3,3
8,2010,010702,6,5,1,1
9,2010,010702,13,13,0,3
10,2010,010702,13,13,0,1
11,2010,010702,14,12,2,0
12,2010,010702,10,7,3,1
1,2011,010702,10,8,2,4
2,2011,010702,5,5,0,4
1,1999,010501,23,17,6,1
2,1999,010501,15,15,0,1
3,1999,010501,15,15,0,2
4,1999,010501,28,25,3,2
5,1999,010501,36,33,3,0
6,1999,010501,21,20,1,4
7,1999,010501,47,42,5,5
8,1999,010501,39,34,5,3
9,1999,010501,20,18,2,4
10,1999,010501,34,33,1,7
11,1999,010501,17,15,2,2
12,1999,010501,24,22,2,6
1,2000,010501,31,29,2,5
2,2000,010501,28,26,2,12
3,2000,010501,14,12,2,6
4,2000,010501,19,18,1,5
5,2000,010501,24,21,3,7
6,2000,010501,14,12,2,10
7,2000,010501,29,26,3,13
8,2000,010501,18,17,1,4
9,2000,010501,29,27,2,3
10,2000,010501,21,15,6,6
11,2000,010501,16,15,1,6
12,2000,010501,16,14,2,4
1,2001,010501,17,15,2,13
2,2001,010501,13,12,1,16
3,2001,010501,13,13,0,7
4,2001,010501,17,15,2,3
5,2001,010501,17,16,1,3
6,2001,010501,16,16,0,1
7,2001,010501,28,25,3,5
8,2001,010501,17,14,3,6
9,2001,010501,16,13,3,8
10,2001,010501,20,17,3,3
11,2001,010501,10,9,1,2
12,2001,010501,7,6,1,4
1,2002,010501,20,20,0,7
2,2002,010501,15,10,5,1
3,2002,010501,22,19,3,3
4,2002,010501,21,15,6,1
5,2002,010501,22,22,0,4
6,2002,010501,21,20,1,5
7,2002,010501,22,21,1,2
8,2002,010501,16,15,1,4
9,2002,010501,17,17,0,3
10,2002,010501,22,19,3,3
11,2002,010501,21,19,2,8
12,2002,010501,25,25,0,5
1,2003,010501,14,12,2,13
2,2003,010501,18,15,3,10
3,2003,010501,20,19,1,2
4,2003,010501,18,16,2,6
5,2003,010501,15,14,1,10
6,2003,010501,18,15,3,12
7,2003,010501,15,14,1,6
8,2003,010501,12,12,0,3
9,2003,010501,25,24,1,2
10,2003,010501,12,12,0,5
11,2003,010501,12,12,0,6
12,2003,010501,13,12,1,3
1,2004,010501,8,7,1,5
2,2004,010501,9,8,1,5
3,2004,010501,16,15,1,0
4,2004,010501,30,29,1,6
5,2004,010501,21,20,1,2
6,2004,010501,24,23,1,2
7,2004,010501,27,27,0,2
8,2004,010501,28,26,2,7
9,2004,010501,15,12,3,8
10,2004,010501,10,9,1,1
11,2004,010501,18,17,1,3
12,2004,010501,6,4,2,6
1,2005,010501,18,15,3,3
2,2005,010501,17,17,0,8
3,2005,010501,15,14,1,1
4,2005,010501,18,16,2,5
5,2005,010501,11,10,1,1
6,2005,010501,17,17,0,9
7,2005,010501,19,17,2,7
8,2005,010501,19,16,3,8
9,2005,010501,9,9,0,8
10,2005,010501,19,16,3,5
11,2005,010501,17,14,3,5
12,2005,010501,18,15,3,7
1,2006,010501,25,24,1,6
2,2006,010501,12,12,0,4
3,2006,010501,11,11,0,8
4,2006,010501,11,9,2,5
5,2006,010501,14,12,2,5
6,2006,010501,19,16,3,5
7,2006,010501,26,23,3,5
8,2006,010501,20,20,0,7
9,2006,010501,15,13,2,5
10,2006,010501,10,8,2,6
11,2006,010501,10,10,0,2
12,2006,010501,13,10,3,3
1,2007,010501,17,16,1,11
2,2007,010501,14,13,1,17
3,2007,010501,10,7,3,8
4,2007,010501,12,11,1,4
5,2007,010501,17,15,2,9
6,2007,010501,16,15,1,4
7,2007,010501,19,18,1,8
8,2007,010501,7,7,0,5
9,2007,010501,14,14,0,9
10,2007,010501,12,12,0,8
11,2007,010501,5,4,1,3
12,2007,010501,7,4,3,0
1,2008,010501,8,8,0,6
2,2008,010501,13,12,1,3
3,2008,010501,13,10,3,7
4,2008,010501,7,5,2,4
5,2008,010501,16,15,1,4
6,2008,010501,13,10,3,5
7,2008,010501,13,13,0,2
8,2008,010501,14,13,1,1
9,2008,010501,11,10,1,2
10,2008,010501,7,6,1,5
11,2008,010501,10,8,2,3
12,2008,010501,16,14,2,3
1,2009,010501,11,10,1,9
2,2009,010501,2,2,0,2
3,2009,010501,12,12,0,1
4,2009,010501,14,13,1,0
5,2009,010501,13,10,3,6
6,2009,010501,14,14,0,5
7,2009,010501,13,12,1,1
8,2009,010501,17,14,3,8
9,2009,010501,13,11,2,2
10,2009,010501,10,8,2,2
11,2009,010501,12,12,0,4
12,2009,010501,11,10,1,3
1,2010,010501,9,9,0,1
2,2010,010501,7,6,1,4
3,2010,010501,6,6,0,3
4,2010,010501,11,10,1,1
5,2010,010501,12,11,1,3
6,2010,010501,13,12,1,1
7,2010,010501,12,12,0,6
8,2010,010501,11,10,1,2
9,2010,010501,6,5,1,2
10,2010,010501,13,12,1,4
11,2010,010501,11,10,1,3
12,2010,010501,7,5,2,1
1,2011,010501,9,7,2,1
2,2011,010501,6,6,0,3
1,1999,770602,0,0,0,0
2,1999,770602,0,0,0,0
3,1999,770602,0,0,0,0
4,1999,770602,0,0,0,0
5,1999,770602,0,0,0,0
6,1999,770602,0,0,0,0
7,1999,770602,0,0,0,0
8,1999,770602,0,0,0,0
9,1999,770602,0,0,0,0
10,1999,770602,0,0,0,0
11,1999,770602,0,0,0,0
12,1999,770602,0,0,0,0
1,2000,770602,0,0,0,0
2,2000,770602,0,0,0,0
3,2000,770602,0,0,0,0
4,2000,770602,0,0,0,0
5,2000,770602,0,0,0,0
6,2000,770602,0,0,0,0
7,2000,770602,0,0,0,0
8,2000,770602,0,0,0,0
9,2000,770602,0,0,0,0
10,2000,770602,0,0,0,0
11,2000,770602,0,0,0,0
12,2000,770602,0,0,0,0
1,2001,770602,0,0,0,0
2,2001,770602,0,0,0,0
3,2001,770602,0,0,0,0
4,2001,770602,0,0,0,0
5,2001,770602,0,0,0,0
6,2001,770602,0,0,0,0
7,2001,770602,0,0,0,0
8,2001,770602,0,0,0,0
9,2001,770602,0,0,0,0
10,2001,770602,0,0,0,0
11,2001,770602,0,0,0,0
12,2001,770602,0,0,0,0
1,2002,770602,0,0,0,0
2,2002,770602,0,0,0,0
3,2002,770602,0,0,0,0
4,2002,770602,0,0,0,0
5,2002,770602,0,0,0,0
6,2002,770602,0,0,0,0
7,2002,770602,0,0,0,0
8,2002,770602,0,0,0,0
9,2002,770602,0,0,0,0
10,2002,770602,0,0,0,0
11,2002,770602,0,0,0,0
12,2002,770602,0,0,0,0
1,2003,770602,0,0,0,0
2,2003,770602,0,0,0,0
3,2003,770602,0,0,0,0
4,2003,770602,0,0,0,0
5,2003,770602,0,0,0,0
6,2003,770602,0,0,0,0
7,2003,770602,0,0,0,0
8,2003,770602,0,0,0,0
9,2003,770602,0,0,0,0
10,2003,770602,0,0,0,0
11,2003,770602,0,0,0,0
12,2003,770602,0,0,0,0
1,2004,770602,0,0,0,0
2,2004,770602,0,0,0,0
3,2004,770602,0,0,0,0
4,2004,770602,0,0,0,0
5,2004,770602,0,0,0,0
6,2004,770602,0,0,0,0
7,2004,770602,0,0,0,0
8,2004,770602,0,0,0,0
9,2004,770602,0,0,0,0
10,2004,770602,0,0,0,0
11,2004,770602,0,0,0,0
12,2004,770602,0,0,0,0
1,2005,770602,0,0,0,0
2,2005,770602,0,0,0,0
3,2005,770602,0,0,0,0
4,2005,770602,0,0,0,0
5,2005,770602,0,0,0,0
6,2005,770602,0,0,0,0
7,2005,770602,0,0,0,0
8,2005,770602,0,0,0,0
9,2005,770602,0,0,0,0
10,2005,770602,1,1,0,0
11,2005,770602,0,0,0,0
12,2005,770602,0,0,0,0
1,2006,770602,0,0,0,0
2,2006,770602,0,0,0,0
3,2006,770602,1,1,0,0
4,2006,770602,2,2,0,0
5,2006,770602,0,0,0,0
6,2006,770602,0,0,0,0
7,2006,770602,0,0,0,0
8,2006,770602,0,0,0,0
9,2006,770602,0,0,0,0
10,2006,770602,1,1,0,0
11,2006,770602,0,0,0,0
12,2006,770602,0,0,0,0
1,2007,770602,1,1,0,0
2,2007,770602,0,0,0,0
3,2007,770602,0,0,0,0
4,2007,770602,0,0,0,0
5,2007,770602,1,1,0,0
6,2007,770602,1,1,0,0
7,2007,770602,0,0,0,0
8,2007,770602,1,1,0,0
9,2007,770602,0,0,0,0
10,2007,770602,0,0,0,0
11,2007,770602,0,0,0,0
12,2007,770602,0,0,0,0
1,2008,770602,0,0,0,0
2,2008,770602,0,0,0,0
3,2008,770602,0,0,0,0
4,2008,770602,0,0,0,0
5,2008,770602,0,0,0,0
6,2008,770602,0,0,0,0
7,2008,770602,0,0,0,0
8,2008,770602,0,0,0,0
9,2008,770602,0,0,0,0
10,2008,770602,0,0,0,0
11,2008,770602,0,0,0,0
12,2008,770602,1,1,0,0
1,2009,770602,0,0,0,0
2,2009,770602,0,0,0,0
3,2009,770602,1,1,0,0
4,2009,770602,1,1,0,0
5,2009,770602,0,0,0,0
6,2009,770602,0,0,0,0
7,2009,770602,0,0,0,0
8,2009,770602,1,1,0,0
9,2009,770602,0,0,0,0
10,2009,770602,0,0,0,0
11,2009,770602,1,1,0,0
12,2009,770602,1,1,0,0
1,2010,770602,0,0,0,0
2,2010,770602,0,0,0,0
3,2010,770602,0,0,0,0
4,2010,770602,0,0,0,0
5,2010,770602,0,0,0,0
6,2010,770602,0,0,0,0
7,2010,770602,0,0,0,0
8,2010,770602,1,1,0,0
9,2010,770602,0,0,0,0
10,2010,770602,0,0,0,0
11,2010,770602,0,0,0,0
12,2010,770602,1,1,0,0
1,2011,770602,0,0,0,0
2,2011,770602,0,0,0,0
1,1999,090100,2,2,0,2
2,1999,090100,5,5,0,1
3,1999,090100,4,4,0,0
4,1999,090100,6,3,3,1
5,1999,090100,4,4,0,1
6,1999,090100,9,7,2,0
7,1999,090100,5,5,0,0
8,1999,090100,6,6,0,4
9,1999,090100,7,7,0,1
10,1999,090100,5,5,0,2
11,1999,090100,5,3,2,1
12,1999,090100,6,6,0,1
1,2000,090100,4,4,0,0
2,2000,090100,6,5,1,0
3,2000,090100,3,3,0,2
4,2000,090100,2,2,0,1
5,2000,090100,4,4,0,0
6,2000,090100,3,2,1,0
7,2000,090100,4,4,0,0
8,2000,090100,6,6,0,0
9,2000,090100,3,3,0,0
10,2000,090100,2,2,0,0
11,2000,090100,4,4,0,0
12,2000,090100,3,2,1,4
1,2001,090100,4,4,0,2
2,2001,090100,3,1,2,0
3,2001,090100,2,2,0,1
4,2001,090100,5,4,1,0
5,2001,090100,2,2,0,4
6,2001,090100,4,3,1,2
7,2001,090100,3,3,0,4
8,2001,090100,5,4,1,5
9,2001,090100,4,4,0,0
10,2001,090100,3,3,0,1
11,2001,090100,4,4,0,2
12,2001,090100,3,3,0,0
1,2002,090100,5,5,0,2
2,2002,090100,3,3,0,1
3,2002,090100,5,5,0,0
4,2002,090100,1,1,0,1
5,2002,090100,5,5,0,0
6,2002,090100,8,7,1,2
7,2002,090100,6,5,1,0
8,2002,090100,3,2,1,0
9,2002,090100,6,6,0,1
10,2002,090100,3,2,1,0
11,2002,090100,1,1,0,0
12,2002,090100,4,4,0,0
1,2003,090100,2,1,1,0
2,2003,090100,7,7,0,1
3,2003,090100,6,6,0,1
4,2003,090100,3,3,0,0
5,2003,090100,2,2,0,1
6,2003,090100,1,1,0,1
7,2003,090100,5,3,2,0
8,2003,090100,0,0,0,1
9,2003,090100,1,1,0,1
10,2003,090100,3,3,0,0
11,2003,090100,1,0,1,0
12,2003,090100,2,2,0,0
1,2004,090100,3,3,0,1
2,2004,090100,2,2,0,0
3,2004,090100,3,3,0,0
4,2004,090100,3,3,0,1
5,2004,090100,5,5,0,0
6,2004,090100,0,0,0,0
7,2004,090100,6,5,1,0
8,2004,090100,2,2,0,0
9,2004,090100,3,3,0,1
10,2004,090100,2,2,0,0
11,2004,090100,4,3,1,0
12,2004,090100,6,5,1,3
1,2005,090100,2,2,0,1
2,2005,090100,3,3,0,1
3,2005,090100,2,2,0,1
4,2005,090100,5,5,0,1
5,2005,090100,4,3,1,1
6,2005,090100,6,6,0,2
7,2005,090100,1,1,0,2
8,2005,090100,5,5,0,1
9,2005,090100,2,2,0,2
10,2005,090100,8,8,0,0
11,2005,090100,3,3,0,0
12,2005,090100,4,4,0,0
1,2006,090100,3,3,0,1
2,2006,090100,1,1,0,1
3,2006,090100,5,5,0,1
4,2006,090100,3,3,0,0
5,2006,090100,3,3,0,0
6,2006,090100,5,4,1,2
7,2006,090100,7,7,0,1
8,2006,090100,5,4,1,3
9,2006,090100,2,1,1,0
10,2006,090100,4,3,1,0
11,2006,090100,4,3,1,0
12,2006,090100,7,7,0,1
1,2007,090100,2,2,0,1
2,2007,090100,0,0,0,1
3,2007,090100,3,3,0,0
4,2007,090100,2,2,0,1
5,2007,090100,7,6,1,2
6,2007,090100,5,5,0,1
7,2007,090100,4,4,0,0
8,2007,090100,2,2,0,0
9,2007,090100,6,6,0,1
10,2007,090100,2,2,0,1
11,2007,090100,5,5,0,0
12,2007,090100,2,2,0,0
1,2008,090100,7,7,0,0
2,2008,090100,1,1,0,0
3,2008,090100,5,5,0,2
4,2008,090100,7,7,0,0
5,2008,090100,4,4,0,1
6,2008,090100,4,4,0,0
7,2008,090100,2,2,0,2
8,2008,090100,7,7,0,1
9,2008,090100,3,3,0,1
10,2008,090100,5,5,0,0
11,2008,090100,3,3,0,0
12,2008,090100,3,3,0,0
1,2009,090100,2,2,0,1
2,2009,090100,3,3,0,0
3,2009,090100,2,2,0,0
4,2009,090100,4,4,0,0
5,2009,090100,6,6,0,1
6,2009,090100,4,4,0,0
7,2009,090100,5,5,0,0
8,2009,090100,8,7,1,0
9,2009,090100,1,1,0,2
10,2009,090100,3,3,0,1
11,2009,090100,4,4,0,1
12,2009,090100,1,1,0,1
1,2010,090100,3,3,0,0
2,2010,090100,2,2,0,1
3,2010,090100,4,4,0,1
4,2010,090100,1,1,0,0
5,2010,090100,2,2,0,2
6,2010,090100,1,1,0,0
7,2010,090100,3,3,0,2
8,2010,090100,3,3,0,0
9,2010,090100,1,1,0,0
10,2010,090100,6,5,1,0
11,2010,090100,2,2,0,0
12,2010,090100,2,1,1,4
1,2011,090100,1,1,0,0
2,2011,090100,3,3,0,0
1,1999,020200,15,15,0,0
2,1999,020200,12,11,1,0
3,1999,020200,16,15,1,3
4,1999,020200,25,24,1,0
5,1999,020200,28,27,1,1
6,1999,020200,24,23,1,3
7,1999,020200,14,11,3,0
8,1999,020200,25,25,0,1
9,1999,020200,18,18,0,1
10,1999,020200,15,14,1,1
11,1999,020200,18,17,1,0
12,1999,020200,27,27,0,0
1,2000,020200,20,20,0,0
2,2000,020200,25,24,1,1
3,2000,020200,30,27,3,1
4,2000,020200,25,22,3,0
5,2000,020200,20,18,2,3
6,2000,020200,24,23,1,2
7,2000,020200,30,28,2,2
8,2000,020200,37,33,4,1
9,2000,020200,32,31,1,0
10,2000,020200,35,35,0,0
11,2000,020200,29,29,0,1
12,2000,020200,24,24,0,2
1,2001,020200,26,26,0,1
2,2001,020200,33,31,2,2
3,2001,020200,26,26,0,1
4,2001,020200,33,33,0,3
5,2001,020200,38,36,2,0
6,2001,020200,24,23,1,1
7,2001,020200,35,34,1,2
8,2001,020200,50,50,0,0
9,2001,020200,47,47,0,0
10,2001,020200,33,32,1,2
11,2001,020200,35,33,2,4
12,2001,020200,41,41,0,0
1,2002,020200,28,27,1,0
2,2002,020200,33,31,2,2
3,2002,020200,40,38,2,0
4,2002,020200,32,32,0,0
5,2002,020200,27,26,1,3
6,2002,020200,35,33,2,1
7,2002,020200,33,31,2,0
8,2002,020200,21,21,0,1
9,2002,020200,35,33,2,0
10,2002,020200,23,23,0,0
11,2002,020200,31,29,2,1
12,2002,020200,13,12,1,3
1,2003,020200,20,20,0,0
2,2003,020200,27,26,1,4
3,2003,020200,22,21,1,1
4,2003,020200,33,32,1,0
5,2003,020200,34,34,0,0
6,2003,020200,28,26,2,3
7,2003,020200,27,27,0,0
8,2003,020200,37,36,1,0
9,2003,020200,30,30,0,1
10,2003,020200,33,32,1,3
11,2003,020200,23,23,0,0
12,2003,020200,21,18,3,1
1,2004,020200,20,19,1,3
2,2004,020200,23,21,2,2
3,2004,020200,24,24,0,1
4,2004,020200,23,23,0,5
5,2004,020200,25,24,1,0
6,2004,020200,33,33,0,2
7,2004,020200,35,35,0,1
8,2004,020200,36,35,1,0
9,2004,020200,38,34,4,0
10,2004,020200,24,24,0,0
11,2004,020200,24,24,0,3
12,2004,020200,28,28,0,1
1,2005,020200,28,28,0,1
2,2005,020200,26,25,1,6
3,2005,020200,17,17,0,5
4,2005,020200,28,27,1,0
5,2005,020200,30,30,0,1
6,2005,020200,17,15,2,6
7,2005,020200,26,25,1,3
8,2005,020200,28,26,2,3
9,2005,020200,25,25,0,5
10,2005,020200,46,45,1,1
11,2005,020200,25,24,1,1
12,2005,020200,32,30,2,3
1,2006,020200,27,23,4,1
2,2006,020200,23,22,1,2
3,2006,020200,38,38,0,1
4,2006,020200,24,23,1,3
5,2006,020200,28,28,0,2
6,2006,020200,27,26,1,6
7,2006,020200,33,33,0,2
8,2006,020200,32,31,1,4
9,2006,020200,19,19,0,1
10,2006,020200,22,21,1,4
11,2006,020200,27,25,2,0
12,2006,020200,31,31,0,0
1,2007,020200,26,26,0,1
2,2007,020200,16,15,1,0
3,2007,020200,36,36,0,2
4,2007,020200,26,23,3,3
5,2007,020200,23,22,1,2
6,2007,020200,13,13,0,1
7,2007,020200,29,29,0,0
8,2007,020200,31,29,2,1
9,2007,020200,31,30,1,2
10,2007,020200,28,28,0,4
11,2007,020200,31,30,1,3
12,2007,020200,22,21,1,3
1,2008,020200,25,24,1,2
2,2008,020200,22,22,0,3
3,2008,020200,21,19,2,1
4,2008,020200,24,24,0,2
5,2008,020200,26,25,1,5
6,2008,020200,19,19,0,8
7,2008,020200,18,18,0,3
8,2008,020200,26,25,1,10
9,2008,020200,30,29,1,1
10,2008,020200,38,38,0,1
11,2008,020200,24,24,0,2
12,2008,020200,26,26,0,1
1,2009,020200,25,24,1,5
2,2009,020200,15,15,0,4
3,2009,020200,34,32,2,4
4,2009,020200,21,21,0,4
5,2009,020200,27,25,2,1
6,2009,020200,24,24,0,1
7,2009,020200,25,24,1,1
8,2009,020200,28,28,0,0
9,2009,020200,21,20,1,1
10,2009,020200,14,13,1,5
11,2009,020200,29,28,1,1
12,2009,020200,24,24,0,2
1,2010,020200,27,27,0,1
2,2010,020200,21,21,0,4
3,2010,020200,33,32,1,5
4,2010,020200,22,21,1,4
5,2010,020200,28,27,1,2
6,2010,020200,23,22,1,3
7,2010,020200,22,22,0,5
8,2010,020200,21,21,0,2
9,2010,020200,27,25,2,0
10,2010,020200,14,13,1,1
11,2010,020200,21,21,0,1
12,2010,020200,22,22,0,4
1,2011,020200,22,21,1,0
2,2011,020200,12,12,0,2
1,1999,020100,7,6,1,0
2,1999,020100,8,8,0,1
3,1999,020100,7,6,1,0
4,1999,020100,8,8,0,2
5,1999,020100,7,6,1,0
6,1999,020100,5,5,0,0
7,1999,020100,8,8,0,0
8,1999,020100,8,8,0,1
9,1999,020100,8,8,0,2
10,1999,020100,5,5,0,0
11,1999,020100,5,5,0,0
12,1999,020100,11,9,2,0
1,2000,020100,6,5,1,0
2,2000,020100,8,8,0,0
3,2000,020100,11,11,0,0
4,2000,020100,14,14,0,0
5,2000,020100,14,14,0,1
6,2000,020100,9,8,1,0
7,2000,020100,11,10,1,0
8,2000,020100,11,6,5,1
9,2000,020100,10,10,0,0
10,2000,020100,18,18,0,2
11,2000,020100,14,14,0,0
12,2000,020100,8,7,1,0
1,2001,020100,13,13,0,1
2,2001,020100,13,11,2,0
3,2001,020100,10,10,0,1
4,2001,020100,13,12,1,0
5,2001,020100,10,8,2,0
6,2001,020100,11,10,1,0
7,2001,020100,10,9,1,0
8,2001,020100,9,9,0,1
9,2001,020100,9,9,0,0
10,2001,020100,14,13,1,1
11,2001,020100,8,7,1,0
12,2001,020100,11,9,2,0
1,2002,020100,16,15,1,0
2,2002,020100,9,8,1,1
3,2002,020100,14,14,0,0
4,2002,020100,11,11,0,1
5,2002,020100,11,11,0,0
6,2002,020100,9,9,0,0
7,2002,020100,20,16,4,0
8,2002,020100,17,17,0,0
9,2002,020100,15,15,0,3
10,2002,020100,13,13,0,1
11,2002,020100,11,9,2,3
12,2002,020100,12,12,0,1
1,2003,020100,15,13,2,0
2,2003,020100,4,4,0,2
3,2003,020100,13,12,1,0
4,2003,020100,8,7,1,2
5,2003,020100,13,10,3,2
6,2003,020100,6,6,0,0
7,2003,020100,10,9,1,4
8,2003,020100,12,12,0,1
9,2003,020100,8,7,1,0
10,2003,020100,8,8,0,0
11,2003,020100,7,6,1,0
12,2003,020100,8,8,0,1
1,2004,020100,7,6,1,2
2,2004,020100,7,7,0,1
3,2004,020100,9,9,0,0
4,2004,020100,10,9,1,0
5,2004,020100,13,13,0,4
6,2004,020100,11,9,2,0
7,2004,020100,10,10,0,0
8,2004,020100,12,11,1,1
9,2004,020100,8,8,0,0
10,2004,020100,13,12,1,0
11,2004,020100,13,13,0,1
12,2004,020100,11,11,0,0
1,2005,020100,4,4,0,0
2,2005,020100,7,7,0,1
3,2005,020100,5,4,1,0
4,2005,020100,9,8,1,1
5,2005,020100,12,11,1,0
6,2005,020100,14,12,2,1
7,2005,020100,19,18,1,0
8,2005,020100,15,12,3,2
9,2005,020100,11,10,1,0
10,2005,020100,10,10,0,0
11,2005,020100,10,5,5,2
12,2005,020100,9,9,0,3
1,2006,020100,4,3,1,1
2,2006,020100,10,10,0,2
3,2006,020100,15,14,1,2
4,2006,020100,18,17,1,0
5,2006,020100,8,8,0,3
6,2006,020100,18,18,0,1
7,2006,020100,18,16,2,2
8,2006,020100,14,13,1,0
9,2006,020100,7,7,0,2
10,2006,020100,12,12,0,2
11,2006,020100,11,11,0,1
12,2006,020100,12,12,0,0
1,2007,020100,11,10,1,1
2,2007,020100,9,9,0,1
3,2007,020100,8,8,0,4
4,2007,020100,17,17,0,0
5,2007,020100,12,12,0,4
6,2007,020100,13,12,1,2
7,2007,020100,8,7,1,2
8,2007,020100,8,7,1,0
9,2007,020100,16,16,0,0
10,2007,020100,13,13,0,1
11,2007,020100,10,8,2,1
12,2007,020100,13,12,1,0
1,2008,020100,9,7,2,2
2,2008,020100,9,8,1,0
3,2008,020100,11,10,1,2
4,2008,020100,8,7,1,2
5,2008,020100,9,9,0,1
6,2008,020100,9,7,2,0
7,2008,020100,9,6,3,2
8,2008,020100,15,14,1,6
9,2008,020100,6,6,0,4
10,2008,020100,11,10,1,4
11,2008,020100,10,8,2,2
12,2008,020100,14,14,0,0
1,2009,020100,3,2,1,0
2,2009,020100,7,7,0,1
3,2009,020100,5,3,2,0
4,2009,020100,9,9,0,6
5,2009,020100,11,10,1,0
6,2009,020100,12,12,0,0
7,2009,020100,13,11,2,5
8,2009,020100,12,9,3,1
9,2009,020100,8,8,0,1
10,2009,020100,4,4,0,1
11,2009,020100,6,6,0,2
12,2009,020100,6,6,0,1
1,2010,020100,3,3,0,2
2,2010,020100,2,2,0,1
3,2010,020100,10,9,1,0
4,2010,020100,5,4,1,2
5,2010,020100,9,9,0,3
6,2010,020100,15,14,1,1
7,2010,020100,5,4,1,3
8,2010,020100,16,16,0,1
9,2010,020100,13,12,1,4
10,2010,020100,9,9,0,1
11,2010,020100,8,7,1,1
12,2010,020100,8,8,0,3
1,2011,020100,4,3,1,0
2,2011,020100,7,7,0,1
1,1999,010201,34,26,8,9
2,1999,010201,34,29,5,1
3,1999,010201,24,21,3,15
4,1999,010201,27,21,6,14
5,1999,010201,24,19,5,6
6,1999,010201,25,18,7,5
7,1999,010201,35,20,15,3
8,1999,010201,26,24,2,12
9,1999,010201,20,17,3,15
10,1999,010201,32,29,3,9
11,1999,010201,20,15,5,8
12,1999,010201,24,18,6,3
1,2000,010201,18,17,1,9
2,2000,010201,19,13,6,9
3,2000,010201,22,17,5,9
4,2000,010201,28,23,5,4
5,2000,010201,35,29,6,13
6,2000,010201,28,24,4,11
7,2000,010201,17,12,5,7
8,2000,010201,24,21,3,2
9,2000,010201,21,19,2,10
10,2000,010201,23,19,4,12
11,2000,010201,19,15,4,12
12,2000,010201,25,24,1,4
1,2001,010201,18,14,4,8
2,2001,010201,15,14,1,5
3,2001,010201,17,13,4,3
4,2001,010201,18,15,3,9
5,2001,010201,15,12,3,10
6,2001,010201,14,12,2,0
7,2001,010201,18,17,1,9
8,2001,010201,13,11,2,7
9,2001,010201,16,13,3,9
10,2001,010201,17,16,1,7
11,2001,010201,12,10,2,11
12,2001,010201,17,14,3,4
1,2002,010201,18,14,4,12
2,2002,010201,6,6,0,11
3,2002,010201,9,9,0,5
4,2002,010201,21,17,4,11
5,2002,010201,11,7,4,4
6,2002,010201,20,13,7,10
7,2002,010201,29,21,8,17
8,2002,010201,23,19,4,6
9,2002,010201,27,20,7,6
10,2002,010201,19,16,3,14
11,2002,010201,22,18,4,7
12,2002,010201,21,18,3,2
1,2003,010201,16,12,4,5
2,2003,010201,14,11,3,4
3,2003,010201,20,18,2,2
4,2003,010201,15,12,3,11
5,2003,010201,21,18,3,9
6,2003,010201,13,10,3,4
7,2003,010201,19,17,2,7
8,2003,010201,26,20,6,5
9,2003,010201,14,12,2,11
10,2003,010201,12,7,5,3
11,2003,010201,20,18,2,6
12,2003,010201,16,16,0,20
1,2004,010201,10,9,1,6
2,2004,010201,13,12,1,4
3,2004,010201,13,12,1,5
4,2004,010201,22,18,4,4
5,2004,010201,26,25,1,9
6,2004,010201,23,20,3,14
7,2004,010201,24,21,3,11
8,2004,010201,23,22,1,6
9,2004,010201,15,14,1,7
10,2004,010201,31,25,6,5
11,2004,010201,20,17,3,10
12,2004,010201,20,18,2,15
1,2005,010201,17,14,3,7
2,2005,010201,18,15,3,4
3,2005,010201,10,9,1,6
4,2005,010201,21,18,3,16
5,2005,010201,11,11,0,16
6,2005,010201,22,17,5,22
7,2005,010201,25,19,6,11
8,2005,010201,18,16,2,11
9,2005,010201,19,17,2,7
10,2005,010201,23,17,6,10
11,2005,010201,18,17,1,6
12,2005,010201,12,10,2,6
1,2006,010201,16,13,3,12
2,2006,010201,11,8,3,13
3,2006,010201,14,13,1,8
4,2006,010201,14,10,4,9
5,2006,010201,20,19,1,6
6,2006,010201,22,19,3,18
7,2006,010201,15,12,3,11
8,2006,010201,29,24,5,7
9,2006,010201,11,10,1,16
10,2006,010201,25,23,2,8
11,2006,010201,17,15,2,10
12,2006,010201,22,18,4,4
1,2007,010201,16,16,0,11
2,2007,010201,10,9,1,8
3,2007,010201,14,13,1,9
4,2007,010201,16,15,1,5
5,2007,010201,25,20,5,7
6,2007,010201,21,20,1,4
7,2007,010201,20,20,0,6
8,2007,010201,18,15,3,7
9,2007,010201,19,16,3,7
10,2007,010201,19,17,2,5
11,2007,010201,19,17,2,4
12,2007,010201,20,16,4,6
1,2008,010201,18,15,3,6
2,2008,010201,11,7,4,3
3,2008,010201,16,12,4,4
4,2008,010201,17,13,4,6
5,2008,010201,15,15,0,4
6,2008,010201,18,14,4,5
7,2008,010201,15,14,1,9
8,2008,010201,16,14,2,10
9,2008,010201,16,15,1,5
10,2008,010201,11,10,1,6
11,2008,010201,4,4,0,5
12,2008,010201,14,11,3,2
1,2009,010201,8,7,1,3
2,2009,010201,8,6,2,4
3,2009,010201,18,14,4,3
4,2009,010201,10,6,4,8
5,2009,010201,14,14,0,3
6,2009,010201,12,7,5,3
7,2009,010201,20,16,4,9
8,2009,010201,15,12,3,7
9,2009,010201,19,19,0,6
10,2009,010201,16,12,4,7
11,2009,010201,4,3,1,8
12,2009,010201,12,11,1,8
1,2010,010201,12,9,3,3
2,2010,010201,9,9,0,3
3,2010,010201,9,8,1,7
4,2010,010201,15,14,1,8
5,2010,010201,30,25,5,5
6,2010,010201,18,17,1,3
7,2010,010201,17,13,4,2
8,2010,010201,18,16,2,3
9,2010,010201,16,16,0,4
10,2010,010201,21,20,1,4
11,2010,010201,17,15,2,2
12,2010,010201,6,6,0,7
1,2011,010201,16,13,3,5
2,2011,010201,10,10,0,4
1,1999,010202,24,20,4,11
2,1999,010202,14,13,1,5
3,1999,010202,17,16,1,10
4,1999,010202,19,17,2,3
5,1999,010202,33,30,3,7
6,1999,010202,23,22,1,11
7,1999,010202,29,26,3,4
8,1999,010202,29,22,7,13
9,1999,010202,25,20,5,6
10,1999,010202,19,15,4,4
11,1999,010202,29,23,6,3
12,1999,010202,20,19,1,2
1,2000,010202,21,19,2,1
2,2000,010202,21,17,4,4
3,2000,010202,33,32,1,10
4,2000,010202,24,21,3,5
5,2000,010202,25,22,3,8
6,2000,010202,26,24,2,9
7,2000,010202,24,21,3,7
8,2000,010202,22,22,0,7
9,2000,010202,34,31,3,7
10,2000,010202,25,21,4,7
11,2000,010202,25,25,0,8
12,2000,010202,25,23,2,6
1,2001,010202,27,26,1,12
2,2001,010202,17,17,0,10
3,2001,010202,23,19,4,14
4,2001,010202,14,8,6,5
5,2001,010202,16,13,3,10
6,2001,010202,18,16,2,6
7,2001,010202,30,29,1,3
8,2001,010202,21,20,1,2
9,2001,010202,21,19,2,3
10,2001,010202,24,19,5,8
11,2001,010202,21,21,0,4
12,2001,010202,20,18,2,9
1,2002,010202,18,17,1,5
2,2002,010202,11,9,2,14
3,2002,010202,15,14,1,5
4,2002,010202,16,14,2,14
5,2002,010202,15,12,3,11
6,2002,010202,24,22,2,12
7,2002,010202,18,16,2,17
8,2002,010202,28,25,3,11
9,2002,010202,19,15,4,8
10,2002,010202,20,19,1,6
11,2002,010202,20,18,2,7
12,2002,010202,25,23,2,5
1,2003,010202,7,7,0,9
2,2003,010202,17,15,2,10
3,2003,010202,21,19,2,7
4,2003,010202,13,9,4,13
5,2003,010202,17,12,5,8
6,2003,010202,19,15,4,8
7,2003,010202,21,20,1,9
8,2003,010202,22,19,3,5
9,2003,010202,15,11,4,5
10,2003,010202,16,15,1,8
11,2003,010202,18,15,3,6
12,2003,010202,19,17,2,11
1,2004,010202,12,10,2,10
2,2004,010202,17,14,3,7
3,2004,010202,22,19,3,7
4,2004,010202,10,9,1,6
5,2004,010202,21,19,2,8
6,2004,010202,14,13,1,6
7,2004,010202,23,21,2,8
8,2004,010202,13,11,2,5
9,2004,010202,22,21,1,8
10,2004,010202,22,19,3,9
11,2004,010202,19,17,2,8
12,2004,010202,18,16,2,5
1,2005,010202,16,12,4,7
2,2005,010202,17,13,4,17
3,2005,010202,22,18,4,7
4,2005,010202,13,12,1,16
5,2005,010202,11,7,4,4
6,2005,010202,27,24,3,10
7,2005,010202,24,22,2,11
8,2005,010202,24,24,0,12
9,2005,010202,15,12,3,10
10,2005,010202,28,26,2,8
11,2005,010202,23,21,2,8
12,2005,010202,17,16,1,11
1,2006,010202,12,12,0,6
2,2006,010202,16,14,2,8
3,2006,010202,23,22,1,8
4,2006,010202,15,14,1,11
5,2006,010202,27,23,4,9
6,2006,010202,17,16,1,9
7,2006,010202,22,22,0,8
8,2006,010202,28,26,2,9
9,2006,010202,15,15,0,8
10,2006,010202,23,19,4,7
11,2006,010202,15,14,1,4
12,2006,010202,25,25,0,3
1,2007,010202,23,21,2,2
2,2007,010202,7,7,0,0
3,2007,010202,14,11,3,7
4,2007,010202,16,13,3,4
5,2007,010202,24,20,4,6
6,2007,010202,13,13,0,9
7,2007,010202,16,14,2,2
8,2007,010202,24,22,2,8
9,2007,010202,17,14,3,5
10,2007,010202,24,23,1,5
11,2007,010202,17,17,0,5
12,2007,010202,12,12,0,7
1,2008,010202,15,15,0,8
2,2008,010202,13,11,2,11
3,2008,010202,12,10,2,8
4,2008,010202,16,16,0,4
5,2008,010202,13,12,1,12
6,2008,010202,21,19,2,5
7,2008,010202,16,16,0,10
8,2008,010202,25,23,2,13
9,2008,010202,20,20,0,6
10,2008,010202,24,20,4,6
11,2008,010202,21,17,4,9
12,2008,010202,12,10,2,4
1,2009,010202,12,11,1,6
2,2009,010202,9,8,1,6
3,2009,010202,12,12,0,3
4,2009,010202,11,11,0,9
5,2009,010202,14,13,1,5
6,2009,010202,21,21,0,3
7,2009,010202,27,24,3,13
8,2009,010202,23,20,3,6
9,2009,010202,26,23,3,7
10,2009,010202,19,14,5,3
11,2009,010202,17,17,0,6
12,2009,010202,8,7,1,7
1,2010,010202,12,11,1,13
2,2010,010202,11,11,0,11
3,2010,010202,16,14,2,11
4,2010,010202,21,20,1,13
5,2010,010202,25,22,3,7
6,2010,010202,27,26,1,3
7,2010,010202,15,10,5,7
8,2010,010202,24,23,1,8
9,2010,010202,17,12,5,4
10,2010,010202,16,13,3,3
11,2010,010202,13,11,2,5
12,2010,010202,13,13,0,3
1,2011,010202,14,13,1,3
2,2011,010202,9,9,0,2
1,1999,010300,16,10,6,3
2,1999,010300,17,14,3,4
3,1999,010300,19,14,5,5
4,1999,010300,27,27,0,11
5,1999,010300,25,18,7,3
6,1999,010300,35,33,2,11
7,1999,010300,36,33,3,5
8,1999,010300,43,40,3,12
9,1999,010300,34,29,5,6
10,1999,010300,28,25,3,15
11,1999,010300,20,18,2,6
12,1999,010300,23,22,1,8
1,2000,010300,14,9,5,4
2,2000,010300,25,22,3,5
3,2000,010300,26,21,5,11
4,2000,010300,16,16,0,7
5,2000,010300,25,21,4,7
6,2000,010300,28,22,6,11
7,2000,010300,30,26,4,3
8,2000,010300,40,38,2,9
9,2000,010300,34,32,2,5
10,2000,010300,30,28,2,6
11,2000,010300,32,31,1,6
12,2000,010300,37,36,1,7
1,2001,010300,26,22,4,5
2,2001,010300,16,13,3,4
3,2001,010300,13,13,0,5
4,2001,010300,23,22,1,3
5,2001,010300,22,20,2,6
6,2001,010300,21,19,2,11
7,2001,010300,33,31,2,8
8,2001,010300,29,28,1,6
9,2001,010300,33,32,1,4
10,2001,010300,26,23,3,5
11,2001,010300,22,20,2,7
12,2001,010300,24,21,3,1
1,2002,010300,25,23,2,4
2,2002,010300,17,17,0,3
3,2002,010300,21,18,3,8
4,2002,010300,31,30,1,5
5,2002,010300,36,34,2,5
6,2002,010300,27,27,0,2
7,2002,010300,20,18,2,4
8,2002,010300,22,20,2,5
9,2002,010300,26,22,4,6
10,2002,010300,29,25,4,8
11,2002,010300,16,15,1,2
12,2002,010300,10,10,0,4
1,2003,010300,10,10,0,3
2,2003,010300,12,11,1,2
3,2003,010300,17,17,0,5
4,2003,010300,23,20,3,3
5,2003,010300,29,28,1,9
6,2003,010300,25,25,0,5
7,2003,010300,36,33,3,6
8,2003,010300,24,24,0,4
9,2003,010300,28,27,1,4
10,2003,010300,28,26,2,2
11,2003,010300,37,34,3,7
12,2003,010300,35,34,1,2
1,2004,010300,15,13,2,10
2,2004,010300,8,8,0,2
3,2004,010300,21,16,5,1
4,2004,010300,20,16,4,5
5,2004,010300,23,21,2,3
6,2004,010300,27,24,3,2
7,2004,010300,37,34,3,4
8,2004,010300,34,33,1,5
9,2004,010300,26,23,3,2
10,2004,010300,31,29,2,8
11,2004,010300,23,22,1,5
12,2004,010300,24,23,1,4
1,2005,010300,18,17,1,9
2,2005,010300,14,12,2,6
3,2005,010300,13,12,1,12
4,2005,010300,18,15,3,11
5,2005,010300,21,18,3,13
6,2005,010300,14,14,0,5
7,2005,010300,30,26,4,7
8,2005,010300,31,31,0,10
9,2005,010300,17,15,2,19
10,2005,010300,27,24,3,7
11,2005,010300,29,27,2,4
12,2005,010300,28,28,0,8
1,2006,010300,24,22,2,9
2,2006,010300,20,17,3,8
3,2006,010300,20,19,1,6
4,2006,010300,14,14,0,5
5,2006,010300,23,21,2,1
6,2006,010300,24,23,1,5
7,2006,010300,31,30,1,5
8,2006,010300,25,23,2,10
9,2006,010300,25,25,0,5
10,2006,010300,31,28,3,6
11,2006,010300,22,22,0,1
12,2006,010300,23,21,2,3
1,2007,010300,21,17,4,4
2,2007,010300,18,14,4,4
3,2007,010300,19,18,1,7
4,2007,010300,12,12,0,6
5,2007,010300,17,17,0,3
6,2007,010300,32,31,1,3
7,2007,010300,20,15,5,1
8,2007,010300,19,18,1,1
9,2007,010300,25,22,3,5
10,2007,010300,46,41,5,10
11,2007,010300,19,18,1,8
12,2007,010300,14,12,2,2
1,2008,010300,10,9,1,4
2,2008,010300,12,9,3,6
3,2008,010300,12,10,2,3
4,2008,010300,16,16,0,6
5,2008,010300,21,16,5,8
6,2008,010300,27,25,2,4
7,2008,010300,28,27,1,5
8,2008,010300,23,22,1,2
9,2008,010300,13,11,2,8
10,2008,010300,20,19,1,3
11,2008,010300,22,20,2,3
12,2008,010300,12,9,3,3
1,2009,010300,8,7,1,1
2,2009,010300,7,5,2,5
3,2009,010300,21,19,2,3
4,2009,010300,14,12,2,3
5,2009,010300,20,19,1,3
6,2009,010300,25,22,3,5
7,2009,010300,26,25,1,6
8,2009,010300,20,18,2,2
9,2009,010300,20,17,3,3
10,2009,010300,20,20,0,1
11,2009,010300,12,11,1,3
12,2009,010300,15,14,1,3
1,2010,010300,15,13,2,4
2,2010,010300,8,6,2,7
3,2010,010300,17,14,3,9
4,2010,010300,17,17,0,6
5,2010,010300,25,24,1,4
6,2010,010300,19,19,0,0
7,2010,010300,15,14,1,6
8,2010,010300,23,22,1,5
9,2010,010300,11,10,1,4
10,2010,010300,20,19,1,2
11,2010,010300,13,12,1,2
12,2010,010300,8,6,2,1
1,2011,010300,10,7,3,5
2,2011,010300,12,10,2,4
1,1999,010100,22,15,7,43
2,1999,010100,22,12,10,36
3,1999,010100,29,23,6,15
4,1999,010100,22,19,3,18
5,1999,010100,31,27,4,13
6,1999,010100,38,29,9,23
7,1999,010100,38,33,5,16
8,1999,010100,24,23,1,55
9,1999,010100,36,28,8,26
10,1999,010100,30,26,4,20
11,1999,010100,20,13,7,16
12,1999,010100,20,17,3,18
1,2000,010100,24,17,7,13
2,2000,010100,28,22,6,34
3,2000,010100,48,32,16,26
4,2000,010100,35,28,7,19
5,2000,010100,39,32,7,22
6,2000,010100,35,26,9,24
7,2000,010100,35,28,7,15
8,2000,010100,38,29,9,24
9,2000,010100,41,35,6,16
10,2000,010100,33,23,10,19
11,2000,010100,28,24,4,15
12,2000,010100,31,27,4,17
1,2001,010100,22,19,3,16
2,2001,010100,19,15,4,19
3,2001,010100,28,26,2,21
4,2001,010100,30,24,6,12
5,2001,010100,29,23,6,22
6,2001,010100,25,21,4,17
7,2001,010100,33,27,6,14
8,2001,010100,51,44,7,22
9,2001,010100,27,22,5,19
10,2001,010100,17,11,6,17
11,2001,010100,23,19,4,19
12,2001,010100,24,21,3,15
1,2002,010100,20,19,1,13
2,2002,010100,11,10,1,15
3,2002,010100,13,8,5,15
4,2002,010100,30,26,4,23
5,2002,010100,28,21,7,14
6,2002,010100,27,18,9,14
7,2002,010100,27,22,5,10
8,2002,010100,23,19,4,24
9,2002,010100,29,26,3,14
10,2002,010100,21,18,3,16
11,2002,010100,26,22,4,10
12,2002,010100,22,20,2,13
1,2003,010100,22,17,5,25
2,2003,010100,17,15,2,18
3,2003,010100,17,13,4,21
4,2003,010100,20,15,5,18
5,2003,010100,25,21,4,6
6,2003,010100,24,20,4,17
7,2003,010100,29,22,7,7
8,2003,010100,32,30,2,5
9,2003,010100,14,13,1,13
10,2003,010100,23,22,1,6
11,2003,010100,25,24,1,14
12,2003,010100,24,20,4,11
1,2004,010100,15,12,3,9
2,2004,010100,13,11,2,16
3,2004,010100,27,18,9,18
4,2004,010100,19,19,0,19
5,2004,010100,8,8,0,12
6,2004,010100,18,12,6,8
7,2004,010100,20,18,2,19
8,2004,010100,25,21,4,11
9,2004,010100,13,12,1,8
10,2004,010100,21,20,1,10
11,2004,010100,15,13,2,8
12,2004,010100,16,15,1,8
1,2005,010100,19,17,2,13
2,2005,010100,6,5,1,12
3,2005,010100,14,12,2,15
4,2005,010100,15,10,5,15
5,2005,010100,13,12,1,15
6,2005,010100,17,11,6,14
7,2005,010100,33,28,5,18
8,2005,010100,24,21,3,22
9,2005,010100,18,15,3,27
10,2005,010100,14,13,1,17
11,2005,010100,24,17,7,14
12,2005,010100,27,23,4,11
1,2006,010100,9,6,3,14
2,2006,010100,9,6,3,14
3,2006,010100,8,6,2,18
4,2006,010100,12,10,2,20
5,2006,010100,20,16,4,14
6,2006,010100,20,16,4,9
7,2006,010100,22,17,5,17
8,2006,010100,12,11,1,16
9,2006,010100,15,12,3,14
10,2006,010100,16,12,4,9
11,2006,010100,15,14,1,11
12,2006,010100,19,16,3,13
1,2007,010100,18,16,2,19
2,2007,010100,13,12,1,14
3,2007,010100,21,19,2,26
4,2007,010100,12,10,2,8
5,2007,010100,20,19,1,16
6,2007,010100,19,14,5,18
7,2007,010100,23,21,2,11
8,2007,010100,22,18,4,13
9,2007,010100,18,14,4,18
10,2007,010100,24,23,1,18
11,2007,010100,14,12,2,22
12,2007,010100,11,8,3,13
1,2008,010100,16,15,1,13
2,2008,010100,12,10,2,15
3,2008,010100,14,13,1,14
4,2008,010100,29,27,2,15
5,2008,010100,14,10,4,18
6,2008,010100,23,20,3,14
7,2008,010100,39,32,7,21
8,2008,010100,28,23,5,18
9,2008,010100,23,18,5,23
10,2008,010100,27,19,8,12
11,2008,010100,13,12,1,9
12,2008,010100,15,10,5,6
1,2009,010100,15,13,2,18
2,2009,010100,9,7,2,14
3,2009,010100,15,13,2,13
4,2009,010100,13,9,4,17
5,2009,010100,21,19,2,17
6,2009,010100,24,21,3,16
7,2009,010100,28,25,3,14
8,2009,010100,21,17,4,11
9,2009,010100,20,17,3,11
10,2009,010100,11,6,5,17
11,2009,010100,17,15,2,11
12,2009,010100,11,9,2,13
1,2010,010100,12,11,1,15
2,2010,010100,12,11,1,20
3,2010,010100,15,13,2,19
4,2010,010100,31,26,5,13
5,2010,010100,23,18,5,21
6,2010,010100,15,10,5,9
7,2010,010100,18,14,4,12
8,2010,010100,18,13,5,22
9,2010,010100,18,15,3,12
10,2010,010100,14,11,3,18
11,2010,010100,13,8,5,15
12,2010,010100,11,7,4,4
1,2011,010100,14,10,4,5
2,2011,010100,7,7,0,8
